C행정구역별(읍면동),행정구역별(읍면동),C연령별,연령별,시점,총인구(명),총인구_남자(명),총인구_여자(명),총인구_성비,내국인(명),내국인_남자(명),내국인_여자(명),내국인_성비
'00,전국,'000,합계,2019,51779203,25952070,25827133,100.5,50000285,24934662,25065623,99.5
'00,전국,'005,0~4세,2019,1881548,965211,916337,105.3,1841730,944850,896880,105.3
'00,전국,'005001, 0세,2019,311988,160253,151735,105.6,305221,156770,148451,105.6
'00,전국,'005002, 1세,2019,338085,173663,164422,105.6,330199,169587,160612,105.6
'00,전국,'005003, 2세,2019,370324,190316,180008,105.7,361757,185961,175796,105.8
'00,전국,'005004, 3세,2019,420211,214942,205269,104.7,411248,210376,200872,104.7
'00,전국,'005005, 4세,2019,440940,226037,214903,105.2,433305,222156,211149,105.2
'00,전국,'010,5~9세,2019,2276617,1168966,1107651,105.5,2251185,1156094,1095091,105.6
'00,전국,'010001, 5세,2019,435405,222928,212477,104.9,428790,219583,209207,105
'00,전국,'010002, 6세,2019,440443,225515,214928,104.9,434852,222749,212103,105
'00,전국,'010003, 7세,2019,478152,245603,232549,105.6,472902,242974,229928,105.7
'00,전국,'010004, 8세,2019,470751,241858,228893,105.7,466543,239680,226863,105.6
'00,전국,'010005, 9세,2019,451866,233062,218804,106.5,448098,231108,216990,106.5
'00,전국,'015,10~14세,2019,2234015,1152447,1081568,106.6,2219036,1144862,1074174,106.6
'00,전국,'015001, 10세,2019,437398,225446,211952,106.4,433893,223672,210221,106.4
'00,전국,'015002, 11세,2019,461579,237412,224167,105.9,458245,235678,222567,105.9
'00,전국,'015003, 12세,2019,473043,243515,229528,106.1,470031,242012,228019,106.1
'00,전국,'015004, 13세,2019,434062,224673,209389,107.3,431496,223377,208119,107.3
'00,전국,'015005, 14세,2019,427933,221401,206532,107.2,425371,220123,205248,107.2
'00,전국,'020,15~19세,2019,2637341,1371661,1265680,108.4,2595613,1352018,1243595,108.7
'00,전국,'020001, 15세,2019,466023,241734,224289,107.8,463490,240450,223040,107.8
'00,전국,'020002, 16세,2019,474134,246325,227809,108.1,471891,245224,226667,108.2
'00,전국,'020003, 17세,2019,490777,255959,234818,109,487502,254293,233209,109
'00,전국,'020004, 18세,2019,567632,295145,272487,108.3,557999,290807,267192,108.8
'00,전국,'020005, 19세,2019,638775,332498,306277,108.6,614731,321244,293487,109.5
'00,전국,'025,20~24세,2019,3413656,1806316,1607340,112.4,3203741,1690943,1512798,111.8
'00,전국,'025001, 20세,2019,628950,330032,298918,110.4,596772,314462,282310,111.4
'00,전국,'025002, 21세,2019,658817,347551,311266,111.7,620194,327480,292714,111.9
'00,전국,'025003, 22세,2019,687736,361347,326389,110.7,645322,338160,307162,110.1
'00,전국,'025004, 23세,2019,712868,379014,333854,113.5,666222,352196,314026,112.2
'00,전국,'025005, 24세,2019,725285,388372,336913,115.3,675231,358645,316586,113.3
'00,전국,'030,25~29세,2019,3612505,1938641,1673864,115.8,3343423,1771185,1572238,112.7
'00,전국,'030001, 25세,2019,735154,396434,338720,117,684597,365508,319089,114.5
'00,전국,'030002, 26세,2019,739933,398759,341174,116.9,687572,366131,321441,113.9
'00,전국,'030003, 27세,2019,748772,400824,347948,115.2,695028,367068,327960,111.9
'00,전국,'030004, 28세,2019,707556,377700,329856,114.5,653508,343998,309510,111.1
'00,전국,'030005, 29세,2019,681090,364924,316166,115.4,622718,328480,294238,111.6
'00,전국,'035,30~34세,2019,3304679,1745076,1559603,111.9,3029678,1573520,1456158,108.1
'00,전국,'035001, 30세,2019,662457,354427,308030,115.1,605759,318968,286791,111.2
'00,전국,'035002, 31세,2019,650178,344199,305979,112.5,593187,308901,284286,108.7
'00,전국,'035003, 32세,2019,655448,343605,311843,110.2,598173,307834,290339,106
'00,전국,'035004, 33세,2019,663266,349602,313664,111.5,609588,316101,293487,107.7
'00,전국,'035005, 34세,2019,673330,353243,320087,110.4,622971,321716,301255,106.8
'00,전국,'040,35~39세,2019,3999744,2070152,1929592,107.3,3791256,1939621,1851635,104.8
'00,전국,'040001, 35세,2019,701935,366003,335932,109,654826,336333,318493,105.6
'00,전국,'040002, 36세,2019,771572,400080,371492,107.7,727245,372183,355062,104.8
'00,전국,'040003, 37세,2019,838657,432846,405811,106.7,794871,405581,389290,104.2
'00,전국,'040004, 38세,2019,834261,433186,401075,108,796674,409733,386941,105.9
'00,전국,'040005, 39세,2019,853319,438037,415282,105.5,817640,415791,401849,103.5
'00,전국,'045,40~44세,2019,3855403,1974200,1881203,104.9,3707290,1884344,1822946,103.4
'00,전국,'045001, 40세,2019,809471,415259,394212,105.3,774313,393501,380812,103.3
'00,전국,'045002, 41세,2019,742111,381844,360267,106,710751,362668,348083,104.2
'00,전국,'045003, 42세,2019,765187,390888,374299,104.4,737038,373804,363234,102.9
'00,전국,'045004, 43세,2019,749787,385346,364441,105.7,722162,368644,353518,104.3
'00,전국,'045005, 44세,2019,788847,400863,387984,103.3,763026,385727,377299,102.2
'00,전국,'050,45~49세,2019,4449226,2263200,2186026,103.5,4307141,2182319,2124822,102.7
'00,전국,'050001, 45세,2019,863228,440719,422509,104.3,837041,425429,411612,103.4
'00,전국,'050002, 46세,2019,873150,440690,432460,101.9,845741,424903,420838,101
'00,전국,'050003, 47세,2019,875984,449111,426873,105.2,847107,432495,414612,104.3
'00,전국,'050004, 48세,2019,934116,475285,458831,103.6,904447,458648,445799,102.9
'00,전국,'050005, 49세,2019,902748,457395,445353,102.7,872805,440844,431961,102.1
'00,전국,'055,50~54세,2019,4322368,2170535,2151833,100.9,4191706,2101302,2090404,100.5
'00,전국,'055001, 50세,2019,914395,459820,454575,101.2,886649,444824,441825,100.7
'00,전국,'055002, 51세,2019,911915,454779,457136,99.5,884228,439855,444373,99
'00,전국,'055003, 52세,2019,834016,414255,419761,98.7,810829,402030,408799,98.3
'00,전국,'055004, 53세,2019,818720,419353,399367,105,793568,406236,387332,104.9
'00,전국,'055005, 54세,2019,843322,422328,420994,100.3,816432,408357,408075,100.1
'00,전국,'060,55~59세,2019,4285702,2143941,2141761,100.1,4167929,2084851,2083078,100.1
'00,전국,'060001, 55세,2019,783884,395012,388872,101.6,757542,381563,375979,101.5
'00,전국,'060002, 56세,2019,836108,424476,411632,103.1,805688,409099,396589,103.2
'00,전국,'060003, 57세,2019,845643,426989,418654,102,822170,415237,406933,102
'00,전국,'060004, 58세,2019,913761,452434,461327,98.1,898200,444850,453350,98.1
'00,전국,'060005, 59세,2019,906306,445030,461276,96.5,884329,434102,450227,96.4
'00,전국,'065,60~64세,2019,3689408,1816973,1872435,97,3604994,1775178,1829816,97
'00,전국,'065001, 60세,2019,810912,400631,410281,97.6,792916,391650,401266,97.6
'00,전국,'065002, 61세,2019,756359,375991,380368,98.8,737427,366603,370824,98.9
'00,전국,'065003, 62세,2019,747594,370702,376892,98.4,729286,361582,367704,98.3
'00,전국,'065004, 63세,2019,677686,332795,344891,96.5,662587,325392,337195,96.5
'00,전국,'065005, 64세,2019,696857,336854,360003,93.6,682778,329951,352827,93.5
'00,전국,'070,65~69세,2019,2492232,1199690,1292542,92.8,2450215,1179719,1270496,92.9
'00,전국,'070001, 65세,2019,580957,283164,297793,95.1,568790,277289,291501,95.1
'00,전국,'070002, 66세,2019,509730,245608,264122,93,500165,240999,259166,93
'00,전국,'070003, 67세,2019,555364,267548,287816,93,547181,263666,283515,93
'00,전국,'070004, 68세,2019,408047,194964,213083,91.5,401417,191877,209540,91.6
'00,전국,'070005, 69세,2019,438134,208406,229728,90.7,432662,205888,226774,90.8
'00,전국,'075,70~74세,2019,1926601,896925,1029676,87.1,1911438,890402,1021036,87.2
'00,전국,'075001, 70세,2019,442822,209763,233059,90,438039,207603,230436,90.1
'00,전국,'075002, 71세,2019,427721,201862,225859,89.4,424433,200430,224003,89.5
'00,전국,'075003, 72세,2019,424201,196281,227920,86.1,421271,195048,226223,86.2
'00,전국,'075004, 73세,2019,318908,147808,171100,86.4,316565,146862,169703,86.5
'00,전국,'075005, 74세,2019,312949,141211,171738,82.2,311130,140459,170671,82.3
'00,전국,'080,75~79세,2019,1595168,676049,919119,73.6,1588073,673589,914484,73.7
'00,전국,'080001, 75세,2019,318684,139595,179089,77.9,317057,138972,178085,78
'00,전국,'080002, 76세,2019,325646,141039,184607,76.4,324235,140546,183689,76.5
'00,전국,'080003, 77세,2019,378506,161431,217075,74.4,377100,160944,216156,74.5
'00,전국,'080004, 78세,2019,300716,124973,175743,71.1,299352,124532,174820,71.2
'00,전국,'080005, 79세,2019,271616,109011,162605,67,270329,108595,161734,67.1
'00,전국,'085,80~84세,2019,1075010,396231,678779,58.4,1070623,394900,675723,58.4
'00,전국,'085001, 80세,2019,266485,104669,161816,64.7,265389,104358,161031,64.8
'00,전국,'085002, 81세,2019,235056,89397,145659,61.4,233995,89086,144909,61.5
'00,전국,'085003, 82세,2019,211272,77803,133469,58.3,210376,77509,132867,58.3
'00,전국,'085004, 83세,2019,188546,66370,122176,54.3,187802,66142,121660,54.4
'00,전국,'085005, 84세,2019,173651,57992,115659,50.1,173061,57805,115256,50.2
'00,전국,'086,85세이상,2019,727980,195856,532124,36.8,725214,194965,530249,36.8
'00,전국,'090,85~89세,2019,511197,148298,362899,40.9,509347,147716,361631,40.8
'00,전국,'090001, 85세,2019,144227,46223,98004,47.2,143683,46053,97630,47.2
'00,전국,'090002, 86세,2019,118820,35868,82952,43.2,118366,35727,82639,43.2
'00,전국,'090003, 87세,2019,102044,29217,72827,40.1,101728,29112,72616,40.1
'00,전국,'090004, 88세,2019,76970,20383,56587,36,76685,20288,56397,36
'00,전국,'090005, 89세,2019,69136,16607,52529,31.6,68885,16536,52349,31.6
'00,전국,'095,90~94세,2019,173427,38990,134437,29,172793,38783,134010,28.9
'00,전국,'095001, 90세,2019,56128,13911,42217,33,55933,13847,42086,32.9
'00,전국,'095002, 91세,2019,44024,9915,34109,29.1,43882,9863,34019,29
'00,전국,'095003, 92세,2019,33483,7221,26262,27.5,33365,7186,26179,27.4
'00,전국,'095004, 93세,2019,22112,4525,17587,25.7,22012,4487,17525,25.6
'00,전국,'095005, 94세,2019,17680,3418,14262,24,17601,3400,14201,23.9
'00,전국,'100,95~99세,2019,38482,7760,30722,25.3,38255,7683,30572,25.1
'00,전국,'100001, 95세,2019,11864,2546,9318,27.3,11806,2527,9279,27.2
'00,전국,'100002, 96세,2019,11347,2332,9015,25.9,11282,2308,8974,25.7
'00,전국,'100003, 97세,2019,7603,1457,6146,23.7,7556,1444,6112,23.6
'00,전국,'100004, 98세,2019,4568,857,3711,23.1,4539,847,3692,22.9
'00,전국,'100005, 99세,2019,3100,568,2532,22.4,3072,557,2515,22.1
'00,전국,'101,100세이상,2019,4874,808,4066,19.9,4819,783,4036,19.4
'00,전국,'102,15세미만,2019,6392180,3286624,3105556,105.8,6311951,3245806,3066145,105.9
'00,전국,'103,15~64세,2019,37570032,19300695,18269337,105.6,35942771,18355281,17587490,104.4
'00,전국,'104,65세이상,2019,7816991,3364751,4452240,75.6,7745563,3333575,4411988,75.6
'00,전국,'126,평균연령,2019,42.4,41.2,43.6,,42.5,41.3,43.7,
'00,전국,'127,중위연령,2019,43.3,41.9,44.7,,43.7,42.4,45,
'04,읍부,'000,합계,2019,5057507,2599416,2458091,105.7,4839016,2459087,2379929,103.3
'04,읍부,'005,0~4세,2019,203163,104195,98968,105.3,199442,102293,97149,105.3
'04,읍부,'005001, 0세,2019,33339,17203,16136,106.6,32709,16867,15842,106.5
'04,읍부,'005002, 1세,2019,36624,18623,18001,103.5,35891,18270,17621,103.7
'04,읍부,'005003, 2세,2019,39971,20366,19605,103.9,39149,19962,19187,104
'04,읍부,'005004, 3세,2019,45495,23354,22141,105.5,44662,22915,21747,105.4
'04,읍부,'005005, 4세,2019,47734,24649,23085,106.8,47031,24279,22752,106.7
'04,읍부,'010,5~9세,2019,250511,128663,121848,105.6,247997,127415,120582,105.7
'04,읍부,'010001, 5세,2019,47405,24239,23166,104.6,46748,23914,22834,104.7
'04,읍부,'010002, 6세,2019,48495,24837,23658,105,47919,24547,23372,105
'04,읍부,'010003, 7세,2019,52696,27106,25590,105.9,52204,26872,25332,106.1
'04,읍부,'010004, 8세,2019,52390,26892,25498,105.5,51962,26681,25281,105.5
'04,읍부,'010005, 9세,2019,49525,25589,23936,106.9,49164,25401,23763,106.9
'04,읍부,'015,10~14세,2019,239851,123990,115861,107,238245,123181,115064,107.1
'04,읍부,'015001, 10세,2019,47845,24576,23269,105.6,47468,24380,23088,105.6
'04,읍부,'015002, 11세,2019,50295,25926,24369,106.4,49937,25743,24194,106.4
'04,읍부,'015003, 12세,2019,50459,25924,24535,105.7,50138,25766,24372,105.7
'04,읍부,'015004, 13세,2019,46013,23955,22058,108.6,45761,23823,21938,108.6
'04,읍부,'015005, 14세,2019,45239,23609,21630,109.1,44941,23469,21472,109.3
'04,읍부,'020,15~19세,2019,271740,142387,129353,110.1,267482,140165,127317,110.1
'04,읍부,'020001, 15세,2019,48296,25170,23126,108.8,48028,25027,23001,108.8
'04,읍부,'020002, 16세,2019,50744,26202,24542,106.8,50480,26081,24399,106.9
'04,읍부,'020003, 17세,2019,53195,27545,25650,107.4,52887,27379,25508,107.3
'04,읍부,'020004, 18세,2019,58310,30426,27884,109.1,57365,29931,27434,109.1
'04,읍부,'020005, 19세,2019,61195,33044,28151,117.4,58722,31747,26975,117.7
'04,읍부,'025,20~24세,2019,304366,173158,131208,132,279923,157014,122909,127.7
'04,읍부,'025001, 20세,2019,59636,32964,26672,123.6,56586,31251,25335,123.4
'04,읍부,'025002, 21세,2019,60382,33739,26643,126.6,56339,31318,25021,125.2
'04,읍부,'025003, 22세,2019,61322,34407,26915,127.8,56508,31244,25264,123.7
'04,읍부,'025004, 23세,2019,61504,35790,25714,139.2,55628,31673,23955,132.2
'04,읍부,'025005, 24세,2019,61522,36258,25264,143.5,54862,31528,23334,135.1
'04,읍부,'030,25~29세,2019,303201,175272,127929,137,262865,146616,116249,126.1
'04,읍부,'030001, 25세,2019,60920,35918,25002,143.7,53613,30635,22978,133.3
'04,읍부,'030002, 26세,2019,61287,35525,25762,137.9,53400,29897,23503,127.2
'04,읍부,'030003, 27세,2019,62414,35843,26571,134.9,54153,29958,24195,123.8
'04,읍부,'030004, 28세,2019,59464,34238,25226,135.7,51281,28463,22818,124.7
'04,읍부,'030005, 29세,2019,59116,33748,25368,133,50418,27663,22755,121.6
'04,읍부,'035,30~34세,2019,301471,166528,134943,123.4,261216,138604,122612,113
'04,읍부,'035001, 30세,2019,58023,33136,24887,133.1,49560,27128,22432,120.9
'04,읍부,'035002, 31세,2019,58179,32363,25816,125.4,49783,26517,23266,114
'04,읍부,'035003, 32세,2019,60237,32914,27323,120.5,51973,27219,24754,110
'04,읍부,'035004, 33세,2019,61462,33559,27903,120.3,53763,28276,25487,110.9
'04,읍부,'035005, 34세,2019,63570,34556,29014,119.1,56137,29464,26673,110.5
'04,읍부,'040,35~39세,2019,394492,209030,185462,112.7,364452,188553,175899,107.2
'04,읍부,'040001, 35세,2019,67535,36176,31359,115.4,60638,31419,29219,107.5
'04,읍부,'040002, 36세,2019,74677,39642,35035,113.1,68321,35210,33111,106.3
'04,읍부,'040003, 37세,2019,83109,43708,39401,110.9,76861,39463,37398,105.5
'04,읍부,'040004, 38세,2019,82924,44430,38494,115.4,77390,40701,36689,110.9
'04,읍부,'040005, 39세,2019,86247,45074,41173,109.5,81242,41760,39482,105.8
'04,읍부,'045,40~44세,2019,390080,205613,184467,111.5,370160,192718,177442,108.6
'04,읍부,'045001, 40세,2019,81524,42688,38836,109.9,76698,39534,37164,106.4
'04,읍부,'045002, 41세,2019,76010,40102,35908,111.7,71684,37227,34457,108
'04,읍부,'045003, 42세,2019,77872,41005,36867,111.2,74046,38524,35522,108.5
'04,읍부,'045004, 43세,2019,75515,40138,35377,113.5,71835,37761,34074,110.8
'04,읍부,'045005, 44세,2019,79159,41680,37479,111.2,75897,39672,36225,109.5
'04,읍부,'050,45~49세,2019,433622,231468,202154,114.5,417220,221714,195506,113.4
'04,읍부,'050001, 45세,2019,86449,46091,40358,114.2,83153,44060,39093,112.7
'04,읍부,'050002, 46세,2019,85971,45513,40458,112.5,82784,43595,39189,111.2
'04,읍부,'050003, 47세,2019,85198,45786,39412,116.2,81851,43777,38074,115
'04,읍부,'050004, 48세,2019,89952,48180,41772,115.3,86691,46291,40400,114.6
'04,읍부,'050005, 49세,2019,86052,45898,40154,114.3,82741,43991,38750,113.5
'04,읍부,'055,50~54세,2019,410181,216088,194093,111.3,396816,208746,188070,111
'04,읍부,'055001, 50세,2019,87258,46165,41093,112.3,84265,44490,39775,111.9
'04,읍부,'055002, 51세,2019,86810,45657,41153,110.9,83897,44038,39859,110.5
'04,읍부,'055003, 52세,2019,78469,40941,37528,109.1,76042,39625,36417,108.8
'04,읍부,'055004, 53세,2019,78492,42062,36430,115.5,76000,40716,35284,115.4
'04,읍부,'055005, 54세,2019,79152,41263,37889,108.9,76612,39877,36735,108.6
'04,읍부,'060,55~59세,2019,402412,208649,193763,107.7,392351,203349,189002,107.6
'04,읍부,'060001, 55세,2019,73308,38626,34682,111.4,70938,37354,33584,111.2
'04,읍부,'060002, 56세,2019,77813,40886,36927,110.7,75287,39539,35748,110.6
'04,읍부,'060003, 57세,2019,79623,41758,37865,110.3,77608,40683,36925,110.2
'04,읍부,'060004, 58세,2019,86985,44497,42488,104.7,85571,43781,41790,104.8
'04,읍부,'060005, 59세,2019,84683,42882,41801,102.6,82947,41992,40955,102.5
'04,읍부,'065,60~64세,2019,346874,174227,172647,100.9,340593,171000,169593,100.8
'04,읍부,'065001, 60세,2019,75988,38425,37563,102.3,74590,37730,36860,102.4
'04,읍부,'065002, 61세,2019,70912,36028,34884,103.3,69462,35252,34210,103
'04,읍부,'065003, 62세,2019,70573,35729,34844,102.5,69218,35036,34182,102.5
'04,읍부,'065004, 63세,2019,63998,32059,31939,100.4,62879,31485,31394,100.3
'04,읍부,'065005, 64세,2019,65403,31986,33417,95.7,64444,31497,32947,95.6
'04,읍부,'070,65~69세,2019,239755,116003,123752,93.7,236735,114491,122244,93.7
'04,읍부,'070001, 65세,2019,55297,27053,28244,95.8,54395,26605,27790,95.7
'04,읍부,'070002, 66세,2019,48169,23572,24597,95.8,47508,23226,24282,95.7
'04,읍부,'070003, 67세,2019,53678,26060,27618,94.4,53122,25788,27334,94.3
'04,읍부,'070004, 68세,2019,40102,19196,20906,91.8,39611,18957,20654,91.8
'04,읍부,'070005, 69세,2019,42509,20122,22387,89.9,42099,19915,22184,89.8
'04,읍부,'075,70~74세,2019,191446,89773,101673,88.3,190249,89248,101001,88.4
'04,읍부,'075001, 70세,2019,43772,20770,23002,90.3,43422,20611,22811,90.4
'04,읍부,'075002, 71세,2019,42104,20043,22061,90.9,41835,19932,21903,91
'04,읍부,'075003, 72세,2019,42222,19971,22251,89.8,41976,19871,22105,89.9
'04,읍부,'075004, 73세,2019,31680,14776,16904,87.4,31491,14688,16803,87.4
'04,읍부,'075005, 74세,2019,31668,14213,17455,81.4,31525,14146,17379,81.4
'04,읍부,'080,75~79세,2019,168205,69275,98930,70,167645,69057,98588,70
'04,읍부,'080001, 75세,2019,32418,13966,18452,75.7,32287,13904,18383,75.6
'04,읍부,'080002, 76세,2019,33931,14323,19608,73,33810,14275,19535,73.1
'04,읍부,'080003, 77세,2019,39939,16493,23446,70.3,39831,16454,23377,70.4
'04,읍부,'080004, 78세,2019,32293,12963,19330,67.1,32184,12916,19268,67
'04,읍부,'080005, 79세,2019,29624,11530,18094,63.7,29533,11508,18025,63.8
'04,읍부,'085,80~84세,2019,121220,43198,78022,55.4,120897,43094,77803,55.4
'04,읍부,'085001, 80세,2019,29843,11235,18608,60.4,29764,11213,18551,60.4
'04,읍부,'085002, 81세,2019,26343,9751,16592,58.8,26265,9731,16534,58.9
'04,읍부,'085003, 82세,2019,23612,8462,15150,55.9,23525,8426,15099,55.8
'04,읍부,'085004, 83세,2019,21549,7366,14183,51.9,21504,7352,14152,52
'04,읍부,'085005, 84세,2019,19873,6384,13489,47.3,19839,6372,13467,47.3
'04,읍부,'086,85세이상,2019,84917,21899,63018,34.8,84728,21829,62899,34.7
'04,읍부,'090,85~89세,2019,59597,16665,42932,38.8,59481,16622,42859,38.8
'04,읍부,'090001, 85세,2019,16747,5207,11540,45.1,16710,5193,11517,45.1
'04,읍부,'090002, 86세,2019,13824,4054,9770,41.5,13792,4040,9752,41.4
'04,읍부,'090003, 87세,2019,12115,3280,8835,37.1,12098,3276,8822,37.1
'04,읍부,'090004, 88세,2019,8855,2230,6625,33.7,8837,2225,6612,33.7
'04,읍부,'090005, 89세,2019,8056,1894,6162,30.7,8044,1888,6156,30.7
'04,읍부,'095,90~94세,2019,20129,4265,15864,26.9,20083,4248,15835,26.8
'04,읍부,'095001, 90세,2019,6511,1562,4949,31.6,6497,1558,4939,31.5
'04,읍부,'095002, 91세,2019,5003,1058,3945,26.8,4992,1051,3941,26.7
'04,읍부,'095003, 92세,2019,3908,763,3145,24.3,3900,760,3140,24.2
'04,읍부,'095004, 93세,2019,2616,504,2112,23.9,2609,502,2107,23.8
'04,읍부,'095005, 94세,2019,2091,378,1713,22.1,2085,377,1708,22.1
'04,읍부,'100,95~99세,2019,4627,880,3747,23.5,4601,870,3731,23.3
'04,읍부,'100001, 95세,2019,1382,299,1083,27.6,1379,297,1082,27.4
'04,읍부,'100002, 96세,2019,1422,250,1172,21.3,1417,249,1168,21.3
'04,읍부,'100003, 97세,2019,910,172,738,23.3,902,169,733,23.1
'04,읍부,'100004, 98세,2019,551,105,446,23.5,548,105,443,23.7
'04,읍부,'100005, 99세,2019,362,54,308,17.5,355,50,305,16.4
'04,읍부,'101,100세이상,2019,564,89,475,18.7,563,89,474,18.8
'04,읍부,'102,15세미만,2019,693525,356848,336677,106,685684,352889,332795,106
'04,읍부,'103,15~64세,2019,3558439,1902420,1656019,114.9,3353078,1768479,1584599,111.6
'04,읍부,'104,65세이상,2019,805543,340148,465395,73.1,800254,337719,462535,73
'04,읍부,'126,평균연령,2019,42.3,40.9,43.8,,42.6,41.3,44,
'04,읍부,'127,중위연령,2019,43.3,41.8,45,,44,42.8,45.4,
'05,면부,'000,합계,2019,4698591,2447379,2251212,108.7,4415652,2244382,2171270,103.4
'05,면부,'005,0~4세,2019,115629,59143,56486,104.7,113714,58227,55487,104.9
'05,면부,'005001, 0세,2019,20043,10273,9770,105.1,19746,10146,9600,105.7
'05,면부,'005002, 1세,2019,21247,10799,10448,103.4,20870,10625,10245,103.7
'05,면부,'005003, 2세,2019,22771,11769,11002,107,22356,11557,10799,107
'05,면부,'005004, 3세,2019,25263,12827,12436,103.1,24824,12615,12209,103.3
'05,면부,'005005, 4세,2019,26305,13475,12830,105,25918,13284,12634,105.1
'05,면부,'010,5~9세,2019,134987,69865,65122,107.3,133633,69181,64452,107.3
'05,면부,'010001, 5세,2019,26076,13313,12763,104.3,25718,13121,12597,104.2
'05,면부,'010002, 6세,2019,25919,13422,12497,107.4,25641,13283,12358,107.5
'05,면부,'010003, 7세,2019,28009,14453,13556,106.6,27724,14308,13416,106.6
'05,면부,'010004, 8세,2019,28205,14800,13405,110.4,27979,14690,13289,110.5
'05,면부,'010005, 9세,2019,26778,13877,12901,107.6,26571,13779,12792,107.7
'05,면부,'015,10~14세,2019,129885,67786,62099,109.2,128973,67309,61664,109.2
'05,면부,'015001, 10세,2019,25874,13425,12449,107.8,25663,13318,12345,107.9
'05,면부,'015002, 11세,2019,26976,13989,12987,107.7,26761,13879,12882,107.7
'05,면부,'015003, 12세,2019,26761,13928,12833,108.5,26584,13834,12750,108.5
'05,면부,'015004, 13세,2019,25296,13335,11961,111.5,25140,13253,11887,111.5
'05,면부,'015005, 14세,2019,24978,13109,11869,110.4,24825,13025,11800,110.4
'05,면부,'020,15~19세,2019,168858,91587,77271,118.5,165861,89886,75975,118.3
'05,면부,'020001, 15세,2019,27222,14454,12768,113.2,27059,14378,12681,113.4
'05,면부,'020002, 16세,2019,28688,15289,13399,114.1,28520,15186,13334,113.9
'05,면부,'020003, 17세,2019,29675,16001,13674,117,29436,15856,13580,116.8
'05,면부,'020004, 18세,2019,36985,19913,17072,116.6,36317,19552,16765,116.6
'05,면부,'020005, 19세,2019,46288,25930,20358,127.4,44529,24914,19615,127
'05,면부,'025,20~24세,2019,239995,144846,95149,152.2,202989,118190,84799,139.4
'05,면부,'025001, 20세,2019,43791,24926,18865,132.1,40477,22788,17689,128.8
'05,면부,'025002, 21세,2019,45942,26514,19428,136.5,40384,22783,17601,129.4
'05,면부,'025003, 22세,2019,48341,28713,19628,146.3,40850,23433,17417,134.5
'05,면부,'025004, 23세,2019,50183,31457,18726,168,40692,24412,16280,150
'05,면부,'025005, 24세,2019,51738,33236,18502,179.6,40586,24774,15812,156.7
'05,면부,'030,25~29세,2019,257797,164343,93454,175.9,193197,114860,78337,146.6
'05,면부,'030001, 25세,2019,52018,33548,18470,181.6,40079,24421,15658,156
'05,면부,'030002, 26세,2019,52254,33469,18785,178.2,39293,23581,15712,150.1
'05,면부,'030003, 27세,2019,52798,33588,19210,174.8,39517,23338,16179,144.2
'05,면부,'030004, 28세,2019,50414,31818,18596,171.1,37477,21876,15601,140.2
'05,면부,'030005, 29세,2019,50313,31920,18393,173.5,36831,21644,15187,142.5
'05,면부,'035,30~34세,2019,238668,148034,90634,163.3,180350,103241,77109,133.9
'05,면부,'035001, 30세,2019,48351,30702,17649,174,35691,20883,14808,141
'05,면부,'035002, 31세,2019,47927,29924,18003,166.2,35603,20520,15083,136
'05,면부,'035003, 32세,2019,47876,29424,18452,159.5,35938,20286,15652,129.6
'05,면부,'035004, 33세,2019,47414,29270,18144,161.3,36417,20846,15571,133.9
'05,면부,'035005, 34세,2019,47100,28714,18386,156.2,36701,20706,15995,129.5
'05,면부,'040,35~39세,2019,263463,155631,107832,144.3,222426,124844,97582,127.9
'05,면부,'040001, 35세,2019,48367,28950,19417,149.1,38849,21709,17140,126.7
'05,면부,'040002, 36세,2019,51694,30597,21097,145,42810,23833,18977,125.6
'05,면부,'040003, 37세,2019,55195,32587,22608,144.1,46743,26285,20458,128.5
'05,면부,'040004, 38세,2019,53402,31401,22001,142.7,46088,25961,20127,129
'05,면부,'040005, 39세,2019,54805,32096,22709,141.3,47936,27056,20880,129.6
'05,면부,'045,40~44세,2019,248402,146853,101549,144.6,223555,129179,94376,136.9
'05,면부,'045001, 40세,2019,51526,30453,21073,144.5,45281,25867,19414,133.2
'05,면부,'045002, 41세,2019,47955,28433,19522,145.6,42653,24648,18005,136.9
'05,면부,'045003, 42세,2019,49054,28853,20201,142.8,44202,25405,18797,135.2
'05,면부,'045004, 43세,2019,48806,29086,19720,147.5,44284,25897,18387,140.8
'05,면부,'045005, 44세,2019,51061,30028,21033,142.8,47135,27362,19773,138.4
'05,면부,'050,45~49세,2019,300875,174286,126589,137.7,283042,162636,120406,135.1
'05,면부,'050001, 45세,2019,56406,33164,23242,142.7,52633,30648,21985,139.4
'05,면부,'050002, 46세,2019,58361,33876,24485,138.4,54765,31482,23283,135.2
'05,면부,'050003, 47세,2019,58092,33970,24122,140.8,54423,31575,22848,138.2
'05,면부,'050004, 48세,2019,64319,37089,27230,136.2,60870,34873,25997,134.1
'05,면부,'050005, 49세,2019,63697,36187,27510,131.5,60351,34058,26293,129.5
'05,면부,'055,50~54세,2019,360106,196980,163126,120.8,346766,189014,157752,119.8
'05,면부,'055001, 50세,2019,69053,38541,30512,126.3,66042,36697,29345,125.1
'05,면부,'055002, 51세,2019,72258,39578,32680,121.1,69308,37797,31511,119.9
'05,면부,'055003, 52세,2019,69445,37405,32040,116.7,66957,35920,31037,115.7
'05,면부,'055004, 53세,2019,72106,39712,32394,122.6,69669,38262,31407,121.8
'05,면부,'055005, 54세,2019,77244,41744,35500,117.6,74790,40338,34452,117.1
'05,면부,'060,55~59세,2019,443633,231525,212108,109.2,434301,226313,207988,108.8
'05,면부,'060001, 55세,2019,73115,38735,34380,112.7,70873,37478,33395,112.2
'05,면부,'060002, 56세,2019,80267,42876,37391,114.7,77891,41519,36372,114.2
'05,면부,'060003, 57세,2019,87206,46098,41108,112.1,85360,45075,40285,111.9
'05,면부,'060004, 58세,2019,100904,52026,48878,106.4,99593,51319,48274,106.3
'05,면부,'060005, 59세,2019,102141,51790,50351,102.9,100584,50922,49662,102.5
'05,면부,'065,60~64세,2019,450600,231809,218791,105.9,445281,228839,216442,105.7
'05,면부,'065001, 60세,2019,93724,48056,45668,105.2,92466,47377,45089,105.1
'05,면부,'065002, 61세,2019,89996,46673,43323,107.7,88777,45985,42792,107.5
'05,면부,'065003, 62세,2019,91373,47526,43847,108.4,90291,46909,43382,108.1
'05,면부,'065004, 63세,2019,86058,44365,41693,106.4,85157,43861,41296,106.2
'05,면부,'065005, 64세,2019,89449,45189,44260,102.1,88590,44707,43883,101.9
'05,면부,'070,65~69세,2019,347260,172720,174540,99,344954,171513,173441,98.9
'05,면부,'070001, 65세,2019,77537,39135,38402,101.9,76876,38779,38097,101.8
'05,면부,'070002, 66세,2019,68341,34276,34065,100.6,67785,33992,33793,100.6
'05,면부,'070003, 67세,2019,77985,38772,39213,98.9,77566,38549,39017,98.8
'05,면부,'070004, 68세,2019,59233,29088,30145,96.5,58914,28929,29985,96.5
'05,면부,'070005, 69세,2019,64164,31449,32715,96.1,63813,31264,32549,96.1
'05,면부,'075,70~74세,2019,294149,141198,152951,92.3,293206,140729,152477,92.3
'05,면부,'075001, 70세,2019,65725,32621,33104,98.5,65450,32477,32973,98.5
'05,면부,'075002, 71세,2019,64422,31703,32719,96.9,64206,31589,32617,96.8
'05,면부,'075003, 72세,2019,64969,31213,33756,92.5,64790,31128,33662,92.5
'05,면부,'075004, 73세,2019,48457,23040,25417,90.6,48314,22972,25342,90.6
'05,면부,'075005, 74세,2019,50576,22621,27955,80.9,50446,22563,27883,80.9
'05,면부,'080,75~79세,2019,298127,121330,176797,68.6,297695,121149,176546,68.6
'05,면부,'080001, 75세,2019,53561,22708,30853,73.6,53478,22673,30805,73.6
'05,면부,'080002, 76세,2019,57905,24127,33778,71.4,57816,24085,33731,71.4
'05,면부,'080003, 77세,2019,72984,29831,43153,69.1,72894,29798,43096,69.1
'05,면부,'080004, 78세,2019,58808,23498,35310,66.5,58715,23464,35251,66.6
'05,면부,'080005, 79세,2019,54869,21166,33703,62.8,54792,21129,33663,62.8
'05,면부,'085,80~84세,2019,237637,84464,153173,55.1,237377,84368,153009,55.1
'05,면부,'085001, 80세,2019,56772,21333,35439,60.2,56702,21309,35393,60.2
'05,면부,'085002, 81세,2019,50779,18437,32342,57,50703,18415,32288,57
'05,면부,'085003, 82세,2019,46970,16805,30165,55.7,46918,16783,30135,55.7
'05,면부,'085004, 83세,2019,42897,14910,27987,53.3,42866,14895,27971,53.3
'05,면부,'085005, 84세,2019,40219,12979,27240,47.6,40188,12966,27222,47.6
'05,면부,'086,85세이상,2019,168520,44979,123541,36.4,168332,44904,123428,36.4
'05,면부,'090,85~89세,2019,120051,34242,85809,39.9,119928,34192,85736,39.9
'05,면부,'090001, 85세,2019,34156,10678,23478,45.5,34126,10664,23462,45.5
'05,면부,'090002, 86세,2019,27984,8246,19738,41.8,27951,8232,19719,41.7
'05,면부,'090003, 87세,2019,23793,6746,17047,39.6,23775,6739,17036,39.6
'05,면부,'090004, 88세,2019,18099,4755,13344,35.6,18074,4744,13330,35.6
'05,면부,'090005, 89세,2019,16019,3817,12202,31.3,16002,3813,12189,31.3
'05,면부,'095,90~94세,2019,38899,8889,30010,29.6,38859,8875,29984,29.6
'05,면부,'095001, 90세,2019,12585,3072,9513,32.3,12572,3066,9506,32.3
'05,면부,'095002, 91세,2019,9951,2240,7711,29,9943,2237,7706,29
'05,면부,'095003, 92세,2019,7401,1656,5745,28.8,7392,1654,5738,28.8
'05,면부,'095004, 93세,2019,4987,1081,3906,27.7,4980,1079,3901,27.7
'05,면부,'095005, 94세,2019,3975,840,3135,26.8,3972,839,3133,26.8
'05,면부,'100,95~99세,2019,8509,1685,6824,24.7,8489,1677,6812,24.6
'05,면부,'100001, 95세,2019,2631,575,2056,28,2625,572,2053,27.9
'05,면부,'100002, 96세,2019,2505,510,1995,25.6,2499,507,1992,25.5
'05,면부,'100003, 97세,2019,1705,312,1393,22.4,1701,311,1390,22.4
'05,면부,'100004, 98세,2019,989,175,814,21.5,986,175,811,21.6
'05,면부,'100005, 99세,2019,679,113,566,20,678,112,566,19.8
'05,면부,'101,100세이상,2019,1061,163,898,18.2,1056,160,896,17.9
'05,면부,'102,15세미만,2019,380501,196794,183707,107.1,376320,194717,181603,107.2
'05,면부,'103,15~64세,2019,2972397,1685894,1286503,131,2697768,1487002,1210766,122.8
'05,면부,'104,65세이상,2019,1345693,564691,781002,72.3,1341564,562663,778901,72.2
'05,면부,'126,평균연령,2019,50.2,47.6,53.1,,51.2,48.8,53.7,
'05,면부,'127,중위연령,2019,53.6,50,57.4,,55.2,52.3,58.2,
'03,동부,'000,합계,2019,42023105,20905275,21117830,99,40745617,20231193,20514424,98.6
'03,동부,'005,0~4세,2019,1562756,801873,760883,105.4,1528574,784330,744244,105.4
'03,동부,'005001, 0세,2019,258606,132777,125829,105.5,252766,129757,123009,105.5
'03,동부,'005002, 1세,2019,280214,144241,135973,106.1,273438,140692,132746,106
'03,동부,'005003, 2세,2019,307582,158181,149401,105.9,300252,154442,145810,105.9
'03,동부,'005004, 3세,2019,349453,178761,170692,104.7,341762,174846,166916,104.8
'03,동부,'005005, 4세,2019,366901,187913,178988,105,360356,184593,175763,105
'03,동부,'010,5~9세,2019,1891119,970438,920681,105.4,1869555,959498,910057,105.4
'03,동부,'010001, 5세,2019,361924,185376,176548,105,356324,182548,173776,105
'03,동부,'010002, 6세,2019,366029,187256,178773,104.7,361292,184919,176373,104.8
'03,동부,'010003, 7세,2019,397447,204044,193403,105.5,392974,201794,191180,105.6
'03,동부,'010004, 8세,2019,390156,200166,189990,105.4,386602,198309,188293,105.3
'03,동부,'010005, 9세,2019,375563,193596,181967,106.4,372363,191928,180435,106.4
'03,동부,'015,10~14세,2019,1864279,960671,903608,106.3,1851818,954372,897446,106.3
'03,동부,'015001, 10세,2019,363679,187445,176234,106.4,360762,185974,174788,106.4
'03,동부,'015002, 11세,2019,384308,197497,186811,105.7,381547,196056,185491,105.7
'03,동부,'015003, 12세,2019,395823,203663,192160,106,393309,202412,190897,106
'03,동부,'015004, 13세,2019,362753,187383,175370,106.9,360595,186301,174294,106.9
'03,동부,'015005, 14세,2019,357716,184683,173033,106.7,355605,183629,171976,106.8
'03,동부,'020,15~19세,2019,2196743,1137687,1059056,107.4,2162270,1121967,1040303,107.9
'03,동부,'020001, 15세,2019,390505,202110,188395,107.3,388403,201045,187358,107.3
'03,동부,'020002, 16세,2019,394702,204834,189868,107.9,392891,203957,188934,108
'03,동부,'020003, 17세,2019,407907,212413,195494,108.7,405179,211058,194121,108.7
'03,동부,'020004, 18세,2019,472337,244806,227531,107.6,464317,241324,222993,108.2
'03,동부,'020005, 19세,2019,531292,273524,257768,106.1,511480,264583,246897,107.2
'03,동부,'025,20~24세,2019,2869295,1488312,1380983,107.8,2720829,1415739,1305090,108.5
'03,동부,'025001, 20세,2019,525523,272142,253381,107.4,499709,260423,239286,108.8
'03,동부,'025002, 21세,2019,552493,287298,265195,108.3,523471,273379,250092,109.3
'03,동부,'025003, 22세,2019,578073,298227,279846,106.6,547964,283483,264481,107.2
'03,동부,'025004, 23세,2019,601181,311767,289414,107.7,569902,296111,273791,108.2
'03,동부,'025005, 24세,2019,612025,318878,293147,108.8,579783,302343,277440,109
'03,동부,'030,25~29세,2019,3051507,1599026,1452481,110.1,2887361,1509709,1377652,109.6
'03,동부,'030001, 25세,2019,622216,326968,295248,110.7,590905,310452,280453,110.7
'03,동부,'030002, 26세,2019,626392,329765,296627,111.2,594879,312653,282226,110.8
'03,동부,'030003, 27세,2019,633560,331393,302167,109.7,601358,313772,287586,109.1
'03,동부,'030004, 28세,2019,597678,311644,286034,109,564750,293659,271091,108.3
'03,동부,'030005, 29세,2019,571661,299256,272405,109.9,535469,279173,256296,108.9
'03,동부,'035,30~34세,2019,2764540,1430514,1334026,107.2,2588112,1331675,1256437,106
'03,동부,'035001, 30세,2019,556083,290589,265494,109.5,520508,270957,249551,108.6
'03,동부,'035002, 31세,2019,544072,281912,262160,107.5,507801,261864,245937,106.5
'03,동부,'035003, 32세,2019,547335,281267,266068,105.7,510262,260329,249933,104.2
'03,동부,'035004, 33세,2019,554390,286773,267617,107.2,519408,266979,252429,105.8
'03,동부,'035005, 34세,2019,562660,289973,272687,106.3,530133,271546,258587,105
'03,동부,'040,35~39세,2019,3341789,1705491,1636298,104.2,3204378,1626224,1578154,103
'03,동부,'040001, 35세,2019,586033,300877,285156,105.5,555339,283205,272134,104.1
'03,동부,'040002, 36세,2019,645201,329841,315360,104.6,616114,313140,302974,103.4
'03,동부,'040003, 37세,2019,700353,356551,343802,103.7,671267,339833,331434,102.5
'03,동부,'040004, 38세,2019,697935,357355,340580,104.9,673196,343071,330125,103.9
'03,동부,'040005, 39세,2019,712267,360867,351400,102.7,688462,346975,341487,101.6
'03,동부,'045,40~44세,2019,3216921,1621734,1595187,101.7,3113575,1562447,1551128,100.7
'03,동부,'045001, 40세,2019,676421,342118,334303,102.3,652334,328100,324234,101.2
'03,동부,'045002, 41세,2019,618146,313309,304837,102.8,596414,300793,295621,101.7
'03,동부,'045003, 42세,2019,638261,321030,317231,101.2,618790,309875,308915,100.3
'03,동부,'045004, 43세,2019,625466,316122,309344,102.2,606043,304986,301057,101.3
'03,동부,'045005, 44세,2019,658627,329155,329472,99.9,639994,318693,321301,99.2
'03,동부,'050,45~49세,2019,3714729,1857446,1857283,100,3606879,1797969,1808910,99.4
'03,동부,'050001, 45세,2019,720373,361464,358909,100.7,701255,350721,350534,100.1
'03,동부,'050002, 46세,2019,728818,361301,367517,98.3,708192,349826,358366,97.6
'03,동부,'050003, 47세,2019,732694,369355,363339,101.7,710833,357143,353690,101
'03,동부,'050004, 48세,2019,779845,390016,389829,100,756886,377484,379402,99.5
'03,동부,'050005, 49세,2019,752999,375310,377689,99.4,729713,362795,366918,98.9
'03,동부,'055,50~54세,2019,3552081,1757467,1794614,97.9,3448124,1703542,1744582,97.6
'03,동부,'055001, 50세,2019,758084,375114,382970,97.9,736342,363637,372705,97.6
'03,동부,'055002, 51세,2019,752847,369544,383303,96.4,731023,358020,373003,96
'03,동부,'055003, 52세,2019,686102,335909,350193,95.9,667830,326485,341345,95.6
'03,동부,'055004, 53세,2019,668122,337579,330543,102.1,647899,327258,320641,102.1
'03,동부,'055005, 54세,2019,686926,339321,347605,97.6,665030,328142,336888,97.4
'03,동부,'060,55~59세,2019,3439657,1703767,1735890,98.1,3341277,1655189,1686088,98.2
'03,동부,'060001, 55세,2019,637461,317651,319810,99.3,615731,306731,309000,99.3
'03,동부,'060002, 56세,2019,678028,340714,337314,101,652510,328041,324469,101.1
'03,동부,'060003, 57세,2019,678814,339133,339681,99.8,659202,329479,329723,99.9
'03,동부,'060004, 58세,2019,725872,355911,369961,96.2,713036,349750,363286,96.3
'03,동부,'060005, 59세,2019,719482,350358,369124,94.9,700798,341188,359610,94.9
'03,동부,'065,60~64세,2019,2891934,1410937,1480997,95.3,2819120,1375339,1443781,95.3
'03,동부,'065001, 60세,2019,641200,314150,327050,96.1,625860,306543,319317,96
'03,동부,'065002, 61세,2019,595451,293290,302161,97.1,579188,285366,293822,97.1
'03,동부,'065003, 62세,2019,585648,287447,298201,96.4,569777,279637,290140,96.4
'03,동부,'065004, 63세,2019,527630,256371,271259,94.5,514551,250046,264505,94.5
'03,동부,'065005, 64세,2019,542005,259679,282326,92,529744,253747,275997,91.9
'03,동부,'070,65~69세,2019,1905217,910967,994250,91.6,1868526,893715,974811,91.7
'03,동부,'070001, 65세,2019,448123,216976,231147,93.9,437519,211905,225614,93.9
'03,동부,'070002, 66세,2019,393220,187760,205460,91.4,384872,183781,201091,91.4
'03,동부,'070003, 67세,2019,423701,202716,220985,91.7,416493,199329,217164,91.8
'03,동부,'070004, 68세,2019,308712,146680,162032,90.5,302892,143991,158901,90.6
'03,동부,'070005, 69세,2019,331461,156835,174626,89.8,326750,154709,172041,89.9
'03,동부,'075,70~74세,2019,1441006,665954,775052,85.9,1427983,660425,767558,86
'03,동부,'075001, 70세,2019,333325,156372,176953,88.4,329167,154515,174652,88.5
'03,동부,'075002, 71세,2019,321195,150116,171079,87.7,318392,148909,169483,87.9
'03,동부,'075003, 72세,2019,317010,145097,171913,84.4,314505,144049,170456,84.5
'03,동부,'075004, 73세,2019,238771,109992,128779,85.4,236760,109202,127558,85.6
'03,동부,'075005, 74세,2019,230705,104377,126328,82.6,229159,103750,125409,82.7
'03,동부,'080,75~79세,2019,1128836,485444,643392,75.5,1122733,483383,639350,75.6
'03,동부,'080001, 75세,2019,232705,102921,129784,79.3,231292,102395,128897,79.4
'03,동부,'080002, 76세,2019,233810,102589,131221,78.2,232609,102186,130423,78.3
'03,동부,'080003, 77세,2019,265583,115107,150476,76.5,264375,114692,149683,76.6
'03,동부,'080004, 78세,2019,209615,88512,121103,73.1,208453,88152,120301,73.3
'03,동부,'080005, 79세,2019,187123,76315,110808,68.9,186004,75958,110046,69
'03,동부,'085,80~84세,2019,716153,268569,447584,60,712349,267438,444911,60.1
'03,동부,'085001, 80세,2019,179870,72101,107769,66.9,178923,71836,107087,67.1
'03,동부,'085002, 81세,2019,157934,61209,96725,63.3,157027,60940,96087,63.4
'03,동부,'085003, 82세,2019,140690,52536,88154,59.6,139933,52300,87633,59.7
'03,동부,'085004, 83세,2019,124100,44094,80006,55.1,123432,43895,79537,55.2
'03,동부,'085005, 84세,2019,113559,38629,74930,51.6,113034,38467,74567,51.6
'03,동부,'086,85세이상,2019,474543,128978,345565,37.3,472154,128232,343922,37.3
'03,동부,'090,85~89세,2019,331549,97391,234158,41.6,329938,96902,233036,41.6
'03,동부,'090001, 85세,2019,93324,30338,62986,48.2,92847,30196,62651,48.2
'03,동부,'090002, 86세,2019,77012,23568,53444,44.1,76623,23455,53168,44.1
'03,동부,'090003, 87세,2019,66136,19191,46945,40.9,65855,19097,46758,40.8
'03,동부,'090004, 88세,2019,50016,13398,36618,36.6,49774,13319,36455,36.5
'03,동부,'090005, 89세,2019,45061,10896,34165,31.9,44839,10835,34004,31.9
'03,동부,'095,90~94세,2019,114399,25836,88563,29.2,113851,25660,88191,29.1
'03,동부,'095001, 90세,2019,37032,9277,27755,33.4,36864,9223,27641,33.4
'03,동부,'095002, 91세,2019,29070,6617,22453,29.5,28947,6575,22372,29.4
'03,동부,'095003, 92세,2019,22174,4802,17372,27.6,22073,4772,17301,27.6
'03,동부,'095004, 93세,2019,14509,2940,11569,25.4,14423,2906,11517,25.2
'03,동부,'095005, 94세,2019,11614,2200,9414,23.4,11544,2184,9360,23.3
'03,동부,'100,95~99세,2019,25346,5195,20151,25.8,25165,5136,20029,25.6
'03,동부,'100001, 95세,2019,7851,1672,6179,27.1,7802,1658,6144,27
'03,동부,'100002, 96세,2019,7420,1572,5848,26.9,7366,1552,5814,26.7
'03,동부,'100003, 97세,2019,4988,973,4015,24.2,4953,964,3989,24.2
'03,동부,'100004, 98세,2019,3028,577,2451,23.5,3005,567,2438,23.3
'03,동부,'100005, 99세,2019,2059,401,1658,24.2,2039,395,1644,24
'03,동부,'101,100세이상,2019,3249,556,2693,20.6,3200,534,2666,20
'03,동부,'102,15세미만,2019,5318154,2732982,2585172,105.7,5249947,2698200,2551747,105.7
'03,동부,'103,15~64세,2019,31039196,15712381,15326815,102.5,29891925,15099800,14792125,102.1
'03,동부,'104,65세이상,2019,5665755,2459912,3205843,76.7,5603745,2433193,3170552,76.7
'03,동부,'126,평균연령,2019,41.5,40.4,42.5,,41.6,40.5,42.6,
'03,동부,'127,중위연령,2019,42.3,41.1,43.5,,42.5,41.3,43.7,
'11,서울특별시,'000,합계,2019,9639541,4690440,4949101,94.8,9249364,4500878,4748486,94.8
'11,서울특별시,'005,0~4세,2019,306901,157770,149131,105.8,296570,152446,144124,105.8
'11,서울특별시,'005001, 0세,2019,54672,28400,26272,108.1,53115,27576,25539,108
'11,서울특별시,'005002, 1세,2019,56141,29186,26955,108.3,54179,28181,25998,108.4
'11,서울특별시,'005003, 2세,2019,60099,30652,29447,104.1,57798,29484,28314,104.1
'11,서울특별시,'005004, 3세,2019,67052,34246,32806,104.4,64664,33006,31658,104.3
'11,서울특별시,'005005, 4세,2019,68937,35286,33651,104.9,66814,34199,32615,104.9
'11,서울특별시,'010,5~9세,2019,347642,178533,169109,105.6,340831,175038,165793,105.6
'11,서울특별시,'010001, 5세,2019,67345,34534,32811,105.3,65644,33663,31981,105.3
'11,서울특별시,'010002, 6세,2019,67563,34726,32837,105.8,66024,33955,32069,105.9
'11,서울특별시,'010003, 7세,2019,72549,37271,35278,105.6,71139,36558,34581,105.7
'11,서울특별시,'010004, 8세,2019,70925,36363,34562,105.2,69795,35763,34032,105.1
'11,서울특별시,'010005, 9세,2019,69260,35639,33621,106,68229,35099,33130,105.9
'11,서울특별시,'015,10~14세,2019,352373,181578,170795,106.3,348371,179550,168821,106.4
'11,서울특별시,'015001, 10세,2019,67025,34313,32712,104.9,66101,33857,32244,105
'11,서울특별시,'015002, 11세,2019,72140,37094,35046,105.8,71244,36639,34605,105.9
'11,서울특별시,'015003, 12세,2019,74805,38541,36264,106.3,73982,38123,35859,106.3
'11,서울특별시,'015004, 13세,2019,69431,35885,33546,107,68755,35539,33216,107
'11,서울특별시,'015005, 14세,2019,68972,35745,33227,107.6,68289,35392,32897,107.6
'11,서울특별시,'020,15~19세,2019,443224,222941,220283,101.2,431953,218491,213462,102.4
'11,서울특별시,'020001, 15세,2019,76407,39429,36978,106.6,75697,39049,36648,106.6
'11,서울특별시,'020002, 16세,2019,76287,39174,37113,105.6,75709,38883,36826,105.6
'11,서울특별시,'020003, 17세,2019,79459,40797,38662,105.5,78536,40361,38175,105.7
'11,서울특별시,'020004, 18세,2019,94307,47656,46651,102.2,91699,46726,44973,103.9
'11,서울특별시,'020005, 19세,2019,116764,55885,60879,91.8,110312,53472,56840,94.1
'11,서울특별시,'025,20~24세,2019,681005,319500,361505,88.4,630814,300486,330328,91
'11,서울특별시,'025001, 20세,2019,119118,55899,63219,88.4,110353,52760,57593,91.6
'11,서울특별시,'025002, 21세,2019,125866,59164,66702,88.7,115658,55270,60388,91.5
'11,서울특별시,'025003, 22세,2019,135420,63377,72043,88,124970,59480,65490,90.8
'11,서울특별시,'025004, 23세,2019,146915,68451,78464,87.2,136335,64425,71910,89.6
'11,서울특별시,'025005, 24세,2019,153686,72609,81077,89.6,143498,68551,74947,91.5
'11,서울특별시,'030,25~29세,2019,821238,405143,416095,97.4,777456,385270,392186,98.2
'11,서울특별시,'030001, 25세,2019,162093,78316,83777,93.5,152939,74509,78430,95
'11,서울특별시,'030002, 26세,2019,167270,82635,84635,97.6,158579,78788,79791,98.7
'11,서울특별시,'030003, 27세,2019,171786,84972,86814,97.9,163272,81087,82185,98.7
'11,서울특별시,'030004, 28세,2019,163743,81186,82557,98.3,155508,77330,78178,98.9
'11,서울특별시,'030005, 29세,2019,156346,78034,78312,99.6,147158,73556,73602,99.9
'11,서울특별시,'035,30~34세,2019,729069,364799,364270,100.1,685989,342943,343046,100
'11,서울특별시,'035001, 30세,2019,150943,75446,75497,99.9,142015,71177,70838,100.5
'11,서울특별시,'035002, 31세,2019,146806,73122,73684,99.2,137947,68707,69240,99.2
'11,서울특별시,'035003, 32세,2019,144937,72007,72930,98.7,135805,67323,68482,98.3
'11,서울특별시,'035004, 33세,2019,143762,72278,71484,101.1,135313,67838,67475,100.5
'11,서울특별시,'035005, 34세,2019,142621,71946,70675,101.8,134909,67898,67011,101.3
'11,서울특별시,'040,35~39세,2019,778838,393596,385242,102.2,745331,375341,369990,101.4
'11,서울특별시,'040001, 35세,2019,144908,73247,71661,102.2,137442,69190,68252,101.4
'11,서울특별시,'040002, 36세,2019,153919,77985,75934,102.7,146812,74153,72659,102.1
'11,서울특별시,'040003, 37세,2019,162003,81461,80542,101.1,154886,77596,77290,100.4
'11,서울특별시,'040004, 38세,2019,158914,80938,77976,103.8,152937,77701,75236,103.3
'11,서울특별시,'040005, 39세,2019,159094,79965,79129,101.1,153254,76701,76553,100.2
'11,서울특별시,'045,40~44세,2019,705535,352718,352817,100,678136,337292,340844,99
'11,서울특별시,'045001, 40세,2019,150680,75633,75047,100.8,144544,72183,72361,99.8
'11,서울특별시,'045002, 41세,2019,134850,67626,67224,100.6,129113,64324,64789,99.3
'11,서울특별시,'045003, 42세,2019,139665,69460,70205,98.9,134533,66586,67947,98
'11,서울특별시,'045004, 43세,2019,137186,68746,68440,100.4,131907,65801,66106,99.5
'11,서울특별시,'045005, 44세,2019,143154,71253,71901,99.1,138039,68398,69641,98.2
'11,서울특별시,'050,45~49세,2019,817450,406212,411238,98.8,784288,388140,396148,98
'11,서울특별시,'050001, 45세,2019,156020,78025,77995,100,150481,74897,75584,99.1
'11,서울특별시,'050002, 46세,2019,159228,78581,80647,97.4,153061,75135,77926,96.4
'11,서울특별시,'050003, 47세,2019,162806,81527,81279,100.3,156095,77858,78237,99.5
'11,서울특별시,'050004, 48세,2019,173173,86068,87105,98.8,165959,82201,83758,98.1
'11,서울특별시,'050005, 49세,2019,166223,82011,84212,97.4,158692,78049,80643,96.8
'11,서울특별시,'055,50~54세,2019,769856,376654,393202,95.8,733888,358203,375685,95.3
'11,서울특별시,'055001, 50세,2019,165838,81617,84221,96.9,158653,77852,80801,96.4
'11,서울특별시,'055002, 51세,2019,162025,78820,83205,94.7,154594,74917,79677,94
'11,서울특별시,'055003, 52세,2019,148126,71531,76595,93.4,141916,68381,73535,93
'11,서울특별시,'055004, 53세,2019,143355,71635,71720,99.9,136154,67951,68203,99.6
'11,서울특별시,'055005, 54세,2019,150512,73051,77461,94.3,142571,69102,73469,94.1
'11,서울특별시,'060,55~59세,2019,769236,371525,397711,93.4,731534,352865,378669,93.2
'11,서울특별시,'060001, 55세,2019,143437,70034,73403,95.4,135260,65918,69342,95.1
'11,서울특별시,'060002, 56세,2019,152044,74513,77531,96.1,142244,69670,72574,96
'11,서울특별시,'060003, 57세,2019,150410,73686,76724,96,142849,69927,72922,95.9
'11,서울특별시,'060004, 58세,2019,159479,75949,83530,90.9,154671,73637,81034,90.9
'11,서울특별시,'060005, 59세,2019,163866,77343,86523,89.4,156510,73713,82797,89
'11,서울특별시,'065,60~64세,2019,697227,330631,366596,90.2,668037,316264,351773,89.9
'11,서울특별시,'065001, 60세,2019,149188,71160,78028,91.2,143061,68108,74953,90.9
'11,서울특별시,'065002, 61세,2019,141978,67862,74116,91.6,135459,64691,70768,91.4
'11,서울특별시,'065003, 62세,2019,141506,67327,74179,90.8,135022,64095,70927,90.4
'11,서울특별시,'065004, 63세,2019,129025,60951,68074,89.5,123839,58449,65390,89.4
'11,서울특별시,'065005, 64세,2019,135530,63331,72199,87.7,130656,60921,69735,87.4
'11,서울특별시,'070,65~69세,2019,481211,226481,254730,88.9,466998,219693,247305,88.8
'11,서울특별시,'070001, 65세,2019,112617,53252,59365,89.7,108385,51210,57175,89.6
'11,서울특별시,'070002, 66세,2019,99892,46962,52930,88.7,96691,45440,51251,88.7
'11,서울특별시,'070003, 67세,2019,106614,50293,56321,89.3,103826,48947,54879,89.2
'11,서울특별시,'070004, 68세,2019,76723,35960,40763,88.2,74492,34902,39590,88.2
'11,서울특별시,'070005, 69세,2019,85365,40014,45351,88.2,83604,39194,44410,88.3
'11,서울특별시,'075,70~74세,2019,377160,173395,203765,85.1,372271,171356,200915,85.3
'11,서울특별시,'075001, 70세,2019,85785,39696,46089,86.1,84243,38991,45252,86.2
'11,서울특별시,'075002, 71세,2019,82564,38404,44160,87,81485,37971,43514,87.3
'11,서울특별시,'075003, 72세,2019,83432,38065,45367,83.9,82500,37683,44817,84.1
'11,서울특별시,'075004, 73세,2019,64312,29300,35012,83.7,63540,28995,34545,83.9
'11,서울특별시,'075005, 74세,2019,61067,27930,33137,84.3,60503,27716,32787,84.5
'11,서울특별시,'080,75~79세,2019,285466,128585,156881,82,283214,127835,155379,82.3
'11,서울특별시,'080001, 75세,2019,60066,27263,32803,83.1,59558,27063,32495,83.3
'11,서울특별시,'080002, 76세,2019,59362,27035,32327,83.6,58898,26872,32026,83.9
'11,서울특별시,'080003, 77세,2019,67251,30607,36644,83.5,66809,30470,36339,83.8
'11,서울특별시,'080004, 78세,2019,52667,23643,29024,81.5,52269,23527,28742,81.9
'11,서울특별시,'080005, 79세,2019,46120,20037,26083,76.8,45680,19903,25777,77.2
'11,서울특별시,'085,80~84세,2019,169625,68264,101361,67.3,168147,67840,100307,67.6
'11,서울특별시,'085001, 80세,2019,43615,18669,24946,74.8,43217,18565,24652,75.3
'11,서울특별시,'085002, 81세,2019,37793,15666,22127,70.8,37472,15579,21893,71.2
'11,서울특별시,'085003, 82세,2019,33314,13245,20069,66,33013,13158,19855,66.3
'11,서울특별시,'085004, 83세,2019,28784,11073,17711,62.5,28531,10996,17535,62.7
'11,서울특별시,'085005, 84세,2019,26119,9611,16508,58.2,25914,9542,16372,58.3
'11,서울특별시,'086,85세이상,2019,106485,32115,74370,43.2,105536,31825,73711,43.2
'11,서울특별시,'090,85~89세,2019,73786,23907,49879,47.9,73138,23718,49420,48
'11,서울특별시,'090001, 85세,2019,20905,7367,13538,54.4,20726,7317,13409,54.6
'11,서울특별시,'090002, 86세,2019,17184,5757,11427,50.4,17020,5710,11310,50.5
'11,서울특별시,'090003, 87세,2019,14713,4775,9938,48,14601,4740,9861,48.1
'11,서울특별시,'090004, 88세,2019,11072,3279,7793,42.1,10970,3248,7722,42.1
'11,서울특별시,'090005, 89세,2019,9912,2729,7183,38,9821,2703,7118,38
'11,서울특별시,'095,90~94세,2019,25898,6565,19333,34,25702,6500,19202,33.9
'11,서울특별시,'095001, 90세,2019,8301,2353,5948,39.6,8244,2335,5909,39.5
'11,서울특별시,'095002, 91세,2019,6617,1691,4926,34.3,6571,1675,4896,34.2
'11,서울특별시,'095003, 92세,2019,5074,1229,3845,32,5037,1216,3821,31.8
'11,서울특별시,'095004, 93세,2019,3355,742,2613,28.4,3323,730,2593,28.2
'11,서울특별시,'095005, 94세,2019,2551,550,2001,27.5,2527,544,1983,27.4
'11,서울특별시,'100,95~99세,2019,6012,1485,4527,32.8,5938,1461,4477,32.6
'11,서울특별시,'100001, 95세,2019,1920,475,1445,32.9,1900,470,1430,32.9
'11,서울특별시,'100002, 96세,2019,1780,475,1305,36.4,1754,463,1291,35.9
'11,서울특별시,'100003, 97세,2019,1128,240,888,27,1116,238,878,27.1
'11,서울특별시,'100004, 98세,2019,696,172,524,32.8,685,169,516,32.8
'11,서울특별시,'100005, 99세,2019,488,123,365,33.7,483,121,362,33.4
'11,서울특별시,'101,100세이상,2019,789,158,631,25,758,146,612,23.9
'11,서울특별시,'102,15세미만,2019,1006916,517881,489035,105.9,985772,507034,478738,105.9
'11,서울특별시,'103,15~64세,2019,7212678,3543719,3668959,96.6,6867426,3375295,3492131,96.7
'11,서울특별시,'104,65세이상,2019,1419947,628840,791107,79.5,1396166,618549,777617,79.5
'11,서울특별시,'126,평균연령,2019,42.4,41.6,43.2,,42.5,41.7,43.3,
'11,서울특별시,'127,중위연령,2019,42.5,41.7,43.4,,42.7,41.8,43.6,
'11010, 종로구,'000,합계,2019,154969,74880,80089,93.5,141810,69062,72748,94.9
'11010, 종로구,'005,0~4세,2019,3565,1778,1787,99.5,3384,1685,1699,99.2
'11010, 종로구,'005001, 0세,2019,649,329,320,102.8,623,316,307,102.9
'11010, 종로구,'005002, 1세,2019,583,296,287,103.1,552,280,272,102.9
'11010, 종로구,'005003, 2세,2019,699,340,359,94.7,660,317,343,92.4
'11010, 종로구,'005004, 3세,2019,790,388,402,96.5,747,368,379,97.1
'11010, 종로구,'005005, 4세,2019,844,425,419,101.4,802,404,398,101.5
'11010, 종로구,'010,5~9세,2019,4372,2203,2169,101.6,4242,2137,2105,101.5
'11010, 종로구,'010001, 5세,2019,841,407,434,93.8,806,392,414,94.7
'11010, 종로구,'010002, 6세,2019,824,422,402,105,799,406,393,103.3
'11010, 종로구,'010003, 7세,2019,940,475,465,102.2,910,457,453,100.9
'11010, 종로구,'010004, 8세,2019,876,453,423,107.1,860,445,415,107.2
'11010, 종로구,'010005, 9세,2019,891,446,445,100.2,867,437,430,101.6
'11010, 종로구,'015,10~14세,2019,4740,2428,2312,105,4659,2383,2276,104.7
'11010, 종로구,'015001, 10세,2019,891,458,433,105.8,875,449,426,105.4
'11010, 종로구,'015002, 11세,2019,934,492,442,111.3,919,486,433,112.2
'11010, 종로구,'015003, 12세,2019,1039,516,523,98.7,1019,505,514,98.2
'11010, 종로구,'015004, 13세,2019,956,488,468,104.3,944,485,459,105.7
'11010, 종로구,'015005, 14세,2019,920,474,446,106.3,902,458,444,103.2
'11010, 종로구,'020,15~19세,2019,9015,4607,4408,104.5,8000,4259,3741,113.8
'11010, 종로구,'020001, 15세,2019,1100,589,511,115.3,1088,585,503,116.3
'11010, 종로구,'020002, 16세,2019,1572,924,648,142.6,1557,918,639,143.7
'11010, 종로구,'020003, 17세,2019,1654,904,750,120.5,1591,882,709,124.4
'11010, 종로구,'020004, 18세,2019,2035,1046,989,105.8,1722,935,787,118.8
'11010, 종로구,'020005, 19세,2019,2654,1144,1510,75.8,2042,939,1103,85.1
'11010, 종로구,'025,20~24세,2019,15242,6707,8535,78.6,11548,5431,6117,88.8
'11010, 종로구,'025001, 20세,2019,2765,1083,1682,64.4,2008,857,1151,74.5
'11010, 종로구,'025002, 21세,2019,2977,1208,1769,68.3,2097,896,1201,74.6
'11010, 종로구,'025003, 22세,2019,3095,1353,1742,77.7,2307,1093,1214,90
'11010, 종로구,'025004, 23세,2019,3269,1520,1749,86.9,2557,1268,1289,98.4
'11010, 종로구,'025005, 24세,2019,3136,1543,1593,96.9,2579,1317,1262,104.4
'11010, 종로구,'030,25~29세,2019,14057,7194,6863,104.8,12384,6443,5941,108.4
'11010, 종로구,'030001, 25세,2019,2953,1485,1468,101.2,2550,1309,1241,105.5
'11010, 종로구,'030002, 26세,2019,2984,1505,1479,101.8,2615,1344,1271,105.7
'11010, 종로구,'030003, 27세,2019,2831,1469,1362,107.9,2513,1328,1185,112.1
'11010, 종로구,'030004, 28세,2019,2747,1436,1311,109.5,2457,1305,1152,113.3
'11010, 종로구,'030005, 29세,2019,2542,1299,1243,104.5,2249,1157,1092,106
'11010, 종로구,'035,30~34세,2019,10753,5443,5310,102.5,9479,4793,4686,102.3
'11010, 종로구,'035001, 30세,2019,2310,1186,1124,105.5,2038,1053,985,106.9
'11010, 종로구,'035002, 31세,2019,2262,1187,1075,110.4,1987,1042,945,110.3
'11010, 종로구,'035003, 32세,2019,2224,1045,1179,88.6,1946,914,1032,88.6
'11010, 종로구,'035004, 33세,2019,2002,1024,978,104.7,1734,869,865,100.5
'11010, 종로구,'035005, 34세,2019,1955,1001,954,104.9,1774,915,859,106.5
'11010, 종로구,'040,35~39세,2019,10504,5206,5298,98.3,9483,4664,4819,96.8
'11010, 종로구,'040001, 35세,2019,1939,995,944,105.4,1723,874,849,102.9
'11010, 종로구,'040002, 36세,2019,2055,1019,1036,98.4,1863,927,936,99
'11010, 종로구,'040003, 37세,2019,2161,1058,1103,95.9,1936,943,993,95
'11010, 종로구,'040004, 38세,2019,2216,1101,1115,98.7,2013,998,1015,98.3
'11010, 종로구,'040005, 39세,2019,2133,1033,1100,93.9,1948,922,1026,89.9
'11010, 종로구,'045,40~44세,2019,9846,4811,5035,95.6,9038,4353,4685,92.9
'11010, 종로구,'045001, 40세,2019,2040,1014,1026,98.8,1869,922,947,97.4
'11010, 종로구,'045002, 41세,2019,1840,923,917,100.7,1676,830,846,98.1
'11010, 종로구,'045003, 42세,2019,1927,906,1021,88.7,1758,815,943,86.4
'11010, 종로구,'045004, 43세,2019,1978,976,1002,97.4,1817,880,937,93.9
'11010, 종로구,'045005, 44세,2019,2061,992,1069,92.8,1918,906,1012,89.5
'11010, 종로구,'050,45~49세,2019,12652,6214,6438,96.5,11824,5771,6053,95.3
'11010, 종로구,'050001, 45세,2019,2243,1088,1155,94.2,2097,1009,1088,92.7
'11010, 종로구,'050002, 46세,2019,2458,1155,1303,88.6,2288,1067,1221,87.4
'11010, 종로구,'050003, 47세,2019,2552,1278,1274,100.3,2385,1190,1195,99.6
'11010, 종로구,'050004, 48세,2019,2708,1387,1321,105,2543,1293,1250,103.4
'11010, 종로구,'050005, 49세,2019,2691,1306,1385,94.3,2511,1212,1299,93.3
'11010, 종로구,'055,50~54세,2019,12323,5969,6354,93.9,11538,5586,5952,93.9
'11010, 종로구,'055001, 50세,2019,2592,1245,1347,92.4,2438,1167,1271,91.8
'11010, 종로구,'055002, 51세,2019,2549,1221,1328,91.9,2370,1137,1233,92.2
'11010, 종로구,'055003, 52세,2019,2393,1161,1232,94.2,2263,1091,1172,93.1
'11010, 종로구,'055004, 53세,2019,2340,1135,1205,94.2,2194,1066,1128,94.5
'11010, 종로구,'055005, 54세,2019,2449,1207,1242,97.2,2273,1125,1148,98
'11010, 종로구,'060,55~59세,2019,12556,6204,6352,97.7,11885,5885,6000,98.1
'11010, 종로구,'060001, 55세,2019,2448,1226,1222,100.3,2278,1142,1136,100.5
'11010, 종로구,'060002, 56세,2019,2488,1249,1239,100.8,2328,1175,1153,101.9
'11010, 종로구,'060003, 57세,2019,2444,1265,1179,107.3,2307,1197,1110,107.8
'11010, 종로구,'060004, 58세,2019,2616,1274,1342,94.9,2546,1245,1301,95.7
'11010, 종로구,'060005, 59세,2019,2560,1190,1370,86.9,2426,1126,1300,86.6
'11010, 종로구,'065,60~64세,2019,10726,5338,5388,99.1,10199,5101,5098,100.1
'11010, 종로구,'065001, 60세,2019,2365,1204,1161,103.7,2238,1158,1080,107.2
'11010, 종로구,'065002, 61세,2019,2169,1085,1084,100.1,2048,1032,1016,101.6
'11010, 종로구,'065003, 62세,2019,2136,1067,1069,99.8,2032,1015,1017,99.8
'11010, 종로구,'065004, 63세,2019,1999,989,1010,97.9,1905,946,959,98.6
'11010, 종로구,'065005, 64세,2019,2057,993,1064,93.3,1976,950,1026,92.6
'11010, 종로구,'070,65~69세,2019,7366,3527,3839,91.9,7102,3414,3688,92.6
'11010, 종로구,'070001, 65세,2019,1759,869,890,97.6,1684,838,846,99.1
'11010, 종로구,'070002, 66세,2019,1563,763,800,95.4,1500,737,763,96.6
'11010, 종로구,'070003, 67세,2019,1634,797,837,95.2,1587,773,814,95
'11010, 종로구,'070004, 68세,2019,1126,513,613,83.7,1079,494,585,84.4
'11010, 종로구,'070005, 69세,2019,1284,585,699,83.7,1252,572,680,84.1
'11010, 종로구,'075,70~74세,2019,6101,2718,3383,80.3,5999,2673,3326,80.4
'11010, 종로구,'075001, 70세,2019,1330,609,721,84.5,1304,595,709,83.9
'11010, 종로구,'075002, 71세,2019,1321,599,722,83,1295,586,709,82.7
'11010, 종로구,'075003, 72세,2019,1346,600,746,80.4,1328,593,735,80.7
'11010, 종로구,'075004, 73세,2019,1042,450,592,76,1029,446,583,76.5
'11010, 종로구,'075005, 74세,2019,1062,460,602,76.4,1043,453,590,76.8
'11010, 종로구,'080,75~79세,2019,5377,2329,3048,76.4,5327,2309,3018,76.5
'11010, 종로구,'080001, 75세,2019,1080,445,635,70.1,1072,443,629,70.4
'11010, 종로구,'080002, 76세,2019,1095,497,598,83.1,1086,492,594,82.8
'11010, 종로구,'080003, 77세,2019,1256,550,706,77.9,1243,545,698,78.1
'11010, 종로구,'080004, 78세,2019,1039,449,590,76.1,1029,444,585,75.9
'11010, 종로구,'080005, 79세,2019,907,388,519,74.8,897,385,512,75.2
'11010, 종로구,'085,80~84세,2019,3461,1416,2045,69.2,3430,1401,2029,69
'11010, 종로구,'085001, 80세,2019,904,375,529,70.9,896,372,524,71
'11010, 종로구,'085002, 81세,2019,752,299,453,66,744,297,447,66.4
'11010, 종로구,'085003, 82세,2019,669,285,384,74.2,663,282,381,74
'11010, 종로구,'085004, 83세,2019,602,246,356,69.1,601,246,355,69.3
'11010, 종로구,'085005, 84세,2019,534,211,323,65.3,526,204,322,63.4
'11010, 종로구,'086,85세이상,2019,2313,788,1525,51.7,2289,774,1515,51.1
'11010, 종로구,'090,85~89세,2019,1580,555,1025,54.1,1567,549,1018,53.9
'11010, 종로구,'090001, 85세,2019,445,173,272,63.6,441,172,269,63.9
'11010, 종로구,'090002, 86세,2019,354,123,231,53.2,351,121,230,52.6
'11010, 종로구,'090003, 87세,2019,308,114,194,58.8,306,113,193,58.5
'11010, 종로구,'090004, 88세,2019,267,84,183,45.9,265,83,182,45.6
'11010, 종로구,'090005, 89세,2019,206,61,145,42.1,204,60,144,41.7
'11010, 종로구,'095,90~94세,2019,565,182,383,47.5,557,177,380,46.6
'11010, 종로구,'095001, 90세,2019,178,67,111,60.4,175,64,111,57.7
'11010, 종로구,'095002, 91세,2019,132,33,99,33.3,129,33,96,34.4
'11010, 종로구,'095003, 92세,2019,116,42,74,56.8,115,41,74,55.4
'11010, 종로구,'095004, 93세,2019,76,23,53,43.4,75,22,53,41.5
'11010, 종로구,'095005, 94세,2019,63,17,46,37,63,17,46,37
'11010, 종로구,'100,95~99세,2019,147,45,102,44.1,145,43,102,42.2
'11010, 종로구,'100001, 95세,2019,43,13,30,43.3,43,13,30,43.3
'11010, 종로구,'100002, 96세,2019,35,12,23,52.2,34,11,23,47.8
'11010, 종로구,'100003, 97세,2019,39,12,27,44.4,39,12,27,44.4
'11010, 종로구,'100004, 98세,2019,16,5,11,45.5,15,X,11,36.4
'11010, 종로구,'100005, 99세,2019,14,X,11,27.3,14,X,11,27.3
'11010, 종로구,'101,100세이상,2019,21,6,15,40,20,5,15,33.3
'11010, 종로구,'102,15세미만,2019,12677,6409,6268,102.2,12285,6205,6080,102.1
'11010, 종로구,'103,15~64세,2019,117674,57693,59981,96.2,105378,52286,53092,98.5
'11010, 종로구,'104,65세이상,2019,24618,10778,13840,77.9,24147,10571,13576,77.9
'11010, 종로구,'126,평균연령,2019,42.8,42.2,43.5,,43.6,42.7,44.5,
'11010, 종로구,'127,중위연령,2019,42.7,41.9,43.4,,44.3,43.2,45.3,
'11020, 중구,'000,합계,2019,130957,63406,67551,93.9,118398,57381,61017,94
'11020, 중구,'005,0~4세,2019,3968,2023,1945,104,3616,1833,1783,102.8
'11020, 중구,'005001, 0세,2019,776,397,379,104.7,728,373,355,105.1
'11020, 중구,'005002, 1세,2019,724,369,355,103.9,656,330,326,101.2
'11020, 중구,'005003, 2세,2019,788,392,396,99,701,348,353,98.6
'11020, 중구,'005004, 3세,2019,870,458,412,111.2,786,411,375,109.6
'11020, 중구,'005005, 4세,2019,810,407,403,101,745,371,374,99.2
'11020, 중구,'010,5~9세,2019,3676,1889,1787,105.7,3444,1762,1682,104.8
'11020, 중구,'010001, 5세,2019,799,406,393,103.3,746,377,369,102.2
'11020, 중구,'010002, 6세,2019,755,395,360,109.7,704,361,343,105.2
'11020, 중구,'010003, 7세,2019,738,389,349,111.5,687,369,318,116
'11020, 중구,'010004, 8세,2019,733,358,375,95.5,688,334,354,94.4
'11020, 중구,'010005, 9세,2019,651,341,310,110,619,321,298,107.7
'11020, 중구,'015,10~14세,2019,2951,1485,1466,101.3,2811,1409,1402,100.5
'11020, 중구,'015001, 10세,2019,585,291,294,99,552,272,280,97.1
'11020, 중구,'015002, 11세,2019,668,322,346,93.1,639,310,329,94.2
'11020, 중구,'015003, 12세,2019,625,315,310,101.6,597,295,302,97.7
'11020, 중구,'015004, 13세,2019,511,271,240,112.9,487,257,230,111.7
'11020, 중구,'015005, 14세,2019,562,286,276,103.6,536,275,261,105.4
'11020, 중구,'020,15~19세,2019,5098,2289,2809,81.5,4656,2111,2545,82.9
'11020, 중구,'020001, 15세,2019,675,331,344,96.2,640,314,326,96.3
'11020, 중구,'020002, 16세,2019,710,306,404,75.7,695,301,394,76.4
'11020, 중구,'020003, 17세,2019,786,340,446,76.2,747,320,427,74.9
'11020, 중구,'020004, 18세,2019,1133,486,647,75.1,1045,463,582,79.6
'11020, 중구,'020005, 19세,2019,1794,826,968,85.3,1529,713,816,87.4
'11020, 중구,'025,20~24세,2019,10762,4841,5921,81.8,8523,3919,4604,85.1
'11020, 중구,'025001, 20세,2019,1955,852,1103,77.2,1513,654,859,76.1
'11020, 중구,'025002, 21세,2019,1996,813,1183,68.7,1526,619,907,68.2
'11020, 중구,'025003, 22세,2019,2194,966,1228,78.7,1748,796,952,83.6
'11020, 중구,'025004, 23세,2019,2351,1101,1250,88.1,1898,930,968,96.1
'11020, 중구,'025005, 24세,2019,2266,1109,1157,95.9,1838,920,918,100.2
'11020, 중구,'030,25~29세,2019,12057,6006,6051,99.3,10448,5238,5210,100.5
'11020, 중구,'030001, 25세,2019,2392,1187,1205,98.5,2043,1036,1007,102.9
'11020, 중구,'030002, 26세,2019,2495,1226,1269,96.6,2152,1068,1084,98.5
'11020, 중구,'030003, 27세,2019,2572,1275,1297,98.3,2233,1112,1121,99.2
'11020, 중구,'030004, 28세,2019,2332,1168,1164,100.3,2065,1034,1031,100.3
'11020, 중구,'030005, 29세,2019,2266,1150,1116,103,1955,988,967,102.2
'11020, 중구,'035,30~34세,2019,11034,5548,5486,101.1,9594,4782,4812,99.4
'11020, 중구,'035001, 30세,2019,2169,1115,1054,105.8,1900,970,930,104.3
'11020, 중구,'035002, 31세,2019,2284,1122,1162,96.6,1978,954,1024,93.2
'11020, 중구,'035003, 32세,2019,2258,1149,1109,103.6,1954,998,956,104.4
'11020, 중구,'035004, 33세,2019,2171,1073,1098,97.7,1862,902,960,94
'11020, 중구,'035005, 34세,2019,2152,1089,1063,102.4,1900,958,942,101.7
'11020, 중구,'040,35~39세,2019,10933,5607,5326,105.3,9855,4996,4859,102.8
'11020, 중구,'040001, 35세,2019,2141,1104,1037,106.5,1920,974,946,103
'11020, 중구,'040002, 36세,2019,2230,1122,1108,101.3,2008,1004,1004,100
'11020, 중구,'040003, 37세,2019,2242,1144,1098,104.2,2004,1009,995,101.4
'11020, 중구,'040004, 38세,2019,2116,1087,1029,105.6,1922,977,945,103.4
'11020, 중구,'040005, 39세,2019,2204,1150,1054,109.1,2001,1032,969,106.5
'11020, 중구,'045,40~44세,2019,8810,4586,4224,108.6,7897,4087,3810,107.3
'11020, 중구,'045001, 40세,2019,1907,982,925,106.2,1714,869,845,102.8
'11020, 중구,'045002, 41세,2019,1782,966,816,118.4,1580,849,731,116.1
'11020, 중구,'045003, 42세,2019,1723,887,836,106.1,1561,803,758,105.9
'11020, 중구,'045004, 43세,2019,1664,867,797,108.8,1470,764,706,108.2
'11020, 중구,'045005, 44세,2019,1734,884,850,104,1572,802,770,104.2
'11020, 중구,'050,45~49세,2019,9926,4963,4963,100,8961,4480,4481,100
'11020, 중구,'050001, 45세,2019,1873,955,918,104,1671,855,816,104.8
'11020, 중구,'050002, 46세,2019,1828,885,943,93.8,1647,799,848,94.2
'11020, 중구,'050003, 47세,2019,1993,1024,969,105.7,1794,912,882,103.4
'11020, 중구,'050004, 48세,2019,2153,1083,1070,101.2,1974,991,983,100.8
'11020, 중구,'050005, 49세,2019,2079,1016,1063,95.6,1875,923,952,97
'11020, 중구,'055,50~54세,2019,10291,5096,5195,98.1,9416,4660,4756,98
'11020, 중구,'055001, 50세,2019,2125,1105,1020,108.3,1950,1016,934,108.8
'11020, 중구,'055002, 51세,2019,2262,1082,1180,91.7,2053,969,1084,89.4
'11020, 중구,'055003, 52세,2019,1996,986,1010,97.6,1846,921,925,99.6
'11020, 중구,'055004, 53세,2019,1874,959,915,104.8,1709,876,833,105.2
'11020, 중구,'055005, 54세,2019,2034,964,1070,90.1,1858,878,980,89.6
'11020, 중구,'060,55~59세,2019,10786,5306,5480,96.8,9892,4914,4978,98.7
'11020, 중구,'060001, 55세,2019,2015,997,1018,97.9,1830,918,912,100.7
'11020, 중구,'060002, 56세,2019,2158,1074,1084,99.1,1923,962,961,100.1
'11020, 중구,'060003, 57세,2019,2132,1061,1071,99.1,1947,990,957,103.4
'11020, 중구,'060004, 58세,2019,2210,1085,1125,96.4,2091,1035,1056,98
'11020, 중구,'060005, 59세,2019,2271,1089,1182,92.1,2101,1009,1092,92.4
'11020, 중구,'065,60~64세,2019,9870,4799,5071,94.6,9125,4489,4636,96.8
'11020, 중구,'065001, 60세,2019,2066,1023,1043,98.1,1899,953,946,100.7
'11020, 중구,'065002, 61세,2019,1984,927,1057,87.7,1796,850,946,89.9
'11020, 중구,'065003, 62세,2019,2027,1010,1017,99.3,1864,945,919,102.8
'11020, 중구,'065004, 63세,2019,1900,929,971,95.7,1784,881,903,97.6
'11020, 중구,'065005, 64세,2019,1893,910,983,92.6,1782,860,922,93.3
'11020, 중구,'070,65~69세,2019,6665,3200,3465,92.4,6308,3040,3268,93
'11020, 중구,'070001, 65세,2019,1587,781,806,96.9,1482,731,751,97.3
'11020, 중구,'070002, 66세,2019,1363,643,720,89.3,1282,611,671,91.1
'11020, 중구,'070003, 67세,2019,1437,678,759,89.3,1374,648,726,89.3
'11020, 중구,'070004, 68세,2019,1041,496,545,91,979,468,511,91.6
'11020, 중구,'070005, 69세,2019,1237,602,635,94.8,1191,582,609,95.6
'11020, 중구,'075,70~74세,2019,5286,2370,2916,81.3,5156,2319,2837,81.7
'11020, 중구,'075001, 70세,2019,1166,542,624,86.9,1127,525,602,87.2
'11020, 중구,'075002, 71세,2019,1168,539,629,85.7,1141,532,609,87.4
'11020, 중구,'075003, 72세,2019,1179,519,660,78.6,1147,505,642,78.7
'11020, 중구,'075004, 73세,2019,861,355,506,70.2,843,346,497,69.6
'11020, 중구,'075005, 74세,2019,912,415,497,83.5,898,411,487,84.4
'11020, 중구,'080,75~79세,2019,4333,1835,2498,73.5,4256,1801,2455,73.4
'11020, 중구,'080001, 75세,2019,912,405,507,79.9,894,394,500,78.8
'11020, 중구,'080002, 76세,2019,862,362,500,72.4,843,356,487,73.1
'11020, 중구,'080003, 77세,2019,1034,436,598,72.9,1018,431,587,73.4
'11020, 중구,'080004, 78세,2019,836,354,482,73.4,825,349,476,73.3
'11020, 중구,'080005, 79세,2019,689,278,411,67.6,676,271,405,66.9
'11020, 중구,'085,80~84세,2019,2692,1029,1663,61.9,2642,1013,1629,62.2
'11020, 중구,'085001, 80세,2019,694,288,406,70.9,682,284,398,71.4
'11020, 중구,'085002, 81세,2019,584,225,359,62.7,575,220,355,62
'11020, 중구,'085003, 82세,2019,527,185,342,54.1,517,184,333,55.3
'11020, 중구,'085004, 83세,2019,477,178,299,59.5,467,176,291,60.5
'11020, 중구,'085005, 84세,2019,410,153,257,59.5,401,149,252,59.1
'11020, 중구,'086,85세이상,2019,1819,534,1285,41.6,1798,528,1270,41.6
'11020, 중구,'090,85~89세,2019,1234,370,864,42.8,1222,366,856,42.8
'11020, 중구,'090001, 85세,2019,344,105,239,43.9,339,104,235,44.3
'11020, 중구,'090002, 86세,2019,284,86,198,43.4,281,84,197,42.6
'11020, 중구,'090003, 87세,2019,237,68,169,40.2,235,68,167,40.7
'11020, 중구,'090004, 88세,2019,187,59,128,46.1,187,59,128,46.1
'11020, 중구,'090005, 89세,2019,182,52,130,40,180,51,129,39.5
'11020, 중구,'095,90~94세,2019,476,133,343,38.8,469,131,338,38.8
'11020, 중구,'095001, 90세,2019,147,51,96,53.1,145,50,95,52.6
'11020, 중구,'095002, 91세,2019,130,36,94,38.3,129,36,93,38.7
'11020, 중구,'095003, 92세,2019,99,25,74,33.8,95,24,71,33.8
'11020, 중구,'095004, 93세,2019,60,14,46,30.4,60,14,46,30.4
'11020, 중구,'095005, 94세,2019,40,7,33,21.2,40,7,33,21.2
'11020, 중구,'100,95~99세,2019,92,26,66,39.4,91,26,65,40
'11020, 중구,'100001, 95세,2019,32,13,19,68.4,32,13,19,68.4
'11020, 중구,'100002, 96세,2019,21,X,18,16.7,21,X,18,16.7
'11020, 중구,'100003, 97세,2019,26,7,19,36.8,25,7,18,38.9
'11020, 중구,'100004, 98세,2019,9,X,7,28.6,9,X,7,28.6
'11020, 중구,'100005, 99세,2019,X,X,X,33.3,X,X,X,33.3
'11020, 중구,'101,100세이상,2019,17,5,12,41.7,16,5,11,45.5
'11020, 중구,'102,15세미만,2019,10595,5397,5198,103.8,9871,5004,4867,102.8
'11020, 중구,'103,15~64세,2019,99567,49041,50526,97.1,88367,43676,44691,97.7
'11020, 중구,'104,65세이상,2019,20795,8968,11827,75.8,20160,8701,11459,75.9
'11020, 중구,'126,평균연령,2019,43.4,42.7,44,,44,43.3,44.7,
'11020, 중구,'127,중위연령,2019,42.8,42.1,43.5,,44,43.2,44.7,
'11030, 용산구,'000,합계,2019,227181,110934,116247,95.4,206678,99313,107365,92.5
'11030, 용산구,'005,0~4세,2019,8159,4185,3974,105.3,6568,3407,3161,107.8
'11030, 용산구,'005001, 0세,2019,1400,748,652,114.7,1268,675,593,113.8
'11030, 용산구,'005002, 1세,2019,1529,796,733,108.6,1216,647,569,113.7
'11030, 용산구,'005003, 2세,2019,1622,796,826,96.4,1259,628,631,99.5
'11030, 용산구,'005004, 3세,2019,1809,918,891,103,1433,730,703,103.8
'11030, 용산구,'005005, 4세,2019,1799,927,872,106.3,1392,727,665,109.3
'11030, 용산구,'010,5~9세,2019,7702,3978,3724,106.8,6604,3435,3169,108.4
'11030, 용산구,'010001, 5세,2019,1638,842,796,105.8,1338,689,649,106.2
'11030, 용산구,'010002, 6세,2019,1563,789,774,101.9,1309,663,646,102.6
'11030, 용산구,'010003, 7세,2019,1572,828,744,111.3,1369,731,638,114.6
'11030, 용산구,'010004, 8세,2019,1492,781,711,109.8,1301,680,621,109.5
'11030, 용산구,'010005, 9세,2019,1437,738,699,105.6,1287,672,615,109.3
'11030, 용산구,'015,10~14세,2019,7049,3543,3506,101.1,6450,3254,3196,101.8
'11030, 용산구,'015001, 10세,2019,1400,670,730,91.8,1262,605,657,92.1
'11030, 용산구,'015002, 11세,2019,1483,733,750,97.7,1350,674,676,99.7
'11030, 용산구,'015003, 12세,2019,1476,767,709,108.2,1351,703,648,108.5
'11030, 용산구,'015004, 13세,2019,1325,660,665,99.2,1223,612,611,100.2
'11030, 용산구,'015005, 14세,2019,1365,713,652,109.4,1264,660,604,109.3
'11030, 용산구,'020,15~19세,2019,8722,4383,4339,101,8087,4004,4083,98.1
'11030, 용산구,'020001, 15세,2019,1462,783,679,115.3,1380,739,641,115.3
'11030, 용산구,'020002, 16세,2019,1424,739,685,107.9,1353,700,653,107.2
'11030, 용산구,'020003, 17세,2019,1570,838,732,114.5,1490,790,700,112.9
'11030, 용산구,'020004, 18세,2019,1823,929,894,103.9,1732,873,859,101.6
'11030, 용산구,'020005, 19세,2019,2443,1094,1349,81.1,2132,902,1230,73.3
'11030, 용산구,'025,20~24세,2019,15289,6954,8335,83.4,12896,5506,7390,74.5
'11030, 용산구,'025001, 20세,2019,2575,1156,1419,81.5,2168,947,1221,77.6
'11030, 용산구,'025002, 21세,2019,2887,1322,1565,84.5,2441,1065,1376,77.4
'11030, 용산구,'025003, 22세,2019,3048,1408,1640,85.9,2571,1101,1470,74.9
'11030, 용산구,'025004, 23세,2019,3188,1475,1713,86.1,2691,1155,1536,75.2
'11030, 용산구,'025005, 24세,2019,3591,1593,1998,79.7,3025,1238,1787,69.3
'11030, 용산구,'030,25~29세,2019,20431,10232,10199,100.3,17661,8571,9090,94.3
'11030, 용산구,'030001, 25세,2019,3813,1815,1998,90.8,3253,1470,1783,82.4
'11030, 용산구,'030002, 26세,2019,3934,1935,1999,96.8,3385,1597,1788,89.3
'11030, 용산구,'030003, 27세,2019,4245,2112,2133,99,3681,1790,1891,94.7
'11030, 용산구,'030004, 28세,2019,4312,2210,2102,105.1,3754,1882,1872,100.5
'11030, 용산구,'030005, 29세,2019,4127,2160,1967,109.8,3588,1832,1756,104.3
'11030, 용산구,'035,30~34세,2019,19789,10207,9582,106.5,17185,8600,8585,100.2
'11030, 용산구,'035001, 30세,2019,4060,2107,1953,107.9,3546,1783,1763,101.1
'11030, 용산구,'035002, 31세,2019,4075,2127,1948,109.2,3489,1761,1728,101.9
'11030, 용산구,'035003, 32세,2019,3851,1929,1922,100.4,3355,1638,1717,95.4
'11030, 용산구,'035004, 33세,2019,3972,2066,1906,108.4,3471,1746,1725,101.2
'11030, 용산구,'035005, 34세,2019,3831,1978,1853,106.7,3324,1672,1652,101.2
'11030, 용산구,'040,35~39세,2019,20216,10431,9785,106.6,17923,9044,8879,101.9
'11030, 용산구,'040001, 35세,2019,3941,2053,1888,108.7,3407,1720,1687,102
'11030, 용산구,'040002, 36세,2019,4061,2114,1947,108.6,3576,1817,1759,103.3
'11030, 용산구,'040003, 37세,2019,4129,2074,2055,100.9,3705,1827,1878,97.3
'11030, 용산구,'040004, 38세,2019,4060,2125,1935,109.8,3652,1891,1761,107.4
'11030, 용산구,'040005, 39세,2019,4025,2065,1960,105.4,3583,1789,1794,99.7
'11030, 용산구,'045,40~44세,2019,16585,8372,8213,101.9,14852,7351,7501,98
'11030, 용산구,'045001, 40세,2019,3529,1784,1745,102.2,3145,1553,1592,97.6
'11030, 용산구,'045002, 41세,2019,3292,1699,1593,106.7,2906,1464,1442,101.5
'11030, 용산구,'045003, 42세,2019,3238,1586,1652,96,2906,1396,1510,92.5
'11030, 용산구,'045004, 43세,2019,3194,1606,1588,101.1,2870,1417,1453,97.5
'11030, 용산구,'045005, 44세,2019,3332,1697,1635,103.8,3025,1521,1504,101.1
'11030, 용산구,'050,45~49세,2019,19022,9498,9524,99.7,17564,8667,8897,97.4
'11030, 용산구,'050001, 45세,2019,3634,1843,1791,102.9,3341,1666,1675,99.5
'11030, 용산구,'050002, 46세,2019,3600,1819,1781,102.1,3311,1656,1655,100.1
'11030, 용산구,'050003, 47세,2019,3882,1939,1943,99.8,3555,1760,1795,98.1
'11030, 용산구,'050004, 48세,2019,4007,1974,2033,97.1,3736,1819,1917,94.9
'11030, 용산구,'050005, 49세,2019,3899,1923,1976,97.3,3621,1766,1855,95.2
'11030, 용산구,'055,50~54세,2019,17673,8754,8919,98.2,16522,8129,8393,96.9
'11030, 용산구,'055001, 50세,2019,3895,1933,1962,98.5,3626,1765,1861,94.8
'11030, 용산구,'055002, 51세,2019,3794,1876,1918,97.8,3522,1717,1805,95.1
'11030, 용산구,'055003, 52세,2019,3338,1606,1732,92.7,3137,1505,1632,92.2
'11030, 용산구,'055004, 53세,2019,3238,1664,1574,105.7,3044,1562,1482,105.4
'11030, 용산구,'055005, 54세,2019,3408,1675,1733,96.7,3193,1580,1613,98
'11030, 용산구,'060,55~59세,2019,17272,8430,8842,95.3,16362,7974,8388,95.1
'11030, 용산구,'060001, 55세,2019,3250,1606,1644,97.7,3041,1491,1550,96.2
'11030, 용산구,'060002, 56세,2019,3481,1704,1777,95.9,3232,1583,1649,96
'11030, 용산구,'060003, 57세,2019,3454,1731,1723,100.5,3286,1644,1642,100.1
'11030, 용산구,'060004, 58세,2019,3513,1710,1803,94.8,3382,1645,1737,94.7
'11030, 용산구,'060005, 59세,2019,3574,1679,1895,88.6,3421,1611,1810,89
'11030, 용산구,'065,60~64세,2019,15423,7468,7955,93.9,14842,7200,7642,94.2
'11030, 용산구,'065001, 60세,2019,3311,1606,1705,94.2,3197,1550,1647,94.1
'11030, 용산구,'065002, 61세,2019,3106,1556,1550,100.4,2963,1485,1478,100.5
'11030, 용산구,'065003, 62세,2019,3148,1531,1617,94.7,3013,1468,1545,95
'11030, 용산구,'065004, 63세,2019,2900,1390,1510,92.1,2811,1354,1457,92.9
'11030, 용산구,'065005, 64세,2019,2958,1385,1573,88,2858,1343,1515,88.6
'11030, 용산구,'070,65~69세,2019,10344,4838,5506,87.9,10004,4677,5327,87.8
'11030, 용산구,'070001, 65세,2019,2455,1188,1267,93.8,2363,1142,1221,93.5
'11030, 용산구,'070002, 66세,2019,2154,1041,1113,93.5,2087,1009,1078,93.6
'11030, 용산구,'070003, 67세,2019,2216,979,1237,79.1,2138,948,1190,79.7
'11030, 용산구,'070004, 68세,2019,1635,759,876,86.6,1570,730,840,86.9
'11030, 용산구,'070005, 69세,2019,1884,871,1013,86,1846,848,998,85
'11030, 용산구,'075,70~74세,2019,8396,3739,4657,80.3,8231,3654,4577,79.8
'11030, 용산구,'075001, 70세,2019,1866,875,991,88.3,1819,845,974,86.8
'11030, 용산구,'075002, 71세,2019,1846,858,988,86.8,1812,842,970,86.8
'11030, 용산구,'075003, 72세,2019,1822,762,1060,71.9,1781,745,1036,71.9
'11030, 용산구,'075004, 73세,2019,1453,615,838,73.4,1424,603,821,73.4
'11030, 용산구,'075005, 74세,2019,1409,629,780,80.6,1395,619,776,79.8
'11030, 용산구,'080,75~79세,2019,7180,3052,4128,73.9,7097,3009,4088,73.6
'11030, 용산구,'080001, 75세,2019,1416,585,831,70.4,1400,577,823,70.1
'11030, 용산구,'080002, 76세,2019,1454,656,798,82.2,1433,645,788,81.9
'11030, 용산구,'080003, 77세,2019,1724,745,979,76.1,1710,737,973,75.7
'11030, 용산구,'080004, 78세,2019,1370,569,801,71,1356,565,791,71.4
'11030, 용산구,'080005, 79세,2019,1216,497,719,69.1,1198,485,713,68
'11030, 용산구,'085,80~84세,2019,4847,1852,2995,61.8,4794,1832,2962,61.9
'11030, 용산구,'085001, 80세,2019,1166,480,686,70,1153,473,680,69.6
'11030, 용산구,'085002, 81세,2019,1116,422,694,60.8,1105,418,687,60.8
'11030, 용산구,'085003, 82세,2019,958,375,583,64.3,947,373,574,65
'11030, 용산구,'085004, 83세,2019,876,300,576,52.1,865,296,569,52
'11030, 용산구,'085005, 84세,2019,731,275,456,60.3,724,272,452,60.2
'11030, 용산구,'086,85세이상,2019,3082,1018,2064,49.3,3036,999,2037,49
'11030, 용산구,'090,85~89세,2019,2141,759,1382,54.9,2111,746,1365,54.7
'11030, 용산구,'090001, 85세,2019,611,207,404,51.2,605,204,401,50.9
'11030, 용산구,'090002, 86세,2019,500,177,323,54.8,489,171,318,53.8
'11030, 용산구,'090003, 87세,2019,428,151,277,54.5,423,150,273,54.9
'11030, 용산구,'090004, 88세,2019,330,125,205,61,325,122,203,60.1
'11030, 용산구,'090005, 89세,2019,272,99,173,57.2,269,99,170,58.2
'11030, 용산구,'095,90~94세,2019,725,192,533,36,715,186,529,35.2
'11030, 용산구,'095001, 90세,2019,250,69,181,38.1,248,69,179,38.5
'11030, 용산구,'095002, 91세,2019,191,44,147,29.9,189,43,146,29.5
'11030, 용산구,'095003, 92세,2019,127,28,99,28.3,126,27,99,27.3
'11030, 용산구,'095004, 93세,2019,88,22,66,33.3,87,21,66,31.8
'11030, 용산구,'095005, 94세,2019,69,29,40,72.5,65,26,39,66.7
'11030, 용산구,'100,95~99세,2019,194,62,132,47,190,62,128,48.4
'11030, 용산구,'100001, 95세,2019,61,21,40,52.5,60,21,39,53.8
'11030, 용산구,'100002, 96세,2019,59,23,36,63.9,56,23,33,69.7
'11030, 용산구,'100003, 97세,2019,33,6,27,22.2,33,6,27,22.2
'11030, 용산구,'100004, 98세,2019,30,9,21,42.9,30,9,21,42.9
'11030, 용산구,'100005, 99세,2019,11,X,8,37.5,11,X,8,37.5
'11030, 용산구,'101,100세이상,2019,22,5,17,29.4,20,5,15,33.3
'11030, 용산구,'102,15세미만,2019,22910,11706,11204,104.5,19622,10096,9526,106
'11030, 용산구,'103,15~64세,2019,170422,84729,85693,98.9,153894,75046,78848,95.2
'11030, 용산구,'104,65세이상,2019,33849,14499,19350,74.9,33162,14171,18991,74.6
'11030, 용산구,'126,평균연령,2019,42.5,41.6,43.4,,43.5,42.6,44.2,
'11030, 용산구,'127,중위연령,2019,41.8,40.9,42.8,,43.4,42.6,44.1,
'11040, 성동구,'000,합계,2019,299688,146630,153058,95.8,287914,141020,146894,96
'11040, 성동구,'005,0~4세,2019,11452,5869,5583,105.1,11141,5710,5431,105.1
'11040, 성동구,'005001, 0세,2019,2200,1147,1053,108.9,2155,1125,1030,109.2
'11040, 성동구,'005002, 1세,2019,2204,1114,1090,102.2,2158,1090,1068,102.1
'11040, 성동구,'005003, 2세,2019,2277,1180,1097,107.6,2195,1137,1058,107.5
'11040, 성동구,'005004, 3세,2019,2390,1207,1183,102,2323,1175,1148,102.4
'11040, 성동구,'005005, 4세,2019,2381,1221,1160,105.3,2310,1183,1127,105
'11040, 성동구,'010,5~9세,2019,10398,5241,5157,101.6,10210,5151,5059,101.8
'11040, 성동구,'010001, 5세,2019,2300,1144,1156,99,2244,1119,1125,99.5
'11040, 성동구,'010002, 6세,2019,2171,1102,1069,103.1,2138,1086,1052,103.2
'11040, 성동구,'010003, 7세,2019,2110,1053,1057,99.6,2077,1037,1040,99.7
'11040, 성동구,'010004, 8세,2019,1976,1028,948,108.4,1950,1014,936,108.3
'11040, 성동구,'010005, 9세,2019,1841,914,927,98.6,1801,895,906,98.8
'11040, 성동구,'015,10~14세,2019,8974,4566,4408,103.6,8888,4522,4366,103.6
'11040, 성동구,'015001, 10세,2019,1713,875,838,104.4,1696,867,829,104.6
'11040, 성동구,'015002, 11세,2019,1929,984,945,104.1,1913,979,934,104.8
'11040, 성동구,'015003, 12세,2019,1894,966,928,104.1,1883,959,924,103.8
'11040, 성동구,'015004, 13세,2019,1715,874,841,103.9,1697,864,833,103.7
'11040, 성동구,'015005, 14세,2019,1723,867,856,101.3,1699,853,846,100.8
'11040, 성동구,'020,15~19세,2019,11942,5816,6126,94.9,11434,5597,5837,95.9
'11040, 성동구,'020001, 15세,2019,1868,941,927,101.5,1850,932,918,101.5
'11040, 성동구,'020002, 16세,2019,1844,849,995,85.3,1819,835,984,84.9
'11040, 성동구,'020003, 17세,2019,2012,949,1063,89.3,1977,933,1044,89.4
'11040, 성동구,'020004, 18세,2019,2568,1302,1266,102.8,2444,1252,1192,105
'11040, 성동구,'020005, 19세,2019,3650,1775,1875,94.7,3344,1645,1699,96.8
'11040, 성동구,'025,20~24세,2019,22964,11089,11875,93.4,20770,10206,10564,96.6
'11040, 성동구,'025001, 20세,2019,3804,1822,1982,91.9,3447,1692,1755,96.4
'11040, 성동구,'025002, 21세,2019,4114,1887,2227,84.7,3670,1707,1963,87
'11040, 성동구,'025003, 22세,2019,4585,2198,2387,92.1,4129,2022,2107,96
'11040, 성동구,'025004, 23세,2019,5195,2544,2651,96,4722,2355,2367,99.5
'11040, 성동구,'025005, 24세,2019,5266,2638,2628,100.4,4802,2430,2372,102.4
'11040, 성동구,'030,25~29세,2019,26568,13490,13078,103.2,25055,12783,12272,104.2
'11040, 성동구,'030001, 25세,2019,5391,2715,2676,101.5,5039,2566,2473,103.8
'11040, 성동구,'030002, 26세,2019,5433,2870,2563,112,5130,2733,2397,114
'11040, 성동구,'030003, 27세,2019,5526,2838,2688,105.6,5233,2701,2532,106.7
'11040, 성동구,'030004, 28세,2019,5167,2598,2569,101.1,4898,2464,2434,101.2
'11040, 성동구,'030005, 29세,2019,5051,2469,2582,95.6,4755,2319,2436,95.2
'11040, 성동구,'035,30~34세,2019,24647,12001,12646,94.9,23412,11362,12050,94.3
'11040, 성동구,'035001, 30세,2019,4944,2372,2572,92.2,4699,2247,2452,91.6
'11040, 성동구,'035002, 31세,2019,4856,2331,2525,92.3,4607,2201,2406,91.5
'11040, 성동구,'035003, 32세,2019,4768,2286,2482,92.1,4526,2155,2371,90.9
'11040, 성동구,'035004, 33세,2019,4986,2484,2502,99.3,4732,2357,2375,99.2
'11040, 성동구,'035005, 34세,2019,5093,2528,2565,98.6,4848,2402,2446,98.2
'11040, 성동구,'040,35~39세,2019,26456,13420,13036,102.9,25414,12837,12577,102.1
'11040, 성동구,'040001, 35세,2019,5082,2544,2538,100.2,4845,2415,2430,99.4
'11040, 성동구,'040002, 36세,2019,5308,2710,2598,104.3,5105,2596,2509,103.5
'11040, 성동구,'040003, 37세,2019,5483,2788,2695,103.5,5244,2659,2585,102.9
'11040, 성동구,'040004, 38세,2019,5303,2701,2602,103.8,5119,2590,2529,102.4
'11040, 성동구,'040005, 39세,2019,5280,2677,2603,102.8,5101,2577,2524,102.1
'11040, 성동구,'045,40~44세,2019,21640,11068,10572,104.7,20842,10645,10197,104.4
'11040, 성동구,'045001, 40세,2019,4666,2377,2289,103.8,4503,2293,2210,103.8
'11040, 성동구,'045002, 41세,2019,4237,2176,2061,105.6,4078,2084,1994,104.5
'11040, 성동구,'045003, 42세,2019,4306,2216,2090,106,4153,2134,2019,105.7
'11040, 성동구,'045004, 43세,2019,4187,2181,2006,108.7,4022,2101,1921,109.4
'11040, 성동구,'045005, 44세,2019,4244,2118,2126,99.6,4086,2033,2053,99
'11040, 성동구,'050,45~49세,2019,24238,12076,12162,99.3,23323,11623,11700,99.3
'11040, 성동구,'050001, 45세,2019,4580,2317,2263,102.4,4446,2249,2197,102.4
'11040, 성동구,'050002, 46세,2019,4693,2378,2315,102.7,4527,2306,2221,103.8
'11040, 성동구,'050003, 47세,2019,4786,2376,2410,98.6,4583,2275,2308,98.6
'11040, 성동구,'050004, 48세,2019,5112,2505,2607,96.1,4934,2409,2525,95.4
'11040, 성동구,'050005, 49세,2019,5067,2500,2567,97.4,4833,2384,2449,97.3
'11040, 성동구,'055,50~54세,2019,23687,11616,12071,96.2,22764,11135,11629,95.8
'11040, 성동구,'055001, 50세,2019,5024,2441,2583,94.5,4847,2351,2496,94.2
'11040, 성동구,'055002, 51세,2019,4968,2450,2518,97.3,4777,2348,2429,96.7
'11040, 성동구,'055003, 52세,2019,4539,2206,2333,94.6,4386,2123,2263,93.8
'11040, 성동구,'055004, 53세,2019,4449,2217,2232,99.3,4261,2119,2142,98.9
'11040, 성동구,'055005, 54세,2019,4707,2302,2405,95.7,4493,2194,2299,95.4
'11040, 성동구,'060,55~59세,2019,24039,11919,12120,98.3,23190,11539,11651,99
'11040, 성동구,'060001, 55세,2019,4514,2272,2242,101.3,4331,2180,2151,101.3
'11040, 성동구,'060002, 56세,2019,4751,2319,2432,95.4,4545,2231,2314,96.4
'11040, 성동구,'060003, 57세,2019,4731,2394,2337,102.4,4549,2305,2244,102.7
'11040, 성동구,'060004, 58세,2019,4938,2422,2516,96.3,4815,2372,2443,97.1
'11040, 성동구,'060005, 59세,2019,5105,2512,2593,96.9,4950,2451,2499,98.1
'11040, 성동구,'065,60~64세,2019,20801,10164,10637,95.6,20121,9850,10271,95.9
'11040, 성동구,'065001, 60세,2019,4507,2229,2278,97.8,4366,2156,2210,97.6
'11040, 성동구,'065002, 61세,2019,4322,2173,2149,101.1,4168,2104,2064,101.9
'11040, 성동구,'065003, 62세,2019,4242,2085,2157,96.7,4106,2025,2081,97.3
'11040, 성동구,'065004, 63세,2019,3818,1839,1979,92.9,3677,1776,1901,93.4
'11040, 성동구,'065005, 64세,2019,3912,1838,2074,88.6,3804,1789,2015,88.8
'11040, 성동구,'070,65~69세,2019,13760,6534,7226,90.4,13422,6363,7059,90.1
'11040, 성동구,'070001, 65세,2019,3294,1592,1702,93.5,3188,1541,1647,93.6
'11040, 성동구,'070002, 66세,2019,2792,1356,1436,94.4,2725,1319,1406,93.8
'11040, 성동구,'070003, 67세,2019,3006,1429,1577,90.6,2940,1394,1546,90.2
'11040, 성동구,'070004, 68세,2019,2222,1028,1194,86.1,2164,1000,1164,85.9
'11040, 성동구,'070005, 69세,2019,2446,1129,1317,85.7,2405,1109,1296,85.6
'11040, 성동구,'075,70~74세,2019,10870,4880,5990,81.5,10770,4846,5924,81.8
'11040, 성동구,'075001, 70세,2019,2434,1120,1314,85.2,2404,1110,1294,85.8
'11040, 성동구,'075002, 71세,2019,2310,1078,1232,87.5,2290,1073,1217,88.2
'11040, 성동구,'075003, 72세,2019,2424,1080,1344,80.4,2410,1075,1335,80.5
'11040, 성동구,'075004, 73세,2019,1895,832,1063,78.3,1871,823,1048,78.5
'11040, 성동구,'075005, 74세,2019,1807,770,1037,74.3,1795,765,1030,74.3
'11040, 성동구,'080,75~79세,2019,8810,3869,4941,78.3,8766,3853,4913,78.4
'11040, 성동구,'080001, 75세,2019,1824,824,1000,82.4,1814,820,994,82.5
'11040, 성동구,'080002, 76세,2019,1808,800,1008,79.4,1798,796,1002,79.4
'11040, 성동구,'080003, 77세,2019,2109,951,1158,82.1,2104,948,1156,82
'11040, 성동구,'080004, 78세,2019,1670,737,933,79,1662,735,927,79.3
'11040, 성동구,'080005, 79세,2019,1399,557,842,66.2,1388,554,834,66.4
'11040, 성동구,'085,80~84세,2019,5273,2052,3221,63.7,5248,2048,3200,64
'11040, 성동구,'085001, 80세,2019,1329,570,759,75.1,1323,569,754,75.5
'11040, 성동구,'085002, 81세,2019,1193,463,730,63.4,1190,462,728,63.5
'11040, 성동구,'085003, 82세,2019,1078,412,666,61.9,1073,411,662,62.1
'11040, 성동구,'085004, 83세,2019,916,331,585,56.6,911,331,580,57.1
'11040, 성동구,'085005, 84세,2019,757,276,481,57.4,751,275,476,57.8
'11040, 성동구,'086,85세이상,2019,3169,960,2209,43.5,3144,950,2194,43.3
'11040, 성동구,'090,85~89세,2019,2241,717,1524,47,2225,710,1515,46.9
'11040, 성동구,'090001, 85세,2019,707,270,437,61.8,700,267,433,61.7
'11040, 성동구,'090002, 86세,2019,498,153,345,44.3,497,153,344,44.5
'11040, 성동구,'090003, 87세,2019,431,133,298,44.6,429,132,297,44.4
'11040, 성동구,'090004, 88세,2019,323,88,235,37.4,319,85,234,36.3
'11040, 성동구,'090005, 89세,2019,282,73,209,34.9,280,73,207,35.3
'11040, 성동구,'095,90~94세,2019,724,194,530,36.6,721,194,527,36.8
'11040, 성동구,'095001, 90세,2019,241,75,166,45.2,241,75,166,45.2
'11040, 성동구,'095002, 91세,2019,168,47,121,38.8,168,47,121,38.8
'11040, 성동구,'095003, 92세,2019,150,37,113,32.7,150,37,113,32.7
'11040, 성동구,'095004, 93세,2019,95,20,75,26.7,93,20,73,27.4
'11040, 성동구,'095005, 94세,2019,70,15,55,27.3,69,15,54,27.8
'11040, 성동구,'100,95~99세,2019,181,44,137,32.1,178,43,135,31.9
'11040, 성동구,'100001, 95세,2019,57,14,43,32.6,57,14,43,32.6
'11040, 성동구,'100002, 96세,2019,53,13,40,32.5,51,12,39,30.8
'11040, 성동구,'100003, 97세,2019,35,8,27,29.6,34,8,26,30.8
'11040, 성동구,'100004, 98세,2019,23,5,18,27.8,23,5,18,27.8
'11040, 성동구,'100005, 99세,2019,13,X,9,44.4,13,X,9,44.4
'11040, 성동구,'101,100세이상,2019,23,5,18,27.8,20,X,17,17.6
'11040, 성동구,'102,15세미만,2019,30824,15676,15148,103.5,30239,15383,14856,103.5
'11040, 성동구,'103,15~64세,2019,226982,112659,114323,98.5,216325,107577,108748,98.9
'11040, 성동구,'104,65세이상,2019,41882,18295,23587,77.6,41350,18060,23290,77.5
'11040, 성동구,'126,평균연령,2019,42,41.3,42.7,,42.2,41.4,42.9,
'11040, 성동구,'127,중위연령,2019,41.4,40.8,42.1,,41.8,41,42.5,
'11050, 광진구,'000,합계,2019,359766,174027,185739,93.7,338841,164553,174288,94.4
'11050, 광진구,'005,0~4세,2019,10211,5254,4957,106,9781,5020,4761,105.4
'11050, 광진구,'005001, 0세,2019,1949,1020,929,109.8,1855,963,892,108
'11050, 광진구,'005002, 1세,2019,1871,963,908,106.1,1792,923,869,106.2
'11050, 광진구,'005003, 2세,2019,1957,994,963,103.2,1878,952,926,102.8
'11050, 광진구,'005004, 3세,2019,2153,1119,1034,108.2,2052,1064,988,107.7
'11050, 광진구,'005005, 4세,2019,2281,1158,1123,103.1,2204,1118,1086,102.9
'11050, 광진구,'010,5~9세,2019,11392,5879,5513,106.6,11079,5715,5364,106.5
'11050, 광진구,'010001, 5세,2019,2155,1126,1029,109.4,2065,1084,981,110.5
'11050, 광진구,'010002, 6세,2019,2216,1124,1092,102.9,2159,1099,1060,103.7
'11050, 광진구,'010003, 7세,2019,2383,1230,1153,106.7,2318,1191,1127,105.7
'11050, 광진구,'010004, 8세,2019,2311,1162,1149,101.1,2260,1130,1130,100
'11050, 광진구,'010005, 9세,2019,2327,1237,1090,113.5,2277,1211,1066,113.6
'11050, 광진구,'015,10~14세,2019,11810,6010,5800,103.6,11641,5915,5726,103.3
'11050, 광진구,'015001, 10세,2019,2163,1117,1046,106.8,2118,1097,1021,107.4
'11050, 광진구,'015002, 11세,2019,2382,1230,1152,106.8,2345,1207,1138,106.1
'11050, 광진구,'015003, 12세,2019,2547,1278,1269,100.7,2510,1254,1256,99.8
'11050, 광진구,'015004, 13세,2019,2359,1193,1166,102.3,2333,1179,1154,102.2
'11050, 광진구,'015005, 14세,2019,2359,1192,1167,102.1,2335,1178,1157,101.8
'11050, 광진구,'020,15~19세,2019,15873,7905,7968,99.2,14932,7566,7366,102.7
'11050, 광진구,'020001, 15세,2019,2534,1314,1220,107.7,2498,1296,1202,107.8
'11050, 광진구,'020002, 16세,2019,2532,1280,1252,102.2,2508,1269,1239,102.4
'11050, 광진구,'020003, 17세,2019,2614,1294,1320,98,2549,1267,1282,98.8
'11050, 광진구,'020004, 18세,2019,3352,1707,1645,103.8,3112,1627,1485,109.6
'11050, 광진구,'020005, 19세,2019,4841,2310,2531,91.3,4265,2107,2158,97.6
'11050, 광진구,'025,20~24세,2019,31082,14044,17038,82.4,27405,12733,14672,86.8
'11050, 광진구,'025001, 20세,2019,5073,2309,2764,83.5,4418,2100,2318,90.6
'11050, 광진구,'025002, 21세,2019,5701,2475,3226,76.7,4962,2210,2752,80.3
'11050, 광진구,'025003, 22세,2019,6202,2838,3364,84.4,5415,2549,2866,88.9
'11050, 광진구,'025004, 23세,2019,6906,3089,3817,80.9,6127,2818,3309,85.2
'11050, 광진구,'025005, 24세,2019,7200,3333,3867,86.2,6483,3056,3427,89.2
'11050, 광진구,'030,25~29세,2019,37355,18230,19125,95.3,34831,17153,17678,97
'11050, 광진구,'030001, 25세,2019,7563,3525,4038,87.3,6962,3292,3670,89.7
'11050, 광진구,'030002, 26세,2019,7797,3869,3928,98.5,7275,3641,3634,100.2
'11050, 광진구,'030003, 27세,2019,7769,3794,3975,95.4,7319,3611,3708,97.4
'11050, 광진구,'030004, 28세,2019,7272,3612,3660,98.7,6838,3415,3423,99.8
'11050, 광진구,'030005, 29세,2019,6954,3430,3524,97.3,6437,3194,3243,98.5
'11050, 광진구,'035,30~34세,2019,30527,15147,15380,98.5,28404,14064,14340,98.1
'11050, 광진구,'035001, 30세,2019,6636,3253,3383,96.2,6195,3036,3159,96.1
'11050, 광진구,'035002, 31세,2019,6251,3056,3195,95.6,5793,2825,2968,95.2
'11050, 광진구,'035003, 32세,2019,6099,3029,3070,98.7,5653,2792,2861,97.6
'11050, 광진구,'035004, 33세,2019,5915,2972,2943,101,5509,2764,2745,100.7
'11050, 광진구,'035005, 34세,2019,5626,2837,2789,101.7,5254,2647,2607,101.5
'11050, 광진구,'040,35~39세,2019,28970,14525,14445,100.6,27441,13737,13704,100.2
'11050, 광진구,'040001, 35세,2019,5561,2786,2775,100.4,5221,2603,2618,99.4
'11050, 광진구,'040002, 36세,2019,5914,2980,2934,101.6,5575,2817,2758,102.1
'11050, 광진구,'040003, 37세,2019,6082,3007,3075,97.8,5750,2841,2909,97.7
'11050, 광진구,'040004, 38세,2019,5778,2916,2862,101.9,5511,2775,2736,101.4
'11050, 광진구,'040005, 39세,2019,5635,2836,2799,101.3,5384,2701,2683,100.7
'11050, 광진구,'045,40~44세,2019,25167,12611,12556,100.4,23944,11954,11990,99.7
'11050, 광진구,'045001, 40세,2019,5387,2667,2720,98.1,5141,2546,2595,98.1
'11050, 광진구,'045002, 41세,2019,4759,2434,2325,104.7,4496,2286,2210,103.4
'11050, 광진구,'045003, 42세,2019,5098,2555,2543,100.5,4846,2410,2436,98.9
'11050, 광진구,'045004, 43세,2019,4858,2454,2404,102.1,4621,2327,2294,101.4
'11050, 광진구,'045005, 44세,2019,5065,2501,2564,97.5,4840,2385,2455,97.1
'11050, 광진구,'050,45~49세,2019,29148,14285,14863,96.1,27594,13526,14068,96.1
'11050, 광진구,'050001, 45세,2019,5460,2700,2760,97.8,5207,2576,2631,97.9
'11050, 광진구,'050002, 46세,2019,5620,2724,2896,94.1,5328,2578,2750,93.7
'11050, 광진구,'050003, 47세,2019,5788,2900,2888,100.4,5499,2760,2739,100.8
'11050, 광진구,'050004, 48세,2019,6221,3062,3159,96.9,5875,2889,2986,96.8
'11050, 광진구,'050005, 49세,2019,6059,2899,3160,91.7,5685,2723,2962,91.9
'11050, 광진구,'055,50~54세,2019,28712,13839,14873,93,26870,12961,13909,93.2
'11050, 광진구,'055001, 50세,2019,6017,2852,3165,90.1,5628,2662,2966,89.8
'11050, 광진구,'055002, 51세,2019,6125,2942,3183,92.4,5759,2777,2982,93.1
'11050, 광진구,'055003, 52세,2019,5535,2655,2880,92.2,5216,2492,2724,91.5
'11050, 광진구,'055004, 53세,2019,5406,2624,2782,94.3,5036,2453,2583,95
'11050, 광진구,'055005, 54세,2019,5629,2766,2863,96.6,5231,2577,2654,97.1
'11050, 광진구,'060,55~59세,2019,28433,13753,14680,93.7,26378,12814,13564,94.5
'11050, 광진구,'060001, 55세,2019,5260,2581,2679,96.3,4804,2360,2444,96.6
'11050, 광진구,'060002, 56세,2019,5737,2844,2893,98.3,5184,2588,2596,99.7
'11050, 광진구,'060003, 57세,2019,5588,2721,2867,94.9,5180,2540,2640,96.2
'11050, 광진구,'060004, 58세,2019,5857,2740,3117,87.9,5597,2636,2961,89
'11050, 광진구,'060005, 59세,2019,5991,2867,3124,91.8,5613,2690,2923,92
'11050, 광진구,'065,60~64세,2019,24756,11783,12973,90.8,23292,11087,12205,90.8
'11050, 광진구,'065001, 60세,2019,5353,2535,2818,90,5025,2381,2644,90.1
'11050, 광진구,'065002, 61세,2019,5216,2492,2724,91.5,4865,2328,2537,91.8
'11050, 광진구,'065003, 62세,2019,5015,2413,2602,92.7,4697,2260,2437,92.7
'11050, 광진구,'065004, 63세,2019,4530,2143,2387,89.8,4295,2028,2267,89.5
'11050, 광진구,'065005, 64세,2019,4642,2200,2442,90.1,4410,2090,2320,90.1
'11050, 광진구,'070,65~69세,2019,16022,7599,8423,90.2,15356,7301,8055,90.6
'11050, 광진구,'070001, 65세,2019,3814,1845,1969,93.7,3616,1753,1863,94.1
'11050, 광진구,'070002, 66세,2019,3358,1614,1744,92.5,3194,1534,1660,92.4
'11050, 광진구,'070003, 67세,2019,3659,1733,1926,90,3541,1680,1861,90.3
'11050, 광진구,'070004, 68세,2019,2513,1149,1364,84.2,2408,1111,1297,85.7
'11050, 광진구,'070005, 69세,2019,2678,1258,1420,88.6,2597,1223,1374,89
'11050, 광진구,'075,70~74세,2019,12204,5700,6504,87.6,11993,5606,6387,87.8
'11050, 광진구,'075001, 70세,2019,2732,1287,1445,89.1,2670,1261,1409,89.5
'11050, 광진구,'075002, 71세,2019,2737,1280,1457,87.9,2683,1252,1431,87.5
'11050, 광진구,'075003, 72세,2019,2673,1206,1467,82.2,2637,1191,1446,82.4
'11050, 광진구,'075004, 73세,2019,2113,994,1119,88.8,2075,978,1097,89.2
'11050, 광진구,'075005, 74세,2019,1949,933,1016,91.8,1928,924,1004,92
'11050, 광진구,'080,75~79세,2019,9273,4237,5036,84.1,9167,4200,4967,84.6
'11050, 광진구,'080001, 75세,2019,2038,917,1121,81.8,2020,910,1110,82
'11050, 광진구,'080002, 76세,2019,1901,870,1031,84.4,1874,862,1012,85.2
'11050, 광진구,'080003, 77세,2019,2152,998,1154,86.5,2121,988,1133,87.2
'11050, 광진구,'080004, 78세,2019,1691,768,923,83.2,1679,762,917,83.1
'11050, 광진구,'080005, 79세,2019,1491,684,807,84.8,1473,678,795,85.3
'11050, 광진구,'085,80~84세,2019,5452,2201,3251,67.7,5388,2185,3203,68.2
'11050, 광진구,'085001, 80세,2019,1416,633,783,80.8,1403,631,772,81.7
'11050, 광진구,'085002, 81세,2019,1267,528,739,71.4,1250,524,726,72.2
'11050, 광진구,'085003, 82세,2019,1061,431,630,68.4,1044,425,619,68.7
'11050, 광진구,'085004, 83세,2019,888,316,572,55.2,875,313,562,55.7
'11050, 광진구,'085005, 84세,2019,820,293,527,55.6,816,292,524,55.7
'11050, 광진구,'086,85세이상,2019,3379,1025,2354,43.5,3345,1016,2329,43.6
'11050, 광진구,'090,85~89세,2019,2355,761,1594,47.7,2327,754,1573,47.9
'11050, 광진구,'090001, 85세,2019,673,238,435,54.7,666,236,430,54.9
'11050, 광진구,'090002, 86세,2019,554,185,369,50.1,539,182,357,51
'11050, 광진구,'090003, 87세,2019,488,154,334,46.1,486,154,332,46.4
'11050, 광진구,'090004, 88세,2019,332,100,232,43.1,331,100,231,43.3
'11050, 광진구,'090005, 89세,2019,308,84,224,37.5,305,82,223,36.8
'11050, 광진구,'095,90~94세,2019,804,218,586,37.2,802,216,586,36.9
'11050, 광진구,'095001, 90세,2019,267,79,188,42,265,77,188,41
'11050, 광진구,'095002, 91세,2019,197,47,150,31.3,197,47,150,31.3
'11050, 광진구,'095003, 92세,2019,161,49,112,43.8,161,49,112,43.8
'11050, 광진구,'095004, 93세,2019,95,17,78,21.8,95,17,78,21.8
'11050, 광진구,'095005, 94세,2019,84,26,58,44.8,84,26,58,44.8
'11050, 광진구,'100,95~99세,2019,188,41,147,27.9,185,41,144,28.5
'11050, 광진구,'100001, 95세,2019,68,16,52,30.8,67,16,51,31.4
'11050, 광진구,'100002, 96세,2019,45,8,37,21.6,43,8,35,22.9
'11050, 광진구,'100003, 97세,2019,40,5,35,14.3,40,5,35,14.3
'11050, 광진구,'100004, 98세,2019,23,8,15,53.3,23,8,15,53.3
'11050, 광진구,'100005, 99세,2019,12,X,8,50,12,X,8,50
'11050, 광진구,'101,100세이상,2019,32,5,27,18.5,31,5,26,19.2
'11050, 광진구,'102,15세미만,2019,33413,17143,16270,105.4,32501,16650,15851,105
'11050, 광진구,'103,15~64세,2019,280023,136122,143901,94.6,261091,127595,133496,95.6
'11050, 광진구,'104,65세이상,2019,46330,20762,25568,81.2,45249,20308,24941,81.4
'11050, 광진구,'126,평균연령,2019,41.5,40.9,42,,41.6,41,42.2,
'11050, 광진구,'127,중위연령,2019,40.5,40,41,,40.8,40.1,41.4,
'11060, 동대문구,'000,합계,2019,355094,174161,180933,96.3,334045,165309,168736,98
'11060, 동대문구,'005,0~4세,2019,10642,5452,5190,105,10375,5322,5053,105.3
'11060, 동대문구,'005001, 0세,2019,1914,969,945,102.5,1869,946,923,102.5
'11060, 동대문구,'005002, 1세,2019,1932,1001,931,107.5,1886,976,910,107.3
'11060, 동대문구,'005003, 2세,2019,2093,1086,1007,107.8,2055,1061,994,106.7
'11060, 동대문구,'005004, 3세,2019,2335,1211,1124,107.7,2264,1180,1084,108.9
'11060, 동대문구,'005005, 4세,2019,2368,1185,1183,100.2,2301,1159,1142,101.5
'11060, 동대문구,'010,5~9세,2019,11244,5781,5463,105.8,11112,5716,5396,105.9
'11060, 동대문구,'010001, 5세,2019,2252,1157,1095,105.7,2225,1146,1079,106.2
'11060, 동대문구,'010002, 6세,2019,2273,1184,1089,108.7,2236,1169,1067,109.6
'11060, 동대문구,'010003, 7세,2019,2278,1170,1108,105.6,2251,1158,1093,105.9
'11060, 동대문구,'010004, 8세,2019,2271,1140,1131,100.8,2250,1125,1125,100
'11060, 동대문구,'010005, 9세,2019,2170,1130,1040,108.7,2150,1118,1032,108.3
'11060, 동대문구,'015,10~14세,2019,10709,5493,5216,105.3,10595,5442,5153,105.6
'11060, 동대문구,'015001, 10세,2019,2087,1083,1004,107.9,2064,1073,991,108.3
'11060, 동대문구,'015002, 11세,2019,2258,1126,1132,99.5,2231,1111,1120,99.2
'11060, 동대문구,'015003, 12세,2019,2255,1183,1072,110.4,2236,1173,1063,110.3
'11060, 동대문구,'015004, 13세,2019,2098,1088,1010,107.7,2073,1076,997,107.9
'11060, 동대문구,'015005, 14세,2019,2011,1013,998,101.5,1991,1009,982,102.7
'11060, 동대문구,'020,15~19세,2019,15364,7247,8117,89.3,14166,6864,7302,94
'11060, 동대문구,'020001, 15세,2019,2198,1119,1079,103.7,2182,1113,1069,104.1
'11060, 동대문구,'020002, 16세,2019,2215,1109,1106,100.3,2202,1102,1100,100.2
'11060, 동대문구,'020003, 17세,2019,2262,1133,1129,100.4,2216,1115,1101,101.3
'11060, 동대문구,'020004, 18세,2019,3252,1548,1704,90.8,2963,1464,1499,97.7
'11060, 동대문구,'020005, 19세,2019,5437,2338,3099,75.4,4603,2070,2533,81.7
'11060, 동대문구,'025,20~24세,2019,35870,15988,19882,80.4,28903,13590,15313,88.7
'11060, 동대문구,'025001, 20세,2019,6160,2545,3615,70.4,4938,2129,2809,75.8
'11060, 동대문구,'025002, 21세,2019,6902,2821,4081,69.1,5277,2231,3046,73.2
'11060, 동대문구,'025003, 22세,2019,7357,3211,4146,77.4,5811,2708,3103,87.3
'11060, 동대문구,'025004, 23세,2019,7884,3684,4200,87.7,6466,3214,3252,98.8
'11060, 동대문구,'025005, 24세,2019,7567,3727,3840,97.1,6411,3308,3103,106.6
'11060, 동대문구,'030,25~29세,2019,32550,17264,15286,112.9,29352,15893,13459,118.1
'11060, 동대문구,'030001, 25세,2019,7401,3914,3487,112.2,6499,3561,2938,121.2
'11060, 동대문구,'030002, 26세,2019,6882,3661,3221,113.7,6196,3379,2817,120
'11060, 동대문구,'030003, 27세,2019,6649,3574,3075,116.2,6049,3315,2734,121.3
'11060, 동대문구,'030004, 28세,2019,5972,3181,2791,114,5454,2951,2503,117.9
'11060, 동대문구,'030005, 29세,2019,5646,2934,2712,108.2,5154,2687,2467,108.9
'11060, 동대문구,'035,30~34세,2019,25140,12958,12182,106.4,23106,12041,11065,108.8
'11060, 동대문구,'035001, 30세,2019,5253,2731,2522,108.3,4753,2529,2224,113.7
'11060, 동대문구,'035002, 31세,2019,5083,2577,2506,102.8,4663,2401,2262,106.1
'11060, 동대문구,'035003, 32세,2019,4899,2533,2366,107.1,4468,2328,2140,108.8
'11060, 동대문구,'035004, 33세,2019,4994,2604,2390,109,4629,2416,2213,109.2
'11060, 동대문구,'035005, 34세,2019,4911,2513,2398,104.8,4593,2367,2226,106.3
'11060, 동대문구,'040,35~39세,2019,27295,14131,13164,107.3,25899,13425,12474,107.6
'11060, 동대문구,'040001, 35세,2019,5041,2596,2445,106.2,4736,2434,2302,105.7
'11060, 동대문구,'040002, 36세,2019,5435,2820,2615,107.8,5132,2673,2459,108.7
'11060, 동대문구,'040003, 37세,2019,5733,2930,2803,104.5,5432,2786,2646,105.3
'11060, 동대문구,'040004, 38세,2019,5579,2889,2690,107.4,5353,2782,2571,108.2
'11060, 동대문구,'040005, 39세,2019,5507,2896,2611,110.9,5246,2750,2496,110.2
'11060, 동대문구,'045,40~44세,2019,24119,12529,11590,108.1,23007,11927,11080,107.6
'11060, 동대문구,'045001, 40세,2019,5245,2741,2504,109.5,4974,2598,2376,109.3
'11060, 동대문구,'045002, 41세,2019,4649,2433,2216,109.8,4415,2296,2119,108.4
'11060, 동대문구,'045003, 42세,2019,4794,2445,2349,104.1,4578,2326,2252,103.3
'11060, 동대문구,'045004, 43세,2019,4609,2404,2205,109,4397,2302,2095,109.9
'11060, 동대문구,'045005, 44세,2019,4822,2506,2316,108.2,4643,2405,2238,107.5
'11060, 동대문구,'050,45~49세,2019,26980,13831,13149,105.2,25797,13213,12584,105
'11060, 동대문구,'050001, 45세,2019,5089,2636,2453,107.5,4865,2524,2341,107.8
'11060, 동대문구,'050002, 46세,2019,5185,2650,2535,104.5,4958,2536,2422,104.7
'11060, 동대문구,'050003, 47세,2019,5408,2776,2632,105.5,5162,2638,2524,104.5
'11060, 동대문구,'050004, 48세,2019,5736,2963,2773,106.9,5501,2852,2649,107.7
'11060, 동대문구,'050005, 49세,2019,5562,2806,2756,101.8,5311,2663,2648,100.6
'11060, 동대문구,'055,50~54세,2019,26404,13133,13271,99,25257,12600,12657,99.5
'11060, 동대문구,'055001, 50세,2019,5499,2674,2825,94.7,5262,2576,2686,95.9
'11060, 동대문구,'055002, 51세,2019,5469,2706,2763,97.9,5248,2604,2644,98.5
'11060, 동대문구,'055003, 52세,2019,5015,2424,2591,93.6,4823,2342,2481,94.4
'11060, 동대문구,'055004, 53세,2019,5114,2677,2437,109.8,4869,2561,2308,111
'11060, 동대문구,'055005, 54세,2019,5307,2652,2655,99.9,5055,2517,2538,99.2
'11060, 동대문구,'060,55~59세,2019,26995,13171,13824,95.3,26021,12701,13320,95.4
'11060, 동대문구,'060001, 55세,2019,4889,2387,2502,95.4,4665,2278,2387,95.4
'11060, 동대문구,'060002, 56세,2019,5239,2626,2613,100.5,4989,2504,2485,100.8
'11060, 동대문구,'060003, 57세,2019,5261,2589,2672,96.9,5067,2497,2570,97.2
'11060, 동대문구,'060004, 58세,2019,5708,2775,2933,94.6,5588,2717,2871,94.6
'11060, 동대문구,'060005, 59세,2019,5898,2794,3104,90,5712,2705,3007,90
'11060, 동대문구,'065,60~64세,2019,25424,12228,13196,92.7,24707,11898,12809,92.9
'11060, 동대문구,'065001, 60세,2019,5392,2596,2796,92.8,5255,2524,2731,92.4
'11060, 동대문구,'065002, 61세,2019,5135,2479,2656,93.3,4974,2414,2560,94.3
'11060, 동대문구,'065003, 62세,2019,5158,2478,2680,92.5,4985,2393,2592,92.3
'11060, 동대문구,'065004, 63세,2019,4715,2282,2433,93.8,4605,2233,2372,94.1
'11060, 동대문구,'065005, 64세,2019,5024,2393,2631,91,4888,2334,2554,91.4
'11060, 동대문구,'070,65~69세,2019,18196,8678,9518,91.2,17842,8509,9333,91.2
'11060, 동대문구,'070001, 65세,2019,4234,2032,2202,92.3,4140,1988,2152,92.4
'11060, 동대문구,'070002, 66세,2019,3728,1792,1936,92.6,3643,1759,1884,93.4
'11060, 동대문구,'070003, 67세,2019,3987,1854,2133,86.9,3922,1817,2105,86.3
'11060, 동대문구,'070004, 68세,2019,2961,1396,1565,89.2,2903,1368,1535,89.1
'11060, 동대문구,'070005, 69세,2019,3286,1604,1682,95.4,3234,1577,1657,95.2
'11060, 동대문구,'075,70~74세,2019,14840,6690,8150,82.1,14697,6625,8072,82.1
'11060, 동대문구,'075001, 70세,2019,3185,1467,1718,85.4,3142,1446,1696,85.3
'11060, 동대문구,'075002, 71세,2019,3213,1434,1779,80.6,3179,1417,1762,80.4
'11060, 동대문구,'075003, 72세,2019,3320,1482,1838,80.6,3289,1468,1821,80.6
'11060, 동대문구,'075004, 73세,2019,2596,1190,1406,84.6,2573,1179,1394,84.6
'11060, 동대문구,'075005, 74세,2019,2526,1117,1409,79.3,2514,1115,1399,79.7
'11060, 동대문구,'080,75~79세,2019,12064,5340,6724,79.4,12008,5315,6693,79.4
'11060, 동대문구,'080001, 75세,2019,2484,1070,1414,75.7,2469,1063,1406,75.6
'11060, 동대문구,'080002, 76세,2019,2548,1177,1371,85.8,2539,1171,1368,85.6
'11060, 동대문구,'080003, 77세,2019,2851,1258,1593,79,2843,1256,1587,79.1
'11060, 동대문구,'080004, 78세,2019,2229,1009,1220,82.7,2223,1005,1218,82.5
'11060, 동대문구,'080005, 79세,2019,1952,826,1126,73.4,1934,820,1114,73.6
'11060, 동대문구,'085,80~84세,2019,7080,2906,4174,69.6,7043,2896,4147,69.8
'11060, 동대문구,'085001, 80세,2019,1823,794,1029,77.2,1816,793,1023,77.5
'11060, 동대문구,'085002, 81세,2019,1609,679,930,73,1603,679,924,73.5
'11060, 동대문구,'085003, 82세,2019,1350,531,819,64.8,1337,526,811,64.9
'11060, 동대문구,'085004, 83세,2019,1221,486,735,66.1,1217,484,733,66
'11060, 동대문구,'085005, 84세,2019,1077,416,661,62.9,1070,414,656,63.1
'11060, 동대문구,'086,85세이상,2019,4178,1341,2837,47.3,4158,1332,2826,47.1
'11060, 동대문구,'090,85~89세,2019,3010,1012,1998,50.7,2993,1005,1988,50.6
'11060, 동대문구,'090001, 85세,2019,903,329,574,57.3,901,327,574,57
'11060, 동대문구,'090002, 86세,2019,711,225,486,46.3,706,224,482,46.5
'11060, 동대문구,'090003, 87세,2019,609,213,396,53.8,604,210,394,53.3
'11060, 동대문구,'090004, 88세,2019,414,132,282,46.8,410,131,279,47
'11060, 동대문구,'090005, 89세,2019,373,113,260,43.5,372,113,259,43.6
'11060, 동대문구,'095,90~94세,2019,913,255,658,38.8,910,253,657,38.5
'11060, 동대문구,'095001, 90세,2019,289,83,206,40.3,288,83,205,40.5
'11060, 동대문구,'095002, 91세,2019,231,73,158,46.2,231,73,158,46.2
'11060, 동대문구,'095003, 92세,2019,179,50,129,38.8,179,50,129,38.8
'11060, 동대문구,'095004, 93세,2019,116,25,91,27.5,114,23,91,25.3
'11060, 동대문구,'095005, 94세,2019,98,24,74,32.4,98,24,74,32.4
'11060, 동대문구,'100,95~99세,2019,229,66,163,40.5,229,66,163,40.5
'11060, 동대문구,'100001, 95세,2019,66,15,51,29.4,66,15,51,29.4
'11060, 동대문구,'100002, 96세,2019,77,28,49,57.1,77,28,49,57.1
'11060, 동대문구,'100003, 97세,2019,41,9,32,28.1,41,9,32,28.1
'11060, 동대문구,'100004, 98세,2019,22,6,16,37.5,22,6,16,37.5
'11060, 동대문구,'100005, 99세,2019,23,8,15,53.3,23,8,15,53.3
'11060, 동대문구,'101,100세이상,2019,26,8,18,44.4,26,8,18,44.4
'11060, 동대문구,'102,15세미만,2019,32595,16726,15869,105.4,32082,16480,15602,105.6
'11060, 동대문구,'103,15~64세,2019,266141,132480,133661,99.1,246215,124152,122063,101.7
'11060, 동대문구,'104,65세이상,2019,56358,24955,31403,79.5,55748,24677,31071,79.4
'11060, 동대문구,'126,평균연령,2019,42.5,41.8,43.1,,43.1,42.2,43.9,
'11060, 동대문구,'127,중위연령,2019,41.8,41,42.5,,42.9,41.8,44.1,
'11070, 중랑구,'000,합계,2019,386331,190531,195800,97.3,379240,187569,191671,97.9
'11070, 중랑구,'005,0~4세,2019,11889,6155,5734,107.3,11711,6062,5649,107.3
'11070, 중랑구,'005001, 0세,2019,2206,1136,1070,106.2,2172,1119,1053,106.3
'11070, 중랑구,'005002, 1세,2019,2203,1154,1049,110,2166,1138,1028,110.7
'11070, 중랑구,'005003, 2세,2019,2308,1165,1143,101.9,2263,1144,1119,102.2
'11070, 중랑구,'005004, 3세,2019,2550,1321,1229,107.5,2521,1301,1220,106.6
'11070, 중랑구,'005005, 4세,2019,2622,1379,1243,110.9,2589,1360,1229,110.7
'11070, 중랑구,'010,5~9세,2019,12722,6515,6207,105,12585,6449,6136,105.1
'11070, 중랑구,'010001, 5세,2019,2464,1249,1215,102.8,2435,1232,1203,102.4
'11070, 중랑구,'010002, 6세,2019,2506,1288,1218,105.7,2478,1277,1201,106.3
'11070, 중랑구,'010003, 7세,2019,2676,1391,1285,108.2,2634,1372,1262,108.7
'11070, 중랑구,'010004, 8세,2019,2604,1337,1267,105.5,2586,1328,1258,105.6
'11070, 중랑구,'010005, 9세,2019,2472,1250,1222,102.3,2452,1240,1212,102.3
'11070, 중랑구,'015,10~14세,2019,12085,6255,5830,107.3,12000,6207,5793,107.1
'11070, 중랑구,'015001, 10세,2019,2308,1172,1136,103.2,2282,1162,1120,103.8
'11070, 중랑구,'015002, 11세,2019,2499,1255,1244,100.9,2475,1239,1236,100.2
'11070, 중랑구,'015003, 12세,2019,2478,1283,1195,107.4,2462,1272,1190,106.9
'11070, 중랑구,'015004, 13세,2019,2407,1293,1114,116.1,2400,1289,1111,116
'11070, 중랑구,'015005, 14세,2019,2393,1252,1141,109.7,2381,1245,1136,109.6
'11070, 중랑구,'020,15~19세,2019,15376,7798,7578,102.9,15230,7736,7494,103.2
'11070, 중랑구,'020001, 15세,2019,2587,1293,1294,99.9,2570,1285,1285,100
'11070, 중랑구,'020002, 16세,2019,2752,1357,1395,97.3,2738,1349,1389,97.1
'11070, 중랑구,'020003, 17세,2019,2834,1461,1373,106.4,2819,1450,1369,105.9
'11070, 중랑구,'020004, 18세,2019,3373,1773,1600,110.8,3340,1762,1578,111.7
'11070, 중랑구,'020005, 19세,2019,3830,1914,1916,99.9,3763,1890,1873,100.9
'11070, 중랑구,'025,20~24세,2019,23775,12001,11774,101.9,23225,11789,11436,103.1
'11070, 중랑구,'025001, 20세,2019,3940,1983,1957,101.3,3869,1953,1916,101.9
'11070, 중랑구,'025002, 21세,2019,4256,2271,1985,114.4,4161,2244,1917,117.1
'11070, 중랑구,'025003, 22세,2019,4777,2421,2356,102.8,4658,2368,2290,103.4
'11070, 중랑구,'025004, 23세,2019,5180,2560,2620,97.7,5061,2515,2546,98.8
'11070, 중랑구,'025005, 24세,2019,5622,2766,2856,96.8,5476,2709,2767,97.9
'11070, 중랑구,'030,25~29세,2019,31201,15373,15828,97.1,30308,15015,15293,98.2
'11070, 중랑구,'030001, 25세,2019,5999,2912,3087,94.3,5864,2857,3007,95
'11070, 중랑구,'030002, 26세,2019,6279,3165,3114,101.6,6108,3097,3011,102.9
'11070, 중랑구,'030003, 27세,2019,6689,3303,3386,97.5,6512,3234,3278,98.7
'11070, 중랑구,'030004, 28세,2019,6265,3044,3221,94.5,6061,2962,3099,95.6
'11070, 중랑구,'030005, 29세,2019,5969,2949,3020,97.6,5763,2865,2898,98.9
'11070, 중랑구,'035,30~34세,2019,28326,14365,13961,102.9,27333,13962,13371,104.4
'11070, 중랑구,'035001, 30세,2019,5770,2863,2907,98.5,5546,2782,2764,100.7
'11070, 중랑구,'035002, 31세,2019,5716,2866,2850,100.6,5511,2781,2730,101.9
'11070, 중랑구,'035003, 32세,2019,5631,2839,2792,101.7,5428,2758,2670,103.3
'11070, 중랑구,'035004, 33세,2019,5649,2925,2724,107.4,5469,2851,2618,108.9
'11070, 중랑구,'035005, 34세,2019,5560,2872,2688,106.8,5379,2790,2589,107.8
'11070, 중랑구,'040,35~39세,2019,30538,15957,14581,109.4,29822,15655,14167,110.5
'11070, 중랑구,'040001, 35세,2019,5667,2937,2730,107.6,5511,2864,2647,108.2
'11070, 중랑구,'040002, 36세,2019,5988,3114,2874,108.4,5825,3050,2775,109.9
'11070, 중랑구,'040003, 37세,2019,6269,3267,3002,108.8,6129,3206,2923,109.7
'11070, 중랑구,'040004, 38세,2019,6270,3329,2941,113.2,6134,3277,2857,114.7
'11070, 중랑구,'040005, 39세,2019,6344,3310,3034,109.1,6223,3258,2965,109.9
'11070, 중랑구,'045,40~44세,2019,26292,13720,12572,109.1,25740,13493,12247,110.2
'11070, 중랑구,'045001, 40세,2019,5783,3039,2744,110.8,5655,2990,2665,112.2
'11070, 중랑구,'045002, 41세,2019,5028,2675,2353,113.7,4918,2620,2298,114
'11070, 중랑구,'045003, 42세,2019,5279,2747,2532,108.5,5180,2711,2469,109.8
'11070, 중랑구,'045004, 43세,2019,5021,2620,2401,109.1,4902,2572,2330,110.4
'11070, 중랑구,'045005, 44세,2019,5181,2639,2542,103.8,5085,2600,2485,104.6
'11070, 중랑구,'050,45~49세,2019,30929,15538,15391,101,30272,15263,15009,101.7
'11070, 중랑구,'050001, 45세,2019,5710,2916,2794,104.4,5598,2873,2725,105.4
'11070, 중랑구,'050002, 46세,2019,5926,2954,2972,99.4,5807,2902,2905,99.9
'11070, 중랑구,'050003, 47세,2019,6037,3007,3030,99.2,5906,2953,2953,100
'11070, 중랑구,'050004, 48세,2019,6779,3436,3343,102.8,6629,3376,3253,103.8
'11070, 중랑구,'050005, 49세,2019,6477,3225,3252,99.2,6332,3159,3173,99.6
'11070, 중랑구,'055,50~54세,2019,33384,16129,17255,93.5,32729,15854,16875,93.9
'11070, 중랑구,'055001, 50세,2019,6862,3361,3501,96,6727,3305,3422,96.6
'11070, 중랑구,'055002, 51세,2019,6905,3284,3621,90.7,6770,3221,3549,90.8
'11070, 중랑구,'055003, 52세,2019,6500,3075,3425,89.8,6396,3033,3363,90.2
'11070, 중랑구,'055004, 53세,2019,6362,3141,3221,97.5,6220,3079,3141,98
'11070, 중랑구,'055005, 54세,2019,6755,3268,3487,93.7,6616,3216,3400,94.6
'11070, 중랑구,'060,55~59세,2019,35584,17380,18204,95.5,34967,17106,17861,95.8
'11070, 중랑구,'060001, 55세,2019,6450,3188,3262,97.7,6321,3118,3203,97.3
'11070, 중랑구,'060002, 56세,2019,6780,3297,3483,94.7,6618,3231,3387,95.4
'11070, 중랑구,'060003, 57세,2019,7031,3502,3529,99.2,6900,3443,3457,99.6
'11070, 중랑구,'060004, 58세,2019,7669,3676,3993,92.1,7589,3644,3945,92.4
'11070, 중랑구,'060005, 59세,2019,7654,3717,3937,94.4,7539,3670,3869,94.9
'11070, 중랑구,'065,60~64세,2019,31697,15327,16370,93.6,31225,15127,16098,94
'11070, 중랑구,'065001, 60세,2019,6839,3319,3520,94.3,6734,3280,3454,95
'11070, 중랑구,'065002, 61세,2019,6452,3153,3299,95.6,6340,3103,3237,95.9
'11070, 중랑구,'065003, 62세,2019,6385,3081,3304,93.3,6280,3039,3241,93.8
'11070, 중랑구,'065004, 63세,2019,5848,2833,3015,94,5773,2798,2975,94.1
'11070, 중랑구,'065005, 64세,2019,6173,2941,3232,91,6098,2907,3191,91.1
'11070, 중랑구,'070,65~69세,2019,21561,10378,11183,92.8,21318,10281,11037,93.2
'11070, 중랑구,'070001, 65세,2019,5138,2515,2623,95.9,5068,2487,2581,96.4
'11070, 중랑구,'070002, 66세,2019,4459,2159,2300,93.9,4393,2131,2262,94.2
'11070, 중랑구,'070003, 67세,2019,4810,2313,2497,92.6,4760,2289,2471,92.6
'11070, 중랑구,'070004, 68세,2019,3439,1598,1841,86.8,3402,1585,1817,87.2
'11070, 중랑구,'070005, 69세,2019,3715,1793,1922,93.3,3695,1789,1906,93.9
'11070, 중랑구,'075,70~74세,2019,16853,7794,9059,86,16740,7745,8995,86.1
'11070, 중랑구,'075001, 70세,2019,3829,1817,2012,90.3,3797,1798,1999,89.9
'11070, 중랑구,'075002, 71세,2019,3708,1722,1986,86.7,3679,1710,1969,86.8
'11070, 중랑구,'075003, 72세,2019,3735,1704,2031,83.9,3714,1693,2021,83.8
'11070, 중랑구,'075004, 73세,2019,2888,1334,1554,85.8,2868,1330,1538,86.5
'11070, 중랑구,'075005, 74세,2019,2693,1217,1476,82.5,2682,1214,1468,82.7
'11070, 중랑구,'080,75~79세,2019,12770,5735,7035,81.5,12724,5721,7003,81.7
'11070, 중랑구,'080001, 75세,2019,2715,1206,1509,79.9,2704,1204,1500,80.3
'11070, 중랑구,'080002, 76세,2019,2590,1171,1419,82.5,2576,1166,1410,82.7
'11070, 중랑구,'080003, 77세,2019,3068,1371,1697,80.8,3058,1368,1690,80.9
'11070, 중랑구,'080004, 78세,2019,2364,1100,1264,87,2361,1099,1262,87.1
'11070, 중랑구,'080005, 79세,2019,2033,887,1146,77.4,2025,884,1141,77.5
'11070, 중랑구,'085,80~84세,2019,7163,2944,4219,69.8,7144,2942,4202,70
'11070, 중랑구,'085001, 80세,2019,1899,836,1063,78.6,1895,834,1061,78.6
'11070, 중랑구,'085002, 81세,2019,1621,673,948,71,1614,673,941,71.5
'11070, 중랑구,'085003, 82세,2019,1385,584,801,72.9,1379,584,795,73.5
'11070, 중랑구,'085004, 83세,2019,1221,485,736,65.9,1220,485,735,66
'11070, 중랑구,'085005, 84세,2019,1037,366,671,54.5,1036,366,670,54.6
'11070, 중랑구,'086,85세이상,2019,4186,1167,3019,38.7,4167,1162,3005,38.7
'11070, 중랑구,'090,85~89세,2019,2927,896,2031,44.1,2911,891,2020,44.1
'11070, 중랑구,'090001, 85세,2019,868,308,560,55,866,307,559,54.9
'11070, 중랑구,'090002, 86세,2019,687,216,471,45.9,684,216,468,46.2
'11070, 중랑구,'090003, 87세,2019,525,176,349,50.4,522,174,348,50
'11070, 중랑구,'090004, 88세,2019,465,115,350,32.9,460,114,346,32.9
'11070, 중랑구,'090005, 89세,2019,382,81,301,26.9,379,80,299,26.8
'11070, 중랑구,'095,90~94세,2019,985,218,767,28.4,982,218,764,28.5
'11070, 중랑구,'095001, 90세,2019,304,68,236,28.8,304,68,236,28.8
'11070, 중랑구,'095002, 91세,2019,275,59,216,27.3,275,59,216,27.3
'11070, 중랑구,'095003, 92세,2019,186,45,141,31.9,184,45,139,32.4
'11070, 중랑구,'095004, 93세,2019,126,26,100,26,125,26,99,26.3
'11070, 중랑구,'095005, 94세,2019,94,20,74,27,94,20,74,27
'11070, 중랑구,'100,95~99세,2019,233,50,183,27.3,233,50,183,27.3
'11070, 중랑구,'100001, 95세,2019,75,19,56,33.9,75,19,56,33.9
'11070, 중랑구,'100002, 96세,2019,73,17,56,30.4,73,17,56,30.4
'11070, 중랑구,'100003, 97세,2019,40,X,36,11.1,40,X,36,11.1
'11070, 중랑구,'100004, 98세,2019,30,8,22,36.4,30,8,22,36.4
'11070, 중랑구,'100005, 99세,2019,15,X,13,15.4,15,X,13,15.4
'11070, 중랑구,'101,100세이상,2019,41,X,38,7.9,41,X,38,7.9
'11070, 중랑구,'102,15세미만,2019,36696,18925,17771,106.5,36296,18718,17578,106.5
'11070, 중랑구,'103,15~64세,2019,287102,143588,143514,100.1,280851,141000,139851,100.8
'11070, 중랑구,'104,65세이상,2019,62533,28018,34515,81.2,62093,27851,34242,81.3
'11070, 중랑구,'126,평균연령,2019,44,43.1,44.9,,44.1,43.2,44.9,
'11070, 중랑구,'127,중위연령,2019,45.2,43.9,46.4,,45.3,44,46.5,
'11080, 성북구,'000,합계,2019,445327,213832,231495,92.4,429775,207211,222564,93.1
'11080, 성북구,'005,0~4세,2019,13767,7106,6661,106.7,13499,6957,6542,106.3
'11080, 성북구,'005001, 0세,2019,2331,1196,1135,105.4,2293,1173,1120,104.7
'11080, 성북구,'005002, 1세,2019,2414,1266,1148,110.3,2353,1232,1121,109.9
'11080, 성북구,'005003, 2세,2019,2766,1430,1336,107,2699,1394,1305,106.8
'11080, 성북구,'005004, 3세,2019,3066,1573,1493,105.4,3019,1547,1472,105.1
'11080, 성북구,'005005, 4세,2019,3190,1641,1549,105.9,3135,1611,1524,105.7
'11080, 성북구,'010,5~9세,2019,16737,8568,8169,104.9,16550,8475,8075,105
'11080, 성북구,'010001, 5세,2019,3168,1631,1537,106.1,3120,1605,1515,105.9
'11080, 성북구,'010002, 6세,2019,3184,1593,1591,100.1,3136,1570,1566,100.3
'11080, 성북구,'010003, 7세,2019,3498,1836,1662,110.5,3469,1819,1650,110.2
'11080, 성북구,'010004, 8세,2019,3504,1793,1711,104.8,3471,1781,1690,105.4
'11080, 성북구,'010005, 9세,2019,3383,1715,1668,102.8,3354,1700,1654,102.8
'11080, 성북구,'015,10~14세,2019,16752,8697,8055,108,16656,8645,8011,107.9
'11080, 성북구,'015001, 10세,2019,3166,1630,1536,106.1,3147,1617,1530,105.7
'11080, 성북구,'015002, 11세,2019,3412,1783,1629,109.5,3392,1769,1623,109
'11080, 성북구,'015003, 12세,2019,3610,1887,1723,109.5,3590,1878,1712,109.7
'11080, 성북구,'015004, 13세,2019,3259,1649,1610,102.4,3237,1638,1599,102.4
'11080, 성북구,'015005, 14세,2019,3305,1748,1557,112.3,3290,1743,1547,112.7
'11080, 성북구,'020,15~19세,2019,24004,11478,12526,91.6,22942,11111,11831,93.9
'11080, 성북구,'020001, 15세,2019,3705,1915,1790,107,3681,1902,1779,106.9
'11080, 성북구,'020002, 16세,2019,3515,1809,1706,106,3496,1800,1696,106.1
'11080, 성북구,'020003, 17세,2019,3696,1860,1836,101.3,3651,1840,1811,101.6
'11080, 성북구,'020004, 18세,2019,5098,2414,2684,89.9,4797,2298,2499,92
'11080, 성북구,'020005, 19세,2019,7990,3480,4510,77.2,7317,3271,4046,80.8
'11080, 성북구,'025,20~24세,2019,41700,17977,23723,75.8,36770,16281,20489,79.5
'11080, 성북구,'025001, 20세,2019,8134,3246,4888,66.4,7146,2973,4173,71.2
'11080, 성북구,'025002, 21세,2019,8076,3265,4811,67.9,6993,2889,4104,70.4
'11080, 성북구,'025003, 22세,2019,8439,3574,4865,73.5,7386,3211,4175,76.9
'11080, 성북구,'025004, 23세,2019,8599,3857,4742,81.3,7634,3481,4153,83.8
'11080, 성북구,'025005, 24세,2019,8452,4035,4417,91.4,7611,3727,3884,96
'11080, 성북구,'030,25~29세,2019,36245,18544,17701,104.8,33923,17552,16371,107.2
'11080, 성북구,'030001, 25세,2019,8108,4176,3932,106.2,7494,3926,3568,110
'11080, 성북구,'030002, 26세,2019,7631,3978,3653,108.9,7150,3761,3389,111
'11080, 성북구,'030003, 27세,2019,7517,3831,3686,103.9,7067,3633,3434,105.8
'11080, 성북구,'030004, 28세,2019,6703,3463,3240,106.9,6336,3309,3027,109.3
'11080, 성북구,'030005, 29세,2019,6286,3096,3190,97.1,5876,2923,2953,99
'11080, 성북구,'035,30~34세,2019,28703,14317,14386,99.5,27055,13515,13540,99.8
'11080, 성북구,'035001, 30세,2019,5847,2935,2912,100.8,5473,2753,2720,101.2
'11080, 성북구,'035002, 31세,2019,5744,2867,2877,99.7,5371,2704,2667,101.4
'11080, 성북구,'035003, 32세,2019,5615,2799,2816,99.4,5297,2635,2662,99
'11080, 성북구,'035004, 33세,2019,5711,2869,2842,101,5428,2722,2706,100.6
'11080, 성북구,'035005, 34세,2019,5786,2847,2939,96.9,5486,2701,2785,97
'11080, 성북구,'040,35~39세,2019,32997,16456,16541,99.5,31801,15872,15929,99.6
'11080, 성북구,'040001, 35세,2019,5966,2989,2977,100.4,5688,2857,2831,100.9
'11080, 성북구,'040002, 36세,2019,6409,3202,3207,99.8,6162,3082,3080,100.1
'11080, 성북구,'040003, 37세,2019,6841,3389,3452,98.2,6615,3272,3343,97.9
'11080, 성북구,'040004, 38세,2019,6977,3547,3430,103.4,6748,3438,3310,103.9
'11080, 성북구,'040005, 39세,2019,6804,3329,3475,95.8,6588,3223,3365,95.8
'11080, 성북구,'045,40~44세,2019,31566,15656,15910,98.4,30668,15214,15454,98.4
'11080, 성북구,'045001, 40세,2019,6746,3346,3400,98.4,6547,3250,3297,98.6
'11080, 성북구,'045002, 41세,2019,5887,2938,2949,99.6,5681,2838,2843,99.8
'11080, 성북구,'045003, 42세,2019,6123,3059,3064,99.8,5947,2969,2978,99.7
'11080, 성북구,'045004, 43세,2019,6184,3050,3134,97.3,6028,2966,3062,96.9
'11080, 성북구,'045005, 44세,2019,6626,3263,3363,97,6465,3191,3274,97.5
'11080, 성북구,'050,45~49세,2019,38323,18947,19376,97.8,37423,18489,18934,97.6
'11080, 성북구,'050001, 45세,2019,7333,3635,3698,98.3,7182,3549,3633,97.7
'11080, 성북구,'050002, 46세,2019,7494,3713,3781,98.2,7315,3610,3705,97.4
'11080, 성북구,'050003, 47세,2019,7696,3852,3844,100.2,7496,3772,3724,101.3
'11080, 성북구,'050004, 48세,2019,8017,3950,4067,97.1,7826,3851,3975,96.9
'11080, 성북구,'050005, 49세,2019,7783,3797,3986,95.3,7604,3707,3897,95.1
'11080, 성북구,'055,50~54세,2019,34359,17087,17272,98.9,33628,16713,16915,98.8
'11080, 성북구,'055001, 50세,2019,7641,3837,3804,100.9,7477,3748,3729,100.5
'11080, 성북구,'055002, 51세,2019,7312,3684,3628,101.5,7157,3609,3548,101.7
'11080, 성북구,'055003, 52세,2019,6677,3267,3410,95.8,6531,3200,3331,96.1
'11080, 성북구,'055004, 53세,2019,6258,3125,3133,99.7,6128,3050,3078,99.1
'11080, 성북구,'055005, 54세,2019,6471,3174,3297,96.3,6335,3106,3229,96.2
'11080, 성북구,'060,55~59세,2019,32880,15694,17186,91.3,32314,15429,16885,91.4
'11080, 성북구,'060001, 55세,2019,6226,3010,3216,93.6,6101,2941,3160,93.1
'11080, 성북구,'060002, 56세,2019,6395,3077,3318,92.7,6262,3018,3244,93
'11080, 성북구,'060003, 57세,2019,6417,3064,3353,91.4,6305,3018,3287,91.8
'11080, 성북구,'060004, 58세,2019,6819,3299,3520,93.7,6740,3261,3479,93.7
'11080, 성북구,'060005, 59세,2019,7023,3244,3779,85.8,6906,3191,3715,85.9
'11080, 성북구,'065,60~64세,2019,30064,14298,15766,90.7,29685,14118,15567,90.7
'11080, 성북구,'065001, 60세,2019,6394,3120,3274,95.3,6317,3082,3235,95.3
'11080, 성북구,'065002, 61세,2019,6097,2939,3158,93.1,6030,2908,3122,93.1
'11080, 성북구,'065003, 62세,2019,6119,2883,3236,89.1,6030,2844,3186,89.3
'11080, 성북구,'065004, 63세,2019,5631,2663,2968,89.7,5562,2624,2938,89.3
'11080, 성북구,'065005, 64세,2019,5823,2693,3130,86,5746,2660,3086,86.2
'11080, 성북구,'070,65~69세,2019,21029,9807,11222,87.4,20838,9712,11126,87.3
'11080, 성북구,'070001, 65세,2019,4846,2311,2535,91.2,4801,2290,2511,91.2
'11080, 성북구,'070002, 66세,2019,4315,2006,2309,86.9,4269,1985,2284,86.9
'11080, 성북구,'070003, 67세,2019,4718,2205,2513,87.7,4673,2180,2493,87.4
'11080, 성북구,'070004, 68세,2019,3294,1526,1768,86.3,3265,1510,1755,86
'11080, 성북구,'070005, 69세,2019,3856,1759,2097,83.9,3830,1747,2083,83.9
'11080, 성북구,'075,70~74세,2019,17447,7637,9810,77.8,17375,7606,9769,77.9
'11080, 성북구,'075001, 70세,2019,3890,1729,2161,80,3865,1721,2144,80.3
'11080, 성북구,'075002, 71세,2019,3663,1587,2076,76.4,3650,1582,2068,76.5
'11080, 성북구,'075003, 72세,2019,3886,1715,2171,79,3873,1710,2163,79.1
'11080, 성북구,'075004, 73세,2019,3057,1311,1746,75.1,3045,1303,1742,74.8
'11080, 성북구,'075005, 74세,2019,2951,1295,1656,78.2,2942,1290,1652,78.1
'11080, 성북구,'080,75~79세,2019,14594,6356,8238,77.2,14549,6338,8211,77.2
'11080, 성북구,'080001, 75세,2019,2959,1291,1668,77.4,2944,1285,1659,77.5
'11080, 성북구,'080002, 76세,2019,3036,1348,1688,79.9,3026,1344,1682,79.9
'11080, 성북구,'080003, 77세,2019,3466,1525,1941,78.6,3459,1522,1937,78.6
'11080, 성북구,'080004, 78세,2019,2720,1194,1526,78.2,2716,1193,1523,78.3
'11080, 성북구,'080005, 79세,2019,2413,998,1415,70.5,2404,994,1410,70.5
'11080, 성북구,'085,80~84세,2019,8902,3571,5331,67,8871,3559,5312,67
'11080, 성북구,'085001, 80세,2019,2309,966,1343,71.9,2294,961,1333,72.1
'11080, 성북구,'085002, 81세,2019,1971,822,1149,71.5,1969,821,1148,71.5
'11080, 성북구,'085003, 82세,2019,1730,682,1048,65.1,1727,680,1047,64.9
'11080, 성북구,'085004, 83세,2019,1493,571,922,61.9,1484,568,916,62
'11080, 성북구,'085005, 84세,2019,1399,530,869,61,1397,529,868,60.9
'11080, 성북구,'086,85세이상,2019,5258,1636,3622,45.2,5228,1625,3603,45.1
'11080, 성북구,'090,85~89세,2019,3665,1253,2412,51.9,3644,1244,2400,51.8
'11080, 성북구,'090001, 85세,2019,1061,390,671,58.1,1055,387,668,57.9
'11080, 성북구,'090002, 86세,2019,871,318,553,57.5,863,315,548,57.5
'11080, 성북구,'090003, 87세,2019,700,236,464,50.9,697,235,462,50.9
'11080, 성북구,'090004, 88세,2019,547,166,381,43.6,545,165,380,43.4
'11080, 성북구,'090005, 89세,2019,486,143,343,41.7,484,142,342,41.5
'11080, 성북구,'095,90~94세,2019,1299,309,990,31.2,1293,308,985,31.3
'11080, 성북구,'095001, 90세,2019,409,113,296,38.2,407,113,294,38.4
'11080, 성북구,'095002, 91세,2019,332,80,252,31.7,332,80,252,31.7
'11080, 성북구,'095003, 92세,2019,271,59,212,27.8,270,59,211,28
'11080, 성북구,'095004, 93세,2019,172,38,134,28.4,169,37,132,28
'11080, 성북구,'095005, 94세,2019,115,19,96,19.8,115,19,96,19.8
'11080, 성북구,'100,95~99세,2019,267,64,203,31.5,266,64,202,31.7
'11080, 성북구,'100001, 95세,2019,70,14,56,25,70,14,56,25
'11080, 성북구,'100002, 96세,2019,83,21,62,33.9,82,21,61,34.4
'11080, 성북구,'100003, 97세,2019,59,17,42,40.5,59,17,42,40.5
'11080, 성북구,'100004, 98세,2019,30,7,23,30.4,30,7,23,30.4
'11080, 성북구,'100005, 99세,2019,25,5,20,25,25,5,20,25
'11080, 성북구,'101,100세이상,2019,27,10,17,58.8,25,9,16,56.3
'11080, 성북구,'102,15세미만,2019,47256,24371,22885,106.5,46705,24077,22628,106.4
'11080, 성북구,'103,15~64세,2019,330841,160454,170387,94.2,316209,154294,161915,95.3
'11080, 성북구,'104,65세이상,2019,67230,29007,38223,75.9,66861,28840,38021,75.9
'11080, 성북구,'126,평균연령,2019,41.9,41.1,42.6,,42.2,41.4,43,
'11080, 성북구,'127,중위연령,2019,41.9,41.1,42.5,,42.6,41.7,43.4,
'11090, 강북구,'000,합계,2019,303871,147112,156759,93.8,298525,145024,153501,94.5
'11090, 강북구,'005,0~4세,2019,7766,3986,3780,105.4,7682,3946,3736,105.6
'11090, 강북구,'005001, 0세,2019,1243,652,591,110.3,1230,645,585,110.3
'11090, 강북구,'005002, 1세,2019,1409,734,675,108.7,1382,720,662,108.8
'11090, 강북구,'005003, 2세,2019,1596,794,802,99,1577,786,791,99.4
'11090, 강북구,'005004, 3세,2019,1757,900,857,105,1742,892,850,104.9
'11090, 강북구,'005005, 4세,2019,1761,906,855,106,1751,903,848,106.5
'11090, 강북구,'010,5~9세,2019,9461,4877,4584,106.4,9414,4852,4562,106.4
'11090, 강북구,'010001, 5세,2019,1763,890,873,101.9,1753,885,868,102
'11090, 강북구,'010002, 6세,2019,1836,975,861,113.2,1826,969,857,113.1
'11090, 강북구,'010003, 7세,2019,1960,1015,945,107.4,1947,1006,941,106.9
'11090, 강북구,'010004, 8세,2019,1979,1007,972,103.6,1975,1007,968,104
'11090, 강북구,'010005, 9세,2019,1923,990,933,106.1,1913,985,928,106.1
'11090, 강북구,'015,10~14세,2019,9885,5075,4810,105.5,9862,5065,4797,105.6
'11090, 강북구,'015001, 10세,2019,1950,1006,944,106.6,1945,1004,941,106.7
'11090, 강북구,'015002, 11세,2019,1953,977,976,100.1,1948,974,974,100
'11090, 강북구,'015003, 12세,2019,2037,1052,985,106.8,2030,1049,981,106.9
'11090, 강북구,'015004, 13세,2019,1976,1031,945,109.1,1973,1029,944,109
'11090, 강북구,'015005, 14세,2019,1969,1009,960,105.1,1966,1009,957,105.4
'11090, 강북구,'020,15~19세,2019,12804,6476,6328,102.3,12687,6433,6254,102.9
'11090, 강북구,'020001, 15세,2019,2122,1054,1068,98.7,2117,1052,1065,98.8
'11090, 강북구,'020002, 16세,2019,2290,1188,1102,107.8,2282,1184,1098,107.8
'11090, 강북구,'020003, 17세,2019,2332,1231,1101,111.8,2322,1226,1096,111.9
'11090, 강북구,'020004, 18세,2019,2786,1422,1364,104.3,2767,1417,1350,105
'11090, 강북구,'020005, 19세,2019,3274,1581,1693,93.4,3199,1554,1645,94.5
'11090, 강북구,'025,20~24세,2019,20200,9349,10851,86.2,19514,9120,10394,87.7
'11090, 강북구,'025001, 20세,2019,3458,1572,1886,83.4,3342,1534,1808,84.8
'11090, 강북구,'025002, 21세,2019,3837,1764,2073,85.1,3695,1715,1980,86.6
'11090, 강북구,'025003, 22세,2019,4158,1901,2257,84.2,4022,1849,2173,85.1
'11090, 강북구,'025004, 23세,2019,4315,1983,2332,85,4180,1943,2237,86.9
'11090, 강북구,'025005, 24세,2019,4432,2129,2303,92.4,4275,2079,2196,94.7
'11090, 강북구,'030,25~29세,2019,22618,11348,11270,100.7,21852,11098,10754,103.2
'11090, 강북구,'030001, 25세,2019,4749,2316,2433,95.2,4592,2265,2327,97.3
'11090, 강북구,'030002, 26세,2019,4673,2381,2292,103.9,4545,2337,2208,105.8
'11090, 강북구,'030003, 27세,2019,4796,2416,2380,101.5,4642,2366,2276,104
'11090, 강북구,'030004, 28세,2019,4414,2169,2245,96.6,4259,2115,2144,98.6
'11090, 강북구,'030005, 29세,2019,3986,2066,1920,107.6,3814,2015,1799,112
'11090, 강북구,'035,30~34세,2019,18756,9693,9063,107,18061,9435,8626,109.4
'11090, 강북구,'035001, 30세,2019,3948,2007,1941,103.4,3779,1951,1828,106.7
'11090, 강북구,'035002, 31세,2019,3702,1886,1816,103.9,3554,1821,1733,105.1
'11090, 강북구,'035003, 32세,2019,3667,1938,1729,112.1,3537,1891,1646,114.9
'11090, 강북구,'035004, 33세,2019,3716,1955,1761,111,3586,1912,1674,114.2
'11090, 강북구,'035005, 34세,2019,3723,1907,1816,105,3605,1860,1745,106.6
'11090, 강북구,'040,35~39세,2019,21602,11372,10230,111.2,21074,11153,9921,112.4
'11090, 강북구,'040001, 35세,2019,3879,2047,1832,111.7,3769,2010,1759,114.3
'11090, 강북구,'040002, 36세,2019,4172,2164,2008,107.8,4061,2118,1943,109
'11090, 강북구,'040003, 37세,2019,4526,2345,2181,107.5,4412,2299,2113,108.8
'11090, 강북구,'040004, 38세,2019,4413,2380,2033,117.1,4315,2331,1984,117.5
'11090, 강북구,'040005, 39세,2019,4612,2436,2176,111.9,4517,2395,2122,112.9
'11090, 강북구,'045,40~44세,2019,20834,10730,10104,106.2,20433,10564,9869,107
'11090, 강북구,'045001, 40세,2019,4400,2306,2094,110.1,4325,2276,2049,111.1
'11090, 강북구,'045002, 41세,2019,3916,1988,1928,103.1,3824,1949,1875,103.9
'11090, 강북구,'045003, 42세,2019,4126,2129,1997,106.6,4046,2094,1952,107.3
'11090, 강북구,'045004, 43세,2019,4051,2072,1979,104.7,3981,2044,1937,105.5
'11090, 강북구,'045005, 44세,2019,4341,2235,2106,106.1,4257,2201,2056,107.1
'11090, 강북구,'050,45~49세,2019,25824,12981,12843,101.1,25398,12800,12598,101.6
'11090, 강북구,'050001, 45세,2019,4840,2433,2407,101.1,4768,2405,2363,101.8
'11090, 강북구,'050002, 46세,2019,5047,2506,2541,98.6,4960,2470,2490,99.2
'11090, 강북구,'050003, 47세,2019,5148,2658,2490,106.7,5053,2621,2432,107.8
'11090, 강북구,'050004, 48세,2019,5483,2752,2731,100.8,5390,2707,2683,100.9
'11090, 강북구,'050005, 49세,2019,5306,2632,2674,98.4,5227,2597,2630,98.7
'11090, 강북구,'055,50~54세,2019,25310,12153,13157,92.4,24889,11968,12921,92.6
'11090, 강북구,'055001, 50세,2019,5301,2548,2753,92.6,5216,2505,2711,92.4
'11090, 강북구,'055002, 51세,2019,5316,2533,2783,91,5231,2498,2733,91.4
'11090, 강북구,'055003, 52세,2019,4934,2380,2554,93.2,4859,2348,2511,93.5
'11090, 강북구,'055004, 53세,2019,4738,2317,2421,95.7,4649,2280,2369,96.2
'11090, 강북구,'055005, 54세,2019,5021,2375,2646,89.8,4934,2337,2597,90
'11090, 강북구,'060,55~59세,2019,26389,12609,13780,91.5,25915,12413,13502,91.9
'11090, 강북구,'060001, 55세,2019,4710,2285,2425,94.2,4619,2253,2366,95.2
'11090, 강북구,'060002, 56세,2019,5154,2590,2564,101,5029,2527,2502,101
'11090, 강북구,'060003, 57세,2019,5044,2447,2597,94.2,4949,2415,2534,95.3
'11090, 강북구,'060004, 58세,2019,5668,2639,3029,87.1,5609,2615,2994,87.3
'11090, 강북구,'060005, 59세,2019,5813,2648,3165,83.7,5709,2603,3106,83.8
'11090, 강북구,'065,60~64세,2019,24633,11663,12970,89.9,24290,11514,12776,90.1
'11090, 강북구,'065001, 60세,2019,5186,2480,2706,91.6,5111,2451,2660,92.1
'11090, 강북구,'065002, 61세,2019,5065,2381,2684,88.7,4986,2348,2638,89
'11090, 강북구,'065003, 62세,2019,4914,2387,2527,94.5,4830,2346,2484,94.4
'11090, 강북구,'065004, 63세,2019,4541,2115,2426,87.2,4498,2096,2402,87.3
'11090, 강북구,'065005, 64세,2019,4927,2300,2627,87.6,4865,2273,2592,87.7
'11090, 강북구,'070,65~69세,2019,18025,8108,9917,81.8,17825,8024,9801,81.9
'11090, 강북구,'070001, 65세,2019,4103,1856,2247,82.6,4051,1835,2216,82.8
'11090, 강북구,'070002, 66세,2019,3585,1631,1954,83.5,3534,1610,1924,83.7
'11090, 강북구,'070003, 67세,2019,4023,1841,2182,84.4,3986,1825,2161,84.5
'11090, 강북구,'070004, 68세,2019,3037,1363,1674,81.4,3009,1352,1657,81.6
'11090, 강북구,'070005, 69세,2019,3277,1417,1860,76.2,3245,1402,1843,76.1
'11090, 강북구,'075,70~74세,2019,15698,6796,8902,76.3,15624,6765,8859,76.4
'11090, 강북구,'075001, 70세,2019,3510,1548,1962,78.9,3492,1538,1954,78.7
'11090, 강북구,'075002, 71세,2019,3441,1508,1933,78,3426,1499,1927,77.8
'11090, 강북구,'075003, 72세,2019,3461,1506,1955,77,3446,1503,1943,77.4
'11090, 강북구,'075004, 73세,2019,2647,1131,1516,74.6,2630,1123,1507,74.5
'11090, 강북구,'075005, 74세,2019,2639,1103,1536,71.8,2630,1102,1528,72.1
'11090, 강북구,'080,75~79세,2019,12869,5711,7158,79.8,12836,5696,7140,79.8
'11090, 강북구,'080001, 75세,2019,2632,1196,1436,83.3,2623,1190,1433,83
'11090, 강북구,'080002, 76세,2019,2702,1149,1553,74,2694,1146,1548,74
'11090, 강북구,'080003, 77세,2019,3114,1414,1700,83.2,3111,1413,1698,83.2
'11090, 강북구,'080004, 78세,2019,2430,1092,1338,81.6,2423,1089,1334,81.6
'11090, 강북구,'080005, 79세,2019,1991,860,1131,76,1985,858,1127,76.1
'11090, 강북구,'085,80~84세,2019,7302,2968,4334,68.5,7293,2965,4328,68.5
'11090, 강북구,'085001, 80세,2019,1912,775,1137,68.2,1910,774,1136,68.1
'11090, 강북구,'085002, 81세,2019,1676,687,989,69.5,1672,686,986,69.6
'11090, 강북구,'085003, 82세,2019,1377,582,795,73.2,1376,582,794,73.3
'11090, 강북구,'085004, 83세,2019,1289,513,776,66.1,1289,513,776,66.1
'11090, 강북구,'085005, 84세,2019,1048,411,637,64.5,1046,410,636,64.5
'11090, 강북구,'086,85세이상,2019,3895,1217,2678,45.4,3876,1213,2663,45.6
'11090, 강북구,'090,85~89세,2019,2706,897,1809,49.6,2698,897,1801,49.8
'11090, 강북구,'090001, 85세,2019,802,302,500,60.4,800,302,498,60.6
'11090, 강북구,'090002, 86세,2019,619,223,396,56.3,617,223,394,56.6
'11090, 강북구,'090003, 87세,2019,556,178,378,47.1,555,178,377,47.2
'11090, 강북구,'090004, 88세,2019,374,106,268,39.6,373,106,267,39.7
'11090, 강북구,'090005, 89세,2019,355,88,267,33,353,88,265,33.2
'11090, 강북구,'095,90~94세,2019,936,257,679,37.8,930,253,677,37.4
'11090, 강북구,'095001, 90세,2019,321,93,228,40.8,319,91,228,39.9
'11090, 강북구,'095002, 91세,2019,239,76,163,46.6,239,76,163,46.6
'11090, 강북구,'095003, 92세,2019,161,37,124,29.8,161,37,124,29.8
'11090, 강북구,'095004, 93세,2019,127,35,92,38,125,34,91,37.4
'11090, 강북구,'095005, 94세,2019,88,16,72,22.2,86,15,71,21.1
'11090, 강북구,'100,95~99세,2019,233,60,173,34.7,229,60,169,35.5
'11090, 강북구,'100001, 95세,2019,75,13,62,21,74,13,61,21.3
'11090, 강북구,'100002, 96세,2019,63,22,41,53.7,63,22,41,53.7
'11090, 강북구,'100003, 97세,2019,46,12,34,35.3,45,12,33,36.4
'11090, 강북구,'100004, 98세,2019,31,10,21,47.6,30,10,20,50
'11090, 강북구,'100005, 99세,2019,18,X,15,20,17,X,14,21.4
'11090, 강북구,'101,100세이상,2019,20,X,17,17.6,19,X,16,18.8
'11090, 강북구,'102,15세미만,2019,27112,13938,13174,105.8,26958,13863,13095,105.9
'11090, 강북구,'103,15~64세,2019,218970,108374,110596,98,214113,106498,107615,99
'11090, 강북구,'104,65세이상,2019,57789,24800,32989,75.2,57454,24663,32791,75.2
'11090, 강북구,'126,평균연령,2019,45.2,44.1,46.2,,45.3,44.1,46.4,
'11090, 강북구,'127,중위연령,2019,46.6,45.3,48,,46.8,45.4,48.2,
'11100, 도봉구,'000,합계,2019,323543,156961,166582,94.2,320223,155581,164642,94.5
'11100, 도봉구,'005,0~4세,2019,9185,4771,4414,108.1,9115,4730,4385,107.9
'11100, 도봉구,'005001, 0세,2019,1560,831,729,114,1549,822,727,113.1
'11100, 도봉구,'005002, 1세,2019,1630,884,746,118.5,1614,874,740,118.1
'11100, 도봉구,'005003, 2세,2019,1793,920,873,105.4,1779,915,864,105.9
'11100, 도봉구,'005004, 3세,2019,2052,1031,1021,101,2037,1025,1012,101.3
'11100, 도봉구,'005005, 4세,2019,2150,1105,1045,105.7,2136,1094,1042,105
'11100, 도봉구,'010,5~9세,2019,11077,5719,5358,106.7,11047,5702,5345,106.7
'11100, 도봉구,'010001, 5세,2019,2122,1083,1039,104.2,2115,1077,1038,103.8
'11100, 도봉구,'010002, 6세,2019,2089,1097,992,110.6,2083,1095,988,110.8
'11100, 도봉구,'010003, 7세,2019,2320,1198,1122,106.8,2315,1197,1118,107.1
'11100, 도봉구,'010004, 8세,2019,2300,1177,1123,104.8,2292,1172,1120,104.6
'11100, 도봉구,'010005, 9세,2019,2246,1164,1082,107.6,2242,1161,1081,107.4
'11100, 도봉구,'015,10~14세,2019,11481,5920,5561,106.5,11459,5908,5551,106.4
'11100, 도봉구,'015001, 10세,2019,2186,1130,1056,107,2180,1124,1056,106.4
'11100, 도봉구,'015002, 11세,2019,2257,1177,1080,109,2254,1177,1077,109.3
'11100, 도봉구,'015003, 12세,2019,2518,1296,1222,106.1,2515,1295,1220,106.1
'11100, 도봉구,'015004, 13세,2019,2270,1182,1088,108.6,2265,1179,1086,108.6
'11100, 도봉구,'015005, 14세,2019,2250,1135,1115,101.8,2245,1133,1112,101.9
'11100, 도봉구,'020,15~19세,2019,15447,7721,7726,99.9,15373,7686,7687,100
'11100, 도봉구,'020001, 15세,2019,2665,1388,1277,108.7,2662,1386,1276,108.6
'11100, 도봉구,'020002, 16세,2019,2561,1287,1274,101,2556,1285,1271,101.1
'11100, 도봉구,'020003, 17세,2019,2826,1436,1390,103.3,2817,1431,1386,103.2
'11100, 도봉구,'020004, 18세,2019,3330,1741,1589,109.6,3318,1734,1584,109.5
'11100, 도봉구,'020005, 19세,2019,4065,1869,2196,85.1,4020,1850,2170,85.3
'11100, 도봉구,'025,20~24세,2019,21299,10340,10959,94.4,20888,10195,10693,95.3
'11100, 도봉구,'025001, 20세,2019,4088,1920,2168,88.6,4030,1903,2127,89.5
'11100, 도봉구,'025002, 21세,2019,3901,1927,1974,97.6,3820,1893,1927,98.2
'11100, 도봉구,'025003, 22세,2019,4336,2141,2195,97.5,4254,2121,2133,99.4
'11100, 도봉구,'025004, 23세,2019,4451,2125,2326,91.4,4353,2086,2267,92
'11100, 도봉구,'025005, 24세,2019,4523,2227,2296,97,4431,2192,2239,97.9
'11100, 도봉구,'030,25~29세,2019,22651,11480,11171,102.8,22169,11289,10880,103.8
'11100, 도봉구,'030001, 25세,2019,4539,2304,2235,103.1,4453,2267,2186,103.7
'11100, 도봉구,'030002, 26세,2019,4759,2453,2306,106.4,4665,2409,2256,106.8
'11100, 도봉구,'030003, 27세,2019,4766,2389,2377,100.5,4664,2351,2313,101.6
'11100, 도봉구,'030004, 28세,2019,4482,2255,2227,101.3,4391,2224,2167,102.6
'11100, 도봉구,'030005, 29세,2019,4105,2079,2026,102.6,3996,2038,1958,104.1
'11100, 도봉구,'035,30~34세,2019,19403,9870,9533,103.5,18912,9668,9244,104.6
'11100, 도봉구,'035001, 30세,2019,4014,2034,1980,102.7,3910,1998,1912,104.5
'11100, 도봉구,'035002, 31세,2019,3898,1987,1911,104,3795,1939,1856,104.5
'11100, 도봉구,'035003, 32세,2019,3730,1914,1816,105.4,3629,1877,1752,107.1
'11100, 도봉구,'035004, 33세,2019,3806,1935,1871,103.4,3718,1893,1825,103.7
'11100, 도봉구,'035005, 34세,2019,3955,2000,1955,102.3,3860,1961,1899,103.3
'11100, 도봉구,'040,35~39세,2019,22736,11661,11075,105.3,22383,11514,10869,105.9
'11100, 도봉구,'040001, 35세,2019,3988,2076,1912,108.6,3908,2046,1862,109.9
'11100, 도봉구,'040002, 36세,2019,4439,2313,2126,108.8,4352,2279,2073,109.9
'11100, 도봉구,'040003, 37세,2019,4810,2439,2371,102.9,4738,2401,2337,102.7
'11100, 도봉구,'040004, 38세,2019,4749,2413,2336,103.3,4683,2385,2298,103.8
'11100, 도봉구,'040005, 39세,2019,4750,2420,2330,103.9,4702,2403,2299,104.5
'11100, 도봉구,'045,40~44세,2019,21622,10764,10858,99.1,21335,10657,10678,99.8
'11100, 도봉구,'045001, 40세,2019,4508,2271,2237,101.5,4439,2238,2201,101.7
'11100, 도봉구,'045002, 41세,2019,4021,2006,2015,99.6,3953,1979,1974,100.3
'11100, 도봉구,'045003, 42세,2019,4273,2185,2088,104.6,4222,2167,2055,105.5
'11100, 도봉구,'045004, 43세,2019,4254,2121,2133,99.4,4199,2105,2094,100.5
'11100, 도봉구,'045005, 44세,2019,4566,2181,2385,91.4,4522,2168,2354,92.1
'11100, 도봉구,'050,45~49세,2019,27430,13370,14060,95.1,27149,13234,13915,95.1
'11100, 도봉구,'050001, 45세,2019,5060,2540,2520,100.8,5011,2516,2495,100.8
'11100, 도봉구,'050002, 46세,2019,5308,2528,2780,90.9,5256,2501,2755,90.8
'11100, 도봉구,'050003, 47세,2019,5379,2688,2691,99.9,5323,2657,2666,99.7
'11100, 도봉구,'050004, 48세,2019,5890,2832,3058,92.6,5823,2800,3023,92.6
'11100, 도봉구,'050005, 49세,2019,5793,2782,3011,92.4,5736,2760,2976,92.7
'11100, 도봉구,'055,50~54세,2019,27835,13136,14699,89.4,27592,13031,14561,89.5
'11100, 도봉구,'055001, 50세,2019,5766,2712,3054,88.8,5724,2691,3033,88.7
'11100, 도봉구,'055002, 51세,2019,5888,2778,3110,89.3,5834,2755,3079,89.5
'11100, 도봉구,'055003, 52세,2019,5412,2516,2896,86.9,5358,2492,2866,87
'11100, 도봉구,'055004, 53세,2019,5276,2565,2711,94.6,5232,2550,2682,95.1
'11100, 도봉구,'055005, 54세,2019,5493,2565,2928,87.6,5444,2543,2901,87.7
'11100, 도봉구,'060,55~59세,2019,29049,13752,15297,89.9,28837,13654,15183,89.9
'11100, 도봉구,'060001, 55세,2019,5165,2472,2693,91.8,5130,2454,2676,91.7
'11100, 도봉구,'060002, 56세,2019,5604,2761,2843,97.1,5555,2737,2818,97.1
'11100, 도봉구,'060003, 57세,2019,5685,2679,3006,89.1,5639,2665,2974,89.6
'11100, 도봉구,'060004, 58세,2019,6176,2839,3337,85.1,6134,2818,3316,85
'11100, 도봉구,'060005, 59세,2019,6419,3001,3418,87.8,6379,2980,3399,87.7
'11100, 도봉구,'065,60~64세,2019,27529,13100,14429,90.8,27359,13029,14330,90.9
'11100, 도봉구,'065001, 60세,2019,5847,2738,3109,88.1,5819,2730,3089,88.4
'11100, 도봉구,'065002, 61세,2019,5556,2628,2928,89.8,5518,2613,2905,89.9
'11100, 도봉구,'065003, 62세,2019,5677,2773,2904,95.5,5638,2753,2885,95.4
'11100, 도봉구,'065004, 63세,2019,5068,2398,2670,89.8,5026,2377,2649,89.7
'11100, 도봉구,'065005, 64세,2019,5381,2563,2818,91,5358,2556,2802,91.2
'11100, 도봉구,'070,65~69세,2019,18470,8973,9497,94.5,18371,8931,9440,94.6
'11100, 도봉구,'070001, 65세,2019,4308,2122,2186,97.1,4283,2112,2171,97.3
'11100, 도봉구,'070002, 66세,2019,3776,1853,1923,96.4,3759,1846,1913,96.5
'11100, 도봉구,'070003, 67세,2019,4159,1990,2169,91.7,4132,1976,2156,91.7
'11100, 도봉구,'070004, 68세,2019,2976,1441,1535,93.9,2958,1435,1523,94.2
'11100, 도봉구,'070005, 69세,2019,3251,1567,1684,93.1,3239,1562,1677,93.1
'11100, 도봉구,'075,70~74세,2019,14546,6784,7762,87.4,14498,6766,7732,87.5
'11100, 도봉구,'075001, 70세,2019,3152,1494,1658,90.1,3139,1487,1652,90
'11100, 도봉구,'075002, 71세,2019,3252,1547,1705,90.7,3244,1544,1700,90.8
'11100, 도봉구,'075003, 72세,2019,3250,1486,1764,84.2,3238,1483,1755,84.5
'11100, 도봉구,'075004, 73세,2019,2474,1151,1323,87,2469,1150,1319,87.2
'11100, 도봉구,'075005, 74세,2019,2418,1106,1312,84.3,2408,1102,1306,84.4
'11100, 도봉구,'080,75~79세,2019,11922,5353,6569,81.5,11898,5345,6553,81.6
'11100, 도봉구,'080001, 75세,2019,2384,1060,1324,80.1,2379,1058,1321,80.1
'11100, 도봉구,'080002, 76세,2019,2453,1090,1363,80,2448,1088,1360,80
'11100, 도봉구,'080003, 77세,2019,2861,1321,1540,85.8,2855,1320,1535,86
'11100, 도봉구,'080004, 78세,2019,2255,1031,1224,84.2,2252,1030,1222,84.3
'11100, 도봉구,'080005, 79세,2019,1969,851,1118,76.1,1964,849,1115,76.1
'11100, 도봉구,'085,80~84세,2019,7181,2858,4323,66.1,7169,2856,4313,66.2
'11100, 도봉구,'085001, 80세,2019,1894,804,1090,73.8,1889,803,1086,73.9
'11100, 도봉구,'085002, 81세,2019,1575,650,925,70.3,1573,650,923,70.4
'11100, 도봉구,'085003, 82세,2019,1428,560,868,64.5,1426,560,866,64.7
'11100, 도봉구,'085004, 83세,2019,1201,448,753,59.5,1200,447,753,59.4
'11100, 도봉구,'085005, 84세,2019,1083,396,687,57.6,1081,396,685,57.8
'11100, 도봉구,'086,85세이상,2019,4680,1389,3291,42.2,4669,1386,3283,42.2
'11100, 도봉구,'090,85~89세,2019,3262,1016,2246,45.2,3256,1016,2240,45.4
'11100, 도봉구,'090001, 85세,2019,882,283,599,47.2,882,283,599,47.2
'11100, 도봉구,'090002, 86세,2019,779,252,527,47.8,778,252,526,47.9
'11100, 도봉구,'090003, 87세,2019,679,206,473,43.6,679,206,473,43.6
'11100, 도봉구,'090004, 88세,2019,509,154,355,43.4,506,154,352,43.8
'11100, 도봉구,'090005, 89세,2019,413,121,292,41.4,411,121,290,41.7
'11100, 도봉구,'095,90~94세,2019,1119,304,815,37.3,1117,304,813,37.4
'11100, 도봉구,'095001, 90세,2019,368,103,265,38.9,367,103,264,39
'11100, 도봉구,'095002, 91세,2019,293,86,207,41.5,293,86,207,41.5
'11100, 도봉구,'095003, 92세,2019,215,58,157,36.9,215,58,157,36.9
'11100, 도봉구,'095004, 93세,2019,140,36,104,34.6,139,36,103,35
'11100, 도봉구,'095005, 94세,2019,103,21,82,25.6,103,21,82,25.6
'11100, 도봉구,'100,95~99세,2019,268,58,210,27.6,267,57,210,27.1
'11100, 도봉구,'100001, 95세,2019,77,13,64,20.3,77,13,64,20.3
'11100, 도봉구,'100002, 96세,2019,91,26,65,40,90,25,65,38.5
'11100, 도봉구,'100003, 97세,2019,52,13,39,33.3,52,13,39,33.3
'11100, 도봉구,'100004, 98세,2019,27,5,22,22.7,27,5,22,22.7
'11100, 도봉구,'100005, 99세,2019,21,X,20,5,21,X,20,5
'11100, 도봉구,'101,100세이상,2019,31,11,20,55,29,9,20,45
'11100, 도봉구,'102,15세미만,2019,31743,16410,15333,107,31621,16340,15281,106.9
'11100, 도봉구,'103,15~64세,2019,235001,115194,119807,96.1,231997,113957,118040,96.5
'11100, 도봉구,'104,65세이상,2019,56799,25357,31442,80.6,56605,25284,31321,80.7
'11100, 도봉구,'126,평균연령,2019,44.6,43.5,45.5,,44.6,43.6,45.6,
'11100, 도봉구,'127,중위연령,2019,46.3,45.1,47.5,,46.5,45.2,47.7,
'11110, 노원구,'000,합계,2019,522480,252662,269818,93.6,516201,249784,266417,93.8
'11110, 노원구,'005,0~4세,2019,15325,7858,7467,105.2,15197,7782,7415,104.9
'11110, 노원구,'005001, 0세,2019,2577,1341,1236,108.5,2553,1325,1228,107.9
'11110, 노원구,'005002, 1세,2019,2736,1418,1318,107.6,2708,1404,1304,107.7
'11110, 노원구,'005003, 2세,2019,3057,1528,1529,99.9,3024,1504,1520,98.9
'11110, 노원구,'005004, 3세,2019,3329,1687,1642,102.7,3311,1676,1635,102.5
'11110, 노원구,'005005, 4세,2019,3626,1884,1742,108.2,3601,1873,1728,108.4
'11110, 노원구,'010,5~9세,2019,19807,10238,9569,107,19708,10187,9521,107
'11110, 노원구,'010001, 5세,2019,3639,1880,1759,106.9,3611,1866,1745,106.9
'11110, 노원구,'010002, 6세,2019,3646,1896,1750,108.3,3625,1882,1743,108
'11110, 노원구,'010003, 7세,2019,4139,2158,1981,108.9,4118,2149,1969,109.1
'11110, 노원구,'010004, 8세,2019,4136,2119,2017,105.1,4123,2113,2010,105.1
'11110, 노원구,'010005, 9세,2019,4247,2185,2062,106,4231,2177,2054,106
'11110, 노원구,'015,10~14세,2019,24001,12466,11535,108.1,23968,12447,11521,108
'11110, 노원구,'015001, 10세,2019,4177,2136,2041,104.7,4166,2130,2036,104.6
'11110, 노원구,'015002, 11세,2019,4780,2489,2291,108.6,4777,2487,2290,108.6
'11110, 노원구,'015003, 12세,2019,5113,2637,2476,106.5,5107,2633,2474,106.4
'11110, 노원구,'015004, 13세,2019,4883,2574,2309,111.5,4877,2571,2306,111.5
'11110, 노원구,'015005, 14세,2019,5048,2630,2418,108.8,5041,2626,2415,108.7
'11110, 노원구,'020,15~19세,2019,32051,16510,15541,106.2,31706,16357,15349,106.6
'11110, 노원구,'020001, 15세,2019,5600,2907,2693,107.9,5589,2901,2688,107.9
'11110, 노원구,'020002, 16세,2019,5540,2911,2629,110.7,5527,2904,2623,110.7
'11110, 노원구,'020003, 17세,2019,5771,2992,2779,107.7,5749,2981,2768,107.7
'11110, 노원구,'020004, 18세,2019,6926,3580,3346,107,6832,3543,3289,107.7
'11110, 노원구,'020005, 19세,2019,8214,4120,4094,100.6,8009,4028,3981,101.2
'11110, 노원구,'025,20~24세,2019,41209,20761,20448,101.5,39751,20072,19679,102
'11110, 노원구,'025001, 20세,2019,7829,3753,4076,92.1,7500,3616,3884,93.1
'11110, 노원구,'025002, 21세,2019,8196,3975,4221,94.2,7840,3816,4024,94.8
'11110, 노원구,'025003, 22세,2019,8455,4225,4230,99.9,8172,4072,4100,99.3
'11110, 노원구,'025004, 23세,2019,8479,4390,4089,107.4,8227,4262,3965,107.5
'11110, 노원구,'025005, 24세,2019,8250,4418,3832,115.3,8012,4306,3706,116.2
'11110, 노원구,'030,25~29세,2019,35048,18323,16725,109.6,34158,17900,16258,110.1
'11110, 노원구,'030001, 25세,2019,7807,4217,3590,117.5,7581,4108,3473,118.3
'11110, 노원구,'030002, 26세,2019,7461,3993,3468,115.1,7281,3902,3379,115.5
'11110, 노원구,'030003, 27세,2019,7100,3708,3392,109.3,6936,3630,3306,109.8
'11110, 노원구,'030004, 28세,2019,6518,3291,3227,102,6364,3222,3142,102.5
'11110, 노원구,'030005, 29세,2019,6162,3114,3048,102.2,5996,3038,2958,102.7
'11110, 노원구,'035,30~34세,2019,29778,14949,14829,100.8,29011,14615,14396,101.5
'11110, 노원구,'035001, 30세,2019,5908,2988,2920,102.3,5744,2918,2826,103.3
'11110, 노원구,'035002, 31세,2019,5848,2922,2926,99.9,5698,2864,2834,101.1
'11110, 노원구,'035003, 32세,2019,5842,2932,2910,100.8,5681,2859,2822,101.3
'11110, 노원구,'035004, 33세,2019,6090,3025,3065,98.7,5946,2960,2986,99.1
'11110, 노원구,'035005, 34세,2019,6090,3082,3008,102.5,5942,3014,2928,102.9
'11110, 노원구,'040,35~39세,2019,35890,17724,18166,97.6,35320,17476,17844,97.9
'11110, 노원구,'040001, 35세,2019,6187,3071,3116,98.6,6070,3014,3056,98.6
'11110, 노원구,'040002, 36세,2019,6952,3476,3476,100,6824,3421,3403,100.5
'11110, 노원구,'040003, 37세,2019,7447,3700,3747,98.7,7330,3651,3679,99.2
'11110, 노원구,'040004, 38세,2019,7443,3724,3719,100.1,7321,3668,3653,100.4
'11110, 노원구,'040005, 39세,2019,7861,3753,4108,91.4,7775,3722,4053,91.8
'11110, 노원구,'045,40~44세,2019,37997,18185,19812,91.8,37516,17947,19569,91.7
'11110, 노원구,'045001, 40세,2019,7600,3724,3876,96.1,7497,3672,3825,96
'11110, 노원구,'045002, 41세,2019,7001,3395,3606,94.1,6900,3342,3558,93.9
'11110, 노원구,'045003, 42세,2019,7607,3570,4037,88.4,7512,3527,3985,88.5
'11110, 노원구,'045004, 43세,2019,7423,3588,3835,93.6,7338,3548,3790,93.6
'11110, 노원구,'045005, 44세,2019,8366,3908,4458,87.7,8269,3858,4411,87.5
'11110, 노원구,'050,45~49세,2019,49258,23507,25751,91.3,48848,23310,25538,91.3
'11110, 노원구,'050001, 45세,2019,9119,4324,4795,90.2,9043,4288,4755,90.2
'11110, 노원구,'050002, 46세,2019,9635,4585,5050,90.8,9566,4560,5006,91.1
'11110, 노원구,'050003, 47세,2019,9707,4612,5095,90.5,9634,4569,5065,90.2
'11110, 노원구,'050004, 48세,2019,10666,5111,5555,92,10567,5062,5505,92
'11110, 노원구,'050005, 49세,2019,10131,4875,5256,92.8,10038,4831,5207,92.8
'11110, 노원구,'055,50~54세,2019,44860,21811,23049,94.6,44478,21635,22843,94.7
'11110, 노원구,'055001, 50세,2019,9932,4858,5074,95.7,9836,4812,5024,95.8
'11110, 노원구,'055002, 51세,2019,9653,4627,5026,92.1,9576,4590,4986,92.1
'11110, 노원구,'055003, 52세,2019,8680,4233,4447,95.2,8612,4204,4408,95.4
'11110, 노원구,'055004, 53세,2019,8262,4100,4162,98.5,8192,4063,4129,98.4
'11110, 노원구,'055005, 54세,2019,8333,3993,4340,92,8262,3966,4296,92.3
'11110, 노원구,'060,55~59세,2019,42037,20129,21908,91.9,41718,20010,21708,92.2
'11110, 노원구,'060001, 55세,2019,7752,3811,3941,96.7,7678,3783,3895,97.1
'11110, 노원구,'060002, 56세,2019,8279,3935,4344,90.6,8193,3909,4284,91.2
'11110, 노원구,'060003, 57세,2019,8310,4031,4279,94.2,8245,4001,4244,94.3
'11110, 노원구,'060004, 58세,2019,8816,4220,4596,91.8,8774,4205,4569,92
'11110, 노원구,'060005, 59세,2019,8880,4132,4748,87,8828,4112,4716,87.2
'11110, 노원구,'065,60~64세,2019,37500,17453,20047,87.1,37323,17386,19937,87.2
'11110, 노원구,'065001, 60세,2019,8023,3728,4295,86.8,7985,3710,4275,86.8
'11110, 노원구,'065002, 61세,2019,7678,3608,4070,88.6,7640,3594,4046,88.8
'11110, 노원구,'065003, 62세,2019,7603,3557,4046,87.9,7569,3543,4026,88
'11110, 노원구,'065004, 63세,2019,6973,3250,3723,87.3,6938,3241,3697,87.7
'11110, 노원구,'065005, 64세,2019,7223,3310,3913,84.6,7191,3298,3893,84.7
'11110, 노원구,'070,65~69세,2019,25548,12011,13537,88.7,25438,11967,13471,88.8
'11110, 노원구,'070001, 65세,2019,6050,2860,3190,89.7,6018,2847,3171,89.8
'11110, 노원구,'070002, 66세,2019,5175,2471,2704,91.4,5149,2462,2687,91.6
'11110, 노원구,'070003, 67세,2019,5769,2719,3050,89.1,5741,2708,3033,89.3
'11110, 노원구,'070004, 68세,2019,4076,1880,2196,85.6,4060,1874,2186,85.7
'11110, 노원구,'070005, 69세,2019,4478,2081,2397,86.8,4470,2076,2394,86.7
'11110, 노원구,'075,70~74세,2019,19651,8714,10937,79.7,19604,8690,10914,79.6
'11110, 노원구,'075001, 70세,2019,4519,2054,2465,83.3,4503,2045,2458,83.2
'11110, 노원구,'075002, 71세,2019,4265,1949,2316,84.2,4255,1947,2308,84.4
'11110, 노원구,'075003, 72세,2019,4338,1878,2460,76.3,4330,1873,2457,76.2
'11110, 노원구,'075004, 73세,2019,3356,1431,1925,74.3,3347,1425,1922,74.1
'11110, 노원구,'075005, 74세,2019,3173,1402,1771,79.2,3169,1400,1769,79.1
'11110, 노원구,'080,75~79세,2019,15818,6549,9269,70.7,15784,6536,9248,70.7
'11110, 노원구,'080001, 75세,2019,3198,1345,1853,72.6,3186,1338,1848,72.4
'11110, 노원구,'080002, 76세,2019,3284,1394,1890,73.8,3276,1392,1884,73.9
'11110, 노원구,'080003, 77세,2019,3722,1566,2156,72.6,3717,1564,2153,72.6
'11110, 노원구,'080004, 78세,2019,2954,1158,1796,64.5,2949,1157,1792,64.6
'11110, 노원구,'080005, 79세,2019,2660,1086,1574,69,2656,1085,1571,69.1
'11110, 노원구,'085,80~84세,2019,10034,3585,6449,55.6,10021,3583,6438,55.7
'11110, 노원구,'085001, 80세,2019,2523,975,1548,63,2518,974,1544,63.1
'11110, 노원구,'085002, 81세,2019,2264,823,1441,57.1,2261,822,1439,57.1
'11110, 노원구,'085003, 82세,2019,1977,712,1265,56.3,1976,712,1264,56.3
'11110, 노원구,'085004, 83세,2019,1706,591,1115,53,1703,591,1112,53.1
'11110, 노원구,'085005, 84세,2019,1564,484,1080,44.8,1563,484,1079,44.9
'11110, 노원구,'086,85세이상,2019,6668,1889,4779,39.5,6652,1884,4768,39.5
'11110, 노원구,'090,85~89세,2019,4688,1421,3267,43.5,4680,1418,3262,43.5
'11110, 노원구,'090001, 85세,2019,1314,419,895,46.8,1310,417,893,46.7
'11110, 노원구,'090002, 86세,2019,1068,334,734,45.5,1068,334,734,45.5
'11110, 노원구,'090003, 87세,2019,948,289,659,43.9,945,288,657,43.8
'11110, 노원구,'090004, 88세,2019,698,189,509,37.1,697,189,508,37.2
'11110, 노원구,'090005, 89세,2019,660,190,470,40.4,660,190,470,40.4
'11110, 노원구,'095,90~94세,2019,1568,373,1195,31.2,1563,371,1192,31.1
'11110, 노원구,'095001, 90세,2019,494,145,349,41.5,491,143,348,41.1
'11110, 노원구,'095002, 91세,2019,412,99,313,31.6,412,99,313,31.6
'11110, 노원구,'095003, 92세,2019,319,67,252,26.6,318,67,251,26.7
'11110, 노원구,'095004, 93세,2019,202,38,164,23.2,201,38,163,23.3
'11110, 노원구,'095005, 94세,2019,141,24,117,20.5,141,24,117,20.5
'11110, 노원구,'100,95~99세,2019,362,89,273,32.6,361,89,272,32.7
'11110, 노원구,'100001, 95세,2019,124,31,93,33.3,124,31,93,33.3
'11110, 노원구,'100002, 96세,2019,102,25,77,32.5,102,25,77,32.5
'11110, 노원구,'100003, 97세,2019,55,16,39,41,55,16,39,41
'11110, 노원구,'100004, 98세,2019,46,5,41,12.2,45,5,40,12.5
'11110, 노원구,'100005, 99세,2019,35,12,23,52.2,35,12,23,52.2
'11110, 노원구,'101,100세이상,2019,50,6,44,13.6,48,6,42,14.3
'11110, 노원구,'102,15세미만,2019,59133,30562,28571,107,58873,30416,28457,106.9
'11110, 노원구,'103,15~64세,2019,385628,189352,196276,96.5,379829,186708,193121,96.7
'11110, 노원구,'104,65세이상,2019,77719,32748,44971,72.8,77499,32660,44839,72.8
'11110, 노원구,'126,평균연령,2019,42.3,41,43.6,,42.4,41.1,43.7,
'11110, 노원구,'127,중위연령,2019,43.8,42.1,45.2,,44,42.3,45.3,
'11120, 은평구,'000,합계,2019,461530,222076,239454,92.7,455140,219283,235857,93
'11120, 은평구,'005,0~4세,2019,14470,7394,7076,104.5,14301,7307,6994,104.5
'11120, 은평구,'005001, 0세,2019,2452,1274,1178,108.1,2428,1261,1167,108.1
'11120, 은평구,'005002, 1세,2019,2658,1337,1321,101.2,2622,1321,1301,101.5
'11120, 은평구,'005003, 2세,2019,2820,1467,1353,108.4,2776,1441,1335,107.9
'11120, 은평구,'005004, 3세,2019,3167,1601,1566,102.2,3135,1587,1548,102.5
'11120, 은평구,'005005, 4세,2019,3373,1715,1658,103.4,3340,1697,1643,103.3
'11120, 은평구,'010,5~9세,2019,16751,8651,8100,106.8,16655,8603,8052,106.8
'11120, 은평구,'010001, 5세,2019,3188,1664,1524,109.2,3167,1656,1511,109.6
'11120, 은평구,'010002, 6세,2019,3192,1668,1524,109.4,3167,1657,1510,109.7
'11120, 은평구,'010003, 7세,2019,3536,1834,1702,107.8,3504,1816,1688,107.6
'11120, 은평구,'010004, 8세,2019,3422,1748,1674,104.4,3415,1745,1670,104.5
'11120, 은평구,'010005, 9세,2019,3413,1737,1676,103.6,3402,1729,1673,103.3
'11120, 은평구,'015,10~14세,2019,17385,9023,8362,107.9,17312,8981,8331,107.8
'11120, 은평구,'015001, 10세,2019,3363,1728,1635,105.7,3352,1723,1629,105.8
'11120, 은평구,'015002, 11세,2019,3484,1776,1708,104,3469,1768,1701,103.9
'11120, 은평구,'015003, 12세,2019,3730,1971,1759,112.1,3716,1962,1754,111.9
'11120, 은평구,'015004, 13세,2019,3472,1775,1697,104.6,3460,1768,1692,104.5
'11120, 은평구,'015005, 14세,2019,3336,1773,1563,113.4,3315,1760,1555,113.2
'11120, 은평구,'020,15~19세,2019,21869,11085,10784,102.8,21630,10972,10658,102.9
'11120, 은평구,'020001, 15세,2019,3901,1988,1913,103.9,3873,1974,1899,103.9
'11120, 은평구,'020002, 16세,2019,4083,2111,1972,107,4056,2098,1958,107.2
'11120, 은평구,'020003, 17세,2019,4315,2192,2123,103.3,4278,2175,2103,103.4
'11120, 은평구,'020004, 18세,2019,4644,2305,2339,98.5,4581,2285,2296,99.5
'11120, 은평구,'020005, 19세,2019,4926,2489,2437,102.1,4842,2440,2402,101.6
'11120, 은평구,'025,20~24세,2019,27888,13650,14238,95.9,27414,13493,13921,96.9
'11120, 은평구,'025001, 20세,2019,5047,2554,2493,102.4,4996,2536,2460,103.1
'11120, 은평구,'025002, 21세,2019,5112,2591,2521,102.8,5015,2552,2463,103.6
'11120, 은평구,'025003, 22세,2019,5567,2709,2858,94.8,5475,2686,2789,96.3
'11120, 은평구,'025004, 23세,2019,5922,2791,3131,89.1,5807,2761,3046,90.6
'11120, 은평구,'025005, 24세,2019,6240,3005,3235,92.9,6121,2958,3163,93.5
'11120, 은평구,'030,25~29세,2019,34413,16508,17905,92.2,33611,16187,17424,92.9
'11120, 은평구,'030001, 25세,2019,6660,3164,3496,90.5,6516,3106,3410,91.1
'11120, 은평구,'030002, 26세,2019,7009,3336,3673,90.8,6848,3275,3573,91.7
'11120, 은평구,'030003, 27세,2019,7175,3476,3699,94,7029,3410,3619,94.2
'11120, 은평구,'030004, 28세,2019,6989,3378,3611,93.5,6826,3313,3513,94.3
'11120, 은평구,'030005, 29세,2019,6580,3154,3426,92.1,6392,3083,3309,93.2
'11120, 은평구,'035,30~34세,2019,31221,15167,16054,94.5,30322,14800,15522,95.3
'11120, 은평구,'035001, 30세,2019,6255,3001,3254,92.2,6071,2930,3141,93.3
'11120, 은평구,'035002, 31세,2019,6146,2983,3163,94.3,5974,2921,3053,95.7
'11120, 은평구,'035003, 32세,2019,6247,3007,3240,92.8,6053,2926,3127,93.6
'11120, 은평구,'035004, 33세,2019,6206,3006,3200,93.9,6021,2925,3096,94.5
'11120, 은평구,'035005, 34세,2019,6367,3170,3197,99.2,6203,3098,3105,99.8
'11120, 은평구,'040,35~39세,2019,36871,18576,18295,101.5,36152,18256,17896,102
'11120, 은평구,'040001, 35세,2019,6540,3231,3309,97.6,6379,3153,3226,97.7
'11120, 은평구,'040002, 36세,2019,7144,3583,3561,100.6,7015,3529,3486,101.2
'11120, 은평구,'040003, 37세,2019,7679,3914,3765,104,7513,3837,3676,104.4
'11120, 은평구,'040004, 38세,2019,7709,3923,3786,103.6,7579,3869,3710,104.3
'11120, 은평구,'040005, 39세,2019,7799,3925,3874,101.3,7666,3868,3798,101.8
'11120, 은평구,'045,40~44세,2019,34139,16983,17156,99,33644,16741,16903,99
'11120, 은평구,'045001, 40세,2019,7192,3607,3585,100.6,7069,3553,3516,101.1
'11120, 은평구,'045002, 41세,2019,6382,3159,3223,98,6295,3122,3173,98.4
'11120, 은평구,'045003, 42세,2019,6829,3393,3436,98.7,6742,3344,3398,98.4
'11120, 은평구,'045004, 43세,2019,6712,3377,3335,101.3,6609,3322,3287,101.1
'11120, 은평구,'045005, 44세,2019,7024,3447,3577,96.4,6929,3400,3529,96.3
'11120, 은평구,'050,45~49세,2019,40411,19876,20535,96.8,39903,19647,20256,97
'11120, 은평구,'050001, 45세,2019,7837,3866,3971,97.4,7745,3827,3918,97.7
'11120, 은평구,'050002, 46세,2019,7992,3956,4036,98,7910,3916,3994,98
'11120, 은평구,'050003, 47세,2019,8067,4004,4063,98.5,7961,3952,4009,98.6
'11120, 은평구,'050004, 48세,2019,8572,4214,4358,96.7,8460,4164,4296,96.9
'11120, 은평구,'050005, 49세,2019,7943,3836,4107,93.4,7827,3788,4039,93.8
'11120, 은평구,'055,50~54세,2019,37344,18001,19343,93.1,36836,17767,19069,93.2
'11120, 은평구,'055001, 50세,2019,8206,4014,4192,95.8,8092,3954,4138,95.6
'11120, 은평구,'055002, 51세,2019,7854,3768,4086,92.2,7733,3721,4012,92.7
'11120, 은평구,'055003, 52세,2019,7274,3503,3771,92.9,7190,3459,3731,92.7
'11120, 은평구,'055004, 53세,2019,6914,3365,3549,94.8,6839,3327,3512,94.7
'11120, 은평구,'055005, 54세,2019,7096,3351,3745,89.5,6982,3306,3676,89.9
'11120, 은평구,'060,55~59세,2019,37378,17630,19748,89.3,36874,17390,19484,89.3
'11120, 은평구,'060001, 55세,2019,6866,3293,3573,92.2,6747,3236,3511,92.2
'11120, 은평구,'060002, 56세,2019,7193,3437,3756,91.5,7054,3369,3685,91.4
'11120, 은평구,'060003, 57세,2019,7296,3494,3802,91.9,7198,3448,3750,91.9
'11120, 은평구,'060004, 58세,2019,7928,3705,4223,87.7,7850,3668,4182,87.7
'11120, 은평구,'060005, 59세,2019,8095,3701,4394,84.2,8025,3669,4356,84.2
'11120, 은평구,'065,60~64세,2019,34572,16207,18365,88.2,34119,16001,18118,88.3
'11120, 은평구,'065001, 60세,2019,7487,3551,3936,90.2,7377,3497,3880,90.1
'11120, 은평구,'065002, 61세,2019,7007,3248,3759,86.4,6920,3209,3711,86.5
'11120, 은평구,'065003, 62세,2019,6906,3223,3683,87.5,6820,3184,3636,87.6
'11120, 은평구,'065004, 63세,2019,6444,3032,3412,88.9,6357,2991,3366,88.9
'11120, 은평구,'065005, 64세,2019,6728,3153,3575,88.2,6645,3120,3525,88.5
'11120, 은평구,'070,65~69세,2019,24430,11116,13314,83.5,24206,11016,13190,83.5
'11120, 은평구,'070001, 65세,2019,5677,2544,3133,81.2,5608,2519,3089,81.5
'11120, 은평구,'070002, 66세,2019,5081,2277,2804,81.2,5038,2253,2785,80.9
'11120, 은평구,'070003, 67세,2019,5292,2506,2786,89.9,5239,2482,2757,90
'11120, 은평구,'070004, 68세,2019,3972,1773,2199,80.6,3939,1756,2183,80.4
'11120, 은평구,'070005, 69세,2019,4408,2016,2392,84.3,4382,2006,2376,84.4
'11120, 은평구,'075,70~74세,2019,20445,9097,11348,80.2,20347,9057,11290,80.2
'11120, 은평구,'075001, 70세,2019,4546,2009,2537,79.2,4522,2004,2518,79.6
'11120, 은평구,'075002, 71세,2019,4461,2006,2455,81.7,4434,1997,2437,81.9
'11120, 은평구,'075003, 72세,2019,4514,2019,2495,80.9,4495,2009,2486,80.8
'11120, 은평구,'075004, 73세,2019,3529,1572,1957,80.3,3511,1561,1950,80.1
'11120, 은평구,'075005, 74세,2019,3395,1491,1904,78.3,3385,1486,1899,78.3
'11120, 은평구,'080,75~79세,2019,16466,7324,9142,80.1,16403,7301,9102,80.2
'11120, 은평구,'080001, 75세,2019,3356,1459,1897,76.9,3340,1456,1884,77.3
'11120, 은평구,'080002, 76세,2019,3428,1481,1947,76.1,3416,1475,1941,76
'11120, 은평구,'080003, 77세,2019,3923,1745,2178,80.1,3912,1739,2173,80
'11120, 은평구,'080004, 78세,2019,3033,1376,1657,83,3019,1372,1647,83.3
'11120, 은평구,'080005, 79세,2019,2726,1263,1463,86.3,2716,1259,1457,86.4
'11120, 은평구,'085,80~84세,2019,9857,4026,5831,69,9818,4010,5808,69
'11120, 은평구,'085001, 80세,2019,2533,1057,1476,71.6,2525,1053,1472,71.5
'11120, 은평구,'085002, 81세,2019,2168,912,1256,72.6,2157,907,1250,72.6
'11120, 은평구,'085003, 82세,2019,1998,825,1173,70.3,1987,821,1166,70.4
'11120, 은평구,'085004, 83세,2019,1688,652,1036,62.9,1683,651,1032,63.1
'11120, 은평구,'085005, 84세,2019,1470,580,890,65.2,1466,578,888,65.1
'11120, 은평구,'086,85세이상,2019,5620,1762,3858,45.7,5593,1754,3839,45.7
'11120, 은평구,'090,85~89세,2019,3916,1319,2597,50.8,3898,1313,2585,50.8
'11120, 은평구,'090001, 85세,2019,1160,438,722,60.7,1155,437,718,60.9
'11120, 은평구,'090002, 86세,2019,886,307,579,53,883,307,576,53.3
'11120, 은평구,'090003, 87세,2019,775,265,510,52,768,261,507,51.5
'11120, 은평구,'090004, 88세,2019,602,175,427,41,601,175,426,41.1
'11120, 은평구,'090005, 89세,2019,493,134,359,37.3,491,133,358,37.2
'11120, 은평구,'095,90~94세,2019,1375,362,1013,35.7,1367,360,1007,35.7
'11120, 은평구,'095001, 90세,2019,444,140,304,46.1,443,140,303,46.2
'11120, 은평구,'095002, 91세,2019,357,101,256,39.5,356,101,255,39.6
'11120, 은평구,'095003, 92세,2019,274,55,219,25.1,270,54,216,25
'11120, 은평구,'095004, 93세,2019,165,41,124,33.1,164,40,124,32.3
'11120, 은평구,'095005, 94세,2019,135,25,110,22.7,134,25,109,22.9
'11120, 은평구,'100,95~99세,2019,299,77,222,34.7,298,77,221,34.8
'11120, 은평구,'100001, 95세,2019,116,31,85,36.5,116,31,85,36.5
'11120, 은평구,'100002, 96세,2019,86,24,62,38.7,85,24,61,39.3
'11120, 은평구,'100003, 97세,2019,50,12,38,31.6,50,12,38,31.6
'11120, 은평구,'100004, 98세,2019,29,6,23,26.1,29,6,23,26.1
'11120, 은평구,'100005, 99세,2019,18,X,14,28.6,18,X,14,28.6
'11120, 은평구,'101,100세이상,2019,30,X,26,15.4,30,X,26,15.4
'11120, 은평구,'102,15세미만,2019,48606,25068,23538,106.5,48268,24891,23377,106.5
'11120, 은평구,'103,15~64세,2019,336106,163683,172423,94.9,330505,161254,169251,95.3
'11120, 은평구,'104,65세이상,2019,76818,33325,43493,76.6,76367,33138,43229,76.7
'11120, 은평구,'126,평균연령,2019,43.5,42.5,44.5,,43.6,42.5,44.5,
'11120, 은평구,'127,중위연령,2019,44.4,43.2,45.4,,44.5,43.3,45.6,
'11130, 서대문구,'000,합계,2019,319394,149113,170281,87.6,303075,143082,159993,89.4
'11130, 서대문구,'005,0~4세,2019,9696,5003,4693,106.6,9253,4780,4473,106.9
'11130, 서대문구,'005001, 0세,2019,1646,847,799,106,1606,823,783,105.1
'11130, 서대문구,'005002, 1세,2019,1818,977,841,116.2,1752,943,809,116.6
'11130, 서대문구,'005003, 2세,2019,1875,1005,870,115.5,1774,944,830,113.7
'11130, 서대문구,'005004, 3세,2019,2152,1075,1077,99.8,2023,1025,998,102.7
'11130, 서대문구,'005005, 4세,2019,2205,1099,1106,99.4,2098,1045,1053,99.2
'11130, 서대문구,'010,5~9세,2019,10510,5338,5172,103.2,10229,5188,5041,102.9
'11130, 서대문구,'010001, 5세,2019,2158,1080,1078,100.2,2092,1047,1045,100.2
'11130, 서대문구,'010002, 6세,2019,2046,1051,995,105.6,1982,1016,966,105.2
'11130, 서대문구,'010003, 7세,2019,2190,1107,1083,102.2,2138,1083,1055,102.7
'11130, 서대문구,'010004, 8세,2019,2076,1033,1043,99,2024,1000,1024,97.7
'11130, 서대문구,'010005, 9세,2019,2040,1067,973,109.7,1993,1042,951,109.6
'11130, 서대문구,'015,10~14세,2019,10389,5218,5171,100.9,10166,5114,5052,101.2
'11130, 서대문구,'015001, 10세,2019,2075,1034,1041,99.3,2039,1020,1019,100.1
'11130, 서대문구,'015002, 11세,2019,2016,1021,995,102.6,1965,995,970,102.6
'11130, 서대문구,'015003, 12세,2019,2122,1055,1067,98.9,2076,1036,1040,99.6
'11130, 서대문구,'015004, 13세,2019,2138,1093,1045,104.6,2088,1067,1021,104.5
'11130, 서대문구,'015005, 14세,2019,2038,1015,1023,99.2,1998,996,1002,99.4
'11130, 서대문구,'020,15~19세,2019,16127,7193,8934,80.5,15117,6909,8208,84.2
'11130, 서대문구,'020001, 15세,2019,2308,1167,1141,102.3,2261,1141,1120,101.9
'11130, 서대문구,'020002, 16세,2019,2545,1311,1234,106.2,2501,1285,1216,105.7
'11130, 서대문구,'020003, 17세,2019,2549,1316,1233,106.7,2472,1281,1191,107.6
'11130, 서대문구,'020004, 18세,2019,3389,1551,1838,84.4,3151,1494,1657,90.2
'11130, 서대문구,'020005, 19세,2019,5336,1848,3488,53,4732,1708,3024,56.5
'11130, 서대문구,'025,20~24세,2019,33354,12781,20573,62.1,28382,11505,16877,68.2
'11130, 서대문구,'025001, 20세,2019,6105,2158,3947,54.7,5184,1952,3232,60.4
'11130, 서대문구,'025002, 21세,2019,6331,2257,4074,55.4,5301,1973,3328,59.3
'11130, 서대문구,'025003, 22세,2019,6738,2488,4250,58.5,5687,2214,3473,63.7
'11130, 서대문구,'025004, 23세,2019,7123,2841,4282,66.3,6095,2580,3515,73.4
'11130, 서대문구,'025005, 24세,2019,7057,3037,4020,75.5,6115,2786,3329,83.7
'11130, 서대문구,'030,25~29세,2019,29777,14446,15331,94.2,27149,13605,13544,100.5
'11130, 서대문구,'030001, 25세,2019,6603,3029,3574,84.8,5936,2847,3089,92.2
'11130, 서대문구,'030002, 26세,2019,6547,3175,3372,94.2,5925,2984,2941,101.5
'11130, 서대문구,'030003, 27세,2019,6010,3003,3007,99.9,5515,2853,2662,107.2
'11130, 서대문구,'030004, 28세,2019,5642,2775,2867,96.8,5217,2621,2596,101
'11130, 서대문구,'030005, 29세,2019,4975,2464,2511,98.1,4556,2300,2256,102
'11130, 서대문구,'035,30~34세,2019,21915,10846,11069,98,20299,10152,10147,100
'11130, 서대문구,'035001, 30세,2019,4634,2319,2315,100.2,4234,2169,2065,105
'11130, 서대문구,'035002, 31세,2019,4397,2129,2268,93.9,4071,1988,2083,95.4
'11130, 서대문구,'035003, 32세,2019,4359,2163,2196,98.5,4026,2013,2013,100
'11130, 서대문구,'035004, 33세,2019,4204,2112,2092,101,3924,1978,1946,101.6
'11130, 서대문구,'035005, 34세,2019,4321,2123,2198,96.6,4044,2004,2040,98.2
'11130, 서대문구,'040,35~39세,2019,23282,11535,11747,98.2,22173,11013,11160,98.7
'11130, 서대문구,'040001, 35세,2019,4213,2041,2172,94,3991,1939,2052,94.5
'11130, 서대문구,'040002, 36세,2019,4632,2368,2264,104.6,4375,2239,2136,104.8
'11130, 서대문구,'040003, 37세,2019,4816,2328,2488,93.6,4590,2219,2371,93.6
'11130, 서대문구,'040004, 38세,2019,4813,2435,2378,102.4,4604,2337,2267,103.1
'11130, 서대문구,'040005, 39세,2019,4808,2363,2445,96.6,4613,2279,2334,97.6
'11130, 서대문구,'045,40~44세,2019,21249,10623,10626,100,20427,10237,10190,100.5
'11130, 서대문구,'045001, 40세,2019,4465,2226,2239,99.4,4265,2141,2124,100.8
'11130, 서대문구,'045002, 41세,2019,4034,2012,2022,99.5,3866,1930,1936,99.7
'11130, 서대문구,'045003, 42세,2019,4223,2107,2116,99.6,4055,2016,2039,98.9
'11130, 서대문구,'045004, 43세,2019,4158,2086,2072,100.7,4030,2033,1997,101.8
'11130, 서대문구,'045005, 44세,2019,4369,2192,2177,100.7,4211,2117,2094,101.1
'11130, 서대문구,'050,45~49세,2019,25370,12489,12881,97,24491,12032,12459,96.6
'11130, 서대문구,'050001, 45세,2019,4790,2344,2446,95.8,4631,2257,2374,95.1
'11130, 서대문구,'050002, 46세,2019,4788,2293,2495,91.9,4622,2206,2416,91.3
'11130, 서대문구,'050003, 47세,2019,5086,2564,2522,101.7,4899,2467,2432,101.4
'11130, 서대문구,'050004, 48세,2019,5491,2759,2732,101,5288,2657,2631,101
'11130, 서대문구,'050005, 49세,2019,5215,2529,2686,94.2,5051,2445,2606,93.8
'11130, 서대문구,'055,50~54세,2019,24088,11566,12522,92.4,23411,11240,12171,92.4
'11130, 서대문구,'055001, 50세,2019,5145,2439,2706,90.1,5004,2375,2629,90.3
'11130, 서대문구,'055002, 51세,2019,5055,2433,2622,92.8,4901,2353,2548,92.3
'11130, 서대문구,'055003, 52세,2019,4705,2201,2504,87.9,4596,2152,2444,88.1
'11130, 서대문구,'055004, 53세,2019,4476,2317,2159,107.3,4340,2254,2086,108.1
'11130, 서대문구,'055005, 54세,2019,4707,2176,2531,86,4570,2106,2464,85.5
'11130, 서대문구,'060,55~59세,2019,23621,11310,12311,91.9,22982,11004,11978,91.9
'11130, 서대문구,'060001, 55세,2019,4429,2110,2319,91,4303,2040,2263,90.1
'11130, 서대문구,'060002, 56세,2019,4661,2275,2386,95.3,4505,2203,2302,95.7
'11130, 서대문구,'060003, 57세,2019,4615,2243,2372,94.6,4477,2182,2295,95.1
'11130, 서대문구,'060004, 58세,2019,4965,2361,2604,90.7,4843,2306,2537,90.9
'11130, 서대문구,'060005, 59세,2019,4951,2321,2630,88.3,4854,2273,2581,88.1
'11130, 서대문구,'065,60~64세,2019,21070,9998,11072,90.3,20590,9775,10815,90.4
'11130, 서대문구,'065001, 60세,2019,4589,2174,2415,90,4494,2130,2364,90.1
'11130, 서대문구,'065002, 61세,2019,4371,2129,2242,95,4251,2075,2176,95.4
'11130, 서대문구,'065003, 62세,2019,4210,2003,2207,90.8,4112,1951,2161,90.3
'11130, 서대문구,'065004, 63세,2019,3844,1800,2044,88.1,3769,1771,1998,88.6
'11130, 서대문구,'065005, 64세,2019,4056,1892,2164,87.4,3964,1848,2116,87.3
'11130, 서대문구,'070,65~69세,2019,14587,6678,7909,84.4,14312,6542,7770,84.2
'11130, 서대문구,'070001, 65세,2019,3357,1580,1777,88.9,3282,1545,1737,88.9
'11130, 서대문구,'070002, 66세,2019,3012,1402,1610,87.1,2934,1365,1569,87
'11130, 서대문구,'070003, 67세,2019,3171,1441,1730,83.3,3120,1418,1702,83.3
'11130, 서대문구,'070004, 68세,2019,2353,1104,1249,88.4,2317,1079,1238,87.2
'11130, 서대문구,'070005, 69세,2019,2694,1151,1543,74.6,2659,1135,1524,74.5
'11130, 서대문구,'075,70~74세,2019,12555,5422,7133,76,12429,5360,7069,75.8
'11130, 서대문구,'075001, 70세,2019,2692,1142,1550,73.7,2656,1124,1532,73.4
'11130, 서대문구,'075002, 71세,2019,2575,1098,1477,74.3,2550,1088,1462,74.4
'11130, 서대문구,'075003, 72세,2019,2914,1271,1643,77.4,2889,1261,1628,77.5
'11130, 서대문구,'075004, 73세,2019,2210,985,1225,80.4,2191,974,1217,80
'11130, 서대문구,'075005, 74세,2019,2164,926,1238,74.8,2143,913,1230,74.2
'11130, 서대문구,'080,75~79세,2019,10755,4600,6155,74.7,10703,4587,6116,75
'11130, 서대문구,'080001, 75세,2019,2122,913,1209,75.5,2113,912,1201,75.9
'11130, 서대문구,'080002, 76세,2019,2181,916,1265,72.4,2174,914,1260,72.5
'11130, 서대문구,'080003, 77세,2019,2587,1136,1451,78.3,2578,1134,1444,78.5
'11130, 서대문구,'080004, 78세,2019,2019,874,1145,76.3,1999,868,1131,76.7
'11130, 서대문구,'080005, 79세,2019,1846,761,1085,70.1,1839,759,1080,70.3
'11130, 서대문구,'085,80~84세,2019,7003,2795,4208,66.4,6959,2779,4180,66.5
'11130, 서대문구,'085001, 80세,2019,1832,752,1080,69.6,1819,749,1070,70
'11130, 서대문구,'085002, 81세,2019,1532,624,908,68.7,1528,622,906,68.7
'11130, 서대문구,'085003, 82세,2019,1336,532,804,66.2,1326,531,795,66.8
'11130, 서대문구,'085004, 83세,2019,1195,478,717,66.7,1181,470,711,66.1
'11130, 서대문구,'085005, 84세,2019,1108,409,699,58.5,1105,407,698,58.3
'11130, 서대문구,'086,85세이상,2019,4046,1272,2774,45.9,4003,1260,2743,45.9
'11130, 서대문구,'090,85~89세,2019,2836,960,1876,51.2,2809,953,1856,51.3
'11130, 서대문구,'090001, 85세,2019,833,313,520,60.2,823,310,513,60.4
'11130, 서대문구,'090002, 86세,2019,663,229,434,52.8,658,226,432,52.3
'11130, 서대문구,'090003, 87세,2019,546,179,367,48.8,542,179,363,49.3
'11130, 서대문구,'090004, 88세,2019,405,122,283,43.1,399,121,278,43.5
'11130, 서대문구,'090005, 89세,2019,389,117,272,43,387,117,270,43.3
'11130, 서대문구,'095,90~94세,2019,966,263,703,37.4,957,261,696,37.5
'11130, 서대문구,'095001, 90세,2019,314,104,210,49.5,311,103,208,49.5
'11130, 서대문구,'095002, 91세,2019,242,69,173,39.9,240,69,171,40.4
'11130, 서대문구,'095003, 92세,2019,187,37,150,24.7,185,36,149,24.2
'11130, 서대문구,'095004, 93세,2019,122,30,92,32.6,122,30,92,32.6
'11130, 서대문구,'095005, 94세,2019,101,23,78,29.5,99,23,76,30.3
'11130, 서대문구,'100,95~99세,2019,206,40,166,24.1,201,39,162,24.1
'11130, 서대문구,'100001, 95세,2019,75,14,61,23,73,14,59,23.7
'11130, 서대문구,'100002, 96세,2019,49,12,37,32.4,48,11,37,29.7
'11130, 서대문구,'100003, 97세,2019,50,9,41,22,48,9,39,23.1
'11130, 서대문구,'100004, 98세,2019,23,X,20,15,23,X,20,15
'11130, 서대문구,'100005, 99세,2019,9,X,7,28.6,9,X,7,28.6
'11130, 서대문구,'101,100세이상,2019,38,9,29,31,36,7,29,24.1
'11130, 서대문구,'102,15세미만,2019,30595,15559,15036,103.5,29648,15082,14566,103.5
'11130, 서대문구,'103,15~64세,2019,239853,112787,127066,88.8,225021,107472,117549,91.4
'11130, 서대문구,'104,65세이상,2019,48946,20767,28179,73.7,48406,20528,27878,73.6
'11130, 서대문구,'126,평균연령,2019,41.9,41.5,42.3,,42.4,41.8,43,
'11130, 서대문구,'127,중위연령,2019,41,41,41.1,,42.2,41.6,42.7,
'11140, 마포구,'000,합계,2019,369327,173893,195434,89,355020,167814,187206,89.6
'11140, 마포구,'005,0~4세,2019,13006,6658,6348,104.9,12658,6483,6175,105
'11140, 마포구,'005001, 0세,2019,2465,1279,1186,107.8,2424,1258,1166,107.9
'11140, 마포구,'005002, 1세,2019,2518,1287,1231,104.5,2449,1250,1199,104.3
'11140, 마포구,'005003, 2세,2019,2482,1265,1217,103.9,2409,1232,1177,104.7
'11140, 마포구,'005004, 3세,2019,2782,1428,1354,105.5,2711,1392,1319,105.5
'11140, 마포구,'005005, 4세,2019,2759,1399,1360,102.9,2665,1351,1314,102.8
'11140, 마포구,'010,5~9세,2019,13141,6590,6551,100.6,12897,6464,6433,100.5
'11140, 마포구,'010001, 5세,2019,2640,1304,1336,97.6,2582,1271,1311,96.9
'11140, 마포구,'010002, 6세,2019,2591,1287,1304,98.7,2526,1253,1273,98.4
'11140, 마포구,'010003, 7세,2019,2757,1401,1356,103.3,2701,1373,1328,103.4
'11140, 마포구,'010004, 8세,2019,2624,1313,1311,100.2,2591,1298,1293,100.4
'11140, 마포구,'010005, 9세,2019,2529,1285,1244,103.3,2497,1269,1228,103.3
'11140, 마포구,'015,10~14세,2019,13091,6648,6443,103.2,12942,6565,6377,102.9
'11140, 마포구,'015001, 10세,2019,2537,1317,1220,108,2501,1299,1202,108.1
'11140, 마포구,'015002, 11세,2019,2757,1402,1355,103.5,2722,1384,1338,103.4
'11140, 마포구,'015003, 12세,2019,2805,1415,1390,101.8,2779,1401,1378,101.7
'11140, 마포구,'015004, 13세,2019,2467,1225,1242,98.6,2439,1207,1232,98
'11140, 마포구,'015005, 14세,2019,2525,1289,1236,104.3,2501,1274,1227,103.8
'11140, 마포구,'020,15~19세,2019,15816,7727,8089,95.5,15171,7534,7637,98.7
'11140, 마포구,'020001, 15세,2019,2716,1359,1357,100.1,2684,1343,1341,100.1
'11140, 마포구,'020002, 16세,2019,2585,1363,1222,111.5,2563,1353,1210,111.8
'11140, 마포구,'020003, 17세,2019,2592,1298,1294,100.3,2550,1281,1269,100.9
'11140, 마포구,'020004, 18세,2019,3275,1609,1666,96.6,3133,1575,1558,101.1
'11140, 마포구,'020005, 19세,2019,4648,2098,2550,82.3,4241,1982,2259,87.7
'11140, 마포구,'025,20~24세,2019,29685,12820,16865,76,26370,11870,14500,81.9
'11140, 마포구,'025001, 20세,2019,4924,2140,2784,76.9,4365,1973,2392,82.5
'11140, 마포구,'025002, 21세,2019,5211,2202,3009,73.2,4581,2019,2562,78.8
'11140, 마포구,'025003, 22세,2019,5935,2518,3417,73.7,5199,2308,2891,79.8
'11140, 마포구,'025004, 23세,2019,6665,2894,3771,76.7,5932,2701,3231,83.6
'11140, 마포구,'025005, 24세,2019,6950,3066,3884,78.9,6293,2869,3424,83.8
'11140, 마포구,'030,25~29세,2019,36087,16593,19494,85.1,33761,15724,18037,87.2
'11140, 마포구,'030001, 25세,2019,7154,3259,3895,83.7,6580,3069,3511,87.4
'11140, 마포구,'030002, 26세,2019,7379,3454,3925,88,6867,3271,3596,91
'11140, 마포구,'030003, 27세,2019,7517,3482,4035,86.3,7077,3300,3777,87.4
'11140, 마포구,'030004, 28세,2019,7259,3343,3916,85.4,6873,3202,3671,87.2
'11140, 마포구,'030005, 29세,2019,6778,3055,3723,82.1,6364,2882,3482,82.8
'11140, 마포구,'035,30~34세,2019,32214,14920,17294,86.3,30522,14112,16410,86
'11140, 마포구,'035001, 30세,2019,6605,3067,3538,86.7,6236,2891,3345,86.4
'11140, 마포구,'035002, 31세,2019,6446,2964,3482,85.1,6088,2803,3285,85.3
'11140, 마포구,'035003, 32세,2019,6394,2871,3523,81.5,6055,2712,3343,81.1
'11140, 마포구,'035004, 33세,2019,6386,2929,3457,84.7,6056,2767,3289,84.1
'11140, 마포구,'035005, 34세,2019,6383,3089,3294,93.8,6087,2939,3148,93.4
'11140, 마포구,'040,35~39세,2019,33136,16279,16857,96.6,31811,15558,16253,95.7
'11140, 마포구,'040001, 35세,2019,6581,3199,3382,94.6,6268,3030,3238,93.6
'11140, 마포구,'040002, 36세,2019,6645,3250,3395,95.7,6370,3099,3271,94.7
'11140, 마포구,'040003, 37세,2019,6935,3403,3532,96.3,6658,3258,3400,95.8
'11140, 마포구,'040004, 38세,2019,6591,3278,3313,98.9,6341,3143,3198,98.3
'11140, 마포구,'040005, 39세,2019,6384,3149,3235,97.3,6174,3028,3146,96.2
'11140, 마포구,'045,40~44세,2019,28687,13949,14738,94.6,27706,13405,14301,93.7
'11140, 마포구,'045001, 40세,2019,6117,2994,3123,95.9,5873,2856,3017,94.7
'11140, 마포구,'045002, 41세,2019,5412,2640,2772,95.2,5206,2528,2678,94.4
'11140, 마포구,'045003, 42세,2019,5729,2738,2991,91.5,5546,2636,2910,90.6
'11140, 마포구,'045004, 43세,2019,5655,2716,2939,92.4,5485,2623,2862,91.6
'11140, 마포구,'045005, 44세,2019,5774,2861,2913,98.2,5596,2762,2834,97.5
'11140, 마포구,'050,45~49세,2019,31497,15528,15969,97.2,30652,15078,15574,96.8
'11140, 마포구,'050001, 45세,2019,6140,3073,3067,100.2,5988,2990,2998,99.7
'11140, 마포구,'050002, 46세,2019,6298,3036,3262,93.1,6116,2931,3185,92
'11140, 마포구,'050003, 47세,2019,6379,3200,3179,100.7,6217,3115,3102,100.4
'11140, 마포구,'050004, 48세,2019,6530,3183,3347,95.1,6343,3077,3266,94.2
'11140, 마포구,'050005, 49세,2019,6150,3036,3114,97.5,5988,2965,3023,98.1
'11140, 마포구,'055,50~54세,2019,27012,13175,13837,95.2,26263,12798,13465,95
'11140, 마포구,'055001, 50세,2019,6020,3010,3010,100,5876,2924,2952,99.1
'11140, 마포구,'055002, 51세,2019,5714,2723,2991,91,5544,2636,2908,90.6
'11140, 마포구,'055003, 52세,2019,5146,2473,2673,92.5,4999,2398,2601,92.2
'11140, 마포구,'055004, 53세,2019,4851,2430,2421,100.4,4715,2364,2351,100.6
'11140, 마포구,'055005, 54세,2019,5281,2539,2742,92.6,5129,2476,2653,93.3
'11140, 마포구,'060,55~59세,2019,25204,12200,13004,93.8,24539,11892,12647,94
'11140, 마포구,'060001, 55세,2019,4790,2311,2479,93.2,4629,2240,2389,93.8
'11140, 마포구,'060002, 56세,2019,5022,2433,2589,94,4861,2364,2497,94.7
'11140, 마포구,'060003, 57세,2019,4886,2403,2483,96.8,4752,2332,2420,96.4
'11140, 마포구,'060004, 58세,2019,5204,2534,2670,94.9,5123,2498,2625,95.2
'11140, 마포구,'060005, 59세,2019,5302,2519,2783,90.5,5174,2458,2716,90.5
'11140, 마포구,'065,60~64세,2019,21889,10174,11715,86.8,21384,9940,11444,86.9
'11140, 마포구,'065001, 60세,2019,4771,2250,2521,89.3,4671,2207,2464,89.6
'11140, 마포구,'065002, 61세,2019,4386,2045,2341,87.4,4265,1993,2272,87.7
'11140, 마포구,'065003, 62세,2019,4496,2054,2442,84.1,4386,1995,2391,83.4
'11140, 마포구,'065004, 63세,2019,4035,1856,2179,85.2,3950,1816,2134,85.1
'11140, 마포구,'065005, 64세,2019,4201,1969,2232,88.2,4112,1929,2183,88.4
'11140, 마포구,'070,65~69세,2019,14793,6684,8109,82.4,14520,6545,7975,82.1
'11140, 마포구,'070001, 65세,2019,3439,1584,1855,85.4,3356,1540,1816,84.8
'11140, 마포구,'070002, 66세,2019,3035,1395,1640,85.1,2977,1368,1609,85
'11140, 마포구,'070003, 67세,2019,3311,1518,1793,84.7,3258,1491,1767,84.4
'11140, 마포구,'070004, 68세,2019,2291,1006,1285,78.3,2250,986,1264,78
'11140, 마포구,'070005, 69세,2019,2717,1181,1536,76.9,2679,1160,1519,76.4
'11140, 마포구,'075,70~74세,2019,12696,5345,7351,72.7,12577,5291,7286,72.6
'11140, 마포구,'075001, 70세,2019,2812,1193,1619,73.7,2784,1174,1610,72.9
'11140, 마포구,'075002, 71세,2019,2757,1168,1589,73.5,2727,1157,1570,73.7
'11140, 마포구,'075003, 72세,2019,2805,1184,1621,73,2778,1177,1601,73.5
'11140, 마포구,'075004, 73세,2019,2116,874,1242,70.4,2101,868,1233,70.4
'11140, 마포구,'075005, 74세,2019,2206,926,1280,72.3,2187,915,1272,71.9
'11140, 마포구,'080,75~79세,2019,10639,4585,6054,75.7,10577,4559,6018,75.8
'11140, 마포구,'080001, 75세,2019,2173,920,1253,73.4,2156,912,1244,73.3
'11140, 마포구,'080002, 76세,2019,2177,963,1214,79.3,2165,958,1207,79.4
'11140, 마포구,'080003, 77세,2019,2561,1123,1438,78.1,2552,1122,1430,78.5
'11140, 마포구,'080004, 78세,2019,1934,831,1103,75.3,1920,825,1095,75.3
'11140, 마포구,'080005, 79세,2019,1794,748,1046,71.5,1784,742,1042,71.2
'11140, 마포구,'085,80~84세,2019,6669,2681,3988,67.2,6638,2671,3967,67.3
'11140, 마포구,'085001, 80세,2019,1655,707,948,74.6,1650,706,944,74.8
'11140, 마포구,'085002, 81세,2019,1431,598,833,71.8,1426,598,828,72.2
'11140, 마포구,'085003, 82세,2019,1396,549,847,64.8,1391,549,842,65.2
'11140, 마포구,'085004, 83세,2019,1143,450,693,64.9,1133,445,688,64.7
'11140, 마포구,'085005, 84세,2019,1044,377,667,56.5,1038,373,665,56.1
'11140, 마포구,'086,85세이상,2019,4065,1337,2728,49,4032,1325,2707,48.9
'11140, 마포구,'090,85~89세,2019,2902,1000,1902,52.6,2882,994,1888,52.6
'11140, 마포구,'090001, 85세,2019,785,260,525,49.5,784,260,524,49.6
'11140, 마포구,'090002, 86세,2019,708,275,433,63.5,703,274,429,63.9
'11140, 마포구,'090003, 87세,2019,581,208,373,55.8,577,206,371,55.5
'11140, 마포구,'090004, 88세,2019,435,141,294,48,432,140,292,47.9
'11140, 마포구,'090005, 89세,2019,393,116,277,41.9,386,114,272,41.9
'11140, 마포구,'095,90~94세,2019,920,270,650,41.5,913,266,647,41.1
'11140, 마포구,'095001, 90세,2019,300,94,206,45.6,299,93,206,45.1
'11140, 마포구,'095002, 91세,2019,245,74,171,43.3,244,73,171,42.7
'11140, 마포구,'095003, 92세,2019,175,48,127,37.8,173,48,125,38.4
'11140, 마포구,'095004, 93세,2019,113,33,80,41.3,112,32,80,40
'11140, 마포구,'095005, 94세,2019,87,21,66,31.8,85,20,65,30.8
'11140, 마포구,'100,95~99세,2019,210,62,148,41.9,206,60,146,41.1
'11140, 마포구,'100001, 95세,2019,64,18,46,39.1,64,18,46,39.1
'11140, 마포구,'100002, 96세,2019,65,21,44,47.7,65,21,44,47.7
'11140, 마포구,'100003, 97세,2019,39,8,31,25.8,39,8,31,25.8
'11140, 마포구,'100004, 98세,2019,23,11,12,91.7,19,9,10,90
'11140, 마포구,'100005, 99세,2019,19,X,15,26.7,19,X,15,26.7
'11140, 마포구,'101,100세이상,2019,33,5,28,17.9,31,5,26,19.2
'11140, 마포구,'102,15세미만,2019,39238,19896,19342,102.9,38497,19512,18985,102.8
'11140, 마포구,'103,15~64세,2019,281227,133365,147862,90.2,268179,127911,140268,91.2
'11140, 마포구,'104,65세이상,2019,48862,20632,28230,73.1,48344,20391,27953,72.9
'11140, 마포구,'126,평균연령,2019,41,40.3,41.5,,41.2,40.5,41.9,
'11140, 마포구,'127,중위연령,2019,39.8,39.6,39.9,,40.2,39.9,40.6,
'11150, 양천구,'000,합계,2019,440354,216078,224276,96.3,434133,213211,220922,96.5
'11150, 양천구,'005,0~4세,2019,13201,6771,6430,105.3,13095,6721,6374,105.4
'11150, 양천구,'005001, 0세,2019,2219,1188,1031,115.2,2204,1181,1023,115.4
'11150, 양천구,'005002, 1세,2019,2237,1128,1109,101.7,2213,1115,1098,101.5
'11150, 양천구,'005003, 2세,2019,2611,1337,1274,104.9,2589,1325,1264,104.8
'11150, 양천구,'005004, 3세,2019,2991,1484,1507,98.5,2959,1472,1487,99
'11150, 양천구,'005005, 4세,2019,3143,1634,1509,108.3,3130,1628,1502,108.4
'11150, 양천구,'010,5~9세,2019,19101,9844,9257,106.3,19013,9803,9210,106.4
'11150, 양천구,'010001, 5세,2019,3330,1685,1645,102.4,3314,1678,1636,102.6
'11150, 양천구,'010002, 6세,2019,3577,1856,1721,107.8,3554,1846,1708,108.1
'11150, 양천구,'010003, 7세,2019,3951,2025,1926,105.1,3935,2017,1918,105.2
'11150, 양천구,'010004, 8세,2019,4046,2103,1943,108.2,4030,2095,1935,108.3
'11150, 양천구,'010005, 9세,2019,4197,2175,2022,107.6,4180,2167,2013,107.7
'11150, 양천구,'015,10~14세,2019,23432,12215,11217,108.9,23374,12188,11186,109
'11150, 양천구,'015001, 10세,2019,4164,2172,1992,109,4152,2166,1986,109.1
'11150, 양천구,'015002, 11세,2019,4711,2439,2272,107.4,4694,2432,2262,107.5
'11150, 양천구,'015003, 12세,2019,5113,2658,2455,108.3,5104,2653,2451,108.2
'11150, 양천구,'015004, 13세,2019,4628,2405,2223,108.2,4617,2400,2217,108.3
'11150, 양천구,'015005, 14세,2019,4816,2541,2275,111.7,4807,2537,2270,111.8
'11150, 양천구,'020,15~19세,2019,25774,13378,12396,107.9,25672,13321,12351,107.9
'11150, 양천구,'020001, 15세,2019,5208,2764,2444,113.1,5197,2758,2439,113.1
'11150, 양천구,'020002, 16세,2019,4857,2487,2370,104.9,4849,2483,2366,104.9
'11150, 양천구,'020003, 17세,2019,5063,2619,2444,107.2,5048,2609,2439,107
'11150, 양천구,'020004, 18세,2019,5485,2832,2653,106.7,5463,2822,2641,106.9
'11150, 양천구,'020005, 19세,2019,5161,2676,2485,107.7,5115,2649,2466,107.4
'11150, 양천구,'025,20~24세,2019,27157,14111,13046,108.2,26734,13946,12788,109.1
'11150, 양천구,'025001, 20세,2019,5203,2786,2417,115.3,5141,2750,2391,115
'11150, 양천구,'025002, 21세,2019,5209,2801,2408,116.3,5146,2778,2368,117.3
'11150, 양천구,'025003, 22세,2019,5419,2852,2567,111.1,5338,2822,2516,112.2
'11150, 양천구,'025004, 23세,2019,5607,2823,2784,101.4,5498,2782,2716,102.4
'11150, 양천구,'025005, 24세,2019,5719,2849,2870,99.3,5611,2814,2797,100.6
'11150, 양천구,'030,25~29세,2019,29182,14578,14604,99.8,28540,14289,14251,100.3
'11150, 양천구,'030001, 25세,2019,5931,2931,3000,97.7,5810,2877,2933,98.1
'11150, 양천구,'030002, 26세,2019,5986,3000,2986,100.5,5876,2954,2922,101.1
'11150, 양천구,'030003, 27세,2019,5978,2975,3003,99.1,5849,2922,2927,99.8
'11150, 양천구,'030004, 28세,2019,5864,2916,2948,98.9,5723,2854,2869,99.5
'11150, 양천구,'030005, 29세,2019,5423,2756,2667,103.3,5282,2682,2600,103.2
'11150, 양천구,'035,30~34세,2019,26089,12969,13120,98.8,25265,12569,12696,99
'11150, 양천구,'035001, 30세,2019,5298,2628,2670,98.4,5115,2537,2578,98.4
'11150, 양천구,'035002, 31세,2019,5099,2524,2575,98,4951,2459,2492,98.7
'11150, 양천구,'035003, 32세,2019,5089,2488,2601,95.7,4901,2389,2512,95.1
'11150, 양천구,'035004, 33세,2019,5270,2671,2599,102.8,5105,2599,2506,103.7
'11150, 양천구,'035005, 34세,2019,5333,2658,2675,99.4,5193,2585,2608,99.1
'11150, 양천구,'040,35~39세,2019,32025,15697,16328,96.1,31424,15395,16029,96
'11150, 양천구,'040001, 35세,2019,5637,2804,2833,99,5490,2736,2754,99.3
'11150, 양천구,'040002, 36세,2019,6133,3022,3111,97.1,6003,2956,3047,97
'11150, 양천구,'040003, 37세,2019,6580,3235,3345,96.7,6459,3174,3285,96.6
'11150, 양천구,'040004, 38세,2019,6715,3256,3459,94.1,6620,3207,3413,94
'11150, 양천구,'040005, 39세,2019,6960,3380,3580,94.4,6852,3322,3530,94.1
'11150, 양천구,'045,40~44세,2019,34663,16286,18377,88.6,34136,16057,18079,88.8
'11150, 양천구,'045001, 40세,2019,6956,3312,3644,90.9,6836,3262,3574,91.3
'11150, 양천구,'045002, 41세,2019,6519,3040,3479,87.4,6419,2999,3420,87.7
'11150, 양천구,'045003, 42세,2019,6815,3177,3638,87.3,6700,3128,3572,87.6
'11150, 양천구,'045004, 43세,2019,6947,3311,3636,91.1,6858,3271,3587,91.2
'11150, 양천구,'045005, 44세,2019,7426,3446,3980,86.6,7323,3397,3926,86.5
'11150, 양천구,'050,45~49세,2019,43431,21020,22411,93.8,42801,20704,22097,93.7
'11150, 양천구,'050001, 45세,2019,8268,4005,4263,93.9,8153,3947,4206,93.8
'11150, 양천구,'050002, 46세,2019,8429,4009,4420,90.7,8317,3952,4365,90.5
'11150, 양천구,'050003, 47세,2019,8582,4124,4458,92.5,8450,4059,4391,92.4
'11150, 양천구,'050004, 48세,2019,9341,4603,4738,97.2,9203,4535,4668,97.2
'11150, 양천구,'050005, 49세,2019,8811,4279,4532,94.4,8678,4211,4467,94.3
'11150, 양천구,'055,50~54세,2019,39440,19547,19893,98.3,38809,19263,19546,98.6
'11150, 양천구,'055001, 50세,2019,8831,4425,4406,100.4,8708,4365,4343,100.5
'11150, 양천구,'055002, 51세,2019,8333,4126,4207,98.1,8203,4065,4138,98.2
'11150, 양천구,'055003, 52세,2019,7543,3704,3839,96.5,7429,3647,3782,96.4
'11150, 양천구,'055004, 53세,2019,7285,3662,3623,101.1,7159,3611,3548,101.8
'11150, 양천구,'055005, 54세,2019,7448,3630,3818,95.1,7310,3575,3735,95.7
'11150, 양천구,'060,55~59세,2019,36506,18075,18431,98.1,35890,17788,18102,98.3
'11150, 양천구,'060001, 55세,2019,7005,3505,3500,100.1,6872,3449,3423,100.8
'11150, 양천구,'060002, 56세,2019,7230,3602,3628,99.3,7071,3535,3536,100
'11150, 양천구,'060003, 57세,2019,7177,3619,3558,101.7,7062,3555,3507,101.4
'11150, 양천구,'060004, 58세,2019,7567,3699,3868,95.6,7479,3654,3825,95.5
'11150, 양천구,'060005, 59세,2019,7527,3650,3877,94.1,7406,3595,3811,94.3
'11150, 양천구,'065,60~64세,2019,31605,15134,16471,91.9,31110,14909,16201,92
'11150, 양천구,'065001, 60세,2019,6820,3290,3530,93.2,6708,3233,3475,93
'11150, 양천구,'065002, 61세,2019,6449,3095,3354,92.3,6349,3050,3299,92.5
'11150, 양천구,'065003, 62세,2019,6338,3038,3300,92.1,6244,2999,3245,92.4
'11150, 양천구,'065004, 63세,2019,5777,2722,3055,89.1,5684,2682,3002,89.3
'11150, 양천구,'065005, 64세,2019,6221,2989,3232,92.5,6125,2945,3180,92.6
'11150, 양천구,'070,65~69세,2019,21513,10503,11010,95.4,21248,10387,10861,95.6
'11150, 양천구,'070001, 65세,2019,5044,2480,2564,96.7,4964,2446,2518,97.1
'11150, 양천구,'070002, 66세,2019,4483,2152,2331,92.3,4442,2139,2303,92.9
'11150, 양천구,'070003, 67세,2019,4787,2326,2461,94.5,4729,2297,2432,94.4
'11150, 양천구,'070004, 68세,2019,3411,1659,1752,94.7,3368,1641,1727,95
'11150, 양천구,'070005, 69세,2019,3788,1886,1902,99.2,3745,1864,1881,99.1
'11150, 양천구,'075,70~74세,2019,15498,7405,8093,91.5,15382,7362,8020,91.8
'11150, 양천구,'075001, 70세,2019,3682,1768,1914,92.4,3648,1757,1891,92.9
'11150, 양천구,'075002, 71세,2019,3484,1688,1796,94,3455,1680,1775,94.6
'11150, 양천구,'075003, 72세,2019,3401,1637,1764,92.8,3374,1622,1752,92.6
'11150, 양천구,'075004, 73세,2019,2572,1218,1354,90,2555,1212,1343,90.2
'11150, 양천구,'075005, 74세,2019,2359,1094,1265,86.5,2350,1091,1259,86.7
'11150, 양천구,'080,75~79세,2019,10824,4887,5937,82.3,10778,4873,5905,82.5
'11150, 양천구,'080001, 75세,2019,2351,1083,1268,85.4,2337,1079,1258,85.8
'11150, 양천구,'080002, 76세,2019,2292,1083,1209,89.6,2282,1079,1203,89.7
'11150, 양천구,'080003, 77세,2019,2488,1106,1382,80,2483,1104,1379,80.1
'11150, 양천구,'080004, 78세,2019,1988,913,1075,84.9,1980,912,1068,85.4
'11150, 양천구,'080005, 79세,2019,1705,702,1003,70,1696,699,997,70.1
'11150, 양천구,'085,80~84세,2019,6505,2415,4090,59,6472,2402,4070,59
'11150, 양천구,'085001, 80세,2019,1647,671,976,68.8,1639,666,973,68.4
'11150, 양천구,'085002, 81세,2019,1421,575,846,68,1416,573,843,68
'11150, 양천구,'085003, 82세,2019,1334,466,868,53.7,1328,464,864,53.7
'11150, 양천구,'085004, 83세,2019,1097,373,724,51.5,1091,372,719,51.7
'11150, 양천구,'085005, 84세,2019,1006,330,676,48.8,998,327,671,48.7
'11150, 양천구,'086,85세이상,2019,4408,1243,3165,39.3,4390,1234,3156,39.1
'11150, 양천구,'090,85~89세,2019,3074,890,2184,40.8,3060,884,2176,40.6
'11150, 양천구,'090001, 85세,2019,832,268,564,47.5,828,267,561,47.6
'11150, 양천구,'090002, 86세,2019,744,235,509,46.2,741,233,508,45.9
'11150, 양천구,'090003, 87세,2019,616,181,435,41.6,616,181,435,41.6
'11150, 양천구,'090004, 88세,2019,462,111,351,31.6,458,109,349,31.2
'11150, 양천구,'090005, 89세,2019,420,95,325,29.2,417,94,323,29.1
'11150, 양천구,'095,90~94세,2019,1054,289,765,37.8,1052,288,764,37.7
'11150, 양천구,'095001, 90세,2019,336,99,237,41.8,336,99,237,41.8
'11150, 양천구,'095002, 91세,2019,274,86,188,45.7,272,85,187,45.5
'11150, 양천구,'095003, 92세,2019,186,58,128,45.3,186,58,128,45.3
'11150, 양천구,'095004, 93세,2019,145,21,124,16.9,145,21,124,16.9
'11150, 양천구,'095005, 94세,2019,113,25,88,28.4,113,25,88,28.4
'11150, 양천구,'100,95~99세,2019,244,54,190,28.4,243,53,190,27.9
'11150, 양천구,'100001, 95세,2019,60,10,50,20,60,10,50,20
'11150, 양천구,'100002, 96세,2019,89,24,65,36.9,89,24,65,36.9
'11150, 양천구,'100003, 97세,2019,49,8,41,19.5,49,8,41,19.5
'11150, 양천구,'100004, 98세,2019,26,7,19,36.8,26,7,19,36.8
'11150, 양천구,'100005, 99세,2019,20,5,15,33.3,19,X,15,26.7
'11150, 양천구,'101,100세이상,2019,36,10,26,38.5,35,9,26,34.6
'11150, 양천구,'102,15세미만,2019,55734,28830,26904,107.2,55482,28712,26770,107.3
'11150, 양천구,'103,15~64세,2019,325872,160795,165077,97.4,320381,158241,162140,97.6
'11150, 양천구,'104,65세이상,2019,58748,26453,32295,81.9,58270,26258,32012,82
'11150, 양천구,'126,평균연령,2019,41.8,40.9,42.7,,41.8,40.9,42.6,
'11150, 양천구,'127,중위연령,2019,43.6,42.7,44.3,,43.6,42.7,44.4,
'11160, 강서구,'000,합계,2019,574097,277365,296732,93.5,565054,273209,291845,93.6
'11160, 강서구,'005,0~4세,2019,20971,10769,10202,105.6,20723,10644,10079,105.6
'11160, 강서구,'005001, 0세,2019,3796,1990,1806,110.2,3751,1967,1784,110.3
'11160, 강서구,'005002, 1세,2019,3822,1960,1862,105.3,3779,1937,1842,105.2
'11160, 강서구,'005003, 2세,2019,4050,2075,1975,105.1,3999,2051,1948,105.3
'11160, 강서구,'005004, 3세,2019,4648,2389,2259,105.8,4598,2366,2232,106
'11160, 강서구,'005005, 4세,2019,4655,2355,2300,102.4,4596,2323,2273,102.2
'11160, 강서구,'010,5~9세,2019,22443,11480,10963,104.7,22312,11421,10891,104.9
'11160, 강서구,'010001, 5세,2019,4488,2254,2234,100.9,4455,2235,2220,100.7
'11160, 강서구,'010002, 6세,2019,4500,2290,2210,103.6,4475,2280,2195,103.9
'11160, 강서구,'010003, 7세,2019,4789,2462,2327,105.8,4762,2449,2313,105.9
'11160, 강서구,'010004, 8세,2019,4460,2297,2163,106.2,4436,2290,2146,106.7
'11160, 강서구,'010005, 9세,2019,4206,2177,2029,107.3,4184,2167,2017,107.4
'11160, 강서구,'015,10~14세,2019,20706,10582,10124,104.5,20630,10543,10087,104.5
'11160, 강서구,'015001, 10세,2019,4012,2075,1937,107.1,3992,2061,1931,106.7
'11160, 강서구,'015002, 11세,2019,4412,2224,2188,101.6,4390,2213,2177,101.7
'11160, 강서구,'015003, 12세,2019,4332,2220,2112,105.1,4320,2214,2106,105.1
'11160, 강서구,'015004, 13세,2019,4015,2067,1948,106.1,4006,2063,1943,106.2
'11160, 강서구,'015005, 14세,2019,3935,1996,1939,102.9,3922,1992,1930,103.2
'11160, 강서구,'020,15~19세,2019,24423,12230,12193,100.3,24312,12178,12134,100.4
'11160, 강서구,'020001, 15세,2019,4425,2263,2162,104.7,4412,2256,2156,104.6
'11160, 강서구,'020002, 16세,2019,4547,2251,2296,98,4537,2249,2288,98.3
'11160, 강서구,'020003, 17세,2019,4702,2361,2341,100.9,4688,2354,2334,100.9
'11160, 강서구,'020004, 18세,2019,5183,2590,2593,99.9,5158,2579,2579,100
'11160, 강서구,'020005, 19세,2019,5566,2765,2801,98.7,5517,2740,2777,98.7
'11160, 강서구,'025,20~24세,2019,32955,15712,17243,91.1,32492,15501,16991,91.2
'11160, 강서구,'025001, 20세,2019,5506,2787,2719,102.5,5443,2752,2691,102.3
'11160, 강서구,'025002, 21세,2019,5787,2996,2791,107.3,5710,2961,2749,107.7
'11160, 강서구,'025003, 22세,2019,6452,3089,3363,91.9,6367,3051,3316,92
'11160, 강서구,'025004, 23세,2019,7106,3267,3839,85.1,7004,3221,3783,85.1
'11160, 강서구,'025005, 24세,2019,8104,3573,4531,78.9,7968,3516,4452,79
'11160, 강서구,'030,25~29세,2019,50078,23179,26899,86.2,49030,22723,26307,86.4
'11160, 강서구,'030001, 25세,2019,8950,3916,5034,77.8,8787,3862,4925,78.4
'11160, 강서구,'030002, 26세,2019,9899,4497,5402,83.2,9693,4409,5284,83.4
'11160, 강서구,'030003, 27세,2019,10568,4897,5671,86.4,10366,4813,5553,86.7
'11160, 강서구,'030004, 28세,2019,10428,4877,5551,87.9,10218,4787,5431,88.1
'11160, 강서구,'030005, 29세,2019,10233,4992,5241,95.2,9966,4852,5114,94.9
'11160, 강서구,'035,30~34세,2019,48967,24354,24613,98.9,47634,23753,23881,99.5
'11160, 강서구,'035001, 30세,2019,9833,4814,5019,95.9,9592,4711,4881,96.5
'11160, 강서구,'035002, 31세,2019,9864,4822,5042,95.6,9591,4697,4894,96
'11160, 강서구,'035003, 32세,2019,9713,4871,4842,100.6,9422,4730,4692,100.8
'11160, 강서구,'035004, 33세,2019,9790,4862,4928,98.7,9518,4749,4769,99.6
'11160, 강서구,'035005, 34세,2019,9767,4985,4782,104.2,9511,4866,4645,104.8
'11160, 강서구,'040,35~39세,2019,52180,26851,25329,106,51172,26373,24799,106.3
'11160, 강서구,'040001, 35세,2019,9769,5006,4763,105.1,9527,4889,4638,105.4
'11160, 강서구,'040002, 36세,2019,10520,5443,5077,107.2,10313,5347,4966,107.7
'11160, 강서구,'040003, 37세,2019,10923,5555,5368,103.5,10724,5452,5272,103.4
'11160, 강서구,'040004, 38세,2019,10543,5553,4990,111.3,10351,5470,4881,112.1
'11160, 강서구,'040005, 39세,2019,10425,5294,5131,103.2,10257,5215,5042,103.4
'11160, 강서구,'045,40~44세,2019,43845,22096,21749,101.6,43142,21744,21398,101.6
'11160, 강서구,'045001, 40세,2019,9870,5037,4833,104.2,9703,4960,4743,104.6
'11160, 강서구,'045002, 41세,2019,8488,4255,4233,100.5,8326,4169,4157,100.3
'11160, 강서구,'045003, 42세,2019,8674,4389,4285,102.4,8546,4325,4221,102.5
'11160, 강서구,'045004, 43세,2019,8224,4116,4108,100.2,8096,4046,4050,99.9
'11160, 강서구,'045005, 44세,2019,8589,4299,4290,100.2,8471,4244,4227,100.4
'11160, 강서구,'050,45~49세,2019,46027,22956,23071,99.5,45277,22598,22679,99.6
'11160, 강서구,'050001, 45세,2019,9355,4647,4708,98.7,9242,4590,4652,98.7
'11160, 강서구,'050002, 46세,2019,9274,4712,4562,103.3,9123,4636,4487,103.3
'11160, 강서구,'050003, 47세,2019,9072,4549,4523,100.6,8911,4487,4424,101.4
'11160, 강서구,'050004, 48세,2019,9372,4651,4721,98.5,9216,4561,4655,98
'11160, 강서구,'050005, 49세,2019,8954,4397,4557,96.5,8785,4324,4461,96.9
'11160, 강서구,'055,50~54세,2019,42383,20264,22119,91.6,41559,19891,21668,91.8
'11160, 강서구,'055001, 50세,2019,8981,4415,4566,96.7,8837,4349,4488,96.9
'11160, 강서구,'055002, 51세,2019,8839,4234,4605,91.9,8674,4161,4513,92.2
'11160, 강서구,'055003, 52세,2019,8087,3828,4259,89.9,7946,3761,4185,89.9
'11160, 강서구,'055004, 53세,2019,7984,3782,4202,90,7800,3701,4099,90.3
'11160, 강서구,'055005, 54세,2019,8492,4005,4487,89.3,8302,3919,4383,89.4
'11160, 강서구,'060,55~59세,2019,45340,21177,24163,87.6,44462,20782,23680,87.8
'11160, 강서구,'060001, 55세,2019,7952,3701,4251,87.1,7761,3618,4143,87.3
'11160, 강서구,'060002, 56세,2019,8691,4126,4565,90.4,8468,4033,4435,90.9
'11160, 강서구,'060003, 57세,2019,8926,4248,4678,90.8,8740,4161,4579,90.9
'11160, 강서구,'060004, 58세,2019,9838,4538,5300,85.6,9719,4486,5233,85.7
'11160, 강서구,'060005, 59세,2019,9933,4564,5369,85,9774,4484,5290,84.8
'11160, 강서구,'065,60~64세,2019,42996,19894,23102,86.1,42240,19539,22701,86.1
'11160, 강서구,'065001, 60세,2019,9263,4361,4902,89,9118,4291,4827,88.9
'11160, 강서구,'065002, 61세,2019,8720,4023,4697,85.7,8559,3956,4603,85.9
'11160, 강서구,'065003, 62세,2019,8790,4104,4686,87.6,8615,4023,4592,87.6
'11160, 강서구,'065004, 63세,2019,7859,3632,4227,85.9,7716,3559,4157,85.6
'11160, 강서구,'065005, 64세,2019,8364,3774,4590,82.2,8232,3710,4522,82
'11160, 강서구,'070,65~69세,2019,29173,13733,15440,88.9,28753,13540,15213,89
'11160, 강서구,'070001, 65세,2019,6791,3122,3669,85.1,6662,3067,3595,85.3
'11160, 강서구,'070002, 66세,2019,6147,2922,3225,90.6,6058,2876,3182,90.4
'11160, 강서구,'070003, 67세,2019,6492,3067,3425,89.5,6417,3031,3386,89.5
'11160, 강서구,'070004, 68세,2019,4554,2160,2394,90.2,4485,2128,2357,90.3
'11160, 강서구,'070005, 69세,2019,5189,2462,2727,90.3,5131,2438,2693,90.5
'11160, 강서구,'075,70~74세,2019,21766,10463,11303,92.6,21620,10409,11211,92.8
'11160, 강서구,'075001, 70세,2019,5127,2452,2675,91.7,5084,2436,2648,92
'11160, 강서구,'075002, 71세,2019,4820,2330,2490,93.6,4796,2321,2475,93.8
'11160, 강서구,'075003, 72세,2019,4867,2327,2540,91.6,4833,2315,2518,91.9
'11160, 강서구,'075004, 73세,2019,3564,1728,1836,94.1,3544,1721,1823,94.4
'11160, 강서구,'075005, 74세,2019,3388,1626,1762,92.3,3363,1616,1747,92.5
'11160, 강서구,'080,75~79세,2019,14687,6608,8079,81.8,14614,6578,8036,81.9
'11160, 강서구,'080001, 75세,2019,3168,1512,1656,91.3,3147,1502,1645,91.3
'11160, 강서구,'080002, 76세,2019,3006,1369,1637,83.6,2990,1364,1626,83.9
'11160, 강서구,'080003, 77세,2019,3409,1552,1857,83.6,3398,1546,1852,83.5
'11160, 강서구,'080004, 78세,2019,2655,1130,1525,74.1,2648,1126,1522,74
'11160, 강서구,'080005, 79세,2019,2449,1045,1404,74.4,2431,1040,1391,74.8
'11160, 강서구,'085,80~84세,2019,8915,3284,5631,58.3,8879,3271,5608,58.3
'11160, 강서구,'085001, 80세,2019,2304,898,1406,63.9,2291,894,1397,64
'11160, 강서구,'085002, 81세,2019,1960,776,1184,65.5,1957,776,1181,65.7
'11160, 강서구,'085003, 82세,2019,1701,593,1108,53.5,1693,592,1101,53.8
'11160, 강서구,'085004, 83세,2019,1482,511,971,52.6,1474,507,967,52.4
'11160, 강서구,'085005, 84세,2019,1468,506,962,52.6,1464,502,962,52.2
'11160, 강서구,'086,85세이상,2019,6242,1733,4509,38.4,6203,1721,4482,38.4
'11160, 강서구,'090,85~89세,2019,4226,1261,2965,42.5,4196,1251,2945,42.5
'11160, 강서구,'090001, 85세,2019,1118,356,762,46.7,1113,354,759,46.6
'11160, 강서구,'090002, 86세,2019,1006,324,682,47.5,998,322,676,47.6
'11160, 강서구,'090003, 87세,2019,832,243,589,41.3,827,242,585,41.4
'11160, 강서구,'090004, 88세,2019,637,180,457,39.4,629,176,453,38.9
'11160, 강서구,'090005, 89세,2019,633,158,475,33.3,629,157,472,33.3
'11160, 강서구,'095,90~94세,2019,1622,367,1255,29.2,1615,366,1249,29.3
'11160, 강서구,'095001, 90세,2019,532,129,403,32,531,129,402,32.1
'11160, 강서구,'095002, 91세,2019,399,79,320,24.7,397,78,319,24.5
'11160, 강서구,'095003, 92세,2019,320,82,238,34.5,319,82,237,34.6
'11160, 강서구,'095004, 93세,2019,212,40,172,23.3,210,40,170,23.5
'11160, 강서구,'095005, 94세,2019,159,37,122,30.3,158,37,121,30.6
'11160, 강서구,'100,95~99세,2019,354,97,257,37.7,352,96,256,37.5
'11160, 강서구,'100001, 95세,2019,126,38,88,43.2,124,37,87,42.5
'11160, 강서구,'100002, 96세,2019,92,22,70,31.4,92,22,70,31.4
'11160, 강서구,'100003, 97세,2019,68,14,54,25.9,68,14,54,25.9
'11160, 강서구,'100004, 98세,2019,42,13,29,44.8,42,13,29,44.8
'11160, 강서구,'100005, 99세,2019,26,10,16,62.5,26,10,16,62.5
'11160, 강서구,'101,100세이상,2019,40,8,32,25,40,8,32,25
'11160, 강서구,'102,15세미만,2019,64120,32831,31289,104.9,63665,32608,31057,105
'11160, 강서구,'103,15~64세,2019,429194,208713,220481,94.7,421320,205082,216238,94.8
'11160, 강서구,'104,65세이상,2019,80783,35821,44962,79.7,80069,35519,44550,79.7
'11160, 강서구,'126,평균연령,2019,42,41.2,42.8,,42,41.2,42.8,
'11160, 강서구,'127,중위연령,2019,41.5,40.7,42.4,,41.5,40.7,42.4,
'11170, 구로구,'000,합계,2019,435560,217373,218187,99.6,389524,192276,197248,97.5
'11170, 구로구,'005,0~4세,2019,15426,7867,7559,104.1,14240,7288,6952,104.8
'11170, 구로구,'005001, 0세,2019,2755,1413,1342,105.3,2512,1297,1215,106.7
'11170, 구로구,'005002, 1세,2019,2955,1543,1412,109.3,2740,1439,1301,110.6
'11170, 구로구,'005003, 2세,2019,3077,1564,1513,103.4,2794,1429,1365,104.7
'11170, 구로구,'005004, 3세,2019,3289,1685,1604,105,3043,1554,1489,104.4
'11170, 구로구,'005005, 4세,2019,3350,1662,1688,98.5,3151,1569,1582,99.2
'11170, 구로구,'010,5~9세,2019,16224,8256,7968,103.6,15489,7862,7627,103.1
'11170, 구로구,'010001, 5세,2019,3191,1656,1535,107.9,3027,1564,1463,106.9
'11170, 구로구,'010002, 6세,2019,3338,1695,1643,103.2,3147,1605,1542,104.1
'11170, 구로구,'010003, 7세,2019,3317,1651,1666,99.1,3155,1563,1592,98.2
'11170, 구로구,'010004, 8세,2019,3242,1631,1611,101.2,3133,1574,1559,101
'11170, 구로구,'010005, 9세,2019,3136,1623,1513,107.3,3027,1556,1471,105.8
'11170, 구로구,'015,10~14세,2019,14346,7352,6994,105.1,13905,7135,6770,105.4
'11170, 구로구,'015001, 10세,2019,2926,1460,1466,99.6,2831,1416,1415,100.1
'11170, 구로구,'015002, 11세,2019,3036,1529,1507,101.5,2939,1478,1461,101.2
'11170, 구로구,'015003, 12세,2019,3020,1513,1507,100.4,2906,1463,1443,101.4
'11170, 구로구,'015004, 13세,2019,2773,1451,1322,109.8,2707,1422,1285,110.7
'11170, 구로구,'015005, 14세,2019,2591,1399,1192,117.4,2522,1356,1166,116.3
'11170, 구로구,'020,15~19세,2019,16547,8671,7876,110.1,16128,8457,7671,110.2
'11170, 구로구,'020001, 15세,2019,2880,1498,1382,108.4,2814,1457,1357,107.4
'11170, 구로구,'020002, 16세,2019,2995,1585,1410,112.4,2949,1563,1386,112.8
'11170, 구로구,'020003, 17세,2019,3200,1724,1476,116.8,3142,1686,1456,115.8
'11170, 구로구,'020004, 18세,2019,3570,1936,1634,118.5,3494,1896,1598,118.6
'11170, 구로구,'020005, 19세,2019,3902,1928,1974,97.7,3729,1855,1874,99
'11170, 구로구,'025,20~24세,2019,23721,11641,12080,96.4,22418,11020,11398,96.7
'11170, 구로구,'025001, 20세,2019,3900,1989,1911,104.1,3712,1894,1818,104.2
'11170, 구로구,'025002, 21세,2019,4306,2259,2047,110.4,4080,2148,1932,111.2
'11170, 구로구,'025003, 22세,2019,4690,2326,2364,98.4,4440,2204,2236,98.6
'11170, 구로구,'025004, 23세,2019,5188,2439,2749,88.7,4895,2292,2603,88.1
'11170, 구로구,'025005, 24세,2019,5637,2628,3009,87.3,5291,2482,2809,88.4
'11170, 구로구,'030,25~29세,2019,33061,16241,16820,96.6,30072,14761,15311,96.4
'11170, 구로구,'030001, 25세,2019,6192,3024,3168,95.5,5779,2822,2957,95.4
'11170, 구로구,'030002, 26세,2019,6450,3147,3303,95.3,5975,2920,3055,95.6
'11170, 구로구,'030003, 27세,2019,6883,3367,3516,95.8,6253,3055,3198,95.5
'11170, 구로구,'030004, 28세,2019,6719,3315,3404,97.4,6084,3000,3084,97.3
'11170, 구로구,'030005, 29세,2019,6817,3388,3429,98.8,5981,2964,3017,98.2
'11170, 구로구,'035,30~34세,2019,33550,17034,16516,103.1,28929,14579,14350,101.6
'11170, 구로구,'035001, 30세,2019,6638,3345,3293,101.6,5771,2902,2869,101.2
'11170, 구로구,'035002, 31세,2019,6695,3395,3300,102.9,5776,2911,2865,101.6
'11170, 구로구,'035003, 32세,2019,6897,3414,3483,98,5862,2883,2979,96.8
'11170, 구로구,'035004, 33세,2019,6709,3432,3277,104.7,5739,2902,2837,102.3
'11170, 구로구,'035005, 34세,2019,6611,3448,3163,109,5781,2981,2800,106.5
'11170, 구로구,'040,35~39세,2019,36930,19287,17643,109.3,33119,17037,16082,105.9
'11170, 구로구,'040001, 35세,2019,6895,3566,3329,107.1,6073,3087,2986,103.4
'11170, 구로구,'040002, 36세,2019,7390,3928,3462,113.5,6549,3429,3120,109.9
'11170, 구로구,'040003, 37세,2019,7730,4052,3678,110.2,6886,3552,3334,106.5
'11170, 구로구,'040004, 38세,2019,7454,3874,3580,108.2,6818,3491,3327,104.9
'11170, 구로구,'040005, 39세,2019,7461,3867,3594,107.6,6793,3478,3315,104.9
'11170, 구로구,'045,40~44세,2019,32844,17434,15410,113.1,29421,15258,14163,107.7
'11170, 구로구,'045001, 40세,2019,7173,3811,3362,113.4,6442,3341,3101,107.7
'11170, 구로구,'045002, 41세,2019,6464,3429,3035,113,5726,2972,2754,107.9
'11170, 구로구,'045003, 42세,2019,6420,3430,2990,114.7,5803,3043,2760,110.3
'11170, 구로구,'045004, 43세,2019,6419,3355,3064,109.5,5738,2910,2828,102.9
'11170, 구로구,'045005, 44세,2019,6368,3409,2959,115.2,5712,2992,2720,110
'11170, 구로구,'050,45~49세,2019,36697,19182,17515,109.5,31765,16226,15539,104.4
'11170, 구로구,'050001, 45세,2019,7059,3717,3342,111.2,6279,3214,3065,104.9
'11170, 구로구,'050002, 46세,2019,7285,3864,3421,112.9,6380,3296,3084,106.9
'11170, 구로구,'050003, 47세,2019,7252,3847,3405,113,6287,3246,3041,106.7
'11170, 구로구,'050004, 48세,2019,7628,3958,3670,107.8,6539,3353,3186,105.2
'11170, 구로구,'050005, 49세,2019,7473,3796,3677,103.2,6280,3117,3163,98.5
'11170, 구로구,'055,50~54세,2019,35888,18099,17789,101.7,29898,14670,15228,96.3
'11170, 구로구,'055001, 50세,2019,7421,3746,3675,101.9,6262,3070,3192,96.2
'11170, 구로구,'055002, 51세,2019,7349,3627,3722,97.4,6169,2932,3237,90.6
'11170, 구로구,'055003, 52세,2019,6897,3510,3387,103.6,5863,2929,2934,99.8
'11170, 구로구,'055004, 53세,2019,6826,3492,3334,104.7,5633,2784,2849,97.7
'11170, 구로구,'055005, 54세,2019,7395,3724,3671,101.4,5971,2955,3016,98
'11170, 구로구,'060,55~59세,2019,38244,18889,19355,97.6,31522,15254,16268,93.8
'11170, 구로구,'060001, 55세,2019,7153,3577,3576,100,5664,2782,2882,96.5
'11170, 구로구,'060002, 56세,2019,7734,3887,3847,101,5980,2935,3045,96.4
'11170, 구로구,'060003, 57세,2019,7496,3724,3772,98.7,6159,3006,3153,95.3
'11170, 구로구,'060004, 58세,2019,7565,3706,3859,96,6776,3290,3486,94.4
'11170, 구로구,'060005, 59세,2019,8296,3995,4301,92.9,6943,3241,3702,87.5
'11170, 구로구,'065,60~64세,2019,35090,16877,18213,92.7,29759,14027,15732,89.2
'11170, 구로구,'065001, 60세,2019,7428,3606,3822,94.3,6315,2979,3336,89.3
'11170, 구로구,'065002, 61세,2019,7174,3494,3680,94.9,5990,2871,3119,92
'11170, 구로구,'065003, 62세,2019,7219,3496,3723,93.9,6008,2843,3165,89.8
'11170, 구로구,'065004, 63세,2019,6505,3050,3455,88.3,5537,2558,2979,85.9
'11170, 구로구,'065005, 64세,2019,6764,3231,3533,91.5,5909,2776,3133,88.6
'11170, 구로구,'070,65~69세,2019,24449,11593,12856,90.2,21842,10280,11562,88.9
'11170, 구로구,'070001, 65세,2019,5832,2767,3065,90.3,5009,2343,2666,87.9
'11170, 구로구,'070002, 66세,2019,5208,2435,2773,87.8,4614,2138,2476,86.3
'11170, 구로구,'070003, 67세,2019,5197,2471,2726,90.6,4689,2223,2466,90.1
'11170, 구로구,'070004, 68세,2019,3907,1852,2055,90.1,3541,1680,1861,90.3
'11170, 구로구,'070005, 69세,2019,4305,2068,2237,92.4,3989,1896,2093,90.6
'11170, 구로구,'075,70~74세,2019,18075,8727,9348,93.4,17284,8394,8890,94.4
'11170, 구로구,'075001, 70세,2019,4280,2057,2223,92.5,4012,1924,2088,92.1
'11170, 구로구,'075002, 71세,2019,3930,1934,1996,96.9,3760,1868,1892,98.7
'11170, 구로구,'075003, 72세,2019,4055,1987,2068,96.1,3901,1920,1981,96.9
'11170, 구로구,'075004, 73세,2019,2990,1414,1576,89.7,2874,1371,1503,91.2
'11170, 구로구,'075005, 74세,2019,2820,1335,1485,89.9,2737,1311,1426,91.9
'11170, 구로구,'080,75~79세,2019,12823,5914,6909,85.6,12458,5814,6644,87.5
'11170, 구로구,'080001, 75세,2019,2753,1314,1439,91.3,2668,1283,1385,92.6
'11170, 구로구,'080002, 76세,2019,2703,1248,1455,85.8,2631,1233,1398,88.2
'11170, 구로구,'080003, 77세,2019,3067,1416,1651,85.8,2987,1391,1596,87.2
'11170, 구로구,'080004, 78세,2019,2274,1067,1207,88.4,2218,1051,1167,90.1
'11170, 구로구,'080005, 79세,2019,2026,869,1157,75.1,1954,856,1098,78
'11170, 구로구,'085,80~84세,2019,7428,3050,4378,69.7,7174,2988,4186,71.4
'11170, 구로구,'085001, 80세,2019,1950,852,1098,77.6,1877,837,1040,80.5
'11170, 구로구,'085002, 81세,2019,1708,705,1003,70.3,1649,688,961,71.6
'11170, 구로구,'085003, 82세,2019,1399,582,817,71.2,1355,571,784,72.8
'11170, 구로구,'085004, 83세,2019,1226,501,725,69.1,1180,489,691,70.8
'11170, 구로구,'085005, 84세,2019,1145,410,735,55.8,1113,403,710,56.8
'11170, 구로구,'086,85세이상,2019,4217,1259,2958,42.6,4101,1226,2875,42.6
'11170, 구로구,'090,85~89세,2019,3001,978,2023,48.3,2913,954,1959,48.7
'11170, 구로구,'090001, 85세,2019,864,286,578,49.5,836,279,557,50.1
'11170, 구로구,'090002, 86세,2019,730,277,453,61.1,713,269,444,60.6
'11170, 구로구,'090003, 87세,2019,574,185,389,47.6,555,180,375,48
'11170, 구로구,'090004, 88세,2019,435,123,312,39.4,420,121,299,40.5
'11170, 구로구,'090005, 89세,2019,398,107,291,36.8,389,105,284,37
'11170, 구로구,'095,90~94세,2019,976,224,752,29.8,955,217,738,29.4
'11170, 구로구,'095001, 90세,2019,311,85,226,37.6,303,84,219,38.4
'11170, 구로구,'095002, 91세,2019,255,57,198,28.8,248,54,194,27.8
'11170, 구로구,'095003, 92세,2019,185,41,144,28.5,182,39,143,27.3
'11170, 구로구,'095004, 93세,2019,136,26,110,23.6,134,25,109,22.9
'11170, 구로구,'095005, 94세,2019,89,15,74,20.3,88,15,73,20.5
'11170, 구로구,'100,95~99세,2019,223,55,168,32.7,216,53,163,32.5
'11170, 구로구,'100001, 95세,2019,63,15,48,31.3,61,15,46,32.6
'11170, 구로구,'100002, 96세,2019,73,20,53,37.7,70,18,52,34.6
'11170, 구로구,'100003, 97세,2019,45,8,37,21.6,45,8,37,21.6
'11170, 구로구,'100004, 98세,2019,24,7,17,41.2,22,7,15,46.7
'11170, 구로구,'100005, 99세,2019,18,5,13,38.5,18,5,13,38.5
'11170, 구로구,'101,100세이상,2019,17,X,15,13.3,17,X,15,13.3
'11170, 구로구,'102,15세미만,2019,45996,23475,22521,104.2,43634,22285,21349,104.4
'11170, 구로구,'103,15~64세,2019,322572,163355,159217,102.6,283031,141289,141742,99.7
'11170, 구로구,'104,65세이상,2019,66992,30543,36449,83.8,62859,28702,34157,84
'11170, 구로구,'126,평균연령,2019,43.4,42.7,44.1,,43.1,42.3,43.8,
'11170, 구로구,'127,중위연령,2019,44.2,43.5,45.1,,43.4,42.6,44.4,
'11180, 금천구,'000,합계,2019,249747,127242,122505,103.9,222193,112286,109907,102.2
'11180, 금천구,'005,0~4세,2019,7379,3800,3579,106.2,6634,3404,3230,105.4
'11180, 금천구,'005001, 0세,2019,1293,686,607,113,1143,605,538,112.5
'11180, 금천구,'005002, 1세,2019,1401,715,686,104.2,1251,633,618,102.4
'11180, 금천구,'005003, 2세,2019,1482,746,736,101.4,1318,667,651,102.5
'11180, 금천구,'005004, 3세,2019,1599,837,762,109.8,1434,746,688,108.4
'11180, 금천구,'005005, 4세,2019,1604,816,788,103.6,1488,753,735,102.4
'11180, 금천구,'010,5~9세,2019,7297,3721,3576,104.1,6807,3478,3329,104.5
'11180, 금천구,'010001, 5세,2019,1483,771,712,108.3,1362,711,651,109.2
'11180, 금천구,'010002, 6세,2019,1392,704,688,102.3,1293,654,639,102.3
'11180, 금천구,'010003, 7세,2019,1578,797,781,102,1478,750,728,103
'11180, 금천구,'010004, 8세,2019,1450,721,729,98.9,1355,674,681,99
'11180, 금천구,'010005, 9세,2019,1394,728,666,109.3,1319,689,630,109.4
'11180, 금천구,'015,10~14세,2019,6869,3478,3391,102.6,6625,3347,3278,102.1
'11180, 금천구,'015001, 10세,2019,1323,660,663,99.5,1262,632,630,100.3
'11180, 금천구,'015002, 11세,2019,1346,701,645,108.7,1301,676,625,108.2
'11180, 금천구,'015003, 12세,2019,1429,714,715,99.9,1379,684,695,98.4
'11180, 금천구,'015004, 13세,2019,1378,686,692,99.1,1334,664,670,99.1
'11180, 금천구,'015005, 14세,2019,1393,717,676,106.1,1349,691,658,105
'11180, 금천구,'020,15~19세,2019,8671,4331,4340,99.8,8506,4258,4248,100.2
'11180, 금천구,'020001, 15세,2019,1461,731,730,100.1,1435,721,714,101
'11180, 금천구,'020002, 16세,2019,1565,759,806,94.2,1540,747,793,94.2
'11180, 금천구,'020003, 17세,2019,1692,867,825,105.1,1668,858,810,105.9
'11180, 금천구,'020004, 18세,2019,1889,928,961,96.6,1865,914,951,96.1
'11180, 금천구,'020005, 19세,2019,2064,1046,1018,102.8,1998,1018,980,103.9
'11180, 금천구,'025,20~24세,2019,14393,7182,7211,99.6,13725,6853,6872,99.7
'11180, 금천구,'025001, 20세,2019,2320,1199,1121,107,2233,1157,1076,107.5
'11180, 금천구,'025002, 21세,2019,2562,1315,1247,105.5,2475,1273,1202,105.9
'11180, 금천구,'025003, 22세,2019,2865,1401,1464,95.7,2732,1335,1397,95.6
'11180, 금천구,'025004, 23세,2019,3212,1573,1639,96,3035,1476,1559,94.7
'11180, 금천구,'025005, 24세,2019,3434,1694,1740,97.4,3250,1612,1638,98.4
'11180, 금천구,'030,25~29세,2019,22364,11716,10648,110,20508,10774,9734,110.7
'11180, 금천구,'030001, 25세,2019,4168,2094,2074,101,3921,1984,1937,102.4
'11180, 금천구,'030002, 26세,2019,4454,2294,2160,106.2,4137,2140,1997,107.2
'11180, 금천구,'030003, 27세,2019,4653,2459,2194,112.1,4307,2273,2034,111.8
'11180, 금천구,'030004, 28세,2019,4679,2487,2192,113.5,4245,2260,1985,113.9
'11180, 금천구,'030005, 29세,2019,4410,2382,2028,117.5,3898,2117,1781,118.9
'11180, 금천구,'035,30~34세,2019,20001,11041,8960,123.2,17266,9571,7695,124.4
'11180, 금천구,'035001, 30세,2019,4223,2316,1907,121.4,3717,2061,1656,124.5
'11180, 금천구,'035002, 31세,2019,3981,2197,1784,123.2,3428,1910,1518,125.8
'11180, 금천구,'035003, 32세,2019,4078,2211,1867,118.4,3488,1904,1584,120.2
'11180, 금천구,'035004, 33세,2019,3973,2246,1727,130.1,3397,1921,1476,130.1
'11180, 금천구,'035005, 34세,2019,3746,2071,1675,123.6,3236,1775,1461,121.5
'11180, 금천구,'040,35~39세,2019,19341,10704,8637,123.9,17090,9421,7669,122.8
'11180, 금천구,'040001, 35세,2019,3850,2106,1744,120.8,3328,1822,1506,121
'11180, 금천구,'040002, 36세,2019,3872,2133,1739,122.7,3404,1877,1527,122.9
'11180, 금천구,'040003, 37세,2019,4012,2240,1772,126.4,3522,1935,1587,121.9
'11180, 금천구,'040004, 38세,2019,3811,2119,1692,125.2,3418,1900,1518,125.2
'11180, 금천구,'040005, 39세,2019,3796,2106,1690,124.6,3418,1887,1531,123.3
'11180, 금천구,'045,40~44세,2019,16710,9064,7646,118.5,14655,7781,6874,113.2
'11180, 금천구,'045001, 40세,2019,3593,1964,1629,120.6,3164,1692,1472,114.9
'11180, 금천구,'045002, 41세,2019,3282,1771,1511,117.2,2861,1503,1358,110.7
'11180, 금천구,'045003, 42세,2019,3177,1783,1394,127.9,2833,1572,1261,124.7
'11180, 금천구,'045004, 43세,2019,3234,1709,1525,112.1,2790,1433,1357,105.6
'11180, 금천구,'045005, 44세,2019,3424,1837,1587,115.8,3007,1581,1426,110.9
'11180, 금천구,'050,45~49세,2019,20828,10904,9924,109.9,17697,9044,8653,104.5
'11180, 금천구,'050001, 45세,2019,3757,2035,1722,118.2,3309,1746,1563,111.7
'11180, 금천구,'050002, 46세,2019,4001,2118,1883,112.5,3385,1739,1646,105.7
'11180, 금천구,'050003, 47세,2019,4129,2157,1972,109.4,3528,1802,1726,104.4
'11180, 금천구,'050004, 48세,2019,4445,2293,2152,106.6,3712,1880,1832,102.6
'11180, 금천구,'050005, 49세,2019,4496,2301,2195,104.8,3763,1877,1886,99.5
'11180, 금천구,'055,50~54세,2019,22722,11445,11277,101.5,19014,9350,9664,96.8
'11180, 금천구,'055001, 50세,2019,4530,2289,2241,102.1,3777,1879,1898,99
'11180, 금천구,'055002, 51세,2019,4691,2361,2330,101.3,3936,1920,2016,95.2
'11180, 금천구,'055003, 52세,2019,4219,2047,2172,94.2,3596,1706,1890,90.3
'11180, 금천구,'055004, 53세,2019,4531,2353,2178,108,3782,1925,1857,103.7
'11180, 금천구,'055005, 54세,2019,4751,2395,2356,101.7,3923,1920,2003,95.9
'11180, 금천구,'060,55~59세,2019,24554,12443,12111,102.7,20485,10242,10243,100
'11180, 금천구,'060001, 55세,2019,4681,2392,2289,104.5,3805,1896,1909,99.3
'11180, 금천구,'060002, 56세,2019,5029,2569,2460,104.4,3966,2015,1951,103.3
'11180, 금천구,'060003, 57세,2019,4819,2460,2359,104.3,3988,2004,1984,101
'11180, 금천구,'060004, 58세,2019,4861,2399,2462,97.4,4393,2138,2255,94.8
'11180, 금천구,'060005, 59세,2019,5164,2623,2541,103.2,4333,2189,2144,102.1
'11180, 금천구,'065,60~64세,2019,20803,10315,10488,98.4,17753,8732,9021,96.8
'11180, 금천구,'065001, 60세,2019,4621,2292,2329,98.4,4006,1955,2051,95.3
'11180, 금천구,'065002, 61세,2019,4347,2184,2163,101,3654,1853,1801,102.9
'11180, 금천구,'065003, 62세,2019,4123,2045,2078,98.4,3423,1691,1732,97.6
'11180, 금천구,'065004, 63세,2019,3827,1934,1893,102.2,3307,1654,1653,100.1
'11180, 금천구,'065005, 64세,2019,3885,1860,2025,91.9,3363,1579,1784,88.5
'11180, 금천구,'070,65~69세,2019,13904,6736,7168,94,12362,5958,6404,93
'11180, 금천구,'070001, 65세,2019,3365,1628,1737,93.7,2916,1376,1540,89.4
'11180, 금천구,'070002, 66세,2019,2791,1336,1455,91.8,2455,1173,1282,91.5
'11180, 금천구,'070003, 67세,2019,2998,1452,1546,93.9,2691,1301,1390,93.6
'11180, 금천구,'070004, 68세,2019,2256,1132,1124,100.7,2012,1004,1008,99.6
'11180, 금천구,'070005, 69세,2019,2494,1188,1306,91,2288,1104,1184,93.2
'11180, 금천구,'075,70~74세,2019,10052,4696,5356,87.7,9576,4503,5073,88.8
'11180, 금천구,'075001, 70세,2019,2362,1107,1255,88.2,2201,1027,1174,87.5
'11180, 금천구,'075002, 71세,2019,2155,1019,1136,89.7,2049,975,1074,90.8
'11180, 금천구,'075003, 72세,2019,2246,1051,1195,87.9,2157,1017,1140,89.2
'11180, 금천구,'075004, 73세,2019,1643,743,900,82.6,1572,722,850,84.9
'11180, 금천구,'075005, 74세,2019,1646,776,870,89.2,1597,762,835,91.3
'11180, 금천구,'080,75~79세,2019,7363,3343,4020,83.2,7177,3289,3888,84.6
'11180, 금천구,'080001, 75세,2019,1549,693,856,81,1509,674,835,80.7
'11180, 금천구,'080002, 76세,2019,1526,728,798,91.2,1490,717,773,92.8
'11180, 금천구,'080003, 77세,2019,1719,786,933,84.2,1684,776,908,85.5
'11180, 금천구,'080004, 78세,2019,1395,619,776,79.8,1355,610,745,81.9
'11180, 금천구,'080005, 79세,2019,1174,517,657,78.7,1139,512,627,81.7
'11180, 금천구,'085,80~84세,2019,4057,1621,2436,66.5,3930,1590,2340,67.9
'11180, 금천구,'085001, 80세,2019,1109,468,641,73,1072,462,610,75.7
'11180, 금천구,'085002, 81세,2019,907,377,530,71.1,879,370,509,72.7
'11180, 금천구,'085003, 82세,2019,744,300,444,67.6,717,294,423,69.5
'11180, 금천구,'085004, 83세,2019,663,250,413,60.5,653,247,406,60.8
'11180, 금천구,'085005, 84세,2019,634,226,408,55.4,609,217,392,55.4
'11180, 금천구,'086,85세이상,2019,2439,702,1737,40.4,2383,691,1692,40.8
'11180, 금천구,'090,85~89세,2019,1740,566,1174,48.2,1697,557,1140,48.9
'11180, 금천구,'090001, 85세,2019,499,172,327,52.6,482,168,314,53.5
'11180, 금천구,'090002, 86세,2019,398,124,274,45.3,387,121,266,45.5
'11180, 금천구,'090003, 87세,2019,347,114,233,48.9,342,114,228,50
'11180, 금천구,'090004, 88세,2019,272,95,177,53.7,268,93,175,53.1
'11180, 금천구,'090005, 89세,2019,224,61,163,37.4,218,61,157,38.9
'11180, 금천구,'095,90~94세,2019,532,92,440,20.9,524,91,433,21
'11180, 금천구,'095001, 90세,2019,145,33,112,29.5,142,32,110,29.1
'11180, 금천구,'095002, 91세,2019,146,22,124,17.7,143,22,121,18.2
'11180, 금천구,'095003, 92세,2019,122,19,103,18.4,122,19,103,18.4
'11180, 금천구,'095004, 93세,2019,54,9,45,20,53,9,44,20.5
'11180, 금천구,'095005, 94세,2019,65,9,56,16.1,64,9,55,16.4
'11180, 금천구,'100,95~99세,2019,145,39,106,36.8,141,38,103,36.9
'11180, 금천구,'100001, 95세,2019,45,10,35,28.6,43,9,34,26.5
'11180, 금천구,'100002, 96세,2019,42,13,29,44.8,40,13,27,48.1
'11180, 금천구,'100003, 97세,2019,26,7,19,36.8,26,7,19,36.8
'11180, 금천구,'100004, 98세,2019,16,X,12,33.3,16,X,12,33.3
'11180, 금천구,'100005, 99세,2019,16,5,11,45.5,16,5,11,45.5
'11180, 금천구,'101,100세이상,2019,22,5,17,29.4,21,5,16,31.3
'11180, 금천구,'102,15세미만,2019,21545,10999,10546,104.3,20066,10229,9837,104
'11180, 금천구,'103,15~64세,2019,190387,99145,91242,108.7,166699,86026,80673,106.6
'11180, 금천구,'104,65세이상,2019,37815,17098,20717,82.5,35428,16031,19397,82.6
'11180, 금천구,'126,평균연령,2019,44.1,43.3,44.9,,43.9,43,44.7,
'11180, 금천구,'127,중위연령,2019,45.5,44.2,46.8,,44.8,43.2,46.3,
'11190, 영등포구,'000,합계,2019,394083,196903,197180,99.9,345903,171068,174835,97.8
'11190, 영등포구,'005,0~4세,2019,13962,7144,6818,104.8,12797,6545,6252,104.7
'11190, 영등포구,'005001, 0세,2019,2722,1379,1343,102.7,2514,1273,1241,102.6
'11190, 영등포구,'005002, 1세,2019,2664,1342,1322,101.5,2439,1225,1214,100.9
'11190, 영등포구,'005003, 2세,2019,2646,1373,1273,107.9,2410,1264,1146,110.3
'11190, 영등포구,'005004, 3세,2019,3010,1523,1487,102.4,2717,1369,1348,101.6
'11190, 영등포구,'005005, 4세,2019,2920,1527,1393,109.6,2717,1414,1303,108.5
'11190, 영등포구,'010,5~9세,2019,12514,6326,6188,102.2,11732,5944,5788,102.7
'11190, 영등포구,'010001, 5세,2019,2684,1384,1300,106.5,2501,1298,1203,107.9
'11190, 영등포구,'010002, 6세,2019,2508,1305,1203,108.5,2339,1219,1120,108.8
'11190, 영등포구,'010003, 7세,2019,2647,1302,1345,96.8,2481,1229,1252,98.2
'11190, 영등포구,'010004, 8세,2019,2411,1185,1226,96.7,2276,1113,1163,95.7
'11190, 영등포구,'010005, 9세,2019,2264,1150,1114,103.2,2135,1085,1050,103.3
'11190, 영등포구,'015,10~14세,2019,10914,5745,5169,111.1,10402,5486,4916,111.6
'11190, 영등포구,'015001, 10세,2019,2164,1127,1037,108.7,2055,1074,981,109.5
'11190, 영등포구,'015002, 11세,2019,2329,1208,1121,107.8,2199,1142,1057,108
'11190, 영등포구,'015003, 12세,2019,2227,1161,1066,108.9,2125,1108,1017,108.9
'11190, 영등포구,'015004, 13세,2019,2106,1136,970,117.1,2020,1087,933,116.5
'11190, 영등포구,'015005, 14세,2019,2088,1113,975,114.2,2003,1075,928,115.8
'11190, 영등포구,'020,15~19세,2019,12867,6773,6094,111.1,12454,6540,5914,110.6
'11190, 영등포구,'020001, 15세,2019,2295,1235,1060,116.5,2204,1179,1025,115
'11190, 영등포구,'020002, 16세,2019,2250,1250,1000,125,2193,1215,978,124.2
'11190, 영등포구,'020003, 17세,2019,2385,1274,1111,114.7,2321,1242,1079,115.1
'11190, 영등포구,'020004, 18세,2019,2770,1424,1346,105.8,2698,1392,1306,106.6
'11190, 영등포구,'020005, 19세,2019,3167,1590,1577,100.8,3038,1512,1526,99.1
'11190, 영등포구,'025,20~24세,2019,21097,9832,11265,87.3,19734,9209,10525,87.5
'11190, 영등포구,'025001, 20세,2019,3296,1671,1625,102.8,3143,1593,1550,102.8
'11190, 영등포구,'025002, 21세,2019,3776,1861,1915,97.2,3541,1753,1788,98
'11190, 영등포구,'025003, 22세,2019,4092,1949,2143,90.9,3835,1830,2005,91.3
'11190, 영등포구,'025004, 23세,2019,4549,2026,2523,80.3,4227,1885,2342,80.5
'11190, 영등포구,'025005, 24세,2019,5384,2325,3059,76,4988,2148,2840,75.6
'11190, 영등포구,'030,25~29세,2019,35950,17237,18713,92.1,32893,15673,17220,91
'11190, 영등포구,'030001, 25세,2019,6124,2784,3340,83.4,5711,2593,3118,83.2
'11190, 영등포구,'030002, 26세,2019,6983,3271,3712,88.1,6443,3011,3432,87.7
'11190, 영등포구,'030003, 27세,2019,7738,3732,4006,93.2,7147,3407,3740,91.1
'11190, 영등포구,'030004, 28세,2019,7702,3746,3956,94.7,7046,3414,3632,94
'11190, 영등포구,'030005, 29세,2019,7403,3704,3699,100.1,6546,3248,3298,98.5
'11190, 영등포구,'035,30~34세,2019,36743,19003,17740,107.1,32060,16382,15678,104.5
'11190, 영등포구,'035001, 30세,2019,7505,3895,3610,107.9,6623,3411,3212,106.2
'11190, 영등포구,'035002, 31세,2019,7529,3879,3650,106.3,6608,3375,3233,104.4
'11190, 영등포구,'035003, 32세,2019,7551,3817,3734,102.2,6421,3174,3247,97.8
'11190, 영등포구,'035004, 33세,2019,7168,3725,3443,108.2,6247,3206,3041,105.4
'11190, 영등포구,'035005, 34세,2019,6990,3687,3303,111.6,6161,3216,2945,109.2
'11190, 영등포구,'040,35~39세,2019,34697,18459,16238,113.7,30886,16154,14732,109.7
'11190, 영등포구,'040001, 35세,2019,6895,3669,3226,113.7,6096,3193,2903,110
'11190, 영등포구,'040002, 36세,2019,7019,3721,3298,112.8,6213,3234,2979,108.6
'11190, 영등포구,'040003, 37세,2019,7275,3835,3440,111.5,6442,3340,3102,107.7
'11190, 영등포구,'040004, 38세,2019,6871,3703,3168,116.9,6183,3295,2888,114.1
'11190, 영등포구,'040005, 39세,2019,6637,3531,3106,113.7,5952,3092,2860,108.1
'11190, 영등포구,'045,40~44세,2019,28438,15114,13324,113.4,24894,12881,12013,107.2
'11190, 영등포구,'045001, 40세,2019,6276,3374,2902,116.3,5492,2882,2610,110.4
'11190, 영등포구,'045002, 41세,2019,5491,2918,2573,113.4,4756,2444,2312,105.7
'11190, 영등포구,'045003, 42세,2019,5651,2985,2666,112,4997,2571,2426,106
'11190, 영등포구,'045004, 43세,2019,5536,2907,2629,110.6,4837,2473,2364,104.6
'11190, 영등포구,'045005, 44세,2019,5484,2930,2554,114.7,4812,2511,2301,109.1
'11190, 영등포구,'050,45~49세,2019,32080,16843,15237,110.5,26815,13766,13049,105.5
'11190, 영등포구,'050001, 45세,2019,5970,3203,2767,115.8,5161,2708,2453,110.4
'11190, 영등포구,'050002, 46세,2019,6202,3268,2934,111.4,5256,2680,2576,104
'11190, 영등포구,'050003, 47세,2019,6320,3325,2995,111,5289,2730,2559,106.7
'11190, 영등포구,'050004, 48세,2019,6874,3542,3332,106.3,5684,2865,2819,101.6
'11190, 영등포구,'050005, 49세,2019,6714,3505,3209,109.2,5425,2783,2642,105.3
'11190, 영등포구,'055,50~54세,2019,32356,16394,15962,102.7,25920,12972,12948,100.2
'11190, 영등포구,'055001, 50세,2019,6763,3365,3398,99,5538,2727,2811,97
'11190, 영등포구,'055002, 51세,2019,6596,3419,3177,107.6,5266,2680,2586,103.6
'11190, 영등포구,'055003, 52세,2019,6096,3026,3070,98.6,5033,2451,2582,94.9
'11190, 영등포구,'055004, 53세,2019,6326,3246,3080,105.4,4975,2535,2440,103.9
'11190, 영등포구,'055005, 54세,2019,6575,3338,3237,103.1,5108,2579,2529,102
'11190, 영등포구,'060,55~59세,2019,34310,17084,17226,99.2,26980,13360,13620,98.1
'11190, 영등포구,'060001, 55세,2019,6659,3348,3311,101.1,5072,2548,2524,101
'11190, 영등포구,'060002, 56세,2019,7063,3644,3419,106.6,5118,2619,2499,104.8
'11190, 영등포구,'060003, 57세,2019,6777,3436,3341,102.8,5313,2686,2627,102.2
'11190, 영등포구,'060004, 58세,2019,6631,3217,3414,94.2,5712,2760,2952,93.5
'11190, 영등포구,'060005, 59세,2019,7180,3439,3741,91.9,5765,2747,3018,91
'11190, 영등포구,'065,60~64세,2019,30549,15136,15413,98.2,24767,12097,12670,95.5
'11190, 영등포구,'065001, 60세,2019,6501,3215,3286,97.8,5277,2582,2695,95.8
'11190, 영등포구,'065002, 61세,2019,6299,3151,3148,100.1,5038,2479,2559,96.9
'11190, 영등포구,'065003, 62세,2019,6330,3134,3196,98.1,5064,2465,2599,94.8
'11190, 영등포구,'065004, 63세,2019,5604,2811,2793,100.6,4539,2263,2276,99.4
'11190, 영등포구,'065005, 64세,2019,5815,2825,2990,94.5,4849,2308,2541,90.8
'11190, 영등포구,'070,65~69세,2019,19951,9538,10413,91.6,17394,8266,9128,90.6
'11190, 영등포구,'070001, 65세,2019,4695,2284,2411,94.7,3933,1903,2030,93.7
'11190, 영등포구,'070002, 66세,2019,4095,1982,2113,93.8,3516,1687,1829,92.2
'11190, 영등포구,'070003, 67세,2019,4349,2101,2248,93.5,3846,1847,1999,92.4
'11190, 영등포구,'070004, 68세,2019,3260,1551,1709,90.8,2846,1346,1500,89.7
'11190, 영등포구,'070005, 69세,2019,3552,1620,1932,83.9,3253,1483,1770,83.8
'11190, 영등포구,'075,70~74세,2019,14932,7058,7874,89.6,14163,6747,7416,91
'11190, 영등포구,'075001, 70세,2019,3515,1689,1826,92.5,3243,1566,1677,93.4
'11190, 영등포구,'075002, 71세,2019,3254,1545,1709,90.4,3096,1480,1616,91.6
'11190, 영등포구,'075003, 72세,2019,3211,1494,1717,87,3078,1442,1636,88.1
'11190, 영등포구,'075004, 73세,2019,2569,1200,1369,87.7,2446,1153,1293,89.2
'11190, 영등포구,'075005, 74세,2019,2383,1130,1253,90.2,2300,1106,1194,92.6
'11190, 영등포구,'080,75~79세,2019,11287,4948,6339,78.1,10953,4858,6095,79.7
'11190, 영등포구,'080001, 75세,2019,2330,1035,1295,79.9,2267,1017,1250,81.4
'11190, 영등포구,'080002, 76세,2019,2317,1030,1287,80,2258,1011,1247,81.1
'11190, 영등포구,'080003, 77세,2019,2734,1203,1531,78.6,2663,1185,1478,80.2
'11190, 영등포구,'080004, 78세,2019,2045,892,1153,77.4,1976,876,1100,79.6
'11190, 영등포구,'080005, 79세,2019,1861,788,1073,73.4,1789,769,1020,75.4
'11190, 영등포구,'085,80~84세,2019,7119,2962,4157,71.3,6869,2907,3962,73.4
'11190, 영등포구,'085001, 80세,2019,1806,789,1017,77.6,1727,776,951,81.6
'11190, 영등포구,'085002, 81세,2019,1538,636,902,70.5,1490,625,865,72.3
'11190, 영등포구,'085003, 82세,2019,1405,572,833,68.7,1358,554,804,68.9
'11190, 영등포구,'085004, 83세,2019,1226,494,732,67.5,1185,486,699,69.5
'11190, 영등포구,'085005, 84세,2019,1144,471,673,70,1109,466,643,72.5
'11190, 영등포구,'086,85세이상,2019,4317,1307,3010,43.4,4190,1281,2909,44
'11190, 영등포구,'090,85~89세,2019,3051,988,2063,47.9,2960,971,1989,48.8
'11190, 영등포구,'090001, 85세,2019,914,327,587,55.7,885,320,565,56.6
'11190, 영등포구,'090002, 86세,2019,710,223,487,45.8,687,222,465,47.7
'11190, 영등포구,'090003, 87세,2019,584,192,392,49,567,187,380,49.2
'11190, 영등포구,'090004, 88세,2019,447,134,313,42.8,436,132,304,43.4
'11190, 영등포구,'090005, 89세,2019,396,112,284,39.4,385,110,275,40
'11190, 영등포구,'095,90~94세,2019,995,251,744,33.7,969,247,722,34.2
'11190, 영등포구,'095001, 90세,2019,311,82,229,35.8,303,81,222,36.5
'11190, 영등포구,'095002, 91세,2019,262,76,186,40.9,255,74,181,40.9
'11190, 영등포구,'095003, 92세,2019,193,44,149,29.5,188,44,144,30.6
'11190, 영등포구,'095004, 93세,2019,118,25,93,26.9,114,24,90,26.7
'11190, 영등포구,'095005, 94세,2019,111,24,87,27.6,109,24,85,28.2
'11190, 영등포구,'100,95~99세,2019,247,64,183,35,237,59,178,33.1
'11190, 영등포구,'100001, 95세,2019,78,22,56,39.3,76,21,55,38.2
'11190, 영등포구,'100002, 96세,2019,84,21,63,33.3,80,17,63,27
'11190, 영등포구,'100003, 97세,2019,45,9,36,25,42,9,33,27.3
'11190, 영등포구,'100004, 98세,2019,21,5,16,31.3,21,5,16,31.3
'11190, 영등포구,'100005, 99세,2019,19,7,12,58.3,18,7,11,63.6
'11190, 영등포구,'101,100세이상,2019,24,X,20,20,24,X,20,20
'11190, 영등포구,'102,15세미만,2019,37390,19215,18175,105.7,34931,17975,16956,106
'11190, 영등포구,'103,15~64세,2019,299087,151875,147212,103.2,257403,129034,128369,100.5
'11190, 영등포구,'104,65세이상,2019,57606,25813,31793,81.2,53569,24059,29510,81.5
'11190, 영등포구,'126,평균연령,2019,43.2,42.6,43.8,,42.8,42.1,43.4,
'11190, 영등포구,'127,중위연령,2019,43.2,42.5,43.8,,41.9,41.3,42.6,
'11200, 동작구,'000,합계,2019,400368,194049,206319,94.1,382396,185757,196639,94.5
'11200, 동작구,'005,0~4세,2019,12614,6385,6229,102.5,12395,6273,6122,102.5
'11200, 동작구,'005001, 0세,2019,2263,1205,1058,113.9,2217,1184,1033,114.6
'11200, 동작구,'005002, 1세,2019,2337,1185,1152,102.9,2283,1156,1127,102.6
'11200, 동작구,'005003, 2세,2019,2427,1179,1248,94.5,2390,1160,1230,94.3
'11200, 동작구,'005004, 3세,2019,2725,1383,1342,103.1,2678,1353,1325,102.1
'11200, 동작구,'005005, 4세,2019,2862,1433,1429,100.3,2827,1420,1407,100.9
'11200, 동작구,'010,5~9세,2019,13427,6891,6536,105.4,13273,6806,6467,105.2
'11200, 동작구,'010001, 5세,2019,2666,1403,1263,111.1,2629,1378,1251,110.2
'11200, 동작구,'010002, 6세,2019,2653,1342,1311,102.4,2616,1325,1291,102.6
'11200, 동작구,'010003, 7세,2019,2779,1409,1370,102.8,2751,1395,1356,102.9
'11200, 동작구,'010004, 8세,2019,2717,1359,1358,100.1,2687,1342,1345,99.8
'11200, 동작구,'010005, 9세,2019,2612,1378,1234,111.7,2590,1366,1224,111.6
'11200, 동작구,'015,10~14세,2019,12591,6473,6118,105.8,12501,6434,6067,106
'11200, 동작구,'015001, 10세,2019,2531,1268,1263,100.4,2513,1261,1252,100.7
'11200, 동작구,'015002, 11세,2019,2576,1342,1234,108.8,2551,1328,1223,108.6
'11200, 동작구,'015003, 12세,2019,2587,1390,1197,116.1,2566,1384,1182,117.1
'11200, 동작구,'015004, 13세,2019,2450,1239,1211,102.3,2434,1231,1203,102.3
'11200, 동작구,'015005, 14세,2019,2447,1234,1213,101.7,2437,1230,1207,101.9
'11200, 동작구,'020,15~19세,2019,17219,8580,8639,99.3,16583,8368,8215,101.9
'11200, 동작구,'020001, 15세,2019,2611,1348,1263,106.7,2596,1343,1253,107.2
'11200, 동작구,'020002, 16세,2019,2581,1326,1255,105.7,2567,1320,1247,105.9
'11200, 동작구,'020003, 17세,2019,2730,1380,1350,102.2,2700,1367,1333,102.6
'11200, 동작구,'020004, 18세,2019,3619,1820,1799,101.2,3457,1764,1693,104.2
'11200, 동작구,'020005, 19세,2019,5678,2706,2972,91,5263,2574,2689,95.7
'11200, 동작구,'025,20~24세,2019,33671,15721,17950,87.6,30325,14513,15812,91.8
'11200, 동작구,'025001, 20세,2019,5763,2584,3179,81.3,5192,2406,2786,86.4
'11200, 동작구,'025002, 21세,2019,6012,2649,3363,78.8,5319,2392,2927,81.7
'11200, 동작구,'025003, 22세,2019,6588,3071,3517,87.3,5870,2814,3056,92.1
'11200, 동작구,'025004, 23세,2019,7494,3544,3950,89.7,6801,3289,3512,93.7
'11200, 동작구,'025005, 24세,2019,7814,3873,3941,98.3,7143,3612,3531,102.3
'11200, 동작구,'030,25~29세,2019,39268,19693,19575,100.6,37189,18787,18402,102.1
'11200, 동작구,'030001, 25세,2019,8036,3967,4069,97.5,7513,3768,3745,100.6
'11200, 동작구,'030002, 26세,2019,8111,4009,4102,97.7,7694,3839,3855,99.6
'11200, 동작구,'030003, 27세,2019,8108,4144,3964,104.5,7736,3986,3750,106.3
'11200, 동작구,'030004, 28세,2019,7728,3889,3839,101.3,7360,3713,3647,101.8
'11200, 동작구,'030005, 29세,2019,7285,3684,3601,102.3,6886,3481,3405,102.2
'11200, 동작구,'035,30~34세,2019,32172,16227,15945,101.8,30476,15380,15096,101.9
'11200, 동작구,'035001, 30세,2019,6788,3449,3339,103.3,6416,3277,3139,104.4
'11200, 동작구,'035002, 31세,2019,6662,3329,3333,99.9,6293,3156,3137,100.6
'11200, 동작구,'035003, 32세,2019,6367,3247,3120,104.1,6021,3065,2956,103.7
'11200, 동작구,'035004, 33세,2019,6211,3116,3095,100.7,5877,2937,2940,99.9
'11200, 동작구,'035005, 34세,2019,6144,3086,3058,100.9,5869,2945,2924,100.7
'11200, 동작구,'040,35~39세,2019,32181,16380,15801,103.7,30917,15670,15247,102.8
'11200, 동작구,'040001, 35세,2019,6100,3085,3015,102.3,5795,2913,2882,101.1
'11200, 동작구,'040002, 36세,2019,6508,3274,3234,101.2,6238,3127,3111,100.5
'11200, 동작구,'040003, 37세,2019,6579,3348,3231,103.6,6321,3209,3112,103.1
'11200, 동작구,'040004, 38세,2019,6399,3335,3064,108.8,6188,3213,2975,108
'11200, 동작구,'040005, 39세,2019,6595,3338,3257,102.5,6375,3208,3167,101.3
'11200, 동작구,'045,40~44세,2019,28291,14376,13915,103.3,27235,13761,13474,102.1
'11200, 동작구,'045001, 40세,2019,6144,3175,2969,106.9,5901,3017,2884,104.6
'11200, 동작구,'045002, 41세,2019,5497,2749,2748,100,5281,2625,2656,98.8
'11200, 동작구,'045003, 42세,2019,5510,2747,2763,99.4,5324,2647,2677,98.9
'11200, 동작구,'045004, 43세,2019,5501,2822,2679,105.3,5297,2707,2590,104.5
'11200, 동작구,'045005, 44세,2019,5639,2883,2756,104.6,5432,2765,2667,103.7
'11200, 동작구,'050,45~49세,2019,30908,15529,15379,101,29558,14811,14747,100.4
'11200, 동작구,'050001, 45세,2019,6088,3201,2887,110.9,5855,3078,2777,110.8
'11200, 동작구,'050002, 46세,2019,5920,2899,3021,96,5705,2786,2919,95.4
'11200, 동작구,'050003, 47세,2019,6059,3098,2961,104.6,5788,2944,2844,103.5
'11200, 동작구,'050004, 48세,2019,6552,3211,3341,96.1,6230,3030,3200,94.7
'11200, 동작구,'050005, 49세,2019,6289,3120,3169,98.5,5980,2973,3007,98.9
'11200, 동작구,'055,50~54세,2019,29450,14004,15446,90.7,27836,13224,14612,90.5
'11200, 동작구,'055001, 50세,2019,6412,3107,3305,94,6086,2935,3151,93.1
'11200, 동작구,'055002, 51세,2019,6125,2868,3257,88.1,5786,2709,3077,88
'11200, 동작구,'055003, 52세,2019,5627,2651,2976,89.1,5357,2519,2838,88.8
'11200, 동작구,'055004, 53세,2019,5547,2674,2873,93.1,5209,2516,2693,93.4
'11200, 동작구,'055005, 54세,2019,5739,2704,3035,89.1,5398,2545,2853,89.2
'11200, 동작구,'060,55~59세,2019,30760,14613,16147,90.5,28876,13714,15162,90.4
'11200, 동작구,'060001, 55세,2019,5773,2769,3004,92.2,5391,2576,2815,91.5
'11200, 동작구,'060002, 56세,2019,6029,2896,3133,92.4,5551,2670,2881,92.7
'11200, 동작구,'060003, 57세,2019,5951,2859,3092,92.5,5565,2676,2889,92.6
'11200, 동작구,'060004, 58세,2019,6287,2912,3375,86.3,6081,2821,3260,86.5
'11200, 동작구,'060005, 59세,2019,6720,3177,3543,89.7,6288,2971,3317,89.6
'11200, 동작구,'065,60~64세,2019,28024,12957,15067,86,26520,12245,14275,85.8
'11200, 동작구,'065001, 60세,2019,5924,2738,3186,85.9,5624,2609,3015,86.5
'11200, 동작구,'065002, 61세,2019,5674,2598,3076,84.5,5334,2436,2898,84.1
'11200, 동작구,'065003, 62세,2019,5755,2705,3050,88.7,5404,2527,2877,87.8
'11200, 동작구,'065004, 63세,2019,5190,2394,2796,85.6,4906,2253,2653,84.9
'11200, 동작구,'065005, 64세,2019,5481,2522,2959,85.2,5252,2420,2832,85.5
'11200, 동작구,'070,65~69세,2019,19812,9068,10744,84.4,19121,8752,10369,84.4
'11200, 동작구,'070001, 65세,2019,4544,2096,2448,85.6,4332,1993,2339,85.2
'11200, 동작구,'070002, 66세,2019,4079,1882,2197,85.7,3912,1805,2107,85.7
'11200, 동작구,'070003, 67세,2019,4317,1983,2334,85,4180,1924,2256,85.3
'11200, 동작구,'070004, 68세,2019,3301,1457,1844,79,3210,1417,1793,79
'11200, 동작구,'070005, 69세,2019,3571,1650,1921,85.9,3487,1613,1874,86.1
'11200, 동작구,'075,70~74세,2019,16027,7048,8979,78.5,15837,6971,8866,78.6
'11200, 동작구,'075001, 70세,2019,3571,1550,2021,76.7,3502,1520,1982,76.7
'11200, 동작구,'075002, 71세,2019,3537,1586,1951,81.3,3489,1569,1920,81.7
'11200, 동작구,'075003, 72세,2019,3520,1547,1973,78.4,3490,1537,1953,78.7
'11200, 동작구,'075004, 73세,2019,2820,1220,1600,76.3,2795,1209,1586,76.2
'11200, 동작구,'075005, 74세,2019,2579,1145,1434,79.8,2561,1136,1425,79.7
'11200, 동작구,'080,75~79세,2019,12267,5712,6555,87.1,12168,5687,6481,87.7
'11200, 동작구,'080001, 75세,2019,2568,1182,1386,85.3,2541,1173,1368,85.7
'11200, 동작구,'080002, 76세,2019,2514,1211,1303,92.9,2492,1201,1291,93
'11200, 동작구,'080003, 77세,2019,2906,1384,1522,90.9,2888,1382,1506,91.8
'11200, 동작구,'080004, 78세,2019,2253,1030,1223,84.2,2234,1026,1208,84.9
'11200, 동작구,'080005, 79세,2019,2026,905,1121,80.7,2013,905,1108,81.7
'11200, 동작구,'085,80~84세,2019,7266,2990,4276,69.9,7198,2967,4231,70.1
'11200, 동작구,'085001, 80세,2019,1890,839,1051,79.8,1879,834,1045,79.8
'11200, 동작구,'085002, 81세,2019,1589,678,911,74.4,1572,672,900,74.7
'11200, 동작구,'085003, 82세,2019,1451,573,878,65.3,1435,567,868,65.3
'11200, 동작구,'085004, 83세,2019,1260,493,767,64.3,1242,488,754,64.7
'11200, 동작구,'085005, 84세,2019,1076,407,669,60.8,1070,406,664,61.1
'11200, 동작구,'086,85세이상,2019,4420,1402,3018,46.5,4388,1394,2994,46.6
'11200, 동작구,'090,85~89세,2019,3083,1038,2045,50.8,3064,1033,2031,50.9
'11200, 동작구,'090001, 85세,2019,913,340,573,59.3,910,339,571,59.4
'11200, 동작구,'090002, 86세,2019,716,250,466,53.6,709,248,461,53.8
'11200, 동작구,'090003, 87세,2019,600,186,414,44.9,596,186,410,45.4
'11200, 동작구,'090004, 88세,2019,450,150,300,50,450,150,300,50
'11200, 동작구,'090005, 89세,2019,404,112,292,38.4,399,110,289,38.1
'11200, 동작구,'095,90~94세,2019,1057,288,769,37.5,1051,287,764,37.6
'11200, 동작구,'095001, 90세,2019,359,111,248,44.8,357,111,246,45.1
'11200, 동작구,'095002, 91세,2019,253,68,185,36.8,250,67,183,36.6
'11200, 동작구,'095003, 92세,2019,208,49,159,30.8,208,49,159,30.8
'11200, 동작구,'095004, 93세,2019,140,38,102,37.3,140,38,102,37.3
'11200, 동작구,'095005, 94세,2019,97,22,75,29.3,96,22,74,29.7
'11200, 동작구,'100,95~99세,2019,243,64,179,35.8,240,64,176,36.4
'11200, 동작구,'100001, 95세,2019,86,24,62,38.7,85,24,61,39.3
'11200, 동작구,'100002, 96세,2019,70,21,49,42.9,69,21,48,43.8
'11200, 동작구,'100003, 97세,2019,37,7,30,23.3,36,7,29,24.1
'11200, 동작구,'100004, 98세,2019,25,6,19,31.6,25,6,19,31.6
'11200, 동작구,'100005, 99세,2019,25,6,19,31.6,25,6,19,31.6
'11200, 동작구,'101,100세이상,2019,37,12,25,48,33,10,23,43.5
'11200, 동작구,'102,15세미만,2019,38632,19749,18883,104.6,38169,19513,18656,104.6
'11200, 동작구,'103,15~64세,2019,301944,148080,153864,96.2,285515,140473,145042,96.8
'11200, 동작구,'104,65세이상,2019,59792,26220,33572,78.1,58712,25771,32941,78.2
'11200, 동작구,'126,평균연령,2019,42.1,41.3,42.9,,42.2,41.3,43.1,
'11200, 동작구,'127,중위연령,2019,41.2,40.2,42.2,,41.3,40.2,42.5,
'11210, 관악구,'000,합계,2019,507828,254082,253746,100.1,482476,242205,240271,100.8
'11210, 관악구,'005,0~4세,2019,12334,6388,5946,107.4,11773,6114,5659,108
'11210, 관악구,'005001, 0세,2019,2263,1151,1112,103.5,2158,1099,1059,103.8
'11210, 관악구,'005002, 1세,2019,2239,1183,1056,112,2127,1134,993,114.2
'11210, 관악구,'005003, 2세,2019,2476,1281,1195,107.2,2356,1214,1142,106.3
'11210, 관악구,'005004, 3세,2019,2629,1358,1271,106.8,2508,1295,1213,106.8
'11210, 관악구,'005005, 4세,2019,2727,1415,1312,107.9,2624,1372,1252,109.6
'11210, 관악구,'010,5~9세,2019,13029,6677,6352,105.1,12689,6501,6188,105.1
'11210, 관악구,'010001, 5세,2019,2636,1357,1279,106.1,2554,1319,1235,106.8
'11210, 관악구,'010002, 6세,2019,2562,1311,1251,104.8,2482,1276,1206,105.8
'11210, 관악구,'010003, 7세,2019,2625,1348,1277,105.6,2553,1306,1247,104.7
'11210, 관악구,'010004, 8세,2019,2668,1369,1299,105.4,2620,1344,1276,105.3
'11210, 관악구,'010005, 9세,2019,2538,1292,1246,103.7,2480,1256,1224,102.6
'11210, 관악구,'015,10~14세,2019,12663,6509,6154,105.8,12448,6407,6041,106.1
'11210, 관악구,'015001, 10세,2019,2427,1272,1155,110.1,2368,1244,1124,110.7
'11210, 관악구,'015002, 11세,2019,2589,1333,1256,106.1,2540,1305,1235,105.7
'11210, 관악구,'015003, 12세,2019,2649,1347,1302,103.5,2610,1330,1280,103.9
'11210, 관악구,'015004, 13세,2019,2484,1290,1194,108,2452,1277,1175,108.7
'11210, 관악구,'015005, 14세,2019,2514,1267,1247,101.6,2478,1251,1227,102
'11210, 관악구,'020,15~19세,2019,17942,9158,8784,104.3,17560,9011,8549,105.4
'11210, 관악구,'020001, 15세,2019,2708,1412,1296,109,2674,1398,1276,109.6
'11210, 관악구,'020002, 16세,2019,2753,1377,1376,100.1,2725,1368,1357,100.8
'11210, 관악구,'020003, 17세,2019,3061,1534,1527,100.5,3024,1521,1503,101.2
'11210, 관악구,'020004, 18세,2019,3890,1962,1928,101.8,3801,1926,1875,102.7
'11210, 관악구,'020005, 19세,2019,5530,2873,2657,108.1,5336,2798,2538,110.2
'11210, 관악구,'025,20~24세,2019,42140,18879,23261,81.2,40252,18193,22059,82.5
'11210, 관악구,'025001, 20세,2019,5989,2864,3125,91.6,5704,2749,2955,93
'11210, 관악구,'025002, 21세,2019,6794,3120,3674,84.9,6531,3013,3518,85.6
'11210, 관악구,'025003, 22세,2019,7860,3380,4480,75.4,7509,3259,4250,76.7
'11210, 관악구,'025004, 23세,2019,10050,4390,5660,77.6,9582,4220,5362,78.7
'11210, 관악구,'025005, 24세,2019,11447,5125,6322,81.1,10926,4952,5974,82.9
'11210, 관악구,'030,25~29세,2019,69742,35815,33927,105.6,66429,34463,31966,107.8
'11210, 관악구,'030001, 25세,2019,13724,6519,7205,90.5,13074,6293,6781,92.8
'11210, 관악구,'030002, 26세,2019,14346,7217,7129,101.2,13726,6976,6750,103.3
'11210, 관악구,'030003, 27세,2019,15093,7862,7231,108.7,14422,7587,6835,111
'11210, 관악구,'030004, 28세,2019,13804,7300,6504,112.2,13146,7022,6124,114.7
'11210, 관악구,'030005, 29세,2019,12775,6917,5858,118.1,12061,6585,5476,120.3
'11210, 관악구,'035,30~34세,2019,49614,27235,22379,121.7,46676,25803,20873,123.6
'11210, 관악구,'035001, 30세,2019,11761,6442,5319,121.1,11099,6145,4954,124
'11210, 관악구,'035002, 31세,2019,10611,5805,4806,120.8,10005,5509,4496,122.5
'11210, 관악구,'035003, 32세,2019,9722,5335,4387,121.6,9136,5027,4109,122.3
'11210, 관악구,'035004, 33세,2019,9057,4989,4068,122.6,8477,4712,3765,125.2
'11210, 관악구,'035005, 34세,2019,8463,4664,3799,122.8,7959,4410,3549,124.3
'11210, 관악구,'040,35~39세,2019,41154,22439,18715,119.9,39174,21382,17792,120.2
'11210, 관악구,'040001, 35세,2019,8185,4463,3722,119.9,7725,4234,3491,121.3
'11210, 관악구,'040002, 36세,2019,8214,4493,3721,120.7,7776,4244,3532,120.2
'11210, 관악구,'040003, 37세,2019,8684,4700,3984,118,8231,4466,3765,118.6
'11210, 관악구,'040004, 38세,2019,8063,4458,3605,123.7,7746,4280,3466,123.5
'11210, 관악구,'040005, 39세,2019,8008,4325,3683,117.4,7696,4158,3538,117.5
'11210, 관악구,'045,40~44세,2019,33299,17951,15348,117,31643,17039,14604,116.7
'11210, 관악구,'045001, 40세,2019,7277,3952,3325,118.9,6867,3724,3143,118.5
'11210, 관악구,'045002, 41세,2019,6506,3446,3060,112.6,6195,3281,2914,112.6
'11210, 관악구,'045003, 42세,2019,6508,3459,3049,113.4,6203,3292,2911,113.1
'11210, 관악구,'045004, 43세,2019,6408,3541,2867,123.5,6097,3376,2721,124.1
'11210, 관악구,'045005, 44세,2019,6600,3553,3047,116.6,6281,3366,2915,115.5
'11210, 관악구,'050,45~49세,2019,36876,19499,17377,112.2,34646,18356,16290,112.7
'11210, 관악구,'050001, 45세,2019,7122,3796,3326,114.1,6756,3598,3158,113.9
'11210, 관악구,'050002, 46세,2019,7175,3880,3295,117.8,6782,3676,3106,118.4
'11210, 관악구,'050003, 47세,2019,7412,3947,3465,113.9,6927,3696,3231,114.4
'11210, 관악구,'050004, 48세,2019,7801,4056,3745,108.3,7335,3829,3506,109.2
'11210, 관악구,'050005, 49세,2019,7366,3820,3546,107.7,6846,3557,3289,108.1
'11210, 관악구,'055,50~54세,2019,35312,17416,17896,97.3,32572,16116,16456,97.9
'11210, 관악구,'055001, 50세,2019,7334,3675,3659,100.4,6804,3417,3387,100.9
'11210, 관악구,'055002, 51세,2019,7232,3538,3694,95.8,6703,3270,3433,95.3
'11210, 관악구,'055003, 52세,2019,6769,3230,3539,91.3,6272,3009,3263,92.2
'11210, 관악구,'055004, 53세,2019,6731,3429,3302,103.8,6180,3161,3019,104.7
'11210, 관악구,'055005, 54세,2019,7246,3544,3702,95.7,6613,3259,3354,97.2
'11210, 관악구,'060,55~59세,2019,36810,17718,19092,92.8,33759,16250,17509,92.8
'11210, 관악구,'060001, 55세,2019,6683,3308,3375,98,6035,3003,3032,99
'11210, 관악구,'060002, 56세,2019,7356,3580,3776,94.8,6515,3180,3335,95.4
'11210, 관악구,'060003, 57세,2019,7261,3510,3751,93.6,6668,3227,3441,93.8
'11210, 관악구,'060004, 58세,2019,7505,3569,3936,90.7,7115,3370,3745,90
'11210, 관악구,'060005, 59세,2019,8005,3751,4254,88.2,7426,3470,3956,87.7
'11210, 관악구,'065,60~64세,2019,33762,15726,18036,87.2,31509,14635,16874,86.7
'11210, 관악구,'065001, 60세,2019,7242,3391,3851,88.1,6754,3140,3614,86.9
'11210, 관악구,'065002, 61세,2019,6804,3279,3525,93,6301,3019,3282,92
'11210, 관악구,'065003, 62세,2019,6721,3098,3623,85.5,6199,2848,3351,85
'11210, 관악구,'065004, 63세,2019,6371,2922,3449,84.7,5989,2768,3221,85.9
'11210, 관악구,'065005, 64세,2019,6624,3036,3588,84.6,6266,2860,3406,84
'11210, 관악구,'070,65~69세,2019,24987,11512,13475,85.4,23888,11018,12870,85.6
'11210, 관악구,'070001, 65세,2019,5677,2609,3068,85,5332,2461,2871,85.7
'11210, 관악구,'070002, 66세,2019,4987,2217,2770,80,4757,2114,2643,80
'11210, 관악구,'070003, 67세,2019,5550,2587,2963,87.3,5349,2494,2855,87.4
'11210, 관악구,'070004, 68세,2019,4205,1922,2283,84.2,4006,1825,2181,83.7
'11210, 관악구,'070005, 69세,2019,4568,2177,2391,91,4444,2124,2320,91.6
'11210, 관악구,'075,70~74세,2019,20224,9209,11015,83.6,19846,9056,10790,83.9
'11210, 관악구,'075001, 70세,2019,4676,2145,2531,84.7,4548,2095,2453,85.4
'11210, 관악구,'075002, 71세,2019,4380,1979,2401,82.4,4296,1943,2353,82.6
'11210, 관악구,'075003, 72세,2019,4454,2034,2420,84,4391,2009,2382,84.3
'11210, 관악구,'075004, 73세,2019,3409,1525,1884,80.9,3355,1503,1852,81.2
'11210, 관악구,'075005, 74세,2019,3305,1526,1779,85.8,3256,1506,1750,86.1
'11210, 관악구,'080,75~79세,2019,15311,7051,8260,85.4,15163,7012,8151,86
'11210, 관악구,'080001, 75세,2019,3267,1502,1765,85.1,3239,1494,1745,85.6
'11210, 관악구,'080002, 76세,2019,3256,1498,1758,85.2,3222,1484,1738,85.4
'11210, 관악구,'080003, 77세,2019,3635,1697,1938,87.6,3609,1693,1916,88.4
'11210, 관악구,'080004, 78세,2019,2811,1327,1484,89.4,2784,1322,1462,90.4
'11210, 관악구,'080005, 79세,2019,2342,1027,1315,78.1,2309,1019,1290,79
'11210, 관악구,'085,80~84세,2019,8233,3527,4706,74.9,8116,3494,4622,75.6
'11210, 관악구,'085001, 80세,2019,2273,1049,1224,85.7,2242,1042,1200,86.8
'11210, 관악구,'085002, 81세,2019,1889,838,1051,79.7,1857,830,1027,80.8
'11210, 관악구,'085003, 82세,2019,1553,642,911,70.5,1532,635,897,70.8
'11210, 관악구,'085004, 83세,2019,1314,537,777,69.1,1295,529,766,69.1
'11210, 관악구,'085005, 84세,2019,1204,461,743,62,1190,458,732,62.6
'11210, 관악구,'086,85세이상,2019,4396,1373,3023,45.4,4333,1355,2978,45.5
'11210, 관악구,'090,85~89세,2019,3120,1091,2029,53.8,3072,1076,1996,53.9
'11210, 관악구,'090001, 85세,2019,872,341,531,64.2,861,339,522,64.9
'11210, 관악구,'090002, 86세,2019,738,260,478,54.4,725,257,468,54.9
'11210, 관악구,'090003, 87세,2019,615,216,399,54.1,610,212,398,53.3
'11210, 관악구,'090004, 88세,2019,480,144,336,42.9,471,142,329,43.2
'11210, 관악구,'090005, 89세,2019,415,130,285,45.6,405,126,279,45.2
'11210, 관악구,'095,90~94세,2019,1002,224,778,28.8,992,222,770,28.8
'11210, 관악구,'095001, 90세,2019,333,87,246,35.4,331,87,244,35.7
'11210, 관악구,'095002, 91세,2019,254,58,196,29.6,250,56,194,28.9
'11210, 관악구,'095003, 92세,2019,192,52,140,37.1,190,52,138,37.7
'11210, 관악구,'095004, 93세,2019,146,19,127,15,145,19,126,15.1
'11210, 관악구,'095005, 94세,2019,77,8,69,11.6,76,8,68,11.8
'11210, 관악구,'100,95~99세,2019,238,53,185,28.6,233,52,181,28.7
'11210, 관악구,'100001, 95세,2019,71,14,57,24.6,67,13,54,24.1
'11210, 관악구,'100002, 96세,2019,79,17,62,27.4,78,17,61,27.9
'11210, 관악구,'100003, 97세,2019,44,13,31,41.9,44,13,31,41.9
'11210, 관악구,'100004, 98세,2019,28,6,22,27.3,28,6,22,27.3
'11210, 관악구,'100005, 99세,2019,16,X,13,23.1,16,X,13,23.1
'11210, 관악구,'101,100세이상,2019,36,5,31,16.1,36,5,31,16.1
'11210, 관악구,'102,15세미만,2019,38026,19574,18452,106.1,36910,19022,17888,106.3
'11210, 관악구,'103,15~64세,2019,396651,201836,194815,103.6,374220,191248,182972,104.5
'11210, 관악구,'104,65세이상,2019,73151,32672,40479,80.7,71346,31935,39411,81
'11210, 관악구,'126,평균연령,2019,41.9,41.1,42.7,,41.9,41,42.7,
'11210, 관악구,'127,중위연령,2019,39.4,38.6,40.4,,39.3,38.4,40.3,
'11220, 서초구,'000,합계,2019,404960,194195,210765,92.1,397025,189922,207103,91.7
'11220, 서초구,'005,0~4세,2019,14509,7452,7057,105.6,14027,7183,6844,105
'11220, 서초구,'005001, 0세,2019,2450,1276,1174,108.7,2414,1255,1159,108.3
'11220, 서초구,'005002, 1세,2019,2633,1419,1214,116.9,2559,1378,1181,116.7
'11220, 서초구,'005003, 2세,2019,2807,1399,1408,99.4,2684,1337,1347,99.3
'11220, 서초구,'005004, 3세,2019,3205,1607,1598,100.6,3080,1538,1542,99.7
'11220, 서초구,'005005, 4세,2019,3414,1751,1663,105.3,3290,1675,1615,103.7
'11220, 서초구,'010,5~9세,2019,19678,10237,9441,108.4,19338,10044,9294,108.1
'11220, 서초구,'010001, 5세,2019,3547,1871,1676,111.6,3443,1813,1630,111.2
'11220, 서초구,'010002, 6세,2019,3770,1974,1796,109.9,3705,1944,1761,110.4
'11220, 서초구,'010003, 7세,2019,4110,2135,1975,108.1,4040,2091,1949,107.3
'11220, 서초구,'010004, 8세,2019,4228,2220,2008,110.6,4170,2179,1991,109.4
'11220, 서초구,'010005, 9세,2019,4023,2037,1986,102.6,3980,2017,1963,102.8
'11220, 서초구,'015,10~14세,2019,20323,10374,9949,104.3,20128,10261,9867,104
'11220, 서초구,'015001, 10세,2019,3977,2043,1934,105.6,3924,2010,1914,105
'11220, 서초구,'015002, 11세,2019,4203,2149,2054,104.6,4161,2126,2035,104.5
'11220, 서초구,'015003, 12세,2019,4356,2142,2214,96.7,4307,2117,2190,96.7
'11220, 서초구,'015004, 13세,2019,3970,2052,1918,107,3941,2035,1906,106.8
'11220, 서초구,'015005, 14세,2019,3817,1988,1829,108.7,3795,1973,1822,108.3
'11220, 서초구,'020,15~19세,2019,21377,10694,10683,100.1,21202,10590,10612,99.8
'11220, 서초구,'020001, 15세,2019,4422,2240,2182,102.7,4398,2223,2175,102.2
'11220, 서초구,'020002, 16세,2019,3887,1981,1906,103.9,3865,1971,1894,104.1
'11220, 서초구,'020003, 17세,2019,3947,1990,1957,101.7,3921,1976,1945,101.6
'11220, 서초구,'020004, 18세,2019,4250,2126,2124,100.1,4229,2120,2109,100.5
'11220, 서초구,'020005, 19세,2019,4871,2357,2514,93.8,4789,2300,2489,92.4
'11220, 서초구,'025,20~24세,2019,23385,11325,12060,93.9,22741,10922,11819,92.4
'11220, 서초구,'025001, 20세,2019,4542,2231,2311,96.5,4458,2173,2285,95.1
'11220, 서초구,'025002, 21세,2019,4612,2328,2284,101.9,4516,2269,2247,101
'11220, 서초구,'025003, 22세,2019,4612,2298,2314,99.3,4463,2211,2252,98.2
'11220, 서초구,'025004, 23세,2019,4733,2254,2479,90.9,4592,2164,2428,89.1
'11220, 서초구,'025005, 24세,2019,4886,2214,2672,82.9,4712,2105,2607,80.7
'11220, 서초구,'030,25~29세,2019,28936,13716,15220,90.1,27963,13159,14804,88.9
'11220, 서초구,'030001, 25세,2019,5333,2563,2770,92.5,5120,2440,2680,91
'11220, 서초구,'030002, 26세,2019,5687,2676,3011,88.9,5483,2563,2920,87.8
'11220, 서초구,'030003, 27세,2019,6064,2846,3218,88.4,5876,2736,3140,87.1
'11220, 서초구,'030004, 28세,2019,6044,2820,3224,87.5,5863,2721,3142,86.6
'11220, 서초구,'030005, 29세,2019,5808,2811,2997,93.8,5621,2699,2922,92.4
'11220, 서초구,'035,30~34세,2019,29252,13623,15629,87.2,28188,13030,15158,86
'11220, 서초구,'035001, 30세,2019,6003,2794,3209,87.1,5774,2681,3093,86.7
'11220, 서초구,'035002, 31세,2019,5850,2731,3119,87.6,5633,2617,3016,86.8
'11220, 서초구,'035003, 32세,2019,5876,2716,3160,85.9,5664,2591,3073,84.3
'11220, 서초구,'035004, 33세,2019,5761,2687,3074,87.4,5567,2575,2992,86.1
'11220, 서초구,'035005, 34세,2019,5762,2695,3067,87.9,5550,2566,2984,86
'11220, 서초구,'040,35~39세,2019,34016,15878,18138,87.5,33066,15322,17744,86.4
'11220, 서초구,'040001, 35세,2019,6059,2866,3193,89.8,5857,2743,3114,88.1
'11220, 서초구,'040002, 36세,2019,6483,3013,3470,86.8,6294,2904,3390,85.7
'11220, 서초구,'040003, 37세,2019,7113,3352,3761,89.1,6907,3236,3671,88.2
'11220, 서초구,'040004, 38세,2019,7077,3254,3823,85.1,6884,3140,3744,83.9
'11220, 서초구,'040005, 39세,2019,7284,3393,3891,87.2,7124,3299,3825,86.2
'11220, 서초구,'045,40~44세,2019,34318,16000,18318,87.3,33589,15605,17984,86.8
'11220, 서초구,'045001, 40세,2019,7082,3319,3763,88.2,6911,3219,3692,87.2
'11220, 서초구,'045002, 41세,2019,6439,3004,3435,87.5,6299,2935,3364,87.2
'11220, 서초구,'045003, 42세,2019,6995,3228,3767,85.7,6847,3141,3706,84.8
'11220, 서초구,'045004, 43세,2019,6842,3098,3744,82.7,6708,3029,3679,82.3
'11220, 서초구,'045005, 44세,2019,6960,3351,3609,92.9,6824,3281,3543,92.6
'11220, 서초구,'050,45~49세,2019,39364,19084,20280,94.1,38689,18702,19987,93.6
'11220, 서초구,'050001, 45세,2019,7737,3682,4055,90.8,7598,3599,3999,90
'11220, 서초구,'050002, 46세,2019,7828,3740,4088,91.5,7694,3665,4029,91
'11220, 서초구,'050003, 47세,2019,7879,3844,4035,95.3,7753,3766,3987,94.5
'11220, 서초구,'050004, 48세,2019,8130,3986,4144,96.2,7996,3911,4085,95.7
'11220, 서초구,'050005, 49세,2019,7790,3832,3958,96.8,7648,3761,3887,96.8
'11220, 서초구,'055,50~54세,2019,31931,15833,16098,98.4,31423,15612,15811,98.7
'11220, 서초구,'055001, 50세,2019,7416,3753,3663,102.5,7319,3711,3608,102.9
'11220, 서초구,'055002, 51세,2019,6930,3405,3525,96.6,6830,3363,3467,97
'11220, 서초구,'055003, 52세,2019,6204,3036,3168,95.8,6096,2985,3111,95.9
'11220, 서초구,'055004, 53세,2019,5455,2732,2723,100.3,5358,2690,2668,100.8
'11220, 서초구,'055005, 54세,2019,5926,2907,3019,96.3,5820,2863,2957,96.8
'11220, 서초구,'060,55~59세,2019,28272,13538,14734,91.9,27822,13339,14483,92.1
'11220, 서초구,'060001, 55세,2019,5645,2738,2907,94.2,5566,2703,2863,94.4
'11220, 서초구,'060002, 56세,2019,5711,2767,2944,94,5604,2721,2883,94.4
'11220, 서초구,'060003, 57세,2019,5434,2624,2810,93.4,5341,2577,2764,93.2
'11220, 서초구,'060004, 58세,2019,5726,2683,3043,88.2,5642,2649,2993,88.5
'11220, 서초구,'060005, 59세,2019,5756,2726,3030,90,5669,2689,2980,90.2
'11220, 서초구,'065,60~64세,2019,26104,12045,14059,85.7,25726,11903,13823,86.1
'11220, 서초구,'065001, 60세,2019,5497,2517,2980,84.5,5416,2484,2932,84.7
'11220, 서초구,'065002, 61세,2019,5324,2535,2789,90.9,5248,2502,2746,91.1
'11220, 서초구,'065003, 62세,2019,5308,2414,2894,83.4,5228,2391,2837,84.3
'11220, 서초구,'065004, 63세,2019,4812,2259,2553,88.5,4739,2230,2509,88.9
'11220, 서초구,'065005, 64세,2019,5163,2320,2843,81.6,5095,2296,2799,82
'11220, 서초구,'070,65~69세,2019,18587,8560,10027,85.4,18410,8487,9923,85.5
'11220, 서초구,'070001, 65세,2019,4257,1981,2276,87,4206,1960,2246,87.3
'11220, 서초구,'070002, 66세,2019,4051,1823,2228,81.8,4017,1811,2206,82.1
'11220, 서초구,'070003, 67세,2019,4080,1865,2215,84.2,4045,1853,2192,84.5
'11220, 서초구,'070004, 68세,2019,2914,1379,1535,89.8,2886,1364,1522,89.6
'11220, 서초구,'070005, 69세,2019,3285,1512,1773,85.3,3256,1499,1757,85.3
'11220, 서초구,'075,70~74세,2019,15018,6984,8034,86.9,14934,6952,7982,87.1
'11220, 서초구,'075001, 70세,2019,3378,1528,1850,82.6,3364,1521,1843,82.5
'11220, 서초구,'075002, 71세,2019,3349,1584,1765,89.7,3323,1576,1747,90.2
'11220, 서초구,'075003, 72세,2019,3218,1491,1727,86.3,3207,1486,1721,86.3
'11220, 서초구,'075004, 73세,2019,2690,1239,1451,85.4,2671,1232,1439,85.6
'11220, 서초구,'075005, 74세,2019,2383,1142,1241,92,2369,1137,1232,92.3
'11220, 서초구,'080,75~79세,2019,10094,4962,5132,96.7,10043,4942,5101,96.9
'11220, 서초구,'080001, 75세,2019,2267,1104,1163,94.9,2254,1098,1156,95
'11220, 서초구,'080002, 76세,2019,2181,1070,1111,96.3,2170,1066,1104,96.6
'11220, 서초구,'080003, 77세,2019,2231,1135,1096,103.6,2224,1133,1091,103.8
'11220, 서초구,'080004, 78세,2019,1830,894,936,95.5,1820,892,928,96.1
'11220, 서초구,'080005, 79세,2019,1585,759,826,91.9,1575,753,822,91.6
'11220, 서초구,'085,80~84세,2019,5726,2593,3133,82.8,5697,2581,3116,82.8
'11220, 서초구,'085001, 80세,2019,1391,676,715,94.5,1386,674,712,94.7
'11220, 서초구,'085002, 81세,2019,1258,597,661,90.3,1252,596,656,90.9
'11220, 서초구,'085003, 82세,2019,1171,491,680,72.2,1162,486,676,71.9
'11220, 서초구,'085004, 83세,2019,965,440,525,83.8,963,439,524,83.8
'11220, 서초구,'085005, 84세,2019,941,389,552,70.5,934,386,548,70.4
'11220, 서초구,'086,85세이상,2019,4070,1297,2773,46.8,4039,1288,2751,46.8
'11220, 서초구,'090,85~89세,2019,2636,927,1709,54.2,2622,925,1697,54.5
'11220, 서초구,'090001, 85세,2019,720,273,447,61.1,717,272,445,61.1
'11220, 서초구,'090002, 86세,2019,590,211,379,55.7,589,211,378,55.8
'11220, 서초구,'090003, 87세,2019,574,216,358,60.3,570,215,355,60.6
'11220, 서초구,'090004, 88세,2019,392,128,264,48.5,388,128,260,49.2
'11220, 서초구,'090005, 89세,2019,360,99,261,37.9,358,99,259,38.2
'11220, 서초구,'095,90~94세,2019,1128,306,822,37.2,1118,301,817,36.8
'11220, 서초구,'095001, 90세,2019,341,103,238,43.3,339,103,236,43.6
'11220, 서초구,'095002, 91세,2019,306,67,239,28,302,66,236,28
'11220, 서초구,'095003, 92세,2019,218,58,160,36.3,215,55,160,34.4
'11220, 서초구,'095004, 93세,2019,144,47,97,48.5,144,47,97,48.5
'11220, 서초구,'095005, 94세,2019,119,31,88,35.2,118,30,88,34.1
'11220, 서초구,'100,95~99세,2019,271,59,212,27.8,266,58,208,27.9
'11220, 서초구,'100001, 95세,2019,89,18,71,25.4,88,18,70,25.7
'11220, 서초구,'100002, 96세,2019,85,27,58,46.6,84,27,57,47.4
'11220, 서초구,'100003, 97세,2019,50,7,43,16.3,49,7,42,16.7
'11220, 서초구,'100004, 98세,2019,26,X,24,8.3,26,X,24,8.3
'11220, 서초구,'100005, 99세,2019,21,5,16,31.3,19,X,15,26.7
'11220, 서초구,'101,100세이상,2019,35,5,30,16.7,33,X,29,13.8
'11220, 서초구,'102,15세미만,2019,54510,28063,26447,106.1,53493,27488,26005,105.7
'11220, 서초구,'103,15~64세,2019,296955,141736,155219,91.3,290409,138184,152225,90.8
'11220, 서초구,'104,65세이상,2019,53495,24396,29099,83.8,53123,24250,28873,84
'11220, 서초구,'126,평균연령,2019,40.9,40.3,41.5,,41,40.4,41.6,
'11220, 서초구,'127,중위연령,2019,41.6,41.2,42,,41.8,41.4,42.1,
'11230, 강남구,'000,합계,2019,509199,244403,264796,92.3,499474,239049,260425,91.8
'11230, 강남구,'005,0~4세,2019,14823,7611,7212,105.5,14512,7422,7090,104.7
'11230, 강남구,'005001, 0세,2019,2630,1386,1244,111.4,2598,1366,1232,110.9
'11230, 강남구,'005002, 1세,2019,2664,1443,1221,118.2,2611,1412,1199,117.8
'11230, 강남구,'005003, 2세,2019,2825,1427,1398,102.1,2744,1376,1368,100.6
'11230, 강남구,'005004, 3세,2019,3240,1586,1654,95.9,3157,1540,1617,95.2
'11230, 강남구,'005005, 4세,2019,3464,1769,1695,104.4,3402,1728,1674,103.2
'11230, 강남구,'010,5~9세,2019,21071,11016,10055,109.6,20875,10888,9987,109
'11230, 강남구,'010001, 5세,2019,3719,1955,1764,110.8,3670,1926,1744,110.4
'11230, 강남구,'010002, 6세,2019,4037,2091,1946,107.5,3988,2058,1930,106.6
'11230, 강남구,'010003, 7세,2019,4373,2287,2086,109.6,4331,2260,2071,109.1
'11230, 강남구,'010004, 8세,2019,4531,2390,2141,111.6,4495,2365,2130,111
'11230, 강남구,'010005, 9세,2019,4411,2293,2118,108.3,4391,2279,2112,107.9
'11230, 강남구,'015,10~14세,2019,25580,13377,12203,109.6,25481,13327,12154,109.7
'11230, 강남구,'015001, 10세,2019,4480,2329,2151,108.3,4459,2318,2141,108.3
'11230, 강남구,'015002, 11세,2019,5156,2689,2467,109,5137,2680,2457,109.1
'11230, 강남구,'015003, 12세,2019,5632,2948,2684,109.8,5611,2938,2673,109.9
'11230, 강남구,'015004, 13세,2019,5137,2699,2438,110.7,5119,2691,2428,110.8
'11230, 강남구,'015005, 14세,2019,5175,2712,2463,110.1,5155,2700,2455,110
'11230, 강남구,'020,15~19세,2019,28841,14972,13869,108,28595,14831,13764,107.8
'11230, 강남구,'020001, 15세,2019,5652,3004,2648,113.4,5623,2982,2641,112.9
'11230, 강남구,'020002, 16세,2019,5430,2804,2626,106.8,5403,2786,2617,106.5
'11230, 강남구,'020003, 17세,2019,5360,2788,2572,108.4,5324,2770,2554,108.5
'11230, 강남구,'020004, 18세,2019,6047,3121,2926,106.7,6010,3104,2906,106.8
'11230, 강남구,'020005, 19세,2019,6352,3255,3097,105.1,6235,3189,3046,104.7
'11230, 강남구,'025,20~24세,2019,29822,14654,15168,96.6,28752,14020,14732,95.2
'11230, 강남구,'025001, 20세,2019,5633,2849,2784,102.3,5456,2725,2731,99.8
'11230, 강남구,'025002, 21세,2019,5803,3061,2742,111.6,5615,2951,2664,110.8
'11230, 강남구,'025003, 22세,2019,5767,2843,2924,97.2,5578,2721,2857,95.2
'11230, 강남구,'025004, 23세,2019,6207,2954,3253,90.8,5962,2824,3138,90
'11230, 강남구,'025005, 24세,2019,6412,2947,3465,85.1,6141,2799,3342,83.8
'11230, 강남구,'030,25~29세,2019,38842,18231,20611,88.5,37255,17385,19870,87.5
'11230, 강남구,'030001, 25세,2019,7056,3254,3802,85.6,6775,3117,3658,85.2
'11230, 강남구,'030002, 26세,2019,7557,3568,3989,89.4,7237,3395,3842,88.4
'11230, 강남구,'030003, 27세,2019,8230,3805,4425,86,7897,3633,4264,85.2
'11230, 강남구,'030004, 28세,2019,7930,3804,4126,92.2,7612,3623,3989,90.8
'11230, 강남구,'030005, 29세,2019,8069,3800,4269,89,7734,3617,4117,87.9
'11230, 강남구,'035,30~34세,2019,38140,17805,20335,87.6,36652,16959,19693,86.1
'11230, 강남구,'035001, 30세,2019,8009,3780,4229,89.4,7692,3622,4070,89
'11230, 강남구,'035002, 31세,2019,7503,3472,4031,86.1,7202,3297,3905,84.4
'11230, 강남구,'035003, 32세,2019,7577,3478,4099,84.8,7283,3321,3962,83.8
'11230, 강남구,'035004, 33세,2019,7563,3569,3994,89.4,7276,3392,3884,87.3
'11230, 강남구,'035005, 34세,2019,7488,3506,3982,88,7199,3327,3872,85.9
'11230, 강남구,'040,35~39세,2019,42611,19670,22941,85.7,41438,18977,22461,84.5
'11230, 강남구,'040001, 35세,2019,7767,3616,4151,87.1,7505,3454,4051,85.3
'11230, 강남구,'040002, 36세,2019,8211,3837,4374,87.7,7977,3703,4274,86.6
'11230, 강남구,'040003, 37세,2019,8753,3944,4809,82,8498,3797,4701,80.8
'11230, 강남구,'040004, 38세,2019,8962,4128,4834,85.4,8768,4016,4752,84.5
'11230, 강남구,'040005, 39세,2019,8918,4145,4773,86.8,8690,4007,4683,85.6
'11230, 강남구,'045,40~44세,2019,42820,19648,23172,84.8,41978,19148,22830,83.9
'11230, 강남구,'045001, 40세,2019,8866,3992,4874,81.9,8661,3872,4789,80.9
'11230, 강남구,'045002, 41세,2019,8082,3757,4325,86.9,7902,3637,4265,85.3
'11230, 강남구,'045003, 42세,2019,8489,3887,4602,84.5,8328,3803,4525,84
'11230, 강남구,'045004, 43세,2019,8460,3879,4581,84.7,8319,3799,4520,84
'11230, 강남구,'045005, 44세,2019,8923,4133,4790,86.3,8768,4037,4731,85.3
'11230, 강남구,'050,45~49세,2019,50261,24068,26193,91.9,49541,23649,25892,91.3
'11230, 강남구,'050001, 45세,2019,9610,4476,5134,87.2,9459,4380,5079,86.2
'11230, 강남구,'050002, 46세,2019,9663,4491,5172,86.8,9521,4408,5113,86.2
'11230, 강남구,'050003, 47세,2019,10156,4860,5296,91.8,10010,4782,5228,91.5
'11230, 강남구,'050004, 48세,2019,10625,5262,5363,98.1,10488,5185,5303,97.8
'11230, 강남구,'050005, 49세,2019,10207,4979,5228,95.2,10063,4894,5169,94.7
'11230, 강남구,'055,50~54세,2019,41943,20990,20953,100.2,41350,20692,20658,100.2
'11230, 강남구,'055001, 50세,2019,9807,4896,4911,99.7,9676,4827,4849,99.5
'11230, 강남구,'055002, 51세,2019,8956,4477,4479,100,8854,4420,4434,99.7
'11230, 강남구,'055003, 52세,2019,8221,4011,4210,95.3,8095,3948,4147,95.2
'11230, 강남구,'055004, 53세,2019,7277,3773,3504,107.7,7161,3717,3444,107.9
'11230, 강남구,'055005, 54세,2019,7682,3833,3849,99.6,7564,3780,3784,99.9
'11230, 강남구,'060,55~59세,2019,35466,17276,18190,95,34943,17040,17903,95.2
'11230, 강남구,'060001, 55세,2019,7152,3516,3636,96.7,7048,3470,3578,97
'11230, 강남구,'060002, 56세,2019,7305,3612,3693,97.8,7178,3554,3624,98.1
'11230, 강남구,'060003, 57세,2019,6773,3394,3379,100.4,6665,3337,3328,100.3
'11230, 강남구,'060004, 58세,2019,7127,3410,3717,91.7,7051,3379,3672,92
'11230, 강남구,'060005, 59세,2019,7109,3344,3765,88.8,7001,3300,3701,89.2
'11230, 강남구,'065,60~64세,2019,32189,14747,17442,84.5,31758,14567,17191,84.7
'11230, 강남구,'065001, 60세,2019,6593,3097,3496,88.6,6500,3061,3439,89
'11230, 강남구,'065002, 61세,2019,6478,2969,3509,84.6,6394,2938,3456,85
'11230, 강남구,'065003, 62세,2019,6572,3044,3528,86.3,6478,3003,3475,86.4
'11230, 강남구,'065004, 63세,2019,6092,2812,3280,85.7,6003,2771,3232,85.7
'11230, 강남구,'065005, 64세,2019,6454,2825,3629,77.8,6383,2794,3589,77.8
'11230, 강남구,'070,65~69세,2019,23510,10706,12804,83.6,23303,10629,12674,83.9
'11230, 강남구,'070001, 65세,2019,5415,2469,2946,83.8,5349,2444,2905,84.1
'11230, 강남구,'070002, 66세,2019,5027,2246,2781,80.8,4982,2230,2752,81
'11230, 강남구,'070003, 67세,2019,5292,2398,2894,82.9,5243,2379,2864,83.1
'11230, 강남구,'070004, 68세,2019,3579,1687,1892,89.2,3552,1677,1875,89.4
'11230, 강남구,'070005, 69세,2019,4197,1906,2291,83.2,4177,1899,2278,83.4
'11230, 강남구,'075,70~74세,2019,18895,8934,9961,89.7,18798,8885,9913,89.6
'11230, 강남구,'075001, 70세,2019,4294,1996,2298,86.9,4268,1985,2283,86.9
'11230, 강남구,'075002, 71세,2019,4220,2031,2189,92.8,4200,2019,2181,92.6
'11230, 강남구,'075003, 72세,2019,4096,1882,2214,85,4072,1869,2203,84.8
'11230, 강남구,'075004, 73세,2019,3335,1594,1741,91.6,3323,1590,1733,91.7
'11230, 강남구,'075005, 74세,2019,2950,1431,1519,94.2,2935,1422,1513,94
'11230, 강남구,'080,75~79세,2019,12433,6093,6340,96.1,12378,6065,6313,96.1
'11230, 강남구,'080001, 75세,2019,2796,1393,1403,99.3,2786,1386,1400,99
'11230, 강남구,'080002, 76세,2019,2639,1293,1346,96.1,2630,1289,1341,96.1
'11230, 강남구,'080003, 77세,2019,2761,1400,1361,102.9,2741,1391,1350,103
'11230, 강남구,'080004, 78세,2019,2287,1080,1207,89.5,2276,1076,1200,89.7
'11230, 강남구,'080005, 79세,2019,1950,927,1023,90.6,1945,923,1022,90.3
'11230, 강남구,'085,80~84세,2019,6919,3086,3833,80.5,6877,3064,3813,80.4
'11230, 강남구,'085001, 80세,2019,1686,819,867,94.5,1675,812,863,94.1
'11230, 강남구,'085002, 81세,2019,1577,713,864,82.5,1569,709,860,82.4
'11230, 강남구,'085003, 82세,2019,1411,624,787,79.3,1401,621,780,79.6
'11230, 강남구,'085004, 83세,2019,1144,503,641,78.5,1138,500,638,78.4
'11230, 강남구,'085005, 84세,2019,1101,427,674,63.4,1094,422,672,62.8
'11230, 강남구,'086,85세이상,2019,5033,1519,3514,43.2,4988,1501,3487,43
'11230, 강남구,'090,85~89세,2019,3298,1087,2211,49.2,3272,1077,2195,49.1
'11230, 강남구,'090001, 85세,2019,892,321,571,56.2,883,318,565,56.3
'11230, 강남구,'090002, 86세,2019,716,243,473,51.4,711,242,469,51.6
'11230, 강남구,'090003, 87세,2019,706,245,461,53.1,703,244,459,53.2
'11230, 강남구,'090004, 88세,2019,506,146,360,40.6,503,145,358,40.5
'11230, 강남구,'090005, 89세,2019,478,132,346,38.2,472,128,344,37.2
'11230, 강남구,'095,90~94세,2019,1354,344,1010,34.1,1340,338,1002,33.7
'11230, 강남구,'095001, 90세,2019,428,118,310,38.1,424,117,307,38.1
'11230, 강남구,'095002, 91세,2019,330,80,250,32,326,77,249,30.9
'11230, 강남구,'095003, 92세,2019,269,65,204,31.9,267,64,203,31.5
'11230, 강남구,'095004, 93세,2019,171,37,134,27.6,169,36,133,27.1
'11230, 강남구,'095005, 94세,2019,156,44,112,39.3,154,44,110,40
'11230, 강남구,'100,95~99세,2019,334,81,253,32,332,79,253,31.2
'11230, 강남구,'100001, 95세,2019,114,29,85,34.1,113,28,85,32.9
'11230, 강남구,'100002, 96세,2019,88,20,68,29.4,88,20,68,29.4
'11230, 강남구,'100003, 97세,2019,56,12,44,27.3,55,11,44,25
'11230, 강남구,'100004, 98세,2019,44,13,31,41.9,44,13,31,41.9
'11230, 강남구,'100005, 99세,2019,32,7,25,28,32,7,25,28
'11230, 강남구,'101,100세이상,2019,47,7,40,17.5,44,7,37,18.9
'11230, 강남구,'102,15세미만,2019,61474,32004,29470,108.6,60868,31637,29231,108.2
'11230, 강남구,'103,15~64세,2019,380935,182061,198874,91.5,372262,177268,194994,90.9
'11230, 강남구,'104,65세이상,2019,66790,30338,36452,83.2,66344,30144,36200,83.3
'11230, 강남구,'126,평균연령,2019,41.2,40.5,41.9,,41.3,40.6,41.9,
'11230, 강남구,'127,중위연령,2019,41.7,41.2,42.2,,42,41.5,42.3,
'11240, 송파구,'000,합계,2019,648600,313725,334875,93.7,637683,308300,329383,93.6
'11240, 송파구,'005,0~4세,2019,24494,12813,11681,109.7,24147,12627,11520,109.6
'11240, 송파구,'005001, 0세,2019,4389,2282,2107,108.3,4351,2260,2091,108.1
'11240, 송파구,'005002, 1세,2019,4421,2345,2076,113,4354,2308,2046,112.8
'11240, 송파구,'005003, 2세,2019,4814,2499,2315,107.9,4744,2462,2282,107.9
'11240, 송파구,'005004, 3세,2019,5433,2856,2577,110.8,5338,2800,2538,110.3
'11240, 송파구,'005005, 4세,2019,5437,2831,2606,108.6,5360,2797,2563,109.1
'11240, 송파구,'010,5~9세,2019,27386,14026,13360,105,27144,13910,13234,105.1
'11240, 송파구,'010001, 5세,2019,5200,2673,2527,105.8,5142,2646,2496,106
'11240, 송파구,'010002, 6세,2019,5273,2688,2585,104,5217,2657,2560,103.8
'11240, 송파구,'010003, 7세,2019,5849,2974,2875,103.4,5802,2955,2847,103.8
'11240, 송파구,'010004, 8세,2019,5536,2887,2649,109,5488,2866,2622,109.3
'11240, 송파구,'010005, 9세,2019,5528,2804,2724,102.9,5495,2786,2709,102.8
'11240, 송파구,'015,10~14세,2019,27014,13803,13211,104.5,26888,13748,13140,104.6
'11240, 송파구,'015001, 10세,2019,5236,2641,2595,101.8,5196,2624,2572,102
'11240, 송파구,'015002, 11세,2019,5459,2810,2649,106.1,5434,2801,2633,106.4
'11240, 송파구,'015003, 12세,2019,5662,2899,2763,104.9,5642,2892,2750,105.2
'11240, 송파구,'015004, 13세,2019,5392,2731,2661,102.6,5373,2719,2654,102.4
'11240, 송파구,'015005, 14세,2019,5265,2722,2543,107,5243,2712,2531,107.2
'11240, 송파구,'020,15~19세,2019,30762,15730,15032,104.6,30604,15645,14959,104.6
'11240, 송파구,'020001, 15세,2019,5665,2897,2768,104.7,5645,2886,2759,104.6
'11240, 송파구,'020002, 16세,2019,5624,2894,2730,106,5606,2885,2721,106
'11240, 송파구,'020003, 17세,2019,5727,2955,2772,106.6,5705,2948,2757,106.9
'11240, 송파구,'020004, 18세,2019,6549,3335,3214,103.8,6533,3323,3210,103.5
'11240, 송파구,'020005, 19세,2019,7197,3649,3548,102.8,7115,3603,3512,102.6
'11240, 송파구,'025,20~24세,2019,38305,18820,19485,96.6,37635,18475,19160,96.4
'11240, 송파구,'025001, 20세,2019,7006,3637,3369,108,6895,3565,3330,107.1
'11240, 송파구,'025002, 21세,2019,7053,3666,3387,108.2,6946,3604,3342,107.8
'11240, 송파구,'025003, 22세,2019,7513,3779,3734,101.2,7396,3727,3669,101.6
'11240, 송파구,'025004, 23세,2019,8020,3749,4271,87.8,7862,3673,4189,87.7
'11240, 송파구,'025005, 24세,2019,8713,3989,4724,84.4,8536,3906,4630,84.4
'11240, 송파구,'030,25~29세,2019,51785,24296,27489,88.4,50599,23719,26880,88.2
'11240, 송파구,'030001, 25세,2019,9680,4482,5198,86.2,9438,4365,5073,86
'11240, 송파구,'030002, 26세,2019,10318,4829,5489,88,10080,4726,5354,88.3
'11240, 송파구,'030003, 27세,2019,10726,4977,5749,86.6,10503,4871,5632,86.5
'11240, 송파구,'030004, 28세,2019,10478,4976,5502,90.4,10262,4855,5407,89.8
'11240, 송파구,'030005, 29세,2019,10583,5032,5551,90.7,10316,4902,5414,90.5
'11240, 송파구,'035,30~34세,2019,52640,25190,27450,91.8,51185,24477,26708,91.6
'11240, 송파구,'035001, 30세,2019,10646,5049,5597,90.2,10350,4923,5427,90.7
'11240, 송파구,'035002, 31세,2019,10341,4980,5361,92.9,10067,4855,5212,93.2
'11240, 송파구,'035003, 32세,2019,10585,5080,5505,92.3,10256,4906,5350,91.7
'11240, 송파구,'035004, 33세,2019,10571,5052,5519,91.5,10294,4909,5385,91.2
'11240, 송파구,'035005, 34세,2019,10497,5029,5468,92,10218,4884,5334,91.6
'11240, 송파구,'040,35~39세,2019,57621,27933,29688,94.1,56477,27311,29166,93.6
'11240, 송파구,'040001, 35세,2019,10651,5197,5454,95.3,10387,5056,5331,94.8
'11240, 송파구,'040002, 36세,2019,11533,5547,5986,92.7,11268,5398,5870,92
'11240, 송파구,'040003, 37세,2019,12004,5849,6155,95,11774,5727,6047,94.7
'11240, 송파구,'040004, 38세,2019,11727,5747,5980,96.1,11509,5623,5886,95.5
'11240, 송파구,'040005, 39세,2019,11706,5593,6113,91.5,11539,5507,6032,91.3
'11240, 송파구,'045,40~44세,2019,50333,24434,25899,94.3,49491,23980,25511,94
'11240, 송파구,'045001, 40세,2019,10984,5191,5793,89.6,10781,5083,5698,89.2
'11240, 송파구,'045002, 41세,2019,9646,4709,4937,95.4,9467,4604,4863,94.7
'11240, 송파구,'045003, 42세,2019,9904,4751,5153,92.2,9763,4673,5090,91.8
'11240, 송파구,'045004, 43세,2019,9698,4830,4868,99.2,9539,4744,4795,98.9
'11240, 송파구,'045005, 44세,2019,10101,4953,5148,96.2,9941,4876,5065,96.3
'11240, 송파구,'050,45~49세,2019,55111,26683,28428,93.9,54130,26143,27987,93.4
'11240, 송파구,'050001, 45세,2019,10654,5218,5436,96,10478,5127,5351,95.8
'11240, 송파구,'050002, 46세,2019,10707,5071,5636,90,10546,4976,5570,89.3
'11240, 송파구,'050003, 47세,2019,11051,5402,5649,95.6,10837,5279,5558,95
'11240, 송파구,'050004, 48세,2019,11777,5608,6169,90.9,11568,5490,6078,90.3
'11240, 송파구,'050005, 49세,2019,10922,5384,5538,97.2,10701,5271,5430,97.1
'11240, 송파구,'055,50~54세,2019,51701,24982,26719,93.5,50590,24455,26135,93.6
'11240, 송파구,'055001, 50세,2019,11208,5469,5739,95.3,10982,5353,5629,95.1
'11240, 송파구,'055002, 51세,2019,10936,5172,5764,89.7,10671,5049,5622,89.8
'11240, 송파구,'055003, 52세,2019,9934,4776,5158,92.6,9757,4688,5069,92.5
'11240, 송파구,'055004, 53세,2019,9553,4712,4841,97.3,9342,4625,4717,98
'11240, 송파구,'055005, 54세,2019,10070,4853,5217,93,9838,4740,5098,93
'11240, 송파구,'060,55~59세,2019,51092,24185,26907,89.9,50034,23696,26338,90
'11240, 송파구,'060001, 55세,2019,9534,4565,4969,91.9,9289,4448,4841,91.9
'11240, 송파구,'060002, 56세,2019,10175,4926,5249,93.8,9927,4810,5117,94
'11240, 송파구,'060003, 57세,2019,9840,4734,5106,92.7,9637,4635,5002,92.7
'11240, 송파구,'060004, 58세,2019,10684,4960,5724,86.7,10533,4896,5637,86.9
'11240, 송파구,'060005, 59세,2019,10859,5000,5859,85.3,10648,4907,5741,85.5
'11240, 송파구,'065,60~64세,2019,46846,22099,24747,89.3,45973,21694,24279,89.4
'11240, 송파구,'065001, 60세,2019,10028,4756,5272,90.2,9841,4676,5165,90.5
'11240, 송파구,'065002, 61세,2019,9469,4477,4992,89.7,9285,4390,4895,89.7
'11240, 송파구,'065003, 62세,2019,9556,4468,5088,87.8,9366,4373,4993,87.6
'11240, 송파구,'065004, 63세,2019,8511,4022,4489,89.6,8359,3957,4402,89.9
'11240, 송파구,'065005, 64세,2019,9282,4376,4906,89.2,9122,4298,4824,89.1
'11240, 송파구,'070,65~69세,2019,31885,15465,16420,94.2,31495,15278,16217,94.2
'11240, 송파구,'070001, 65세,2019,7544,3563,3981,89.5,7439,3516,3923,89.6
'11240, 송파구,'070002, 66세,2019,6870,3289,3581,91.8,6773,3242,3531,91.8
'11240, 송파구,'070003, 67세,2019,7205,3558,3647,97.6,7136,3519,3617,97.3
'11240, 송파구,'070004, 68세,2019,4890,2398,2492,96.2,4823,2369,2454,96.5
'11240, 송파구,'070005, 69세,2019,5376,2657,2719,97.7,5324,2632,2692,97.8
'11240, 송파구,'075,70~74세,2019,22540,11080,11460,96.7,22350,11005,11345,97
'11240, 송파구,'075001, 70세,2019,5310,2619,2691,97.3,5254,2597,2657,97.7
'11240, 송파구,'075002, 71세,2019,4921,2428,2493,97.4,4882,2415,2467,97.9
'11240, 송파구,'075003, 72세,2019,5110,2508,2602,96.4,5077,2494,2583,96.6
'11240, 송파구,'075004, 73세,2019,3779,1854,1925,96.3,3744,1840,1904,96.6
'11240, 송파구,'075005, 74세,2019,3420,1671,1749,95.5,3393,1659,1734,95.7
'11240, 송파구,'080,75~79세,2019,14626,7005,7621,91.9,14555,6979,7576,92.1
'11240, 송파구,'080001, 75세,2019,3279,1619,1660,97.5,3266,1613,1653,97.6
'11240, 송파구,'080002, 76세,2019,3100,1509,1591,94.8,3087,1504,1583,95
'11240, 송파구,'080003, 77세,2019,3351,1595,1756,90.8,3337,1590,1747,91
'11240, 송파구,'080004, 78세,2019,2609,1218,1391,87.6,2596,1215,1381,88
'11240, 송파구,'080005, 79세,2019,2287,1064,1223,87,2269,1057,1212,87.2
'11240, 송파구,'085,80~84세,2019,8355,3427,4928,69.5,8316,3417,4899,69.7
'11240, 송파구,'085001, 80세,2019,2087,927,1160,79.9,2081,925,1156,80
'11240, 송파구,'085002, 81세,2019,1811,788,1023,77,1796,784,1012,77.5
'11240, 송파구,'085003, 82세,2019,1666,690,976,70.7,1658,689,969,71.1
'11240, 송파구,'085004, 83세,2019,1455,538,917,58.7,1448,536,912,58.8
'11240, 송파구,'085005, 84세,2019,1336,484,852,56.8,1333,483,850,56.8
'11240, 송파구,'086,85세이상,2019,6104,1754,4350,40.3,6070,1741,4329,40.2
'11240, 송파구,'090,85~89세,2019,4151,1291,2860,45.1,4129,1284,2845,45.1
'11240, 송파구,'090001, 85세,2019,1104,397,707,56.2,1098,397,701,56.6
'11240, 송파구,'090002, 86세,2019,986,291,695,41.9,981,289,692,41.8
'11240, 송파구,'090003, 87세,2019,861,268,593,45.2,856,266,590,45.1
'11240, 송파구,'090004, 88세,2019,652,192,460,41.7,647,189,458,41.3
'11240, 송파구,'090005, 89세,2019,548,143,405,35.3,547,143,404,35.4
'11240, 송파구,'095,90~94세,2019,1580,381,1199,31.8,1571,377,1194,31.6
'11240, 송파구,'095001, 90세,2019,486,122,364,33.5,483,120,363,33.1
'11240, 송파구,'095002, 91세,2019,399,106,293,36.2,399,106,293,36.2
'11240, 송파구,'095003, 92세,2019,319,76,243,31.3,317,75,242,31
'11240, 송파구,'095004, 93세,2019,222,47,175,26.9,219,46,173,26.6
'11240, 송파구,'095005, 94세,2019,154,30,124,24.2,153,30,123,24.4
'11240, 송파구,'100,95~99세,2019,332,73,259,28.2,329,71,258,27.5
'11240, 송파구,'100001, 95세,2019,105,30,75,40,105,30,75,40
'11240, 송파구,'100002, 96세,2019,96,18,78,23.1,95,17,78,21.8
'11240, 송파구,'100003, 97세,2019,58,8,50,16,57,7,50,14
'11240, 송파구,'100004, 98세,2019,46,10,36,27.8,45,10,35,28.6
'11240, 송파구,'100005, 99세,2019,27,7,20,35,27,7,20,35
'11240, 송파구,'101,100세이상,2019,41,9,32,28.1,41,9,32,28.1
'11240, 송파구,'102,15세미만,2019,78894,40642,38252,106.2,78179,40285,37894,106.3
'11240, 송파구,'103,15~64세,2019,486196,234352,251844,93.1,476718,229595,247123,92.9
'11240, 송파구,'104,65세이상,2019,83510,38731,44779,86.5,82786,38420,44366,86.6
'11240, 송파구,'126,평균연령,2019,41.3,40.7,41.9,,41.3,40.7,41.9,
'11240, 송파구,'127,중위연령,2019,41.3,40.8,41.9,,41.4,40.8,41.9,
'11250, 강동구,'000,합계,2019,415287,204807,210480,97.3,408618,201609,207009,97.4
'11250, 강동구,'005,0~4세,2019,14087,7278,6809,106.9,13946,7201,6745,106.8
'11250, 강동구,'005001, 0세,2019,2524,1278,1246,102.6,2500,1265,1235,102.4
'11250, 강동구,'005002, 1세,2019,2539,1327,1212,109.5,2517,1316,1201,109.6
'11250, 강동구,'005003, 2세,2019,2751,1410,1341,105.1,2721,1396,1325,105.4
'11250, 강동구,'005004, 3세,2019,3081,1621,1460,111,3048,1600,1448,110.5
'11250, 강동구,'005005, 4세,2019,3192,1642,1550,105.9,3160,1624,1536,105.7
'11250, 강동구,'010,5~9세,2019,16482,8592,7890,108.9,16383,8545,7838,109
'11250, 강동구,'010001, 5세,2019,3274,1662,1612,103.1,3248,1649,1599,103.1
'11250, 강동구,'010002, 6세,2019,3061,1599,1462,109.4,3040,1588,1452,109.4
'11250, 강동구,'010003, 7세,2019,3434,1796,1638,109.6,3413,1785,1628,109.6
'11250, 강동구,'010004, 8세,2019,3332,1752,1580,110.9,3319,1749,1570,111.4
'11250, 강동구,'010005, 9세,2019,3381,1783,1598,111.6,3363,1774,1589,111.6
'11250, 강동구,'015,10~14세,2019,16633,8843,7790,113.5,16580,8817,7763,113.6
'11250, 강동구,'015001, 10세,2019,3184,1619,1565,103.5,3170,1609,1561,103.1
'11250, 강동구,'015002, 11세,2019,3511,1903,1608,118.3,3499,1898,1601,118.6
'11250, 강동구,'015003, 12세,2019,3549,1928,1621,118.9,3541,1925,1616,119.1
'11250, 강동구,'015004, 13세,2019,3262,1733,1529,113.3,3256,1729,1527,113.2
'11250, 강동구,'015005, 14세,2019,3127,1660,1467,113.2,3114,1656,1458,113.6
'11250, 강동구,'020,15~19세,2019,19293,10189,9104,111.9,19206,10153,9053,112.2
'11250, 강동구,'020001, 15세,2019,3639,1889,1750,107.9,3624,1883,1741,108.2
'11250, 강동구,'020002, 16세,2019,3630,1916,1714,111.8,3622,1913,1709,111.9
'11250, 강동구,'020003, 17세,2019,3779,2061,1718,120,3767,2058,1709,120.4
'11250, 강동구,'020004, 18세,2019,4071,2169,1902,114,4054,2164,1890,114.5
'11250, 강동구,'020005, 19세,2019,4174,2154,2020,106.6,4139,2135,2004,106.5
'11250, 강동구,'025,20~24세,2019,24040,12321,11719,105.1,23647,12124,11523,105.2
'11250, 강동구,'025001, 20세,2019,4103,2209,1894,116.6,4052,2177,1875,116.1
'11250, 강동구,'025002, 21세,2019,4455,2330,2125,109.6,4400,2299,2101,109.4
'11250, 강동구,'025003, 22세,2019,4676,2438,2238,108.9,4608,2408,2200,109.5
'11250, 강동구,'025004, 23세,2019,5222,2578,2644,97.5,5127,2530,2597,97.4
'11250, 강동구,'025005, 24세,2019,5584,2766,2818,98.2,5460,2710,2750,98.5
'11250, 강동구,'030,25~29세,2019,30972,15410,15562,99,30316,15086,15230,99.1
'11250, 강동구,'030001, 25세,2019,5767,2764,3003,92,5649,2709,2940,92.1
'11250, 강동구,'030002, 26세,2019,6216,3126,3090,101.2,6093,3057,3036,100.7
'11250, 강동구,'030003, 27세,2019,6583,3238,3345,96.8,6446,3170,3276,96.8
'11250, 강동구,'030004, 28세,2019,6293,3133,3160,99.1,6156,3062,3094,99
'11250, 강동구,'030005, 29세,2019,6113,3149,2964,106.2,5972,3088,2884,107.1
'11250, 강동구,'035,30~34세,2019,29695,14887,14808,100.5,28963,14539,14424,100.8
'11250, 강동구,'035001, 30세,2019,5886,2956,2930,100.9,5742,2897,2845,101.8
'11250, 강동구,'035002, 31세,2019,5963,2984,2979,100.2,5814,2916,2898,100.6
'11250, 강동구,'035003, 32세,2019,5898,2916,2982,97.8,5743,2837,2906,97.6
'11250, 강동구,'035004, 33세,2019,5881,2950,2931,100.6,5731,2874,2857,100.6
'11250, 강동구,'035005, 34세,2019,6067,3081,2986,103.2,5933,3015,2918,103.3
'11250, 강동구,'040,35~39세,2019,34656,17418,17238,101,34017,17099,16918,101.1
'11250, 강동구,'040001, 35세,2019,6374,3200,3174,100.8,6223,3130,3093,101.2
'11250, 강동구,'040002, 36세,2019,6652,3339,3313,100.8,6534,3283,3251,101
'11250, 강동구,'040003, 37세,2019,7197,3565,3632,98.2,7066,3500,3566,98.1
'11250, 강동구,'040004, 38세,2019,7275,3663,3612,101.4,7157,3605,3552,101.5
'11250, 강동구,'040005, 39세,2019,7158,3651,3507,104.1,7037,3581,3456,103.6
'11250, 강동구,'045,40~44세,2019,31421,15728,15693,100.2,30903,15463,15440,100.1
'11250, 강동구,'045001, 40세,2019,6874,3428,3446,99.5,6770,3374,3396,99.4
'11250, 강동구,'045002, 41세,2019,6196,3104,3092,100.4,6087,3038,3049,99.6
'11250, 강동구,'045003, 42세,2019,6247,3101,3146,98.6,6137,3043,3094,98.4
'11250, 강동구,'045004, 43세,2019,5969,3060,2909,105.2,5859,3009,2850,105.6
'11250, 강동구,'045005, 44세,2019,6135,3035,3100,97.9,6050,2999,3051,98.3
'11250, 강동구,'050,45~49세,2019,34859,17341,17518,99,34170,17008,17162,99.1
'11250, 강동구,'050001, 45세,2019,6692,3375,3317,101.7,6598,3326,3272,101.7
'11250, 강동구,'050002, 46세,2019,6872,3347,3525,95,6741,3283,3458,94.9
'11250, 강동구,'050003, 47세,2019,6986,3496,3490,100.2,6848,3426,3422,100.1
'11250, 강동구,'050004, 48세,2019,7263,3687,3576,103.1,7099,3615,3484,103.8
'11250, 강동구,'050005, 49세,2019,7046,3436,3610,95.2,6884,3358,3526,95.2
'11250, 강동구,'055,50~54세,2019,33448,16215,17233,94.1,32724,15881,16843,94.3
'11250, 강동구,'055001, 50세,2019,7110,3448,3662,94.2,6961,3368,3593,93.7
'11250, 강동구,'055002, 51세,2019,7174,3486,3688,94.5,7027,3413,3614,94.4
'11250, 강동구,'055003, 52세,2019,6385,3026,3359,90.1,6260,2978,3282,90.7
'11250, 강동구,'055004, 53세,2019,6282,3144,3138,100.2,6127,3082,3045,101.2
'11250, 강동구,'055005, 54세,2019,6497,3111,3386,91.9,6349,3040,3309,91.9
'11250, 강동구,'060,55~59세,2019,35659,17040,18619,91.5,34887,16675,18212,91.6
'11250, 강동구,'060001, 55세,2019,6436,3066,3370,91,6280,2991,3289,90.9
'11250, 강동구,'060002, 56세,2019,6779,3283,3496,93.9,6588,3197,3391,94.3
'11250, 강동구,'060003, 57세,2019,7062,3454,3608,95.7,6910,3386,3524,96.1
'11250, 강동구,'060004, 58세,2019,7601,3577,4024,88.9,7489,3529,3960,89.1
'11250, 강동구,'060005, 59세,2019,7781,3660,4121,88.8,7620,3572,4048,88.2
'11250, 강동구,'065,60~64세,2019,33305,15701,17604,89.2,32661,15401,17260,89.2
'11250, 강동구,'065001, 60세,2019,7141,3344,3797,88.1,7014,3289,3725,88.3
'11250, 강동구,'065002, 61세,2019,6696,3214,3482,92.3,6543,3141,3402,92.3
'11250, 강동구,'065003, 62세,2019,6758,3236,3522,91.9,6631,3171,3460,91.6
'11250, 강동구,'065004, 63세,2019,6231,2874,3357,85.6,6110,2822,3288,85.8
'11250, 강동구,'065005, 64세,2019,6479,3033,3446,88,6363,2978,3385,88
'11250, 강동구,'070,65~69세,2019,22644,10936,11708,93.4,22320,10776,11544,93.3
'11250, 강동구,'070001, 65세,2019,5392,2574,2818,91.3,5303,2533,2770,91.4
'11250, 강동구,'070002, 66세,2019,4758,2275,2483,91.6,4681,2236,2445,91.5
'11250, 강동구,'070003, 67세,2019,5155,2482,2673,92.9,5090,2450,2640,92.8
'11250, 강동구,'070004, 68세,2019,3510,1731,1779,97.3,3460,1703,1757,96.9
'11250, 강동구,'070005, 69세,2019,3829,1874,1955,95.9,3786,1854,1932,96
'11250, 강동구,'075,70~74세,2019,16545,8105,8440,96,16441,8069,8372,96.4
'11250, 강동구,'075001, 70세,2019,3927,1899,2028,93.6,3895,1890,2005,94.3
'11250, 강동구,'075002, 71세,2019,3797,1907,1890,100.9,3774,1899,1875,101.3
'11250, 강동구,'075003, 72세,2019,3587,1695,1892,89.6,3565,1686,1879,89.7
'11250, 강동구,'075004, 73세,2019,2704,1340,1364,98.2,2684,1333,1351,98.7
'11250, 강동구,'075005, 74세,2019,2530,1264,1266,99.8,2523,1261,1262,99.9
'11250, 강동구,'080,75~79세,2019,10881,5187,5694,91.1,10832,5168,5664,91.2
'11250, 강동구,'080001, 75세,2019,2445,1190,1255,94.8,2430,1182,1248,94.7
'11250, 강동구,'080002, 76세,2019,2309,1122,1187,94.5,2298,1119,1179,94.9
'11250, 강동구,'080003, 77세,2019,2522,1194,1328,89.9,2514,1192,1322,90.2
'11250, 강동구,'080004, 78세,2019,1976,931,1045,89.1,1969,928,1041,89.1
'11250, 강동구,'080005, 79세,2019,1629,750,879,85.3,1621,747,874,85.5
'11250, 강동구,'085,80~84세,2019,6186,2425,3761,64.5,6161,2419,3742,64.6
'11250, 강동구,'085001, 80세,2019,1583,669,914,73.2,1575,667,908,73.5
'11250, 강동구,'085002, 81세,2019,1376,578,798,72.4,1368,577,791,72.9
'11250, 강동구,'085003, 82세,2019,1209,467,742,62.9,1205,465,740,62.8
'11250, 강동구,'085004, 83세,2019,1036,388,648,59.9,1033,387,646,59.9
'11250, 강동구,'085005, 84세,2019,982,323,659,49,980,323,657,49.2
'11250, 강동구,'086,85세이상,2019,4481,1191,3290,36.2,4461,1185,3276,36.2
'11250, 강동구,'090,85~89세,2019,2943,854,2089,40.9,2930,850,2080,40.9
'11250, 강동구,'090001, 85세,2019,789,251,538,46.7,786,251,535,46.9
'11250, 강동구,'090002, 86세,2019,668,216,452,47.8,662,214,448,47.8
'11250, 강동구,'090003, 87세,2019,593,159,434,36.6,591,159,432,36.8
'11250, 강동구,'090004, 88세,2019,451,120,331,36.3,450,119,331,36
'11250, 강동구,'090005, 89세,2019,442,108,334,32.3,441,107,334,32
'11250, 강동구,'095,90~94세,2019,1223,269,954,28.2,1219,268,951,28.2
'11250, 강동구,'095001, 90세,2019,393,100,293,34.1,392,100,292,34.2
'11250, 강동구,'095002, 91세,2019,295,68,227,30,295,68,227,30
'11250, 강동구,'095003, 92세,2019,242,48,194,24.7,241,47,194,24.2
'11250, 강동구,'095004, 93세,2019,170,35,135,25.9,169,35,134,26.1
'11250, 강동구,'095005, 94세,2019,123,18,105,17.1,122,18,104,17.3
'11250, 강동구,'100,95~99세,2019,272,62,210,29.5,270,61,209,29.2
'11250, 강동구,'100001, 95세,2019,80,20,60,33.3,80,20,60,33.3
'11250, 강동구,'100002, 96세,2019,80,17,63,27,79,16,63,25.4
'11250, 강동구,'100003, 97세,2019,45,9,36,25,45,9,36,25
'11250, 강동구,'100004, 98세,2019,36,9,27,33.3,35,9,26,34.6
'11250, 강동구,'100005, 99세,2019,31,7,24,29.2,31,7,24,29.2
'11250, 강동구,'101,100세이상,2019,43,6,37,16.2,42,6,36,16.7
'11250, 강동구,'102,15세미만,2019,47202,24713,22489,109.9,46909,24563,22346,109.9
'11250, 강동구,'103,15~64세,2019,307348,152250,155098,98.2,301494,149429,152065,98.3
'11250, 강동구,'104,65세이상,2019,60737,27844,32893,84.7,60215,27617,32598,84.7
'11250, 강동구,'126,평균연령,2019,42.7,41.7,43.6,,42.6,41.7,43.6,
'11250, 강동구,'127,중위연령,2019,43.4,42.3,44.6,,43.4,42.3,44.5,
'21,부산광역시,'000,합계,2019,3372692,1655566,1717126,96.4,3312190,1621545,1690645,95.9
'21,부산광역시,'005,0~4세,2019,108650,55707,52943,105.2,107869,55330,52539,105.3
'21,부산광역시,'005001, 0세,2019,17215,8763,8452,103.7,17109,8707,8402,103.6
'21,부산광역시,'005002, 1세,2019,19409,10002,9407,106.3,19265,9928,9337,106.3
'21,부산광역시,'005003, 2세,2019,21550,11070,10480,105.6,21376,10985,10391,105.7
'21,부산광역시,'005004, 3세,2019,24560,12536,12024,104.3,24376,12446,11930,104.3
'21,부산광역시,'005005, 4세,2019,25916,13336,12580,106,25743,13264,12479,106.3
'21,부산광역시,'010,5~9세,2019,131200,67395,63805,105.6,130691,67164,63527,105.7
'21,부산광역시,'010001, 5세,2019,25476,13124,12352,106.3,25357,13069,12288,106.4
'21,부산광역시,'010002, 6세,2019,25469,13041,12428,104.9,25360,12994,12366,105.1
'21,부산광역시,'010003, 7세,2019,27539,14181,13358,106.2,27424,14128,13296,106.3
'21,부산광역시,'010004, 8세,2019,27114,13798,13316,103.6,27036,13768,13268,103.8
'21,부산광역시,'010005, 9세,2019,25602,13251,12351,107.3,25514,13205,12309,107.3
'21,부산광역시,'015,10~14세,2019,124504,64129,60375,106.2,124150,63960,60190,106.3
'21,부산광역시,'015001, 10세,2019,24406,12560,11846,106,24340,12525,11815,106
'21,부산광역시,'015002, 11세,2019,25590,13146,12444,105.6,25514,13104,12410,105.6
'21,부산광역시,'015003, 12세,2019,26194,13419,12775,105,26125,13389,12736,105.1
'21,부산광역시,'015004, 13세,2019,24072,12467,11605,107.4,24013,12444,11569,107.6
'21,부산광역시,'015005, 14세,2019,24242,12537,11705,107.1,24158,12498,11660,107.2
'21,부산광역시,'020,15~19세,2019,159525,82794,76731,107.9,157152,81706,75446,108.3
'21,부산광역시,'020001, 15세,2019,26567,13780,12787,107.8,26479,13733,12746,107.7
'21,부산광역시,'020002, 16세,2019,27406,14397,13009,110.7,27317,14359,12958,110.8
'21,부산광역시,'020003, 17세,2019,28333,14744,13589,108.5,28170,14664,13506,108.6
'21,부산광역시,'020004, 18세,2019,34653,18151,16502,110,34108,17871,16237,110.1
'21,부산광역시,'020005, 19세,2019,42566,21722,20844,104.2,41078,21079,19999,105.4
'21,부산광역시,'025,20~24세,2019,226140,118208,107932,109.5,214191,112218,101973,110
'21,부산광역시,'025001, 20세,2019,41205,20805,20400,102,38701,19659,19042,103.2
'21,부산광역시,'025002, 21세,2019,43648,22448,21200,105.9,41151,21283,19868,107.1
'21,부산광역시,'025003, 22세,2019,45793,23874,21919,108.9,43488,22700,20788,109.2
'21,부산광역시,'025004, 23세,2019,47950,25526,22424,113.8,45602,24293,21309,114
'21,부산광역시,'025005, 24세,2019,47544,25555,21989,116.2,45249,24283,20966,115.8
'21,부산광역시,'030,25~29세,2019,225555,119893,105662,113.5,215018,113759,101259,112.3
'21,부산광역시,'030001, 25세,2019,47525,25499,22026,115.8,45366,24309,21057,115.4
'21,부산광역시,'030002, 26세,2019,46831,25211,21620,116.6,44685,23951,20734,115.5
'21,부산광역시,'030003, 27세,2019,46953,24881,22072,112.7,44918,23700,21218,111.7
'21,부산광역시,'030004, 28세,2019,43184,22748,20436,111.3,41120,21519,19601,109.8
'21,부산광역시,'030005, 29세,2019,41062,21554,19508,110.5,38929,20280,18649,108.7
'21,부산광역시,'035,30~34세,2019,192974,100218,92756,108,183285,94183,89102,105.7
'21,부산광역시,'035001, 30세,2019,39852,20800,19052,109.2,37853,19583,18270,107.2
'21,부산광역시,'035002, 31세,2019,37977,19668,18309,107.4,35968,18422,17546,105
'21,부산광역시,'035003, 32세,2019,37945,19564,18381,106.4,35896,18298,17598,104
'21,부산광역시,'035004, 33세,2019,38164,19926,18238,109.3,36292,18766,17526,107.1
'21,부산광역시,'035005, 34세,2019,39036,20260,18776,107.9,37276,19114,18162,105.2
'21,부산광역시,'040,35~39세,2019,242964,124675,118289,105.4,235580,120014,115566,103.8
'21,부산광역시,'040001, 35세,2019,41288,21272,20016,106.3,39568,20191,19377,104.2
'21,부산광역시,'040002, 36세,2019,45913,23462,22451,104.5,44374,22485,21889,102.7
'21,부산광역시,'040003, 37세,2019,50569,25896,24673,105,48988,24894,24094,103.3
'21,부산광역시,'040004, 38세,2019,51764,26629,25135,105.9,50459,25802,24657,104.6
'21,부산광역시,'040005, 39세,2019,53430,27416,26014,105.4,52191,26642,25549,104.3
'21,부산광역시,'045,40~44세,2019,232814,118424,114390,103.5,227885,115456,112429,102.7
'21,부산광역시,'045001, 40세,2019,50064,25397,24667,103,48891,24661,24230,101.8
'21,부산광역시,'045002, 41세,2019,45436,23388,22048,106.1,44419,22759,21660,105.1
'21,부산광역시,'045003, 42세,2019,45542,23247,22295,104.3,44584,22658,21926,103.3
'21,부산광역시,'045004, 43세,2019,44044,22427,21617,103.7,43143,21919,21224,103.3
'21,부산광역시,'045005, 44세,2019,47728,23965,23763,100.9,46848,23459,23389,100.3
'21,부산광역시,'050,45~49세,2019,270887,134865,136022,99.1,266775,132490,134285,98.7
'21,부산광역시,'050001, 45세,2019,52040,26253,25787,101.8,51160,25726,25434,101.1
'21,부산광역시,'050002, 46세,2019,52852,26249,26603,98.7,51982,25742,26240,98.1
'21,부산광역시,'050003, 47세,2019,53398,26837,26561,101,52655,26404,26251,100.6
'21,부산광역시,'050004, 48세,2019,56622,27907,28715,97.2,55802,27425,28377,96.6
'21,부산광역시,'050005, 49세,2019,55975,27619,28356,97.4,55176,27193,27983,97.2
'21,부산광역시,'055,50~54세,2019,272717,131636,141081,93.3,269829,130086,139743,93.1
'21,부산광역시,'055001, 50세,2019,56225,27370,28855,94.9,55553,27003,28550,94.6
'21,부산광역시,'055002, 51세,2019,57160,27621,29539,93.5,56547,27297,29250,93.3
'21,부산광역시,'055003, 52세,2019,53782,25578,28204,90.7,53242,25282,27960,90.4
'21,부산광역시,'055004, 53세,2019,52451,25806,26645,96.9,51865,25498,26367,96.7
'21,부산광역시,'055005, 54세,2019,53099,25261,27838,90.7,52622,25006,27616,90.5
'21,부산광역시,'060,55~59세,2019,296549,141227,155322,90.9,294389,140146,154243,90.9
'21,부산광역시,'060001, 55세,2019,50579,24468,26111,93.7,50096,24222,25874,93.6
'21,부산광역시,'060002, 56세,2019,56194,27176,29018,93.7,55677,26914,28763,93.6
'21,부산광역시,'060003, 57세,2019,59119,28398,30721,92.4,58651,28169,30482,92.4
'21,부산광역시,'060004, 58세,2019,65050,30489,34561,88.2,64742,30328,34414,88.1
'21,부산광역시,'060005, 59세,2019,65607,30696,34911,87.9,65223,30513,34710,87.9
'21,부산광역시,'065,60~64세,2019,285494,135149,150345,89.9,284124,134484,149640,89.9
'21,부산광역시,'065001, 60세,2019,59754,28339,31415,90.2,59454,28183,31271,90.1
'21,부산광역시,'065002, 61세,2019,57197,27348,29849,91.6,56888,27196,29692,91.6
'21,부산광역시,'065003, 62세,2019,58163,27647,30516,90.6,57875,27507,30368,90.6
'21,부산광역시,'065004, 63세,2019,53733,25468,28265,90.1,53483,25349,28134,90.1
'21,부산광역시,'065005, 64세,2019,56647,26347,30300,87,56424,26249,30175,87
'21,부산광역시,'070,65~69세,2019,206460,97621,108839,89.7,205671,97240,108431,89.7
'21,부산광역시,'070001, 65세,2019,47092,22890,24202,94.6,46857,22766,24091,94.5
'21,부산광역시,'070002, 66세,2019,42113,19638,22475,87.4,41946,19560,22386,87.4
'21,부산광역시,'070003, 67세,2019,45076,21245,23831,89.1,44919,21167,23752,89.1
'21,부산광역시,'070004, 68세,2019,35976,16843,19133,88,35859,16790,19069,88
'21,부산광역시,'070005, 69세,2019,36203,17005,19198,88.6,36090,16957,19133,88.6
'21,부산광역시,'075,70~74세,2019,155901,71878,84023,85.5,155589,71710,83879,85.5
'21,부산광역시,'075001, 70세,2019,37069,17120,19949,85.8,36979,17068,19911,85.7
'21,부산광역시,'075002, 71세,2019,35624,16479,19145,86.1,35552,16444,19108,86.1
'21,부산광역시,'075003, 72세,2019,33781,15456,18325,84.3,33721,15424,18297,84.3
'21,부산광역시,'075004, 73세,2019,24976,11658,13318,87.5,24929,11631,13298,87.5
'21,부산광역시,'075005, 74세,2019,24451,11165,13286,84,24408,11143,13265,84
'21,부산광역시,'080,75~79세,2019,121817,52726,69091,76.3,121646,52651,68995,76.3
'21,부산광역시,'080001, 75세,2019,25384,11395,13989,81.5,25347,11375,13972,81.4
'21,부산광역시,'080002, 76세,2019,25775,11481,14294,80.3,25748,11469,14279,80.3
'21,부산광역시,'080003, 77세,2019,27674,12069,15605,77.3,27635,12051,15584,77.3
'21,부산광역시,'080004, 78세,2019,22710,9528,13182,72.3,22674,9510,13164,72.2
'21,부산광역시,'080005, 79세,2019,20274,8253,12021,68.7,20242,8246,11996,68.7
'21,부산광역시,'085,80~84세,2019,72969,27161,45808,59.3,72872,27123,45749,59.3
'21,부산광역시,'085001, 80세,2019,19086,7577,11509,65.8,19062,7565,11497,65.8
'21,부산광역시,'085002, 81세,2019,15829,6151,9678,63.6,15801,6143,9658,63.6
'21,부산광역시,'085003, 82세,2019,14415,5361,9054,59.2,14394,5354,9040,59.2
'21,부산광역시,'085004, 83세,2019,12369,4356,8013,54.4,12352,4349,8003,54.3
'21,부산광역시,'085005, 84세,2019,11270,3716,7554,49.2,11263,3712,7551,49.2
'21,부산광역시,'086,85세이상,2019,45572,11860,33712,35.2,45474,11825,33649,35.1
'21,부산광역시,'090,85~89세,2019,32198,9177,23021,39.9,32145,9159,22986,39.8
'21,부산광역시,'090001, 85세,2019,9270,2932,6338,46.3,9257,2929,6328,46.3
'21,부산광역시,'090002, 86세,2019,7465,2269,5196,43.7,7448,2265,5183,43.7
'21,부산광역시,'090003, 87세,2019,6455,1766,4689,37.7,6442,1761,4681,37.6
'21,부산광역시,'090004, 88세,2019,4892,1265,3627,34.9,4886,1261,3625,34.8
'21,부산광역시,'090005, 89세,2019,4116,945,3171,29.8,4112,943,3169,29.8
'21,부산광역시,'095,90~94세,2019,10948,2260,8688,26,10918,2248,8670,25.9
'21,부산광역시,'095001, 90세,2019,3599,856,2743,31.2,3591,852,2739,31.1
'21,부산광역시,'095002, 91세,2019,2824,573,2251,25.5,2814,571,2243,25.5
'21,부산광역시,'095003, 92세,2019,2142,403,1739,23.2,2138,401,1737,23.1
'21,부산광역시,'095004, 93세,2019,1306,243,1063,22.9,1302,242,1060,22.8
'21,부산광역시,'095005, 94세,2019,1077,185,892,20.7,1073,182,891,20.4
'21,부산광역시,'100,95~99세,2019,2153,382,1771,21.6,2141,378,1763,21.4
'21,부산광역시,'100001, 95세,2019,696,123,573,21.5,695,123,572,21.5
'21,부산광역시,'100002, 96세,2019,624,110,514,21.4,618,109,509,21.4
'21,부산광역시,'100003, 97세,2019,427,86,341,25.2,425,85,340,25
'21,부산광역시,'100004, 98세,2019,237,37,200,18.5,235,36,199,18.1
'21,부산광역시,'100005, 99세,2019,169,26,143,18.2,168,25,143,17.5
'21,부산광역시,'101,100세이상,2019,273,41,232,17.7,270,40,230,17.4
'21,부산광역시,'102,15세미만,2019,364354,187231,177123,105.7,362710,186454,176256,105.8
'21,부산광역시,'103,15~64세,2019,2405619,1207089,1198530,100.7,2348228,1174542,1173686,100.1
'21,부산광역시,'104,65세이상,2019,602719,261246,341473,76.5,601252,260549,340703,76.5
'21,부산광역시,'126,평균연령,2019,44.2,42.8,45.5,,44.4,43,45.7,
'21,부산광역시,'127,중위연령,2019,45.8,44,47.5,,46.2,44.4,47.8,
'21004, 읍부,'000,합계,2019,144728,71577,73151,97.8,142250,69854,72396,96.5
'21004, 읍부,'005,0~4세,2019,7900,3997,3903,102.4,7872,3978,3894,102.2
'21004, 읍부,'005001, 0세,2019,1140,601,539,111.5,1136,597,539,110.8
'21004, 읍부,'005002, 1세,2019,1358,680,678,100.3,1349,677,672,100.7
'21004, 읍부,'005003, 2세,2019,1565,815,750,108.7,1561,813,748,108.7
'21004, 읍부,'005004, 3세,2019,1853,902,951,94.8,1849,898,951,94.4
'21004, 읍부,'005005, 4세,2019,1984,999,985,101.4,1977,993,984,100.9
'21004, 읍부,'010,5~9세,2019,9945,5094,4851,105,9930,5088,4842,105.1
'21004, 읍부,'010001, 5세,2019,1997,1044,953,109.5,1992,1042,950,109.7
'21004, 읍부,'010002, 6세,2019,1988,1024,964,106.2,1982,1022,960,106.5
'21004, 읍부,'010003, 7세,2019,2081,1067,1014,105.2,2078,1066,1012,105.3
'21004, 읍부,'010004, 8세,2019,2070,1052,1018,103.3,2069,1051,1018,103.2
'21004, 읍부,'010005, 9세,2019,1809,907,902,100.6,1809,907,902,100.6
'21004, 읍부,'015,10~14세,2019,8022,4189,3833,109.3,8018,4189,3829,109.4
'21004, 읍부,'015001, 10세,2019,1672,848,824,102.9,1671,848,823,103
'21004, 읍부,'015002, 11세,2019,1734,920,814,113,1733,920,813,113.2
'21004, 읍부,'015003, 12세,2019,1694,875,819,106.8,1694,875,819,106.8
'21004, 읍부,'015004, 13세,2019,1459,758,701,108.1,1458,758,700,108.3
'21004, 읍부,'015005, 14세,2019,1463,788,675,116.7,1462,788,674,116.9
'21004, 읍부,'020,15~19세,2019,7088,3641,3447,105.6,7062,3627,3435,105.6
'21004, 읍부,'020001, 15세,2019,1541,808,733,110.2,1537,806,731,110.3
'21004, 읍부,'020002, 16세,2019,1490,752,738,101.9,1487,751,736,102
'21004, 읍부,'020003, 17세,2019,1418,708,710,99.7,1414,708,706,100.3
'21004, 읍부,'020004, 18세,2019,1445,759,686,110.6,1438,754,684,110.2
'21004, 읍부,'020005, 19세,2019,1194,614,580,105.9,1186,608,578,105.2
'21004, 읍부,'025,20~24세,2019,6305,3501,2804,124.9,6060,3324,2736,121.5
'21004, 읍부,'025001, 20세,2019,1171,656,515,127.4,1154,646,508,127.2
'21004, 읍부,'025002, 21세,2019,1224,698,526,132.7,1198,680,518,131.3
'21004, 읍부,'025003, 22세,2019,1271,711,560,127,1221,676,545,124
'21004, 읍부,'025004, 23세,2019,1294,702,592,118.6,1223,651,572,113.8
'21004, 읍부,'025005, 24세,2019,1345,734,611,120.1,1264,671,593,113.2
'21004, 읍부,'030,25~29세,2019,7243,3883,3360,115.6,6729,3497,3232,108.2
'21004, 읍부,'030001, 25세,2019,1369,744,625,119,1277,672,605,111.1
'21004, 읍부,'030002, 26세,2019,1423,733,690,106.2,1330,670,660,101.5
'21004, 읍부,'030003, 27세,2019,1474,801,673,119,1379,725,654,110.9
'21004, 읍부,'030004, 28세,2019,1515,824,691,119.2,1393,730,663,110.1
'21004, 읍부,'030005, 29세,2019,1462,781,681,114.7,1350,700,650,107.7
'21004, 읍부,'035,30~34세,2019,8705,4381,4324,101.3,8168,3969,4199,94.5
'21004, 읍부,'035001, 30세,2019,1541,789,752,104.9,1435,704,731,96.3
'21004, 읍부,'035002, 31세,2019,1680,863,817,105.6,1554,760,794,95.7
'21004, 읍부,'035003, 32세,2019,1720,845,875,96.6,1609,772,837,92.2
'21004, 읍부,'035004, 33세,2019,1806,891,915,97.4,1706,811,895,90.6
'21004, 읍부,'035005, 34세,2019,1958,993,965,102.9,1864,922,942,97.9
'21004, 읍부,'040,35~39세,2019,14632,7255,7377,98.3,14233,6971,7262,96
'21004, 읍부,'040001, 35세,2019,2327,1146,1181,97,2227,1070,1157,92.5
'21004, 읍부,'040002, 36세,2019,2576,1231,1345,91.5,2492,1175,1317,89.2
'21004, 읍부,'040003, 37세,2019,3075,1524,1551,98.3,2986,1466,1520,96.4
'21004, 읍부,'040004, 38세,2019,3220,1635,1585,103.2,3145,1579,1566,100.8
'21004, 읍부,'040005, 39세,2019,3434,1719,1715,100.2,3383,1681,1702,98.8
'21004, 읍부,'045,40~44세,2019,14251,7210,7041,102.4,14032,7065,6967,101.4
'21004, 읍부,'045001, 40세,2019,3191,1612,1579,102.1,3138,1577,1561,101
'21004, 읍부,'045002, 41세,2019,2879,1436,1443,99.5,2831,1403,1428,98.2
'21004, 읍부,'045003, 42세,2019,2777,1425,1352,105.4,2738,1401,1337,104.8
'21004, 읍부,'045004, 43세,2019,2648,1340,1308,102.4,2609,1313,1296,101.3
'21004, 읍부,'045005, 44세,2019,2756,1397,1359,102.8,2716,1371,1345,101.9
'21004, 읍부,'050,45~49세,2019,13007,6781,6226,108.9,12813,6663,6150,108.3
'21004, 읍부,'050001, 45세,2019,2800,1416,1384,102.3,2754,1389,1365,101.8
'21004, 읍부,'050002, 46세,2019,2676,1354,1322,102.4,2631,1324,1307,101.3
'21004, 읍부,'050003, 47세,2019,2601,1366,1235,110.6,2568,1346,1222,110.1
'21004, 읍부,'050004, 48세,2019,2562,1385,1177,117.7,2525,1360,1165,116.7
'21004, 읍부,'050005, 49세,2019,2368,1260,1108,113.7,2335,1244,1091,114
'21004, 읍부,'055,50~54세,2019,9814,4951,4863,101.8,9697,4889,4808,101.7
'21004, 읍부,'055001, 50세,2019,2285,1158,1127,102.8,2255,1144,1111,103
'21004, 읍부,'055002, 51세,2019,2082,1034,1048,98.7,2052,1017,1035,98.3
'21004, 읍부,'055003, 52세,2019,1908,974,934,104.3,1891,963,928,103.8
'21004, 읍부,'055004, 53세,2019,1810,970,840,115.5,1787,960,827,116.1
'21004, 읍부,'055005, 54세,2019,1729,815,914,89.2,1712,805,907,88.8
'21004, 읍부,'060,55~59세,2019,8985,4383,4602,95.2,8928,4348,4580,94.9
'21004, 읍부,'060001, 55세,2019,1608,842,766,109.9,1595,833,762,109.3
'21004, 읍부,'060002, 56세,2019,1773,873,900,97,1758,866,892,97.1
'21004, 읍부,'060003, 57세,2019,1799,875,924,94.7,1791,870,921,94.5
'21004, 읍부,'060004, 58세,2019,1851,887,964,92,1841,878,963,91.2
'21004, 읍부,'060005, 59세,2019,1954,906,1048,86.5,1943,901,1042,86.5
'21004, 읍부,'065,60~64세,2019,8709,3973,4736,83.9,8655,3951,4704,84
'21004, 읍부,'065001, 60세,2019,1894,894,1000,89.4,1883,891,992,89.8
'21004, 읍부,'065002, 61세,2019,1659,766,893,85.8,1645,757,888,85.2
'21004, 읍부,'065003, 62세,2019,1788,786,1002,78.4,1779,783,996,78.6
'21004, 읍부,'065004, 63세,2019,1654,741,913,81.2,1641,737,904,81.5
'21004, 읍부,'065005, 64세,2019,1714,786,928,84.7,1707,783,924,84.7
'21004, 읍부,'070,65~69세,2019,6611,3005,3606,83.3,6573,2983,3590,83.1
'21004, 읍부,'070001, 65세,2019,1461,674,787,85.6,1444,664,780,85.1
'21004, 읍부,'070002, 66세,2019,1378,590,788,74.9,1373,588,785,74.9
'21004, 읍부,'070003, 67세,2019,1441,665,776,85.7,1435,661,774,85.4
'21004, 읍부,'070004, 68세,2019,1182,558,624,89.4,1178,556,622,89.4
'21004, 읍부,'070005, 69세,2019,1149,518,631,82.1,1143,514,629,81.7
'21004, 읍부,'075,70~74세,2019,5091,2328,2763,84.3,5072,2316,2756,84
'21004, 읍부,'075001, 70세,2019,1168,536,632,84.8,1162,531,631,84.2
'21004, 읍부,'075002, 71세,2019,1148,536,612,87.6,1146,535,611,87.6
'21004, 읍부,'075003, 72세,2019,1102,528,574,92,1099,528,571,92.5
'21004, 읍부,'075004, 73세,2019,853,371,482,77,847,366,481,76.1
'21004, 읍부,'075005, 74세,2019,820,357,463,77.1,818,356,462,77.1
'21004, 읍부,'080,75~79세,2019,3992,1702,2290,74.3,3989,1700,2289,74.3
'21004, 읍부,'080001, 75세,2019,887,383,504,76,886,382,504,75.8
'21004, 읍부,'080002, 76세,2019,842,382,460,83,841,381,460,82.8
'21004, 읍부,'080003, 77세,2019,882,381,501,76,881,381,500,76.2
'21004, 읍부,'080004, 78세,2019,709,297,412,72.1,709,297,412,72.1
'21004, 읍부,'080005, 79세,2019,672,259,413,62.7,672,259,413,62.7
'21004, 읍부,'085,80~84세,2019,2567,885,1682,52.6,2563,882,1681,52.5
'21004, 읍부,'085001, 80세,2019,685,248,437,56.8,683,247,436,56.7
'21004, 읍부,'085002, 81세,2019,550,193,357,54.1,549,192,357,53.8
'21004, 읍부,'085003, 82세,2019,496,169,327,51.7,495,168,327,51.4
'21004, 읍부,'085004, 83세,2019,424,131,293,44.7,424,131,293,44.7
'21004, 읍부,'085005, 84세,2019,412,144,268,53.7,412,144,268,53.7
'21004, 읍부,'086,85세이상,2019,1861,418,1443,29,1856,414,1442,28.7
'21004, 읍부,'090,85~89세,2019,1304,341,963,35.4,1302,340,962,35.3
'21004, 읍부,'090001, 85세,2019,344,95,249,38.2,343,95,248,38.3
'21004, 읍부,'090002, 86세,2019,297,80,217,36.9,297,80,217,36.9
'21004, 읍부,'090003, 87세,2019,274,76,198,38.4,273,75,198,37.9
'21004, 읍부,'090004, 88세,2019,218,55,163,33.7,218,55,163,33.7
'21004, 읍부,'090005, 89세,2019,171,35,136,25.7,171,35,136,25.7
'21004, 읍부,'095,90~94세,2019,444,66,378,17.5,444,66,378,17.5
'21004, 읍부,'095001, 90세,2019,128,29,99,29.3,128,29,99,29.3
'21004, 읍부,'095002, 91세,2019,101,16,85,18.8,101,16,85,18.8
'21004, 읍부,'095003, 92세,2019,102,9,93,9.7,102,9,93,9.7
'21004, 읍부,'095004, 93세,2019,53,8,45,17.8,53,8,45,17.8
'21004, 읍부,'095005, 94세,2019,60,X,56,7.1,60,X,56,7.1
'21004, 읍부,'100,95~99세,2019,104,11,93,11.8,101,8,93,8.6
'21004, 읍부,'100001, 95세,2019,29,X,27,7.4,29,X,27,7.4
'21004, 읍부,'100002, 96세,2019,31,X,28,10.7,30,X,28,7.1
'21004, 읍부,'100003, 97세,2019,20,X,16,25,19,X,16,18.8
'21004, 읍부,'100004, 98세,2019,14,X,13,7.7,14,X,13,7.7
'21004, 읍부,'100005, 99세,2019,10,X,9,11.1,9,X,9,0
'21004, 읍부,'101,100세이상,2019,9,X,9,0,9,X,9,0
'21004, 읍부,'102,15세미만,2019,25867,13280,12587,105.5,25820,13255,12565,105.5
'21004, 읍부,'103,15~64세,2019,98739,49959,48780,102.4,96377,48304,48073,100.5
'21004, 읍부,'104,65세이상,2019,20122,8338,11784,70.8,20053,8295,11758,70.5
'21004, 읍부,'126,평균연령,2019,40,38.6,41.4,,40.1,38.7,41.4,
'21004, 읍부,'127,중위연령,2019,40.8,39.9,41.8,,41,40.2,41.8,
'21005, 면부,'000,합계,2019,16004,8032,7972,100.8,15761,7882,7879,100
'21005, 면부,'005,0~4세,2019,404,205,199,103,404,205,199,103
'21005, 면부,'005001, 0세,2019,56,25,31,80.6,56,25,31,80.6
'21005, 면부,'005002, 1세,2019,64,28,36,77.8,64,28,36,77.8
'21005, 면부,'005003, 2세,2019,79,40,39,102.6,79,40,39,102.6
'21005, 면부,'005004, 3세,2019,109,53,56,94.6,109,53,56,94.6
'21005, 면부,'005005, 4세,2019,96,59,37,159.5,96,59,37,159.5
'21005, 면부,'010,5~9세,2019,504,267,237,112.7,504,267,237,112.7
'21005, 면부,'010001, 5세,2019,114,65,49,132.7,114,65,49,132.7
'21005, 면부,'010002, 6세,2019,99,51,48,106.3,99,51,48,106.3
'21005, 면부,'010003, 7세,2019,93,51,42,121.4,93,51,42,121.4
'21005, 면부,'010004, 8세,2019,100,46,54,85.2,100,46,54,85.2
'21005, 면부,'010005, 9세,2019,98,54,44,122.7,98,54,44,122.7
'21005, 면부,'015,10~14세,2019,376,182,194,93.8,375,182,193,94.3
'21005, 면부,'015001, 10세,2019,68,33,35,94.3,68,33,35,94.3
'21005, 면부,'015002, 11세,2019,77,29,48,60.4,77,29,48,60.4
'21005, 면부,'015003, 12세,2019,74,38,36,105.6,74,38,36,105.6
'21005, 면부,'015004, 13세,2019,90,48,42,114.3,90,48,42,114.3
'21005, 면부,'015005, 14세,2019,67,34,33,103,66,34,32,106.3
'21005, 면부,'020,15~19세,2019,432,272,160,170,430,270,160,168.8
'21005, 면부,'020001, 15세,2019,76,46,30,153.3,76,46,30,153.3
'21005, 면부,'020002, 16세,2019,72,40,32,125,72,40,32,125
'21005, 면부,'020003, 17세,2019,82,49,33,148.5,82,49,33,148.5
'21005, 면부,'020004, 18세,2019,96,59,37,159.5,96,59,37,159.5
'21005, 면부,'020005, 19세,2019,106,78,28,278.6,104,76,28,271.4
'21005, 면부,'025,20~24세,2019,710,407,303,134.3,699,399,300,133
'21005, 면부,'025001, 20세,2019,117,73,44,165.9,116,72,44,163.6
'21005, 면부,'025002, 21세,2019,147,93,54,172.2,143,91,52,175
'21005, 면부,'025003, 22세,2019,135,68,67,101.5,134,67,67,100
'21005, 면부,'025004, 23세,2019,161,89,72,123.6,159,88,71,123.9
'21005, 면부,'025005, 24세,2019,150,84,66,127.3,147,81,66,122.7
'21005, 면부,'030,25~29세,2019,842,508,334,152.1,804,484,320,151.3
'21005, 면부,'030001, 25세,2019,172,102,70,145.7,171,102,69,147.8
'21005, 면부,'030002, 26세,2019,189,121,68,177.9,176,112,64,175
'21005, 면부,'030003, 27세,2019,174,108,66,163.6,165,103,62,166.1
'21005, 면부,'030004, 28세,2019,147,85,62,137.1,140,80,60,133.3
'21005, 면부,'030005, 29세,2019,160,92,68,135.3,152,87,65,133.8
'21005, 면부,'035,30~34세,2019,743,389,354,109.9,695,363,332,109.3
'21005, 면부,'035001, 30세,2019,140,81,59,137.3,132,78,54,144.4
'21005, 면부,'035002, 31세,2019,137,79,58,136.2,128,73,55,132.7
'21005, 면부,'035003, 32세,2019,147,71,76,93.4,136,64,72,88.9
'21005, 면부,'035004, 33세,2019,160,78,82,95.1,150,76,74,102.7
'21005, 면부,'035005, 34세,2019,159,80,79,101.3,149,72,77,93.5
'21005, 면부,'040,35~39세,2019,972,550,422,130.3,927,515,412,125
'21005, 면부,'040001, 35세,2019,161,90,71,126.8,154,85,69,123.2
'21005, 면부,'040002, 36세,2019,190,106,84,126.2,184,103,81,127.2
'21005, 면부,'040003, 37세,2019,195,116,79,146.8,186,108,78,138.5
'21005, 면부,'040004, 38세,2019,213,119,94,126.6,199,107,92,116.3
'21005, 면부,'040005, 39세,2019,213,119,94,126.6,204,112,92,121.7
'21005, 면부,'045,40~44세,2019,881,507,374,135.6,844,484,360,134.4
'21005, 면부,'045001, 40세,2019,186,93,93,100,177,88,89,98.9
'21005, 면부,'045002, 41세,2019,157,90,67,134.3,145,82,63,130.2
'21005, 면부,'045003, 42세,2019,170,96,74,129.7,164,90,74,121.6
'21005, 면부,'045004, 43세,2019,175,112,63,177.8,172,110,62,177.4
'21005, 면부,'045005, 44세,2019,193,116,77,150.6,186,114,72,158.3
'21005, 면부,'050,45~49세,2019,1079,575,504,114.1,1059,563,496,113.5
'21005, 면부,'050001, 45세,2019,210,122,88,138.6,206,118,88,134.1
'21005, 면부,'050002, 46세,2019,191,111,80,138.8,189,110,79,139.2
'21005, 면부,'050003, 47세,2019,221,111,110,100.9,221,111,110,100.9
'21005, 면부,'050004, 48세,2019,232,122,110,110.9,224,119,105,113.3
'21005, 면부,'050005, 49세,2019,225,109,116,94,219,105,114,92.1
'21005, 면부,'055,50~54세,2019,1240,616,624,98.7,1232,610,622,98.1
'21005, 면부,'055001, 50세,2019,224,116,108,107.4,221,113,108,104.6
'21005, 면부,'055002, 51세,2019,259,142,117,121.4,258,142,116,122.4
'21005, 면부,'055003, 52세,2019,259,120,139,86.3,258,119,139,85.6
'21005, 면부,'055004, 53세,2019,245,122,123,99.2,243,121,122,99.2
'21005, 면부,'055005, 54세,2019,253,116,137,84.7,252,115,137,83.9
'21005, 면부,'060,55~59세,2019,1643,799,844,94.7,1626,791,835,94.7
'21005, 면부,'060001, 55세,2019,258,121,137,88.3,253,119,134,88.8
'21005, 면부,'060002, 56세,2019,304,141,163,86.5,301,141,160,88.1
'21005, 면부,'060003, 57세,2019,329,170,159,106.9,327,168,159,105.7
'21005, 면부,'060004, 58세,2019,376,181,195,92.8,373,178,195,91.3
'21005, 면부,'060005, 59세,2019,376,186,190,97.9,372,185,187,98.9
'21005, 면부,'065,60~64세,2019,1783,850,933,91.1,1772,846,926,91.4
'21005, 면부,'065001, 60세,2019,342,148,194,76.3,339,147,192,76.6
'21005, 면부,'065002, 61세,2019,365,174,191,91.1,363,172,191,90.1
'21005, 면부,'065003, 62세,2019,373,173,200,86.5,370,173,197,87.8
'21005, 면부,'065004, 63세,2019,341,162,179,90.5,339,161,178,90.4
'21005, 면부,'065005, 64세,2019,362,193,169,114.2,361,193,168,114.9
'21005, 면부,'070,65~69세,2019,1396,651,745,87.4,1395,651,744,87.5
'21005, 면부,'070001, 65세,2019,310,138,172,80.2,310,138,172,80.2
'21005, 면부,'070002, 66세,2019,250,117,133,88,250,117,133,88
'21005, 면부,'070003, 67세,2019,321,152,169,89.9,321,152,169,89.9
'21005, 면부,'070004, 68세,2019,267,124,143,86.7,266,124,142,87.3
'21005, 면부,'070005, 69세,2019,248,120,128,93.8,248,120,128,93.8
'21005, 면부,'075,70~74세,2019,1166,562,604,93,1164,561,603,93
'21005, 면부,'075001, 70세,2019,272,140,132,106.1,272,140,132,106.1
'21005, 면부,'075002, 71세,2019,257,115,142,81,257,115,142,81
'21005, 면부,'075003, 72세,2019,273,129,144,89.6,272,128,144,88.9
'21005, 면부,'075004, 73세,2019,181,84,97,86.6,181,84,97,86.6
'21005, 면부,'075005, 74세,2019,183,94,89,105.6,182,94,88,106.8
'21005, 면부,'080,75~79세,2019,910,393,517,76,908,392,516,76
'21005, 면부,'080001, 75세,2019,187,100,87,114.9,186,100,86,116.3
'21005, 면부,'080002, 76세,2019,198,92,106,86.8,198,92,106,86.8
'21005, 면부,'080003, 77세,2019,209,77,132,58.3,209,77,132,58.3
'21005, 면부,'080004, 78세,2019,150,63,87,72.4,149,62,87,71.3
'21005, 면부,'080005, 79세,2019,166,61,105,58.1,166,61,105,58.1
'21005, 면부,'085,80~84세,2019,562,211,351,60.1,562,211,351,60.1
'21005, 면부,'085001, 80세,2019,147,54,93,58.1,147,54,93,58.1
'21005, 면부,'085002, 81세,2019,129,56,73,76.7,129,56,73,76.7
'21005, 면부,'085003, 82세,2019,116,47,69,68.1,116,47,69,68.1
'21005, 면부,'085004, 83세,2019,92,34,58,58.6,92,34,58,58.6
'21005, 면부,'085005, 84세,2019,78,20,58,34.5,78,20,58,34.5
'21005, 면부,'086,85세이상,2019,361,88,273,32.2,361,88,273,32.2
'21005, 면부,'090,85~89세,2019,267,66,201,32.8,267,66,201,32.8
'21005, 면부,'090001, 85세,2019,78,14,64,21.9,78,14,64,21.9
'21005, 면부,'090002, 86세,2019,60,17,43,39.5,60,17,43,39.5
'21005, 면부,'090003, 87세,2019,53,15,38,39.5,53,15,38,39.5
'21005, 면부,'090004, 88세,2019,41,13,28,46.4,41,13,28,46.4
'21005, 면부,'090005, 89세,2019,35,7,28,25,35,7,28,25
'21005, 면부,'095,90~94세,2019,66,19,47,40.4,66,19,47,40.4
'21005, 면부,'095001, 90세,2019,16,X,13,23.1,16,X,13,23.1
'21005, 면부,'095002, 91세,2019,29,10,19,52.6,29,10,19,52.6
'21005, 면부,'095003, 92세,2019,11,X,7,57.1,11,X,7,57.1
'21005, 면부,'095004, 93세,2019,5,X,X,25,5,X,X,25
'21005, 면부,'095005, 94세,2019,5,X,X,25,5,X,X,25
'21005, 면부,'100,95~99세,2019,25,X,22,13.6,25,X,22,13.6
'21005, 면부,'100001, 95세,2019,10,X,9,11.1,10,X,9,11.1
'21005, 면부,'100002, 96세,2019,5,X,X,25,5,X,X,25
'21005, 면부,'100003, 97세,2019,5,X,5,0,5,X,5,0
'21005, 면부,'100004, 98세,2019,X,X,X,50,X,X,X,50
'21005, 면부,'100005, 99세,2019,X,X,X,0,X,X,X,0
'21005, 면부,'101,100세이상,2019,X,X,X,0,X,X,X,0
'21005, 면부,'102,15세미만,2019,1284,654,630,103.8,1283,654,629,104
'21005, 면부,'103,15~64세,2019,10325,5473,4852,112.8,10088,5325,4763,111.8
'21005, 면부,'104,65세이상,2019,4395,1905,2490,76.5,4390,1903,2487,76.5
'21005, 면부,'126,평균연령,2019,50.3,48.1,52.4,,50.4,48.3,52.5,
'21005, 면부,'127,중위연령,2019,54.3,51.3,56.9,,54.6,51.7,57.1,
'21003, 동부,'000,합계,2019,3211960,1575957,1636003,96.3,3154179,1543809,1610370,95.9
'21003, 동부,'005,0~4세,2019,100346,51505,48841,105.5,99593,51147,48446,105.6
'21003, 동부,'005001, 0세,2019,16019,8137,7882,103.2,15917,8085,7832,103.2
'21003, 동부,'005002, 1세,2019,17987,9294,8693,106.9,17852,9223,8629,106.9
'21003, 동부,'005003, 2세,2019,19906,10215,9691,105.4,19736,10132,9604,105.5
'21003, 동부,'005004, 3세,2019,22598,11581,11017,105.1,22418,11495,10923,105.2
'21003, 동부,'005005, 4세,2019,23836,12278,11558,106.2,23670,12212,11458,106.6
'21003, 동부,'010,5~9세,2019,120751,62034,58717,105.6,120257,61809,58448,105.8
'21003, 동부,'010001, 5세,2019,23365,12015,11350,105.9,23251,11962,11289,106
'21003, 동부,'010002, 6세,2019,23382,11966,11416,104.8,23279,11921,11358,105
'21003, 동부,'010003, 7세,2019,25365,13063,12302,106.2,25253,13011,12242,106.3
'21003, 동부,'010004, 8세,2019,24944,12700,12244,103.7,24867,12671,12196,103.9
'21003, 동부,'010005, 9세,2019,23695,12290,11405,107.8,23607,12244,11363,107.8
'21003, 동부,'015,10~14세,2019,116106,59758,56348,106.1,115757,59589,56168,106.1
'21003, 동부,'015001, 10세,2019,22666,11679,10987,106.3,22601,11644,10957,106.3
'21003, 동부,'015002, 11세,2019,23779,12197,11582,105.3,23704,12155,11549,105.2
'21003, 동부,'015003, 12세,2019,24426,12506,11920,104.9,24357,12476,11881,105
'21003, 동부,'015004, 13세,2019,22523,11661,10862,107.4,22465,11638,10827,107.5
'21003, 동부,'015005, 14세,2019,22712,11715,10997,106.5,22630,11676,10954,106.6
'21003, 동부,'020,15~19세,2019,152005,78881,73124,107.9,149660,77809,71851,108.3
'21003, 동부,'020001, 15세,2019,24950,12926,12024,107.5,24866,12881,11985,107.5
'21003, 동부,'020002, 16세,2019,25844,13605,12239,111.2,25758,13568,12190,111.3
'21003, 동부,'020003, 17세,2019,26833,13987,12846,108.9,26674,13907,12767,108.9
'21003, 동부,'020004, 18세,2019,33112,17333,15779,109.8,32574,17058,15516,109.9
'21003, 동부,'020005, 19세,2019,41266,21030,20236,103.9,39788,20395,19393,105.2
'21003, 동부,'025,20~24세,2019,219125,114300,104825,109,207432,108495,98937,109.7
'21003, 동부,'025001, 20세,2019,39917,20076,19841,101.2,37431,18941,18490,102.4
'21003, 동부,'025002, 21세,2019,42277,21657,20620,105,39810,20512,19298,106.3
'21003, 동부,'025003, 22세,2019,44387,23095,21292,108.5,42133,21957,20176,108.8
'21003, 동부,'025004, 23세,2019,46495,24735,21760,113.7,44220,23554,20666,114
'21003, 동부,'025005, 24세,2019,46049,24737,21312,116.1,43838,23531,20307,115.9
'21003, 동부,'030,25~29세,2019,217470,115502,101968,113.3,207485,109778,97707,112.4
'21003, 동부,'030001, 25세,2019,45984,24653,21331,115.6,43918,23535,20383,115.5
'21003, 동부,'030002, 26세,2019,45219,24357,20862,116.8,43179,23169,20010,115.8
'21003, 동부,'030003, 27세,2019,45305,23972,21333,112.4,43374,22872,20502,111.6
'21003, 동부,'030004, 28세,2019,41522,21839,19683,111,39587,20709,18878,109.7
'21003, 동부,'030005, 29세,2019,39440,20681,18759,110.2,37427,19493,17934,108.7
'21003, 동부,'035,30~34세,2019,183526,95448,88078,108.4,174422,89851,84571,106.2
'21003, 동부,'035001, 30세,2019,38171,19930,18241,109.3,36286,18801,17485,107.5
'21003, 동부,'035002, 31세,2019,36160,18726,17434,107.4,34286,17589,16697,105.3
'21003, 동부,'035003, 32세,2019,36078,18648,17430,107,34151,17462,16689,104.6
'21003, 동부,'035004, 33세,2019,36198,18957,17241,110,34436,17879,16557,108
'21003, 동부,'035005, 34세,2019,36919,19187,17732,108.2,35263,18120,17143,105.7
'21003, 동부,'040,35~39세,2019,227360,116870,110490,105.8,220420,112528,107892,104.3
'21003, 동부,'040001, 35세,2019,38800,20036,18764,106.8,37187,19036,18151,104.9
'21003, 동부,'040002, 36세,2019,43147,22125,21022,105.2,41698,21207,20491,103.5
'21003, 동부,'040003, 37세,2019,47299,24256,23043,105.3,45816,23320,22496,103.7
'21003, 동부,'040004, 38세,2019,48331,24875,23456,106,47115,24116,22999,104.9
'21003, 동부,'040005, 39세,2019,49783,25578,24205,105.7,48604,24849,23755,104.6
'21003, 동부,'045,40~44세,2019,217682,110707,106975,103.5,213009,107907,105102,102.7
'21003, 동부,'045001, 40세,2019,46687,23692,22995,103,45576,22996,22580,101.8
'21003, 동부,'045002, 41세,2019,42400,21862,20538,106.4,41443,21274,20169,105.5
'21003, 동부,'045003, 42세,2019,42595,21726,20869,104.1,41682,21167,20515,103.2
'21003, 동부,'045004, 43세,2019,41221,20975,20246,103.6,40362,20496,19866,103.2
'21003, 동부,'045005, 44세,2019,44779,22452,22327,100.6,43946,21974,21972,100
'21003, 동부,'050,45~49세,2019,256801,127509,129292,98.6,252903,125264,127639,98.1
'21003, 동부,'050001, 45세,2019,49030,24715,24315,101.6,48200,24219,23981,101
'21003, 동부,'050002, 46세,2019,49985,24784,25201,98.3,49162,24308,24854,97.8
'21003, 동부,'050003, 47세,2019,50576,25360,25216,100.6,49866,24947,24919,100.1
'21003, 동부,'050004, 48세,2019,53828,26400,27428,96.3,53053,25946,27107,95.7
'21003, 동부,'050005, 49세,2019,53382,26250,27132,96.7,52622,25844,26778,96.5
'21003, 동부,'055,50~54세,2019,261663,126069,135594,93,258900,124587,134313,92.8
'21003, 동부,'055001, 50세,2019,53716,26096,27620,94.5,53077,25746,27331,94.2
'21003, 동부,'055002, 51세,2019,54819,26445,28374,93.2,54237,26138,28099,93
'21003, 동부,'055003, 52세,2019,51615,24484,27131,90.2,51093,24200,26893,90
'21003, 동부,'055004, 53세,2019,50396,24714,25682,96.2,49835,24417,25418,96.1
'21003, 동부,'055005, 54세,2019,51117,24330,26787,90.8,50658,24086,26572,90.6
'21003, 동부,'060,55~59세,2019,285921,136045,149876,90.8,283835,135007,148828,90.7
'21003, 동부,'060001, 55세,2019,48713,23505,25208,93.2,48248,23270,24978,93.2
'21003, 동부,'060002, 56세,2019,54117,26162,27955,93.6,53618,25907,27711,93.5
'21003, 동부,'060003, 57세,2019,56991,27353,29638,92.3,56533,27131,29402,92.3
'21003, 동부,'060004, 58세,2019,62823,29421,33402,88.1,62528,29272,33256,88
'21003, 동부,'060005, 59세,2019,63277,29604,33673,87.9,62908,29427,33481,87.9
'21003, 동부,'065,60~64세,2019,275002,130326,144676,90.1,273697,129687,144010,90.1
'21003, 동부,'065001, 60세,2019,57518,27297,30221,90.3,57232,27145,30087,90.2
'21003, 동부,'065002, 61세,2019,55173,26408,28765,91.8,54880,26267,28613,91.8
'21003, 동부,'065003, 62세,2019,56002,26688,29314,91,55726,26551,29175,91
'21003, 동부,'065004, 63세,2019,51738,24565,27173,90.4,51503,24451,27052,90.4
'21003, 동부,'065005, 64세,2019,54571,25368,29203,86.9,54356,25273,29083,86.9
'21003, 동부,'070,65~69세,2019,198453,93965,104488,89.9,197703,93606,104097,89.9
'21003, 동부,'070001, 65세,2019,45321,22078,23243,95,45103,21964,23139,94.9
'21003, 동부,'070002, 66세,2019,40485,18931,21554,87.8,40323,18855,21468,87.8
'21003, 동부,'070003, 67세,2019,43314,20428,22886,89.3,43163,20354,22809,89.2
'21003, 동부,'070004, 68세,2019,34527,16161,18366,88,34415,16110,18305,88
'21003, 동부,'070005, 69세,2019,34806,16367,18439,88.8,34699,16323,18376,88.8
'21003, 동부,'075,70~74세,2019,149644,68988,80656,85.5,149353,68833,80520,85.5
'21003, 동부,'075001, 70세,2019,35629,16444,19185,85.7,35545,16397,19148,85.6
'21003, 동부,'075002, 71세,2019,34219,15828,18391,86.1,34149,15794,18355,86
'21003, 동부,'075003, 72세,2019,32406,14799,17607,84.1,32350,14768,17582,84
'21003, 동부,'075004, 73세,2019,23942,11203,12739,87.9,23901,11181,12720,87.9
'21003, 동부,'075005, 74세,2019,23448,10714,12734,84.1,23408,10693,12715,84.1
'21003, 동부,'080,75~79세,2019,116915,50631,66284,76.4,116749,50559,66190,76.4
'21003, 동부,'080001, 75세,2019,24310,10912,13398,81.4,24275,10893,13382,81.4
'21003, 동부,'080002, 76세,2019,24735,11007,13728,80.2,24709,10996,13713,80.2
'21003, 동부,'080003, 77세,2019,26583,11611,14972,77.6,26545,11593,14952,77.5
'21003, 동부,'080004, 78세,2019,21851,9168,12683,72.3,21816,9151,12665,72.3
'21003, 동부,'080005, 79세,2019,19436,7933,11503,69,19404,7926,11478,69.1
'21003, 동부,'085,80~84세,2019,69840,26065,43775,59.5,69747,26030,43717,59.5
'21003, 동부,'085001, 80세,2019,18254,7275,10979,66.3,18232,7264,10968,66.2
'21003, 동부,'085002, 81세,2019,15150,5902,9248,63.8,15123,5895,9228,63.9
'21003, 동부,'085003, 82세,2019,13803,5145,8658,59.4,13783,5139,8644,59.5
'21003, 동부,'085004, 83세,2019,11853,4191,7662,54.7,11836,4184,7652,54.7
'21003, 동부,'085005, 84세,2019,10780,3552,7228,49.1,10773,3548,7225,49.1
'21003, 동부,'086,85세이상,2019,43350,11354,31996,35.5,43257,11323,31934,35.5
'21003, 동부,'090,85~89세,2019,30627,8770,21857,40.1,30576,8753,21823,40.1
'21003, 동부,'090001, 85세,2019,8848,2823,6025,46.9,8836,2820,6016,46.9
'21003, 동부,'090002, 86세,2019,7108,2172,4936,44,7091,2168,4923,44
'21003, 동부,'090003, 87세,2019,6128,1675,4453,37.6,6116,1671,4445,37.6
'21003, 동부,'090004, 88세,2019,4633,1197,3436,34.8,4627,1193,3434,34.7
'21003, 동부,'090005, 89세,2019,3910,903,3007,30,3906,901,3005,30
'21003, 동부,'095,90~94세,2019,10438,2175,8263,26.3,10408,2163,8245,26.2
'21003, 동부,'095001, 90세,2019,3455,824,2631,31.3,3447,820,2627,31.2
'21003, 동부,'095002, 91세,2019,2694,547,2147,25.5,2684,545,2139,25.5
'21003, 동부,'095003, 92세,2019,2029,390,1639,23.8,2025,388,1637,23.7
'21003, 동부,'095004, 93세,2019,1248,234,1014,23.1,1244,233,1011,23
'21003, 동부,'095005, 94세,2019,1012,180,832,21.6,1008,177,831,21.3
'21003, 동부,'100,95~99세,2019,2024,368,1656,22.2,2015,367,1648,22.3
'21003, 동부,'100001, 95세,2019,657,120,537,22.3,656,120,536,22.4
'21003, 동부,'100002, 96세,2019,588,106,482,22,583,106,477,22.2
'21003, 동부,'100003, 97세,2019,402,82,320,25.6,401,82,319,25.7
'21003, 동부,'100004, 98세,2019,220,35,185,18.9,218,34,184,18.5
'21003, 동부,'100005, 99세,2019,157,25,132,18.9,157,25,132,18.9
'21003, 동부,'101,100세이상,2019,261,41,220,18.6,258,40,218,18.3
'21003, 동부,'102,15세미만,2019,337203,173297,163906,105.7,335607,172545,163062,105.8
'21003, 동부,'103,15~64세,2019,2296555,1151657,1144898,100.6,2241763,1120913,1120850,100
'21003, 동부,'104,65세이상,2019,578202,251003,327199,76.7,576809,250351,326458,76.7
'21003, 동부,'126,평균연령,2019,44.3,43,45.7,,44.5,43.2,45.8,
'21003, 동부,'127,중위연령,2019,46.1,44.2,47.8,,46.4,44.7,48.1,
'21010, 중구,'000,합계,2019,41958,20861,21097,98.9,39547,19329,20218,95.6
'21010, 중구,'005,0~4세,2019,649,373,276,135.1,638,365,273,133.7
'21010, 중구,'005001, 0세,2019,100,56,44,127.3,98,54,44,122.7
'21010, 중구,'005002, 1세,2019,127,70,57,122.8,123,68,55,123.6
'21010, 중구,'005003, 2세,2019,140,79,61,129.5,139,78,61,127.9
'21010, 중구,'005004, 3세,2019,118,71,47,151.1,115,69,46,150
'21010, 중구,'005005, 4세,2019,164,97,67,144.8,163,96,67,143.3
'21010, 중구,'010,5~9세,2019,823,434,389,111.6,815,429,386,111.1
'21010, 중구,'010001, 5세,2019,153,80,73,109.6,153,80,73,109.6
'21010, 중구,'010002, 6세,2019,154,75,79,94.9,150,72,78,92.3
'21010, 중구,'010003, 7세,2019,160,91,69,131.9,160,91,69,131.9
'21010, 중구,'010004, 8세,2019,183,100,83,120.5,182,99,83,119.3
'21010, 중구,'010005, 9세,2019,173,88,85,103.5,170,87,83,104.8
'21010, 중구,'015,10~14세,2019,849,417,432,96.5,837,411,426,96.5
'21010, 중구,'015001, 10세,2019,164,89,75,118.7,163,89,74,120.3
'21010, 중구,'015002, 11세,2019,174,93,81,114.8,172,91,81,112.3
'21010, 중구,'015003, 12세,2019,172,67,105,63.8,172,67,105,63.8
'21010, 중구,'015004, 13세,2019,164,82,82,100,161,80,81,98.8
'21010, 중구,'015005, 14세,2019,175,86,89,96.6,169,84,85,98.8
'21010, 중구,'020,15~19세,2019,1395,688,707,97.3,1245,631,614,102.8
'21010, 중구,'020001, 15세,2019,187,85,102,83.3,185,84,101,83.2
'21010, 중구,'020002, 16세,2019,205,102,103,99,202,101,101,100
'21010, 중구,'020003, 17세,2019,242,127,115,110.4,230,121,109,111
'21010, 중구,'020004, 18세,2019,331,174,157,110.8,273,154,119,129.4
'21010, 중구,'020005, 19세,2019,430,200,230,87,355,171,184,92.9
'21010, 중구,'025,20~24세,2019,2588,1279,1309,97.7,2233,1133,1100,103
'21010, 중구,'025001, 20세,2019,442,214,228,93.9,362,182,180,101.1
'21010, 중구,'025002, 21세,2019,446,222,224,99.1,386,197,189,104.2
'21010, 중구,'025003, 22세,2019,531,273,258,105.8,467,247,220,112.3
'21010, 중구,'025004, 23세,2019,561,263,298,88.3,488,237,251,94.4
'21010, 중구,'025005, 24세,2019,608,307,301,102,530,270,260,103.8
'21010, 중구,'030,25~29세,2019,3264,1767,1497,118,2862,1518,1344,112.9
'21010, 중구,'030001, 25세,2019,648,324,324,100,574,283,291,97.3
'21010, 중구,'030002, 26세,2019,675,344,331,103.9,588,291,297,98
'21010, 중구,'030003, 27세,2019,715,389,326,119.3,633,341,292,116.8
'21010, 중구,'030004, 28세,2019,649,378,271,139.5,561,316,245,129
'21010, 중구,'030005, 29세,2019,577,332,245,135.5,506,287,219,131.1
'21010, 중구,'035,30~34세,2019,2481,1455,1026,141.8,2106,1157,949,121.9
'21010, 중구,'035001, 30세,2019,548,308,240,128.3,476,258,218,118.3
'21010, 중구,'035002, 31세,2019,500,292,208,140.4,433,241,192,125.5
'21010, 중구,'035003, 32세,2019,486,287,199,144.2,416,230,186,123.7
'21010, 중구,'035004, 33세,2019,457,268,189,141.8,375,202,173,116.8
'21010, 중구,'035005, 34세,2019,490,300,190,157.9,406,226,180,125.6
'21010, 중구,'040,35~39세,2019,2601,1510,1091,138.4,2253,1240,1013,122.4
'21010, 중구,'040001, 35세,2019,449,265,184,144,367,204,163,125.2
'21010, 중구,'040002, 36세,2019,523,303,220,137.7,443,241,202,119.3
'21010, 중구,'040003, 37세,2019,527,311,216,144,462,260,202,128.7
'21010, 중구,'040004, 38세,2019,545,318,227,140.1,487,273,214,127.6
'21010, 중구,'040005, 39세,2019,557,313,244,128.3,494,262,232,112.9
'21010, 중구,'045,40~44세,2019,2535,1463,1072,136.5,2295,1270,1025,123.9
'21010, 중구,'045001, 40세,2019,486,271,215,126,439,234,205,114.1
'21010, 중구,'045002, 41세,2019,485,279,206,135.4,433,238,195,122.1
'21010, 중구,'045003, 42세,2019,473,280,193,145.1,429,242,187,129.4
'21010, 중구,'045004, 43세,2019,492,292,200,146,433,246,187,131.6
'21010, 중구,'045005, 44세,2019,599,341,258,132.2,561,310,251,123.5
'21010, 중구,'050,45~49세,2019,3221,1730,1491,116,3018,1595,1423,112.1
'21010, 중구,'050001, 45세,2019,590,326,264,123.5,535,283,252,112.3
'21010, 중구,'050002, 46세,2019,632,349,283,123.3,592,323,269,120.1
'21010, 중구,'050003, 47세,2019,636,369,267,138.2,600,343,257,133.5
'21010, 중구,'050004, 48세,2019,677,342,335,102.1,637,317,320,99.1
'21010, 중구,'050005, 49세,2019,686,344,342,100.6,654,329,325,101.2
'21010, 중구,'055,50~54세,2019,3324,1679,1645,102.1,3218,1617,1601,101
'21010, 중구,'055001, 50세,2019,711,378,333,113.5,682,363,319,113.8
'21010, 중구,'055002, 51세,2019,672,339,333,101.8,647,326,321,101.6
'21010, 중구,'055003, 52세,2019,640,322,318,101.3,625,311,314,99
'21010, 중구,'055004, 53세,2019,657,340,317,107.3,634,326,308,105.8
'21010, 중구,'055005, 54세,2019,644,300,344,87.2,630,291,339,85.8
'21010, 중구,'060,55~59세,2019,3802,1831,1971,92.9,3726,1799,1927,93.4
'21010, 중구,'060001, 55세,2019,604,305,299,102,583,294,289,101.7
'21010, 중구,'060002, 56세,2019,724,355,369,96.2,707,350,357,98
'21010, 중구,'060003, 57세,2019,786,380,406,93.6,768,371,397,93.5
'21010, 중구,'060004, 58세,2019,818,363,455,79.8,809,361,448,80.6
'21010, 중구,'060005, 59세,2019,870,428,442,96.8,859,423,436,97
'21010, 중구,'065,60~64세,2019,4165,1955,2210,88.5,4116,1929,2187,88.2
'21010, 중구,'065001, 60세,2019,806,383,423,90.5,791,375,416,90.1
'21010, 중구,'065002, 61세,2019,839,389,450,86.4,830,383,447,85.7
'21010, 중구,'065003, 62세,2019,863,397,466,85.2,853,393,460,85.4
'21010, 중구,'065004, 63세,2019,771,364,407,89.4,763,360,403,89.3
'21010, 중구,'065005, 64세,2019,886,422,464,90.9,879,418,461,90.7
'21010, 중구,'070,65~69세,2019,3218,1499,1719,87.2,3173,1470,1703,86.3
'21010, 중구,'070001, 65세,2019,704,351,353,99.4,689,341,348,98
'21010, 중구,'070002, 66세,2019,663,300,363,82.6,654,294,360,81.7
'21010, 중구,'070003, 67세,2019,682,324,358,90.5,672,318,354,89.8
'21010, 중구,'070004, 68세,2019,561,254,307,82.7,556,250,306,81.7
'21010, 중구,'070005, 69세,2019,608,270,338,79.9,602,267,335,79.7
'21010, 중구,'075,70~74세,2019,2585,1111,1474,75.4,2575,1106,1469,75.3
'21010, 중구,'075001, 70세,2019,606,261,345,75.7,603,259,344,75.3
'21010, 중구,'075002, 71세,2019,579,244,335,72.8,576,244,332,73.5
'21010, 중구,'075003, 72세,2019,522,221,301,73.4,521,220,301,73.1
'21010, 중구,'075004, 73세,2019,451,202,249,81.1,449,201,248,81
'21010, 중구,'075005, 74세,2019,427,183,244,75,426,182,244,74.6
'21010, 중구,'080,75~79세,2019,2200,947,1253,75.6,2193,943,1250,75.4
'21010, 중구,'080001, 75세,2019,464,209,255,82,461,207,254,81.5
'21010, 중구,'080002, 76세,2019,473,214,259,82.6,472,213,259,82.2
'21010, 중구,'080003, 77세,2019,502,209,293,71.3,500,208,292,71.2
'21010, 중구,'080004, 78세,2019,407,164,243,67.5,407,164,243,67.5
'21010, 중구,'080005, 79세,2019,354,151,203,74.4,353,151,202,74.8
'21010, 중구,'085,80~84세,2019,1306,487,819,59.5,1301,484,817,59.2
'21010, 중구,'085001, 80세,2019,355,147,208,70.7,353,145,208,69.7
'21010, 중구,'085002, 81세,2019,293,116,177,65.5,290,115,175,65.7
'21010, 중구,'085003, 82세,2019,249,82,167,49.1,249,82,167,49.1
'21010, 중구,'085004, 83세,2019,215,78,137,56.9,215,78,137,56.9
'21010, 중구,'085005, 84세,2019,194,64,130,49.2,194,64,130,49.2
'21010, 중구,'086,85세이상,2019,952,236,716,33,943,232,711,32.6
'21010, 중구,'090,85~89세,2019,616,173,443,39.1,612,171,441,38.8
'21010, 중구,'090001, 85세,2019,171,55,116,47.4,171,55,116,47.4
'21010, 중구,'090002, 86세,2019,126,36,90,40,123,35,88,39.8
'21010, 중구,'090003, 87세,2019,142,37,105,35.2,142,37,105,35.2
'21010, 중구,'090004, 88세,2019,83,27,56,48.2,83,27,56,48.2
'21010, 중구,'090005, 89세,2019,94,18,76,23.7,93,17,76,22.4
'21010, 중구,'095,90~94세,2019,278,49,229,21.4,274,47,227,20.7
'21010, 중구,'095001, 90세,2019,81,19,62,30.6,80,18,62,29
'21010, 중구,'095002, 91세,2019,71,13,58,22.4,70,12,58,20.7
'21010, 중구,'095003, 92세,2019,62,9,53,17,61,9,52,17.3
'21010, 중구,'095004, 93세,2019,41,5,36,13.9,40,5,35,14.3
'21010, 중구,'095005, 94세,2019,23,X,20,15,23,X,20,15
'21010, 중구,'100,95~99세,2019,49,12,37,32.4,48,12,36,33.3
'21010, 중구,'100001, 95세,2019,12,6,6,100,12,6,6,100
'21010, 중구,'100002, 96세,2019,15,X,14,7.1,14,X,13,7.7
'21010, 중구,'100003, 97세,2019,13,X,11,18.2,13,X,11,18.2
'21010, 중구,'100004, 98세,2019,X,X,X,33.3,X,X,X,33.3
'21010, 중구,'100005, 99세,2019,5,X,X,66.7,5,X,X,66.7
'21010, 중구,'101,100세이상,2019,9,X,7,28.6,9,X,7,28.6
'21010, 중구,'102,15세미만,2019,2321,1224,1097,111.6,2290,1205,1085,111.1
'21010, 중구,'103,15~64세,2019,29376,15357,14019,109.5,27072,13889,13183,105.4
'21010, 중구,'104,65세이상,2019,10261,4280,5981,71.6,10185,4235,5950,71.2
'21010, 중구,'126,평균연령,2019,48.9,46.9,50.8,,49.7,47.8,51.6,
'21010, 중구,'127,중위연령,2019,50.8,48,53.9,,52.2,49.7,54.9,
'21020, 서구,'000,합계,2019,105847,51645,54202,95.3,103459,50094,53365,93.9
'21020, 서구,'005,0~4세,2019,2441,1295,1146,113,2427,1286,1141,112.7
'21020, 서구,'005001, 0세,2019,396,212,184,115.2,394,211,183,115.3
'21020, 서구,'005002, 1세,2019,408,194,214,90.7,406,192,214,89.7
'21020, 서구,'005003, 2세,2019,482,265,217,122.1,478,262,216,121.3
'21020, 서구,'005004, 3세,2019,552,294,258,114,550,292,258,113.2
'21020, 서구,'005005, 4세,2019,603,330,273,120.9,599,329,270,121.9
'21020, 서구,'010,5~9세,2019,3159,1633,1526,107,3146,1627,1519,107.1
'21020, 서구,'010001, 5세,2019,580,295,285,103.5,577,293,284,103.2
'21020, 서구,'010002, 6세,2019,583,327,256,127.7,582,327,255,128.2
'21020, 서구,'010003, 7세,2019,672,347,325,106.8,669,346,323,107.1
'21020, 서구,'010004, 8세,2019,672,343,329,104.3,669,342,327,104.6
'21020, 서구,'010005, 9세,2019,652,321,331,97,649,319,330,96.7
'21020, 서구,'015,10~14세,2019,3139,1585,1554,102,3126,1579,1547,102.1
'21020, 서구,'015001, 10세,2019,604,319,285,111.9,602,318,284,112
'21020, 서구,'015002, 11세,2019,613,291,322,90.4,612,290,322,90.1
'21020, 서구,'015003, 12세,2019,678,353,325,108.6,676,351,325,108
'21020, 서구,'015004, 13세,2019,607,305,302,101,605,304,301,101
'21020, 서구,'015005, 14세,2019,637,317,320,99.1,631,316,315,100.3
'21020, 서구,'020,15~19세,2019,4415,2197,2218,99.1,4318,2157,2161,99.8
'21020, 서구,'020001, 15세,2019,740,369,371,99.5,736,367,369,99.5
'21020, 서구,'020002, 16세,2019,718,374,344,108.7,716,374,342,109.4
'21020, 서구,'020003, 17세,2019,718,375,343,109.3,712,371,341,108.8
'21020, 서구,'020004, 18세,2019,992,501,491,102,973,491,482,101.9
'21020, 서구,'020005, 19세,2019,1247,578,669,86.4,1181,554,627,88.4
'21020, 서구,'025,20~24세,2019,7238,3558,3680,96.7,6893,3381,3512,96.3
'21020, 서구,'025001, 20세,2019,1315,628,687,91.4,1246,594,652,91.1
'21020, 서구,'025002, 21세,2019,1334,620,714,86.8,1283,599,684,87.6
'21020, 서구,'025003, 22세,2019,1435,726,709,102.4,1372,691,681,101.5
'21020, 서구,'025004, 23세,2019,1588,782,806,97,1504,743,761,97.6
'21020, 서구,'025005, 24세,2019,1566,802,764,105,1488,754,734,102.7
'21020, 서구,'030,25~29세,2019,7001,3652,3349,109,6608,3385,3223,105
'21020, 서구,'030001, 25세,2019,1496,783,713,109.8,1412,730,682,107
'21020, 서구,'030002, 26세,2019,1493,764,729,104.8,1420,712,708,100.6
'21020, 서구,'030003, 27세,2019,1489,759,730,104,1414,708,706,100.3
'21020, 서구,'030004, 28세,2019,1304,698,606,115.2,1223,640,583,109.8
'21020, 서구,'030005, 29세,2019,1219,648,571,113.5,1139,595,544,109.4
'21020, 서구,'035,30~34세,2019,5347,2920,2427,120.3,4945,2625,2320,113.1
'21020, 서구,'035001, 30세,2019,1118,606,512,118.4,1055,564,491,114.9
'21020, 서구,'035002, 31세,2019,1150,632,518,122,1066,568,498,114.1
'21020, 서구,'035003, 32세,2019,1002,541,461,117.4,922,485,437,111
'21020, 서구,'035004, 33세,2019,1037,585,452,129.4,946,518,428,121
'21020, 서구,'035005, 34세,2019,1040,556,484,114.9,956,490,466,105.2
'21020, 서구,'040,35~39세,2019,6522,3419,3103,110.2,6188,3171,3017,105.1
'21020, 서구,'040001, 35세,2019,1064,532,532,100,990,481,509,94.5
'21020, 서구,'040002, 36세,2019,1249,663,586,113.1,1183,614,569,107.9
'21020, 서구,'040003, 37세,2019,1363,724,639,113.3,1286,665,621,107.1
'21020, 서구,'040004, 38세,2019,1388,708,680,104.1,1336,671,665,100.9
'21020, 서구,'040005, 39세,2019,1458,792,666,118.9,1393,740,653,113.3
'21020, 서구,'045,40~44세,2019,6351,3397,2954,115,6083,3187,2896,110
'21020, 서구,'045001, 40세,2019,1350,737,613,120.2,1281,679,602,112.8
'21020, 서구,'045002, 41세,2019,1236,654,582,112.4,1177,604,573,105.4
'21020, 서구,'045003, 42세,2019,1222,657,565,116.3,1169,614,555,110.6
'21020, 서구,'045004, 43세,2019,1216,648,568,114.1,1180,626,554,113
'21020, 서구,'045005, 44세,2019,1327,701,626,112,1276,664,612,108.5
'21020, 서구,'050,45~49세,2019,7984,4184,3800,110.1,7794,4047,3747,108
'21020, 서구,'050001, 45세,2019,1481,767,714,107.4,1440,736,704,104.5
'21020, 서구,'050002, 46세,2019,1622,861,761,113.1,1577,829,748,110.8
'21020, 서구,'050003, 47세,2019,1557,827,730,113.3,1522,803,719,111.7
'21020, 서구,'050004, 48세,2019,1648,833,815,102.2,1614,809,805,100.5
'21020, 서구,'050005, 49세,2019,1676,896,780,114.9,1641,870,771,112.8
'21020, 서구,'055,50~54세,2019,8096,4120,3976,103.6,7973,4050,3923,103.2
'21020, 서구,'055001, 50세,2019,1652,856,796,107.5,1624,841,783,107.4
'21020, 서구,'055002, 51세,2019,1664,851,813,104.7,1640,835,805,103.7
'21020, 서구,'055003, 52세,2019,1619,850,769,110.5,1591,835,756,110.4
'21020, 서구,'055004, 53세,2019,1545,775,770,100.6,1516,762,754,101.1
'21020, 서구,'055005, 54세,2019,1616,788,828,95.2,1602,777,825,94.2
'21020, 서구,'060,55~59세,2019,9583,4710,4873,96.7,9501,4669,4832,96.6
'21020, 서구,'060001, 55세,2019,1578,788,790,99.7,1558,779,779,100
'21020, 서구,'060002, 56세,2019,1788,901,887,101.6,1767,890,877,101.5
'21020, 서구,'060003, 57세,2019,1853,954,899,106.1,1837,943,894,105.5
'21020, 서구,'060004, 58세,2019,2120,990,1130,87.6,2110,987,1123,87.9
'21020, 서구,'060005, 59세,2019,2244,1077,1167,92.3,2229,1070,1159,92.3
'21020, 서구,'065,60~64세,2019,9802,4543,5259,86.4,9754,4527,5227,86.6
'21020, 서구,'065001, 60세,2019,2025,923,1102,83.8,2014,917,1097,83.6
'21020, 서구,'065002, 61세,2019,1936,917,1019,90,1926,912,1014,89.9
'21020, 서구,'065003, 62세,2019,2001,936,1065,87.9,1989,933,1056,88.4
'21020, 서구,'065004, 63세,2019,1847,889,958,92.8,1844,889,955,93.1
'21020, 서구,'065005, 64세,2019,1993,878,1115,78.7,1981,876,1105,79.3
'21020, 서구,'070,65~69세,2019,7734,3571,4163,85.8,7699,3555,4144,85.8
'21020, 서구,'070001, 65세,2019,1770,839,931,90.1,1760,834,926,90.1
'21020, 서구,'070002, 66세,2019,1469,676,793,85.2,1463,672,791,85
'21020, 서구,'070003, 67세,2019,1713,782,931,84,1703,780,923,84.5
'21020, 서구,'070004, 68세,2019,1374,617,757,81.5,1369,615,754,81.6
'21020, 서구,'070005, 69세,2019,1408,657,751,87.5,1404,654,750,87.2
'21020, 서구,'075,70~74세,2019,6293,2822,3471,81.3,6283,2815,3468,81.2
'21020, 서구,'075001, 70세,2019,1472,660,812,81.3,1470,660,810,81.5
'21020, 서구,'075002, 71세,2019,1384,633,751,84.3,1383,632,751,84.2
'21020, 서구,'075003, 72세,2019,1411,634,777,81.6,1408,632,776,81.4
'21020, 서구,'075004, 73세,2019,1030,468,562,83.3,1028,466,562,82.9
'21020, 서구,'075005, 74세,2019,996,427,569,75,994,425,569,74.7
'21020, 서구,'080,75~79세,2019,5348,2212,3136,70.5,5339,2209,3130,70.6
'21020, 서구,'080001, 75세,2019,1078,476,602,79.1,1076,475,601,79
'21020, 서구,'080002, 76세,2019,1139,449,690,65.1,1138,449,689,65.2
'21020, 서구,'080003, 77세,2019,1206,535,671,79.7,1205,534,671,79.6
'21020, 서구,'080004, 78세,2019,1022,404,618,65.4,1019,403,616,65.4
'21020, 서구,'080005, 79세,2019,903,348,555,62.7,901,348,553,62.9
'21020, 서구,'085,80~84세,2019,3390,1277,2113,60.4,3382,1275,2107,60.5
'21020, 서구,'085001, 80세,2019,913,350,563,62.2,913,350,563,62.2
'21020, 서구,'085002, 81세,2019,724,270,454,59.5,720,269,451,59.6
'21020, 서구,'085003, 82세,2019,654,254,400,63.5,651,254,397,64
'21020, 서구,'085004, 83세,2019,606,239,367,65.1,606,239,367,65.1
'21020, 서구,'085005, 84세,2019,493,164,329,49.8,492,163,329,49.5
'21020, 서구,'086,85세이상,2019,2004,550,1454,37.8,2000,549,1451,37.8
'21020, 서구,'090,85~89세,2019,1383,414,969,42.7,1381,414,967,42.8
'21020, 서구,'090001, 85세,2019,402,143,259,55.2,402,143,259,55.2
'21020, 서구,'090002, 86세,2019,332,102,230,44.3,332,102,230,44.3
'21020, 서구,'090003, 87세,2019,286,87,199,43.7,284,87,197,44.2
'21020, 서구,'090004, 88세,2019,207,45,162,27.8,207,45,162,27.8
'21020, 서구,'090005, 89세,2019,156,37,119,31.1,156,37,119,31.1
'21020, 서구,'095,90~94세,2019,491,101,390,25.9,490,101,389,26
'21020, 서구,'095001, 90세,2019,165,43,122,35.2,164,43,121,35.5
'21020, 서구,'095002, 91세,2019,126,18,108,16.7,126,18,108,16.7
'21020, 서구,'095003, 92세,2019,105,17,88,19.3,105,17,88,19.3
'21020, 서구,'095004, 93세,2019,50,10,40,25,50,10,40,25
'21020, 서구,'095005, 94세,2019,45,13,32,40.6,45,13,32,40.6
'21020, 서구,'100,95~99세,2019,119,33,86,38.4,118,32,86,37.2
'21020, 서구,'100001, 95세,2019,40,9,31,29,40,9,31,29
'21020, 서구,'100002, 96세,2019,30,8,22,36.4,30,8,22,36.4
'21020, 서구,'100003, 97세,2019,25,8,17,47.1,25,8,17,47.1
'21020, 서구,'100004, 98세,2019,10,X,7,42.9,9,X,7,28.6
'21020, 서구,'100005, 99세,2019,14,5,9,55.6,14,5,9,55.6
'21020, 서구,'101,100세이상,2019,11,X,9,22.2,11,X,9,22.2
'21020, 서구,'102,15세미만,2019,8739,4513,4226,106.8,8699,4492,4207,106.8
'21020, 서구,'103,15~64세,2019,72339,36700,35639,103,70057,35199,34858,101
'21020, 서구,'104,65세이상,2019,24769,10432,14337,72.8,24703,10403,14300,72.7
'21020, 서구,'126,평균연령,2019,47.3,45.8,48.8,,47.6,46.1,49,
'21020, 서구,'127,중위연령,2019,49.6,47.7,51.7,,50.1,48.3,52,
'21030, 동구,'000,합계,2019,85673,41817,43856,95.4,83156,40610,42546,95.4
'21030, 동구,'005,0~4세,2019,1954,1058,896,118.1,1902,1037,865,119.9
'21030, 동구,'005001, 0세,2019,334,176,158,111.4,330,175,155,112.9
'21030, 동구,'005002, 1세,2019,339,199,140,142.1,329,194,135,143.7
'21030, 동구,'005003, 2세,2019,409,218,191,114.1,402,214,188,113.8
'21030, 동구,'005004, 3세,2019,415,222,193,115,396,215,181,118.8
'21030, 동구,'005005, 4세,2019,457,243,214,113.6,445,239,206,116
'21030, 동구,'010,5~9세,2019,2157,1097,1060,103.5,2107,1074,1033,104
'21030, 동구,'010001, 5세,2019,413,203,210,96.7,407,202,205,98.5
'21030, 동구,'010002, 6세,2019,423,222,201,110.4,410,217,193,112.4
'21030, 동구,'010003, 7세,2019,469,243,226,107.5,456,236,220,107.3
'21030, 동구,'010004, 8세,2019,423,220,203,108.4,414,217,197,110.2
'21030, 동구,'010005, 9세,2019,429,209,220,95,420,202,218,92.7
'21030, 동구,'015,10~14세,2019,2133,1072,1061,101,2088,1048,1040,100.8
'21030, 동구,'015001, 10세,2019,400,195,205,95.1,388,187,201,93
'21030, 동구,'015002, 11세,2019,419,217,202,107.4,411,215,196,109.7
'21030, 동구,'015003, 12세,2019,472,239,233,102.6,468,236,232,101.7
'21030, 동구,'015004, 13세,2019,419,198,221,89.6,413,196,217,90.3
'21030, 동구,'015005, 14세,2019,423,223,200,111.5,408,214,194,110.3
'21030, 동구,'020,15~19세,2019,3164,1646,1518,108.4,3108,1616,1492,108.3
'21030, 동구,'020001, 15세,2019,489,252,237,106.3,478,244,234,104.3
'21030, 동구,'020002, 16세,2019,575,285,290,98.3,564,280,284,98.6
'21030, 동구,'020003, 17세,2019,611,340,271,125.5,603,337,266,126.7
'21030, 동구,'020004, 18세,2019,782,403,379,106.3,774,396,378,104.8
'21030, 동구,'020005, 19세,2019,707,366,341,107.3,689,359,330,108.8
'21030, 동구,'025,20~24세,2019,4547,2331,2216,105.2,4349,2241,2108,106.3
'21030, 동구,'025001, 20세,2019,712,375,337,111.3,693,367,326,112.6
'21030, 동구,'025002, 21세,2019,869,477,392,121.7,836,461,375,122.9
'21030, 동구,'025003, 22세,2019,876,432,444,97.3,838,419,419,100
'21030, 동구,'025004, 23세,2019,1029,510,519,98.3,987,492,495,99.4
'21030, 동구,'025005, 24세,2019,1061,537,524,102.5,995,502,493,101.8
'21030, 동구,'030,25~29세,2019,5685,2896,2789,103.8,5302,2717,2585,105.1
'21030, 동구,'030001, 25세,2019,1139,554,585,94.7,1073,530,543,97.6
'21030, 동구,'030002, 26세,2019,1115,589,526,112,1042,556,486,114.4
'21030, 동구,'030003, 27세,2019,1250,646,604,107,1159,601,558,107.7
'21030, 동구,'030004, 28세,2019,1107,539,568,94.9,1041,507,534,94.9
'21030, 동구,'030005, 29세,2019,1074,568,506,112.3,987,523,464,112.7
'21030, 동구,'035,30~34세,2019,4903,2631,2272,115.8,4510,2444,2066,118.3
'21030, 동구,'035001, 30세,2019,1022,522,500,104.4,933,485,448,108.3
'21030, 동구,'035002, 31세,2019,1005,524,481,108.9,910,485,425,114.1
'21030, 동구,'035003, 32세,2019,969,545,424,128.5,900,509,391,130.2
'21030, 동구,'035004, 33세,2019,931,504,427,118,862,469,393,119.3
'21030, 동구,'035005, 34세,2019,976,536,440,121.8,905,496,409,121.3
'21030, 동구,'040,35~39세,2019,5470,2991,2479,120.7,5103,2805,2298,122.1
'21030, 동구,'040001, 35세,2019,989,534,455,117.4,898,489,409,119.6
'21030, 동구,'040002, 36세,2019,1047,571,476,120,976,537,439,122.3
'21030, 동구,'040003, 37세,2019,1152,605,547,110.6,1080,567,513,110.5
'21030, 동구,'040004, 38세,2019,1147,648,499,129.9,1075,608,467,130.2
'21030, 동구,'040005, 39세,2019,1135,633,502,126.1,1074,604,470,128.5
'21030, 동구,'045,40~44세,2019,5200,2826,2374,119,4961,2707,2254,120.1
'21030, 동구,'045001, 40세,2019,1124,624,500,124.8,1070,597,473,126.2
'21030, 동구,'045002, 41세,2019,1016,541,475,113.9,981,522,459,113.7
'21030, 동구,'045003, 42세,2019,998,528,470,112.3,948,510,438,116.4
'21030, 동구,'045004, 43세,2019,968,523,445,117.5,911,492,419,117.4
'21030, 동구,'045005, 44세,2019,1094,610,484,126,1051,586,465,126
'21030, 동구,'050,45~49세,2019,6419,3416,3003,113.8,6218,3315,2903,114.2
'21030, 동구,'050001, 45세,2019,1189,617,572,107.9,1151,596,555,107.4
'21030, 동구,'050002, 46세,2019,1198,635,563,112.8,1166,621,545,113.9
'21030, 동구,'050003, 47세,2019,1299,703,596,118,1265,686,579,118.5
'21030, 동구,'050004, 48세,2019,1380,710,670,106,1334,684,650,105.2
'21030, 동구,'050005, 49세,2019,1353,751,602,124.8,1302,728,574,126.8
'21030, 동구,'055,50~54세,2019,6678,3378,3300,102.4,6529,3309,3220,102.8
'21030, 동구,'055001, 50세,2019,1426,729,697,104.6,1399,720,679,106
'21030, 동구,'055002, 51세,2019,1352,679,673,100.9,1322,668,654,102.1
'21030, 동구,'055003, 52세,2019,1348,657,691,95.1,1312,638,674,94.7
'21030, 동구,'055004, 53세,2019,1262,654,608,107.6,1228,634,594,106.7
'21030, 동구,'055005, 54세,2019,1290,659,631,104.4,1268,649,619,104.8
'21030, 동구,'060,55~59세,2019,7635,3694,3941,93.7,7518,3636,3882,93.7
'21030, 동구,'060001, 55세,2019,1220,629,591,106.4,1197,617,580,106.4
'21030, 동구,'060002, 56세,2019,1398,697,701,99.4,1368,679,689,98.5
'21030, 동구,'060003, 57세,2019,1535,733,802,91.4,1511,727,784,92.7
'21030, 동구,'060004, 58세,2019,1704,801,903,88.7,1685,790,895,88.3
'21030, 동구,'060005, 59세,2019,1778,834,944,88.3,1757,823,934,88.1
'21030, 동구,'065,60~64세,2019,8213,3877,4336,89.4,8102,3824,4278,89.4
'21030, 동구,'065001, 60세,2019,1680,796,884,90,1659,785,874,89.8
'21030, 동구,'065002, 61세,2019,1595,792,803,98.6,1572,777,795,97.7
'21030, 동구,'065003, 62세,2019,1712,827,885,93.4,1692,819,873,93.8
'21030, 동구,'065004, 63세,2019,1582,737,845,87.2,1557,729,828,88
'21030, 동구,'065005, 64세,2019,1644,725,919,78.9,1622,714,908,78.6
'21030, 동구,'070,65~69세,2019,6601,3064,3537,86.6,6510,3026,3484,86.9
'21030, 동구,'070001, 65세,2019,1425,680,745,91.3,1401,668,733,91.1
'21030, 동구,'070002, 66세,2019,1315,608,707,86,1296,600,696,86.2
'21030, 동구,'070003, 67세,2019,1447,658,789,83.4,1428,649,779,83.3
'21030, 동구,'070004, 68세,2019,1233,574,659,87.1,1220,570,650,87.7
'21030, 동구,'070005, 69세,2019,1181,544,637,85.4,1165,539,626,86.1
'21030, 동구,'075,70~74세,2019,5507,2389,3118,76.6,5478,2372,3106,76.4
'21030, 동구,'075001, 70세,2019,1311,574,737,77.9,1299,568,731,77.7
'21030, 동구,'075002, 71세,2019,1245,567,678,83.6,1241,563,678,83
'21030, 동구,'075003, 72세,2019,1154,485,669,72.5,1145,480,665,72.2
'21030, 동구,'075004, 73세,2019,884,405,479,84.6,881,403,478,84.3
'21030, 동구,'075005, 74세,2019,913,358,555,64.5,912,358,554,64.6
'21030, 동구,'080,75~79세,2019,4753,1920,2833,67.8,4736,1912,2824,67.7
'21030, 동구,'080001, 75세,2019,967,401,566,70.8,965,400,565,70.8
'21030, 동구,'080002, 76세,2019,968,418,550,76,965,417,548,76.1
'21030, 동구,'080003, 77세,2019,1107,461,646,71.4,1104,460,644,71.4
'21030, 동구,'080004, 78세,2019,914,347,567,61.2,909,343,566,60.6
'21030, 동구,'080005, 79세,2019,797,293,504,58.1,793,292,501,58.3
'21030, 동구,'085,80~84세,2019,2945,1075,1870,57.5,2935,1072,1863,57.5
'21030, 동구,'085001, 80세,2019,769,283,486,58.2,766,282,484,58.3
'21030, 동구,'085002, 81세,2019,616,228,388,58.8,612,227,385,59
'21030, 동구,'085003, 82세,2019,581,233,348,67,579,232,347,66.9
'21030, 동구,'085004, 83세,2019,532,193,339,56.9,531,193,338,57.1
'21030, 동구,'085005, 84세,2019,447,138,309,44.7,447,138,309,44.7
'21030, 동구,'086,85세이상,2019,1709,456,1253,36.4,1700,455,1245,36.5
'21030, 동구,'090,85~89세,2019,1176,329,847,38.8,1172,329,843,39
'21030, 동구,'090001, 85세,2019,311,88,223,39.5,310,88,222,39.6
'21030, 동구,'090002, 86세,2019,292,98,194,50.5,291,98,193,50.8
'21030, 동구,'090003, 87세,2019,253,61,192,31.8,251,61,190,32.1
'21030, 동구,'090004, 88세,2019,174,42,132,31.8,174,42,132,31.8
'21030, 동구,'090005, 89세,2019,146,40,106,37.7,146,40,106,37.7
'21030, 동구,'095,90~94세,2019,448,111,337,32.9,446,110,336,32.7
'21030, 동구,'095001, 90세,2019,138,35,103,34,138,35,103,34
'21030, 동구,'095002, 91세,2019,124,33,91,36.3,123,33,90,36.7
'21030, 동구,'095003, 92세,2019,90,20,70,28.6,89,19,70,27.1
'21030, 동구,'095004, 93세,2019,61,11,50,22,61,11,50,22
'21030, 동구,'095005, 94세,2019,35,12,23,52.2,35,12,23,52.2
'21030, 동구,'100,95~99세,2019,75,14,61,23,72,14,58,24.1
'21030, 동구,'100001, 95세,2019,23,5,18,27.8,23,5,18,27.8
'21030, 동구,'100002, 96세,2019,15,X,13,15.4,13,X,11,18.2
'21030, 동구,'100003, 97세,2019,22,X,18,22.2,22,X,18,22.2
'21030, 동구,'100004, 98세,2019,9,X,8,12.5,8,X,7,14.3
'21030, 동구,'100005, 99세,2019,6,X,X,50,6,X,X,50
'21030, 동구,'101,100세이상,2019,10,X,8,25,10,X,8,25
'21030, 동구,'102,15세미만,2019,6244,3227,3017,107,6097,3159,2938,107.5
'21030, 동구,'103,15~64세,2019,57914,29686,28228,105.2,55700,28614,27086,105.6
'21030, 동구,'104,65세이상,2019,21515,8904,12611,70.6,21359,8837,12522,70.6
'21030, 동구,'126,평균연령,2019,48.6,46.8,50.4,,48.9,47,50.7,
'21030, 동구,'127,중위연령,2019,50.8,48.6,53.3,,51.4,49,54,
'21040, 영도구,'000,합계,2019,117959,59370,58589,101.3,115822,58013,57809,100.4
'21040, 영도구,'005,0~4세,2019,2399,1181,1218,97,2375,1168,1207,96.8
'21040, 영도구,'005001, 0세,2019,353,160,193,82.9,347,157,190,82.6
'21040, 영도구,'005002, 1세,2019,425,211,214,98.6,422,209,213,98.1
'21040, 영도구,'005003, 2세,2019,468,234,234,100,463,231,232,99.6
'21040, 영도구,'005004, 3세,2019,575,279,296,94.3,572,278,294,94.6
'21040, 영도구,'005005, 4세,2019,578,297,281,105.7,571,293,278,105.4
'21040, 영도구,'010,5~9세,2019,3221,1641,1580,103.9,3208,1632,1576,103.6
'21040, 영도구,'010001, 5세,2019,600,304,296,102.7,598,304,294,103.4
'21040, 영도구,'010002, 6세,2019,593,307,286,107.3,590,306,284,107.7
'21040, 영도구,'010003, 7세,2019,647,339,308,110.1,643,335,308,108.8
'21040, 영도구,'010004, 8세,2019,701,339,362,93.6,699,337,362,93.1
'21040, 영도구,'010005, 9세,2019,680,352,328,107.3,678,350,328,106.7
'21040, 영도구,'015,10~14세,2019,3231,1652,1579,104.6,3222,1645,1577,104.3
'21040, 영도구,'015001, 10세,2019,601,306,295,103.7,600,305,295,103.4
'21040, 영도구,'015002, 11세,2019,650,334,316,105.7,649,333,316,105.4
'21040, 영도구,'015003, 12세,2019,693,367,326,112.6,692,366,326,112.3
'21040, 영도구,'015004, 13세,2019,645,321,324,99.1,644,320,324,98.8
'21040, 영도구,'015005, 14세,2019,642,324,318,101.9,637,321,316,101.6
'21040, 영도구,'020,15~19세,2019,5814,3262,2552,127.8,5739,3230,2509,128.7
'21040, 영도구,'020001, 15세,2019,766,393,373,105.4,761,391,370,105.7
'21040, 영도구,'020002, 16세,2019,872,513,359,142.9,867,509,358,142.2
'21040, 영도구,'020003, 17세,2019,952,548,404,135.6,952,548,404,135.6
'21040, 영도구,'020004, 18세,2019,1246,692,554,124.9,1236,689,547,126
'21040, 영도구,'020005, 19세,2019,1978,1116,862,129.5,1923,1093,830,131.7
'21040, 영도구,'025,20~24세,2019,9424,5589,3835,145.7,9208,5473,3735,146.5
'21040, 영도구,'025001, 20세,2019,1945,1088,857,127,1900,1069,831,128.6
'21040, 영도구,'025002, 21세,2019,1913,1108,805,137.6,1878,1089,789,138
'21040, 영도구,'025003, 22세,2019,1973,1186,787,150.7,1939,1167,772,151.2
'21040, 영도구,'025004, 23세,2019,1878,1164,714,163,1833,1140,693,164.5
'21040, 영도구,'025005, 24세,2019,1715,1043,672,155.2,1658,1008,650,155.1
'21040, 영도구,'030,25~29세,2019,6741,3980,2761,144.2,6375,3741,2634,142
'21040, 영도구,'030001, 25세,2019,1629,1010,619,163.2,1565,969,596,162.6
'21040, 영도구,'030002, 26세,2019,1389,820,569,144.1,1322,775,547,141.7
'21040, 영도구,'030003, 27세,2019,1428,866,562,154.1,1360,824,536,153.7
'21040, 영도구,'030004, 28세,2019,1188,650,538,120.8,1104,593,511,116
'21040, 영도구,'030005, 29세,2019,1107,634,473,134,1024,580,444,130.6
'21040, 영도구,'035,30~34세,2019,5293,3013,2280,132.1,4896,2733,2163,126.4
'21040, 영도구,'035001, 30세,2019,1097,623,474,131.4,1018,569,449,126.7
'21040, 영도구,'035002, 31세,2019,1035,570,465,122.6,961,521,440,118.4
'21040, 영도구,'035003, 32세,2019,1011,589,422,139.6,928,527,401,131.4
'21040, 영도구,'035004, 33세,2019,1035,609,426,143,957,557,400,139.3
'21040, 영도구,'035005, 34세,2019,1115,622,493,126.2,1032,559,473,118.2
'21040, 영도구,'040,35~39세,2019,6578,3546,3032,117,6275,3326,2949,112.8
'21040, 영도구,'040001, 35세,2019,1098,611,487,125.5,1023,557,466,119.5
'21040, 영도구,'040002, 36세,2019,1245,674,571,118,1179,625,554,112.8
'21040, 영도구,'040003, 37세,2019,1303,703,600,117.2,1245,658,587,112.1
'21040, 영도구,'040004, 38세,2019,1441,768,673,114.1,1385,734,651,112.7
'21040, 영도구,'040005, 39세,2019,1491,790,701,112.7,1443,752,691,108.8
'21040, 영도구,'045,40~44세,2019,6787,3612,3175,113.8,6561,3458,3103,111.4
'21040, 영도구,'045001, 40세,2019,1403,731,672,108.8,1348,692,656,105.5
'21040, 영도구,'045002, 41세,2019,1311,700,611,114.6,1264,665,599,111
'21040, 영도구,'045003, 42세,2019,1279,683,596,114.6,1235,658,577,114
'21040, 영도구,'045004, 43세,2019,1290,698,592,117.9,1249,670,579,115.7
'21040, 영도구,'045005, 44세,2019,1504,800,704,113.6,1465,773,692,111.7
'21040, 영도구,'050,45~49세,2019,8630,4578,4052,113,8448,4454,3994,111.5
'21040, 영도구,'050001, 45세,2019,1636,860,776,110.8,1608,836,772,108.3
'21040, 영도구,'050002, 46세,2019,1699,892,807,110.5,1663,866,797,108.7
'21040, 영도구,'050003, 47세,2019,1711,915,796,114.9,1673,894,779,114.8
'21040, 영도구,'050004, 48세,2019,1791,964,827,116.6,1748,936,812,115.3
'21040, 영도구,'050005, 49세,2019,1793,947,846,111.9,1756,922,834,110.6
'21040, 영도구,'055,50~54세,2019,9057,4603,4454,103.3,8920,4532,4388,103.3
'21040, 영도구,'055001, 50세,2019,1748,895,853,104.9,1712,874,838,104.3
'21040, 영도구,'055002, 51세,2019,1867,943,924,102.1,1840,928,912,101.8
'21040, 영도구,'055003, 52세,2019,1815,935,880,106.3,1788,920,868,106
'21040, 영도구,'055004, 53세,2019,1827,988,839,117.8,1807,976,831,117.4
'21040, 영도구,'055005, 54세,2019,1800,842,958,87.9,1773,834,939,88.8
'21040, 영도구,'060,55~59세,2019,10676,5218,5458,95.6,10589,5171,5418,95.4
'21040, 영도구,'060001, 55세,2019,1672,827,845,97.9,1645,809,836,96.8
'21040, 영도구,'060002, 56세,2019,1959,1003,956,104.9,1942,993,949,104.6
'21040, 영도구,'060003, 57세,2019,2176,1041,1135,91.7,2155,1029,1126,91.4
'21040, 영도구,'060004, 58세,2019,2400,1155,1245,92.8,2393,1153,1240,93
'21040, 영도구,'060005, 59세,2019,2469,1192,1277,93.3,2454,1187,1267,93.7
'21040, 영도구,'065,60~64세,2019,11613,5469,6144,89,11571,5450,6121,89
'21040, 영도구,'065001, 60세,2019,2312,1070,1242,86.2,2305,1068,1237,86.3
'21040, 영도구,'065002, 61세,2019,2292,1128,1164,96.9,2282,1126,1156,97.4
'21040, 영도구,'065003, 62세,2019,2288,1084,1204,90,2278,1077,1201,89.7
'21040, 영도구,'065004, 63세,2019,2247,1070,1177,90.9,2239,1066,1173,90.9
'21040, 영도구,'065005, 64세,2019,2474,1117,1357,82.3,2467,1113,1354,82.2
'21040, 영도구,'070,65~69세,2019,8995,4206,4789,87.8,8965,4191,4774,87.8
'21040, 영도구,'070001, 65세,2019,2037,990,1047,94.6,2028,985,1043,94.4
'21040, 영도구,'070002, 66세,2019,1716,795,921,86.3,1712,793,919,86.3
'21040, 영도구,'070003, 67세,2019,1951,922,1029,89.6,1948,921,1027,89.7
'21040, 영도구,'070004, 68세,2019,1655,741,914,81.1,1646,737,909,81.1
'21040, 영도구,'070005, 69세,2019,1636,758,878,86.3,1631,755,876,86.2
'21040, 영도구,'075,70~74세,2019,7558,3338,4220,79.1,7542,3331,4211,79.1
'21040, 영도구,'075001, 70세,2019,1778,800,978,81.8,1774,797,977,81.6
'21040, 영도구,'075002, 71세,2019,1627,724,903,80.2,1624,723,901,80.2
'21040, 영도구,'075003, 72세,2019,1705,749,956,78.3,1699,747,952,78.5
'21040, 영도구,'075004, 73세,2019,1234,546,688,79.4,1232,545,687,79.3
'21040, 영도구,'075005, 74세,2019,1214,519,695,74.7,1213,519,694,74.8
'21040, 영도구,'080,75~79세,2019,6300,2587,3713,69.7,6294,2586,3708,69.7
'21040, 영도구,'080001, 75세,2019,1256,519,737,70.4,1255,519,736,70.5
'21040, 영도구,'080002, 76세,2019,1367,595,772,77.1,1365,594,771,77
'21040, 영도구,'080003, 77세,2019,1436,601,835,72,1435,601,834,72.1
'21040, 영도구,'080004, 78세,2019,1185,489,696,70.3,1184,489,695,70.4
'21040, 영도구,'080005, 79세,2019,1056,383,673,56.9,1055,383,672,57
'21040, 영도구,'085,80~84세,2019,3644,1366,2278,60,3639,1364,2275,60
'21040, 영도구,'085001, 80세,2019,1001,382,619,61.7,1000,382,618,61.8
'21040, 영도구,'085002, 81세,2019,774,322,452,71.2,772,321,451,71.2
'21040, 영도구,'085003, 82세,2019,721,247,474,52.1,721,247,474,52.1
'21040, 영도구,'085004, 83세,2019,618,225,393,57.3,617,225,392,57.4
'21040, 영도구,'085005, 84세,2019,530,190,340,55.9,529,189,340,55.6
'21040, 영도구,'086,85세이상,2019,1998,529,1469,36,1995,528,1467,36
'21040, 영도구,'090,85~89세,2019,1435,426,1009,42.2,1433,425,1008,42.2
'21040, 영도구,'090001, 85세,2019,442,156,286,54.5,442,156,286,54.5
'21040, 영도구,'090002, 86세,2019,325,90,235,38.3,324,90,234,38.5
'21040, 영도구,'090003, 87세,2019,306,80,226,35.4,305,79,226,35
'21040, 영도구,'090004, 88세,2019,206,66,140,47.1,206,66,140,47.1
'21040, 영도구,'090005, 89세,2019,156,34,122,27.9,156,34,122,27.9
'21040, 영도구,'095,90~94세,2019,463,80,383,20.9,462,80,382,20.9
'21040, 영도구,'095001, 90세,2019,167,35,132,26.5,167,35,132,26.5
'21040, 영도구,'095002, 91세,2019,108,13,95,13.7,107,13,94,13.8
'21040, 영도구,'095003, 92세,2019,95,19,76,25,95,19,76,25
'21040, 영도구,'095004, 93세,2019,57,9,48,18.8,57,9,48,18.8
'21040, 영도구,'095005, 94세,2019,36,X,32,12.5,36,X,32,12.5
'21040, 영도구,'100,95~99세,2019,84,20,64,31.3,84,20,64,31.3
'21040, 영도구,'100001, 95세,2019,31,5,26,19.2,31,5,26,19.2
'21040, 영도구,'100002, 96세,2019,30,8,22,36.4,30,8,22,36.4
'21040, 영도구,'100003, 97세,2019,7,X,X,133.3,7,X,X,133.3
'21040, 영도구,'100004, 98세,2019,13,X,10,30,13,X,10,30
'21040, 영도구,'100005, 99세,2019,X,X,X,0,X,X,X,0
'21040, 영도구,'101,100세이상,2019,16,X,13,23.1,16,X,13,23.1
'21040, 영도구,'102,15세미만,2019,8851,4474,4377,102.2,8805,4445,4360,101.9
'21040, 영도구,'103,15~64세,2019,80613,42870,37743,113.6,78582,41568,37014,112.3
'21040, 영도구,'104,65세이상,2019,28495,12026,16469,73,28435,12000,16435,73
'21040, 영도구,'126,평균연령,2019,47.7,45.5,49.9,,47.9,45.7,50.1,
'21040, 영도구,'127,중위연령,2019,50.5,47.5,53.7,,50.9,48,54,
'21050, 부산진구,'000,합계,2019,352390,169565,182825,92.7,349015,168185,180830,93
'21050, 부산진구,'005,0~4세,2019,10294,5280,5014,105.3,10267,5263,5004,105.2
'21050, 부산진구,'005001, 0세,2019,1691,843,848,99.4,1691,843,848,99.4
'21050, 부산진구,'005002, 1세,2019,1953,1020,933,109.3,1943,1015,928,109.4
'21050, 부산진구,'005003, 2세,2019,1995,1026,969,105.9,1987,1021,966,105.7
'21050, 부산진구,'005004, 3세,2019,2291,1164,1127,103.3,2288,1161,1127,103
'21050, 부산진구,'005005, 4세,2019,2364,1227,1137,107.9,2358,1223,1135,107.8
'21050, 부산진구,'010,5~9세,2019,11898,6026,5872,102.6,11879,6014,5865,102.5
'21050, 부산진구,'010001, 5세,2019,2373,1231,1142,107.8,2365,1225,1140,107.5
'21050, 부산진구,'010002, 6세,2019,2278,1145,1133,101.1,2275,1144,1131,101.1
'21050, 부산진구,'010003, 7세,2019,2460,1229,1231,99.8,2457,1227,1230,99.8
'21050, 부산진구,'010004, 8세,2019,2492,1242,1250,99.4,2489,1240,1249,99.3
'21050, 부산진구,'010005, 9세,2019,2295,1179,1116,105.6,2293,1178,1115,105.7
'21050, 부산진구,'015,10~14세,2019,11267,5652,5615,100.7,11249,5645,5604,100.7
'21050, 부산진구,'015001, 10세,2019,2237,1136,1101,103.2,2232,1135,1097,103.5
'21050, 부산진구,'015002, 11세,2019,2352,1180,1172,100.7,2347,1176,1171,100.4
'21050, 부산진구,'015003, 12세,2019,2359,1177,1182,99.6,2355,1177,1178,99.9
'21050, 부산진구,'015004, 13세,2019,2201,1114,1087,102.5,2200,1114,1086,102.6
'21050, 부산진구,'015005, 14세,2019,2118,1045,1073,97.4,2115,1043,1072,97.3
'21050, 부산진구,'020,15~19세,2019,16306,8099,8207,98.7,16019,7965,8054,98.9
'21050, 부산진구,'020001, 15세,2019,2511,1326,1185,111.9,2504,1323,1181,112
'21050, 부산진구,'020002, 16세,2019,2603,1341,1262,106.3,2586,1334,1252,106.5
'21050, 부산진구,'020003, 17세,2019,2594,1289,1305,98.8,2580,1280,1300,98.5
'21050, 부산진구,'020004, 18세,2019,3588,1800,1788,100.7,3514,1765,1749,100.9
'21050, 부산진구,'020005, 19세,2019,5010,2343,2667,87.9,4835,2263,2572,88
'21050, 부산진구,'025,20~24세,2019,25392,12311,13081,94.1,24841,12099,12742,95
'21050, 부산진구,'025001, 20세,2019,4519,2013,2506,80.3,4412,1970,2442,80.7
'21050, 부산진구,'025002, 21세,2019,4676,2164,2512,86.1,4559,2122,2437,87.1
'21050, 부산진구,'025003, 22세,2019,5199,2581,2618,98.6,5077,2532,2545,99.5
'21050, 부산진구,'025004, 23세,2019,5445,2790,2655,105.1,5330,2747,2583,106.3
'21050, 부산진구,'025005, 24세,2019,5553,2763,2790,99,5463,2728,2735,99.7
'21050, 부산진구,'030,25~29세,2019,27190,13530,13660,99,26720,13372,13348,100.2
'21050, 부산진구,'030001, 25세,2019,5666,2773,2893,95.9,5570,2746,2824,97.2
'21050, 부산진구,'030002, 26세,2019,5646,2858,2788,102.5,5560,2824,2736,103.2
'21050, 부산진구,'030003, 27세,2019,5712,2836,2876,98.6,5637,2813,2824,99.6
'21050, 부산진구,'030004, 28세,2019,5208,2580,2628,98.2,5112,2553,2559,99.8
'21050, 부산진구,'030005, 29세,2019,4958,2483,2475,100.3,4841,2436,2405,101.3
'21050, 부산진구,'035,30~34세,2019,22266,11167,11099,100.6,21770,10969,10801,101.6
'21050, 부산진구,'035001, 30세,2019,4808,2350,2458,95.6,4699,2308,2391,96.5
'21050, 부산진구,'035002, 31세,2019,4442,2259,2183,103.5,4342,2214,2128,104
'21050, 부산진구,'035003, 32세,2019,4458,2228,2230,99.9,4346,2193,2153,101.9
'21050, 부산진구,'035004, 33세,2019,4180,2086,2094,99.6,4080,2042,2038,100.2
'21050, 부산진구,'035005, 34세,2019,4378,2244,2134,105.2,4303,2212,2091,105.8
'21050, 부산진구,'040,35~39세,2019,24993,12809,12184,105.1,24651,12684,11967,106
'21050, 부산진구,'040001, 35세,2019,4392,2303,2089,110.2,4314,2274,2040,111.5
'21050, 부산진구,'040002, 36세,2019,4921,2468,2453,100.6,4834,2441,2393,102
'21050, 부산진구,'040003, 37세,2019,5200,2680,2520,106.3,5139,2653,2486,106.7
'21050, 부산진구,'040004, 38세,2019,5159,2655,2504,106,5094,2629,2465,106.7
'21050, 부산진구,'040005, 39세,2019,5321,2703,2618,103.2,5270,2687,2583,104
'21050, 부산진구,'045,40~44세,2019,23250,11784,11466,102.8,22966,11669,11297,103.3
'21050, 부산진구,'045001, 40세,2019,5067,2538,2529,100.4,5001,2511,2490,100.8
'21050, 부산진구,'045002, 41세,2019,4520,2365,2155,109.7,4448,2330,2118,110
'21050, 부산진구,'045003, 42세,2019,4515,2292,2223,103.1,4471,2275,2196,103.6
'21050, 부산진구,'045004, 43세,2019,4450,2218,2232,99.4,4394,2202,2192,100.5
'21050, 부산진구,'045005, 44세,2019,4698,2371,2327,101.9,4652,2351,2301,102.2
'21050, 부산진구,'050,45~49세,2019,27277,13659,13618,100.3,27004,13533,13471,100.5
'21050, 부산진구,'050001, 45세,2019,5351,2739,2612,104.9,5287,2705,2582,104.8
'21050, 부산진구,'050002, 46세,2019,5242,2645,2597,101.8,5185,2615,2570,101.8
'21050, 부산진구,'050003, 47세,2019,5425,2718,2707,100.4,5377,2692,2685,100.3
'21050, 부산진구,'050004, 48세,2019,5660,2754,2906,94.8,5618,2742,2876,95.3
'21050, 부산진구,'050005, 49세,2019,5599,2803,2796,100.3,5537,2779,2758,100.8
'21050, 부산진구,'055,50~54세,2019,27317,13035,14282,91.3,27130,12947,14183,91.3
'21050, 부산진구,'055001, 50세,2019,5513,2679,2834,94.5,5474,2658,2816,94.4
'21050, 부산진구,'055002, 51세,2019,5718,2723,2995,90.9,5677,2708,2969,91.2
'21050, 부산진구,'055003, 52세,2019,5341,2482,2859,86.8,5313,2469,2844,86.8
'21050, 부산진구,'055004, 53세,2019,5308,2560,2748,93.2,5261,2543,2718,93.6
'21050, 부산진구,'055005, 54세,2019,5437,2591,2846,91,5405,2569,2836,90.6
'21050, 부산진구,'060,55~59세,2019,30488,14375,16113,89.2,30315,14301,16014,89.3
'21050, 부산진구,'060001, 55세,2019,5160,2530,2630,96.2,5128,2515,2613,96.2
'21050, 부산진구,'060002, 56세,2019,5754,2761,2993,92.2,5713,2744,2969,92.4
'21050, 부산진구,'060003, 57세,2019,6087,2915,3172,91.9,6038,2894,3144,92
'21050, 부산진구,'060004, 58세,2019,6712,3094,3618,85.5,6688,3083,3605,85.5
'21050, 부산진구,'060005, 59세,2019,6775,3075,3700,83.1,6748,3065,3683,83.2
'21050, 부산진구,'065,60~64세,2019,29905,14018,15887,88.2,29779,13953,15826,88.2
'21050, 부산진구,'065001, 60세,2019,6252,2917,3335,87.5,6225,2900,3325,87.2
'21050, 부산진구,'065002, 61세,2019,5972,2800,3172,88.3,5948,2789,3159,88.3
'21050, 부산진구,'065003, 62세,2019,6087,2858,3229,88.5,6059,2845,3214,88.5
'21050, 부산진구,'065004, 63세,2019,5638,2695,2943,91.6,5614,2682,2932,91.5
'21050, 부산진구,'065005, 64세,2019,5956,2748,3208,85.7,5933,2737,3196,85.6
'21050, 부산진구,'070,65~69세,2019,21798,10290,11508,89.4,21727,10262,11465,89.5
'21050, 부산진구,'070001, 65세,2019,4937,2418,2519,96,4919,2409,2510,96
'21050, 부산진구,'070002, 66세,2019,4442,2002,2440,82,4420,1996,2424,82.3
'21050, 부산진구,'070003, 67세,2019,4786,2267,2519,90,4772,2260,2512,90
'21050, 부산진구,'070004, 68세,2019,3842,1794,2048,87.6,3830,1791,2039,87.8
'21050, 부산진구,'070005, 69세,2019,3791,1809,1982,91.3,3786,1806,1980,91.2
'21050, 부산진구,'075,70~74세,2019,16719,7509,9210,81.5,16698,7499,9199,81.5
'21050, 부산진구,'075001, 70세,2019,3984,1813,2171,83.5,3982,1812,2170,83.5
'21050, 부산진구,'075002, 71세,2019,3871,1752,2119,82.7,3865,1749,2116,82.7
'21050, 부산진구,'075003, 72세,2019,3598,1621,1977,82,3593,1618,1975,81.9
'21050, 부산진구,'075004, 73세,2019,2656,1169,1487,78.6,2652,1167,1485,78.6
'21050, 부산진구,'075005, 74세,2019,2610,1154,1456,79.3,2606,1153,1453,79.4
'21050, 부산진구,'080,75~79세,2019,13525,5766,7759,74.3,13506,5759,7747,74.3
'21050, 부산진구,'080001, 75세,2019,2749,1240,1509,82.2,2743,1237,1506,82.1
'21050, 부산진구,'080002, 76세,2019,2812,1239,1573,78.8,2808,1237,1571,78.7
'21050, 부산진구,'080003, 77세,2019,3113,1285,1828,70.3,3110,1285,1825,70.4
'21050, 부산진구,'080004, 78세,2019,2533,1060,1473,72,2530,1058,1472,71.9
'21050, 부산진구,'080005, 79세,2019,2318,942,1376,68.5,2315,942,1373,68.6
'21050, 부산진구,'085,80~84세,2019,7968,2941,5027,58.5,7963,2938,5025,58.5
'21050, 부산진구,'085001, 80세,2019,2185,850,1335,63.7,2185,850,1335,63.7
'21050, 부산진구,'085002, 81세,2019,1706,659,1047,62.9,1702,657,1045,62.9
'21050, 부산진구,'085003, 82세,2019,1595,590,1005,58.7,1595,590,1005,58.7
'21050, 부산진구,'085004, 83세,2019,1278,452,826,54.7,1277,451,826,54.6
'21050, 부산진구,'085005, 84세,2019,1204,390,814,47.9,1204,390,814,47.9
'21050, 부산진구,'086,85세이상,2019,4537,1314,3223,40.8,4531,1313,3218,40.8
'21050, 부산진구,'090,85~89세,2019,3345,1057,2288,46.2,3342,1056,2286,46.2
'21050, 부산진구,'090001, 85세,2019,973,347,626,55.4,972,346,626,55.3
'21050, 부산진구,'090002, 86세,2019,789,258,531,48.6,787,258,529,48.8
'21050, 부산진구,'090003, 87세,2019,692,221,471,46.9,692,221,471,46.9
'21050, 부산진구,'090004, 88세,2019,484,127,357,35.6,484,127,357,35.6
'21050, 부산진구,'090005, 89세,2019,407,104,303,34.3,407,104,303,34.3
'21050, 부산진구,'095,90~94세,2019,983,216,767,28.2,981,216,765,28.2
'21050, 부산진구,'095001, 90세,2019,335,91,244,37.3,335,91,244,37.3
'21050, 부산진구,'095002, 91세,2019,261,52,209,24.9,261,52,209,24.9
'21050, 부산진구,'095003, 92세,2019,199,36,163,22.1,198,36,162,22.2
'21050, 부산진구,'095004, 93세,2019,104,20,84,23.8,103,20,83,24.1
'21050, 부산진구,'095005, 94세,2019,84,17,67,25.4,84,17,67,25.4
'21050, 부산진구,'100,95~99세,2019,189,39,150,26,188,39,149,26.2
'21050, 부산진구,'100001, 95세,2019,60,11,49,22.4,60,11,49,22.4
'21050, 부산진구,'100002, 96세,2019,53,13,40,32.5,52,13,39,33.3
'21050, 부산진구,'100003, 97세,2019,46,11,35,31.4,46,11,35,31.4
'21050, 부산진구,'100004, 98세,2019,17,X,13,30.8,17,X,13,30.8
'21050, 부산진구,'100005, 99세,2019,13,X,13,0,13,X,13,0
'21050, 부산진구,'101,100세이상,2019,20,X,18,11.1,20,X,18,11.1
'21050, 부산진구,'102,15세미만,2019,33459,16958,16501,102.8,33395,16922,16473,102.7
'21050, 부산진구,'103,15~64세,2019,254384,124787,129597,96.3,251195,123492,127703,96.7
'21050, 부산진구,'104,65세이상,2019,64547,27820,36727,75.7,64425,27771,36654,75.8
'21050, 부산진구,'126,평균연령,2019,44.4,43.3,45.5,,44.5,43.4,45.6,
'21050, 부산진구,'127,중위연령,2019,45.6,44.2,47,,45.8,44.3,47.2,
'21060, 동래구,'000,합계,2019,260986,126910,134076,94.7,259605,126369,133236,94.8
'21060, 동래구,'005,0~4세,2019,8355,4240,4115,103,8323,4231,4092,103.4
'21060, 동래구,'005001, 0세,2019,1324,653,671,97.3,1320,652,668,97.6
'21060, 동래구,'005002, 1세,2019,1428,737,691,106.7,1424,735,689,106.7
'21060, 동래구,'005003, 2세,2019,1670,822,848,96.9,1660,819,841,97.4
'21060, 동래구,'005004, 3세,2019,1872,960,912,105.3,1864,958,906,105.7
'21060, 동래구,'005005, 4세,2019,2061,1068,993,107.6,2055,1067,988,108
'21060, 동래구,'010,5~9세,2019,10977,5750,5227,110,10963,5741,5222,109.9
'21060, 동래구,'010001, 5세,2019,1991,1061,930,114.1,1991,1061,930,114.1
'21060, 동래구,'010002, 6세,2019,2106,1080,1026,105.3,2101,1077,1024,105.2
'21060, 동래구,'010003, 7세,2019,2321,1213,1108,109.5,2315,1210,1105,109.5
'21060, 동래구,'010004, 8세,2019,2224,1151,1073,107.3,2223,1150,1073,107.2
'21060, 동래구,'010005, 9세,2019,2335,1245,1090,114.2,2333,1243,1090,114
'21060, 동래구,'015,10~14세,2019,11266,5934,5332,111.3,11255,5929,5326,111.3
'21060, 동래구,'015001, 10세,2019,2112,1107,1005,110.1,2112,1107,1005,110.1
'21060, 동래구,'015002, 11세,2019,2311,1209,1102,109.7,2308,1208,1100,109.8
'21060, 동래구,'015003, 12세,2019,2453,1279,1174,108.9,2449,1276,1173,108.8
'21060, 동래구,'015004, 13세,2019,2220,1152,1068,107.9,2219,1152,1067,108
'21060, 동래구,'015005, 14세,2019,2170,1187,983,120.8,2167,1186,981,120.9
'21060, 동래구,'020,15~19세,2019,12544,6565,5979,109.8,12515,6555,5960,110
'21060, 동래구,'020001, 15세,2019,2430,1284,1146,112,2426,1284,1142,112.4
'21060, 동래구,'020002, 16세,2019,2368,1202,1166,103.1,2367,1202,1165,103.2
'21060, 동래구,'020003, 17세,2019,2370,1217,1153,105.6,2367,1217,1150,105.8
'21060, 동래구,'020004, 18세,2019,2644,1408,1236,113.9,2636,1405,1231,114.1
'21060, 동래구,'020005, 19세,2019,2732,1454,1278,113.8,2719,1447,1272,113.8
'21060, 동래구,'025,20~24세,2019,14933,7993,6940,115.2,14788,7953,6835,116.4
'21060, 동래구,'025001, 20세,2019,2731,1551,1180,131.4,2705,1541,1164,132.4
'21060, 동래구,'025002, 21세,2019,2850,1577,1273,123.9,2826,1569,1257,124.8
'21060, 동래구,'025003, 22세,2019,2999,1582,1417,111.6,2975,1573,1402,112.2
'21060, 동래구,'025004, 23세,2019,3150,1633,1517,107.6,3120,1627,1493,109
'21060, 동래구,'025005, 24세,2019,3203,1650,1553,106.2,3162,1643,1519,108.2
'21060, 동래구,'030,25~29세,2019,16115,8328,7787,106.9,15875,8250,7625,108.2
'21060, 동래구,'030001, 25세,2019,3245,1726,1519,113.6,3209,1715,1494,114.8
'21060, 동래구,'030002, 26세,2019,3363,1758,1605,109.5,3318,1742,1576,110.5
'21060, 동래구,'030003, 27세,2019,3374,1731,1643,105.4,3323,1719,1604,107.2
'21060, 동래구,'030004, 28세,2019,3081,1603,1478,108.5,3035,1587,1448,109.6
'21060, 동래구,'030005, 29세,2019,3052,1510,1542,97.9,2990,1487,1503,98.9
'21060, 동래구,'035,30~34세,2019,14192,7273,6919,105.1,13975,7190,6785,106
'21060, 동래구,'035001, 30세,2019,2944,1542,1402,110,2900,1524,1376,110.8
'21060, 동래구,'035002, 31세,2019,2836,1411,1425,99,2796,1396,1400,99.7
'21060, 동래구,'035003, 32세,2019,2730,1381,1349,102.4,2690,1372,1318,104.1
'21060, 동래구,'035004, 33세,2019,2855,1452,1403,103.5,2802,1430,1372,104.2
'21060, 동래구,'035005, 34세,2019,2827,1487,1340,111,2787,1468,1319,111.3
'21060, 동래구,'040,35~39세,2019,18575,9197,9378,98.1,18404,9127,9277,98.4
'21060, 동래구,'040001, 35세,2019,3049,1514,1535,98.6,3014,1504,1510,99.6
'21060, 동래구,'040002, 36세,2019,3512,1776,1736,102.3,3476,1756,1720,102.1
'21060, 동래구,'040003, 37세,2019,3889,1859,2030,91.6,3855,1844,2011,91.7
'21060, 동래구,'040004, 38세,2019,3894,1957,1937,101,3862,1944,1918,101.4
'21060, 동래구,'040005, 39세,2019,4231,2091,2140,97.7,4197,2079,2118,98.2
'21060, 동래구,'045,40~44세,2019,18969,9103,9866,92.3,18831,9046,9785,92.4
'21060, 동래구,'045001, 40세,2019,4008,1927,2081,92.6,3979,1914,2065,92.7
'21060, 동래구,'045002, 41세,2019,3644,1771,1873,94.6,3619,1759,1860,94.6
'21060, 동래구,'045003, 42세,2019,3656,1803,1853,97.3,3621,1788,1833,97.5
'21060, 동래구,'045004, 43세,2019,3665,1698,1967,86.3,3643,1691,1952,86.6
'21060, 동래구,'045005, 44세,2019,3996,1904,2092,91,3969,1894,2075,91.3
'21060, 동래구,'050,45~49세,2019,22340,10916,11424,95.6,22229,10863,11366,95.6
'21060, 동래구,'050001, 45세,2019,4294,2110,2184,96.6,4272,2097,2175,96.4
'21060, 동래구,'050002, 46세,2019,4405,2146,2259,95,4376,2135,2241,95.3
'21060, 동래구,'050003, 47세,2019,4393,2193,2200,99.7,4373,2185,2188,99.9
'21060, 동래구,'050004, 48세,2019,4699,2266,2433,93.1,4673,2253,2420,93.1
'21060, 동래구,'050005, 49세,2019,4549,2201,2348,93.7,4535,2193,2342,93.6
'21060, 동래구,'055,50~54세,2019,21854,10445,11409,91.6,21762,10399,11363,91.5
'21060, 동래구,'055001, 50세,2019,4660,2244,2416,92.9,4633,2229,2404,92.7
'21060, 동래구,'055002, 51세,2019,4545,2220,2325,95.5,4529,2213,2316,95.6
'21060, 동래구,'055003, 52세,2019,4373,2057,2316,88.8,4354,2050,2304,89
'21060, 동래구,'055004, 53세,2019,4078,1997,2081,96,4062,1989,2073,95.9
'21060, 동래구,'055005, 54세,2019,4198,1927,2271,84.9,4184,1918,2266,84.6
'21060, 동래구,'060,55~59세,2019,22627,10448,12179,85.8,22555,10417,12138,85.8
'21060, 동래구,'060001, 55세,2019,3893,1807,2086,86.6,3876,1801,2075,86.8
'21060, 동래구,'060002, 56세,2019,4218,1975,2243,88.1,4203,1967,2236,88
'21060, 동래구,'060003, 57세,2019,4514,2099,2415,86.9,4505,2093,2412,86.8
'21060, 동래구,'060004, 58세,2019,4998,2303,2695,85.5,4983,2296,2687,85.4
'21060, 동래구,'060005, 59세,2019,5004,2264,2740,82.6,4988,2260,2728,82.8
'21060, 동래구,'065,60~64세,2019,22008,10294,11714,87.9,21958,10273,11685,87.9
'21060, 동래구,'065001, 60세,2019,4593,2159,2434,88.7,4580,2155,2425,88.9
'21060, 동래구,'065002, 61세,2019,4402,2089,2313,90.3,4390,2084,2306,90.4
'21060, 동래구,'065003, 62세,2019,4467,2131,2336,91.2,4457,2127,2330,91.3
'21060, 동래구,'065004, 63세,2019,4096,1894,2202,86,4086,1887,2199,85.8
'21060, 동래구,'065005, 64세,2019,4450,2021,2429,83.2,4445,2020,2425,83.3
'21060, 동래구,'070,65~69세,2019,16355,7682,8673,88.6,16324,7668,8656,88.6
'21060, 동래구,'070001, 65세,2019,3670,1762,1908,92.3,3665,1760,1905,92.4
'21060, 동래구,'070002, 66세,2019,3385,1548,1837,84.3,3377,1543,1834,84.1
'21060, 동래구,'070003, 67세,2019,3557,1666,1891,88.1,3549,1661,1888,88
'21060, 동래구,'070004, 68세,2019,2886,1356,1530,88.6,2881,1355,1526,88.8
'21060, 동래구,'070005, 69세,2019,2857,1350,1507,89.6,2852,1349,1503,89.8
'21060, 동래구,'075,70~74세,2019,11935,5708,6227,91.7,11921,5700,6221,91.6
'21060, 동래구,'075001, 70세,2019,2839,1340,1499,89.4,2834,1338,1496,89.4
'21060, 동래구,'075002, 71세,2019,2787,1309,1478,88.6,2783,1306,1477,88.4
'21060, 동래구,'075003, 72세,2019,2568,1215,1353,89.8,2566,1214,1352,89.8
'21060, 동래구,'075004, 73세,2019,1907,942,965,97.6,1905,940,965,97.4
'21060, 동래구,'075005, 74세,2019,1834,902,932,96.8,1833,902,931,96.9
'21060, 동래구,'080,75~79세,2019,9074,4040,5034,80.3,9069,4036,5033,80.2
'21060, 동래구,'080001, 75세,2019,1970,923,1047,88.2,1968,921,1047,88
'21060, 동래구,'080002, 76세,2019,1853,847,1006,84.2,1852,846,1006,84.1
'21060, 동래구,'080003, 77세,2019,2050,888,1162,76.4,2048,887,1161,76.4
'21060, 동래구,'080004, 78세,2019,1723,759,964,78.7,1723,759,964,78.7
'21060, 동래구,'080005, 79세,2019,1478,623,855,72.9,1478,623,855,72.9
'21060, 동래구,'085,80~84세,2019,5329,2118,3211,66,5327,2117,3210,66
'21060, 동래구,'085001, 80세,2019,1354,567,787,72,1353,566,787,71.9
'21060, 동래구,'085002, 81세,2019,1117,450,667,67.5,1117,450,667,67.5
'21060, 동래구,'085003, 82세,2019,1033,416,617,67.4,1032,416,616,67.5
'21060, 동래구,'085004, 83세,2019,953,379,574,66,953,379,574,66
'21060, 동래구,'085005, 84세,2019,872,306,566,54.1,872,306,566,54.1
'21060, 동래구,'086,85세이상,2019,3538,876,2662,32.9,3531,874,2657,32.9
'21060, 동래구,'090,85~89세,2019,2481,680,1801,37.8,2478,679,1799,37.7
'21060, 동래구,'090001, 85세,2019,698,211,487,43.3,697,211,486,43.4
'21060, 동래구,'090002, 86세,2019,552,153,399,38.3,552,153,399,38.3
'21060, 동래구,'090003, 87세,2019,487,132,355,37.2,486,132,354,37.3
'21060, 동래구,'090004, 88세,2019,395,110,285,38.6,394,109,285,38.2
'21060, 동래구,'090005, 89세,2019,349,74,275,26.9,349,74,275,26.9
'21060, 동래구,'095,90~94세,2019,838,166,672,24.7,836,165,671,24.6
'21060, 동래구,'095001, 90세,2019,262,56,206,27.2,261,55,206,26.7
'21060, 동래구,'095002, 91세,2019,218,47,171,27.5,217,47,170,27.6
'21060, 동래구,'095003, 92세,2019,152,29,123,23.6,152,29,123,23.6
'21060, 동래구,'095004, 93세,2019,114,18,96,18.8,114,18,96,18.8
'21060, 동래구,'095005, 94세,2019,92,16,76,21.1,92,16,76,21.1
'21060, 동래구,'100,95~99세,2019,190,28,162,17.3,189,28,161,17.4
'21060, 동래구,'100001, 95세,2019,54,10,44,22.7,54,10,44,22.7
'21060, 동래구,'100002, 96세,2019,62,9,53,17,62,9,53,17
'21060, 동래구,'100003, 97세,2019,35,5,30,16.7,34,5,29,17.2
'21060, 동래구,'100004, 98세,2019,21,X,18,16.7,21,X,18,16.7
'21060, 동래구,'100005, 99세,2019,18,X,17,5.9,18,X,17,5.9
'21060, 동래구,'101,100세이상,2019,29,X,27,7.4,28,X,26,7.7
'21060, 동래구,'102,15세미만,2019,30598,15924,14674,108.5,30541,15901,14640,108.6
'21060, 동래구,'103,15~64세,2019,184157,90562,93595,96.8,182892,90073,92819,97
'21060, 동래구,'104,65세이상,2019,46231,20424,25807,79.1,46172,20395,25777,79.1
'21060, 동래구,'126,평균연령,2019,44.1,42.8,45.4,,44.2,42.8,45.5,
'21060, 동래구,'127,중위연령,2019,46.1,44.5,47.5,,46.1,44.6,47.6,
'21070, 남구,'000,합계,2019,278849,137062,141787,96.7,271366,133232,138134,96.5
'21070, 남구,'005,0~4세,2019,8308,4240,4068,104.2,8244,4210,4034,104.4
'21070, 남구,'005001, 0세,2019,1235,598,637,93.9,1228,594,634,93.7
'21070, 남구,'005002, 1세,2019,1413,757,656,115.4,1403,752,651,115.5
'21070, 남구,'005003, 2세,2019,1656,830,826,100.5,1638,820,818,100.2
'21070, 남구,'005004, 3세,2019,1947,977,970,100.7,1929,970,959,101.1
'21070, 남구,'005005, 4세,2019,2057,1078,979,110.1,2046,1074,972,110.5
'21070, 남구,'010,5~9세,2019,10937,5586,5351,104.4,10901,5570,5331,104.5
'21070, 남구,'010001, 5세,2019,2049,1036,1013,102.3,2032,1026,1006,102
'21070, 남구,'010002, 6세,2019,2097,1083,1014,106.8,2092,1082,1010,107.1
'21070, 남구,'010003, 7세,2019,2290,1154,1136,101.6,2286,1153,1133,101.8
'21070, 남구,'010004, 8세,2019,2260,1120,1140,98.2,2256,1120,1136,98.6
'21070, 남구,'010005, 9세,2019,2241,1193,1048,113.8,2235,1189,1046,113.7
'21070, 남구,'015,10~14세,2019,10748,5532,5216,106.1,10724,5520,5204,106.1
'21070, 남구,'015001, 10세,2019,2067,1014,1053,96.3,2063,1011,1052,96.1
'21070, 남구,'015002, 11세,2019,2165,1118,1047,106.8,2159,1115,1044,106.8
'21070, 남구,'015003, 12세,2019,2337,1236,1101,112.3,2330,1232,1098,112.2
'21070, 남구,'015004, 13세,2019,2063,1062,1001,106.1,2061,1062,999,106.3
'21070, 남구,'015005, 14세,2019,2116,1102,1014,108.7,2111,1100,1011,108.8
'21070, 남구,'020,15~19세,2019,15044,7771,7273,106.8,14525,7523,7002,107.4
'21070, 남구,'020001, 15세,2019,2215,1173,1042,112.6,2208,1169,1039,112.5
'21070, 남구,'020002, 16세,2019,2303,1193,1110,107.5,2292,1189,1103,107.8
'21070, 남구,'020003, 17세,2019,2351,1251,1100,113.7,2321,1235,1086,113.7
'21070, 남구,'020004, 18세,2019,3169,1678,1491,112.5,3062,1617,1445,111.9
'21070, 남구,'020005, 19세,2019,5006,2476,2530,97.9,4642,2313,2329,99.3
'21070, 남구,'025,20~24세,2019,24247,12561,11686,107.5,21342,10995,10347,106.3
'21070, 남구,'025001, 20세,2019,4855,2239,2616,85.6,4066,1803,2263,79.7
'21070, 남구,'025002, 21세,2019,4808,2341,2467,94.9,4093,1977,2116,93.4
'21070, 남구,'025003, 22세,2019,4981,2647,2334,113.4,4466,2355,2111,111.6
'21070, 남구,'025004, 23세,2019,4937,2684,2253,119.1,4460,2418,2042,118.4
'21070, 남구,'025005, 24세,2019,4666,2650,2016,131.4,4257,2442,1815,134.5
'21070, 남구,'030,25~29세,2019,18242,9998,8244,121.3,16986,9411,7575,124.2
'21070, 남구,'030001, 25세,2019,4244,2402,1842,130.4,3911,2238,1673,133.8
'21070, 남구,'030002, 26세,2019,3883,2188,1695,129.1,3624,2077,1547,134.3
'21070, 남구,'030003, 27세,2019,3742,2027,1715,118.2,3498,1905,1593,119.6
'21070, 남구,'030004, 28세,2019,3407,1837,1570,117,3180,1740,1440,120.8
'21070, 남구,'030005, 29세,2019,2966,1544,1422,108.6,2773,1451,1322,109.8
'21070, 남구,'035,30~34세,2019,14285,7392,6893,107.2,13515,7021,6494,108.1
'21070, 남구,'035001, 30세,2019,2982,1621,1361,119.1,2819,1539,1280,120.2
'21070, 남구,'035002, 31세,2019,2776,1406,1370,102.6,2602,1328,1274,104.2
'21070, 남구,'035003, 32세,2019,2853,1453,1400,103.8,2695,1378,1317,104.6
'21070, 남구,'035004, 33세,2019,2860,1468,1392,105.5,2711,1400,1311,106.8
'21070, 남구,'035005, 34세,2019,2814,1444,1370,105.4,2688,1376,1312,104.9
'21070, 남구,'040,35~39세,2019,18834,9582,9252,103.6,18269,9295,8974,103.6
'21070, 남구,'040001, 35세,2019,3165,1611,1554,103.7,3025,1542,1483,104
'21070, 남구,'040002, 36세,2019,3431,1750,1681,104.1,3340,1708,1632,104.7
'21070, 남구,'040003, 37세,2019,3944,2006,1938,103.5,3823,1939,1884,102.9
'21070, 남구,'040004, 38세,2019,4037,2053,1984,103.5,3931,1997,1934,103.3
'21070, 남구,'040005, 39세,2019,4257,2162,2095,103.2,4150,2109,2041,103.3
'21070, 남구,'045,40~44세,2019,19453,9753,9700,100.5,19047,9542,9505,100.4
'21070, 남구,'045001, 40세,2019,4179,2069,2110,98.1,4085,2015,2070,97.3
'21070, 남구,'045002, 41세,2019,3768,1886,1882,100.2,3675,1845,1830,100.8
'21070, 남구,'045003, 42세,2019,3812,1892,1920,98.5,3740,1856,1884,98.5
'21070, 남구,'045004, 43세,2019,3641,1813,1828,99.2,3566,1771,1795,98.7
'21070, 남구,'045005, 44세,2019,4053,2093,1960,106.8,3981,2055,1926,106.7
'21070, 남구,'050,45~49세,2019,22880,11515,11365,101.3,22519,11312,11207,100.9
'21070, 남구,'050001, 45세,2019,4434,2257,2177,103.7,4349,2211,2138,103.4
'21070, 남구,'050002, 46세,2019,4554,2285,2269,100.7,4477,2248,2229,100.9
'21070, 남구,'050003, 47세,2019,4499,2335,2164,107.9,4434,2297,2137,107.5
'21070, 남구,'050004, 48세,2019,4812,2376,2436,97.5,4742,2329,2413,96.5
'21070, 남구,'050005, 49세,2019,4581,2262,2319,97.5,4517,2227,2290,97.2
'21070, 남구,'055,50~54세,2019,21312,10490,10822,96.9,21077,10365,10712,96.8
'21070, 남구,'055001, 50세,2019,4628,2329,2299,101.3,4578,2301,2277,101.1
'21070, 남구,'055002, 51세,2019,4573,2236,2337,95.7,4526,2211,2315,95.5
'21070, 남구,'055003, 52세,2019,4138,2038,2100,97,4092,2017,2075,97.2
'21070, 남구,'055004, 53세,2019,4050,1976,2074,95.3,4008,1951,2057,94.8
'21070, 남구,'055005, 54세,2019,3923,1911,2012,95,3873,1885,1988,94.8
'21070, 남구,'060,55~59세,2019,22250,10500,11750,89.4,22102,10414,11688,89.1
'21070, 남구,'060001, 55세,2019,3882,1938,1944,99.7,3849,1914,1935,98.9
'21070, 남구,'060002, 56세,2019,4187,2008,2179,92.2,4159,1993,2166,92
'21070, 남구,'060003, 57세,2019,4335,2074,2261,91.7,4297,2054,2243,91.6
'21070, 남구,'060004, 58세,2019,4770,2179,2591,84.1,4745,2163,2582,83.8
'21070, 남구,'060005, 59세,2019,5076,2301,2775,82.9,5052,2290,2762,82.9
'21070, 남구,'065,60~64세,2019,22272,10279,11993,85.7,22185,10240,11945,85.7
'21070, 남구,'065001, 60세,2019,4537,2112,2425,87.1,4516,2106,2410,87.4
'21070, 남구,'065002, 61세,2019,4452,2091,2361,88.6,4432,2078,2354,88.3
'21070, 남구,'065003, 62세,2019,4538,2136,2402,88.9,4524,2129,2395,88.9
'21070, 남구,'065004, 63세,2019,4253,1900,2353,80.7,4236,1891,2345,80.6
'21070, 남구,'065005, 64세,2019,4492,2040,2452,83.2,4477,2036,2441,83.4
'21070, 남구,'070,65~69세,2019,16820,7765,9055,85.8,16762,7738,9024,85.7
'21070, 남구,'070001, 65세,2019,3751,1781,1970,90.4,3732,1773,1959,90.5
'21070, 남구,'070002, 66세,2019,3309,1541,1768,87.2,3304,1539,1765,87.2
'21070, 남구,'070003, 67세,2019,3657,1670,1987,84,3643,1662,1981,83.9
'21070, 남구,'070004, 68세,2019,2993,1363,1630,83.6,2984,1358,1626,83.5
'21070, 남구,'070005, 69세,2019,3110,1410,1700,82.9,3099,1406,1693,83
'21070, 남구,'075,70~74세,2019,13331,6058,7273,83.3,13309,6048,7261,83.3
'21070, 남구,'075001, 70세,2019,3170,1436,1734,82.8,3162,1432,1730,82.8
'21070, 남구,'075002, 71세,2019,2959,1327,1632,81.3,2952,1324,1628,81.3
'21070, 남구,'075003, 72세,2019,2875,1319,1556,84.8,2874,1318,1556,84.7
'21070, 남구,'075004, 73세,2019,2148,982,1166,84.2,2145,981,1164,84.3
'21070, 남구,'075005, 74세,2019,2179,994,1185,83.9,2176,993,1183,83.9
'21070, 남구,'080,75~79세,2019,10635,4710,5925,79.5,10626,4706,5920,79.5
'21070, 남구,'080001, 75세,2019,2302,1014,1288,78.7,2301,1013,1288,78.6
'21070, 남구,'080002, 76세,2019,2356,1032,1324,77.9,2354,1032,1322,78.1
'21070, 남구,'080003, 77세,2019,2381,1106,1275,86.7,2379,1105,1274,86.7
'21070, 남구,'080004, 78세,2019,1838,790,1048,75.4,1836,788,1048,75.2
'21070, 남구,'080005, 79세,2019,1758,768,990,77.6,1756,768,988,77.7
'21070, 남구,'085,80~84세,2019,5916,2372,3544,66.9,5906,2367,3539,66.9
'21070, 남구,'085001, 80세,2019,1537,663,874,75.9,1534,662,872,75.9
'21070, 남구,'085002, 81세,2019,1321,559,762,73.4,1320,559,761,73.5
'21070, 남구,'085003, 82세,2019,1172,466,706,66,1167,463,704,65.8
'21070, 남구,'085004, 83세,2019,1011,361,650,55.5,1011,361,650,55.5
'21070, 남구,'085005, 84세,2019,875,323,552,58.5,874,322,552,58.3
'21070, 남구,'086,85세이상,2019,3335,958,2377,40.3,3327,955,2372,40.3
'21070, 남구,'090,85~89세,2019,2426,767,1659,46.2,2422,765,1657,46.2
'21070, 남구,'090001, 85세,2019,733,240,493,48.7,732,240,492,48.8
'21070, 남구,'090002, 86세,2019,560,196,364,53.8,559,195,364,53.6
'21070, 남구,'090003, 87세,2019,486,150,336,44.6,485,149,336,44.3
'21070, 남구,'090004, 88세,2019,339,98,241,40.7,338,98,240,40.8
'21070, 남구,'090005, 89세,2019,308,83,225,36.9,308,83,225,36.9
'21070, 남구,'095,90~94세,2019,782,164,618,26.5,779,163,616,26.5
'21070, 남구,'095001, 90세,2019,245,61,184,33.2,244,61,183,33.3
'21070, 남구,'095002, 91세,2019,209,42,167,25.1,208,42,166,25.3
'21070, 남구,'095003, 92세,2019,156,23,133,17.3,156,23,133,17.3
'21070, 남구,'095004, 93세,2019,94,23,71,32.4,93,22,71,31
'21070, 남구,'095005, 94세,2019,78,15,63,23.8,78,15,63,23.8
'21070, 남구,'100,95~99세,2019,109,21,88,23.9,108,21,87,24.1
'21070, 남구,'100001, 95세,2019,35,8,27,29.6,35,8,27,29.6
'21070, 남구,'100002, 96세,2019,30,8,22,36.4,29,8,21,38.1
'21070, 남구,'100003, 97세,2019,22,X,20,10,22,X,20,10
'21070, 남구,'100004, 98세,2019,14,X,12,16.7,14,X,12,16.7
'21070, 남구,'100005, 99세,2019,8,X,7,14.3,8,X,7,14.3
'21070, 남구,'101,100세이상,2019,18,6,12,50,18,6,12,50
'21070, 남구,'102,15세미만,2019,29993,15358,14635,104.9,29869,15300,14569,105
'21070, 남구,'103,15~64세,2019,198819,99841,98978,100.9,191567,96118,95449,100.7
'21070, 남구,'104,65세이상,2019,50037,21863,28174,77.6,49930,21814,28116,77.6
'21070, 남구,'126,평균연령,2019,43.5,42.2,44.8,,43.9,42.5,45.2,
'21070, 남구,'127,중위연령,2019,44.8,43,46.5,,45.5,43.8,47.1,
'21080, 북구,'000,합계,2019,285098,140888,144210,97.7,281975,139449,142526,97.8
'21080, 북구,'005,0~4세,2019,9360,4816,4544,106,9353,4814,4539,106.1
'21080, 북구,'005001, 0세,2019,1461,771,690,111.7,1461,771,690,111.7
'21080, 북구,'005002, 1세,2019,1702,867,835,103.8,1701,866,835,103.7
'21080, 북구,'005003, 2세,2019,1916,1003,913,109.9,1913,1002,911,110
'21080, 북구,'005004, 3세,2019,2093,1048,1045,100.3,2091,1048,1043,100.5
'21080, 북구,'005005, 4세,2019,2188,1127,1061,106.2,2187,1127,1060,106.3
'21080, 북구,'010,5~9세,2019,10781,5561,5220,106.5,10770,5555,5215,106.5
'21080, 북구,'010001, 5세,2019,2121,1060,1061,99.9,2117,1058,1059,99.9
'21080, 북구,'010002, 6세,2019,2139,1094,1045,104.7,2138,1094,1044,104.8
'21080, 북구,'010003, 7세,2019,2271,1210,1061,114,2268,1207,1061,113.8
'21080, 북구,'010004, 8세,2019,2182,1117,1065,104.9,2181,1117,1064,105
'21080, 북구,'010005, 9세,2019,2068,1080,988,109.3,2066,1079,987,109.3
'21080, 북구,'015,10~14세,2019,10890,5632,5258,107.1,10879,5627,5252,107.1
'21080, 북구,'015001, 10세,2019,2131,1063,1068,99.5,2130,1063,1067,99.6
'21080, 북구,'015002, 11세,2019,2168,1104,1064,103.8,2167,1104,1063,103.9
'21080, 북구,'015003, 12세,2019,2192,1117,1075,103.9,2190,1115,1075,103.7
'21080, 북구,'015004, 13세,2019,2167,1172,995,117.8,2165,1170,995,117.6
'21080, 북구,'015005, 14세,2019,2232,1176,1056,111.4,2227,1175,1052,111.7
'21080, 북구,'020,15~19세,2019,13526,7074,6452,109.6,13427,7030,6397,109.9
'21080, 북구,'020001, 15세,2019,2292,1185,1107,107,2287,1182,1105,107
'21080, 북구,'020002, 16세,2019,2281,1185,1096,108.1,2279,1184,1095,108.1
'21080, 북구,'020003, 17세,2019,2418,1233,1185,104.1,2411,1230,1181,104.1
'21080, 북구,'020004, 18세,2019,3019,1573,1446,108.8,3007,1565,1442,108.5
'21080, 북구,'020005, 19세,2019,3516,1898,1618,117.3,3443,1869,1574,118.7
'21080, 북구,'025,20~24세,2019,19457,10720,8737,122.7,18489,10175,8314,122.4
'21080, 북구,'025001, 20세,2019,3330,1857,1473,126.1,3148,1762,1386,127.1
'21080, 북구,'025002, 21세,2019,3811,2190,1621,135.1,3607,2073,1534,135.1
'21080, 북구,'025003, 22세,2019,3958,2171,1787,121.5,3747,2057,1690,121.7
'21080, 북구,'025004, 23세,2019,4147,2210,1937,114.1,3948,2095,1853,113.1
'21080, 북구,'025005, 24세,2019,4211,2292,1919,119.4,4039,2188,1851,118.2
'21080, 북구,'030,25~29세,2019,19755,10594,9161,115.6,19170,10300,8870,116.1
'21080, 북구,'030001, 25세,2019,4164,2249,1915,117.4,4014,2157,1857,116.2
'21080, 북구,'030002, 26세,2019,4101,2220,1881,118,3953,2145,1808,118.6
'21080, 북구,'030003, 27세,2019,4154,2210,1944,113.7,4051,2159,1892,114.1
'21080, 북구,'030004, 28세,2019,3817,2078,1739,119.5,3734,2040,1694,120.4
'21080, 북구,'030005, 29세,2019,3519,1837,1682,109.2,3418,1799,1619,111.1
'21080, 북구,'035,30~34세,2019,15830,8029,7801,102.9,15460,7910,7550,104.8
'21080, 북구,'035001, 30세,2019,3363,1757,1606,109.4,3273,1720,1553,110.8
'21080, 북구,'035002, 31세,2019,3174,1536,1638,93.8,3086,1506,1580,95.3
'21080, 북구,'035003, 32세,2019,3108,1585,1523,104.1,3038,1563,1475,106
'21080, 북구,'035004, 33세,2019,3043,1563,1480,105.6,2989,1552,1437,108
'21080, 북구,'035005, 34세,2019,3142,1588,1554,102.2,3074,1569,1505,104.3
'21080, 북구,'040,35~39세,2019,18934,9696,9238,105,18675,9604,9071,105.9
'21080, 북구,'040001, 35세,2019,3263,1690,1573,107.4,3213,1673,1540,108.6
'21080, 북구,'040002, 36세,2019,3568,1828,1740,105.1,3499,1807,1692,106.8
'21080, 북구,'040003, 37세,2019,3972,2001,1971,101.5,3918,1980,1938,102.2
'21080, 북구,'040004, 38세,2019,4024,2078,1946,106.8,3986,2064,1922,107.4
'21080, 북구,'040005, 39세,2019,4107,2099,2008,104.5,4059,2080,1979,105.1
'21080, 북구,'045,40~44세,2019,18617,9417,9200,102.4,18417,9342,9075,102.9
'21080, 북구,'045001, 40세,2019,3979,2001,1978,101.2,3931,1984,1947,101.9
'21080, 북구,'045002, 41세,2019,3527,1812,1715,105.7,3488,1794,1694,105.9
'21080, 북구,'045003, 42세,2019,3661,1874,1787,104.9,3624,1861,1763,105.6
'21080, 북구,'045004, 43세,2019,3499,1782,1717,103.8,3459,1769,1690,104.7
'21080, 북구,'045005, 44세,2019,3951,1948,2003,97.3,3915,1934,1981,97.6
'21080, 북구,'050,45~49세,2019,22707,10768,11939,90.2,22515,10688,11827,90.4
'21080, 북구,'050001, 45세,2019,4126,2033,2093,97.1,4095,2022,2073,97.5
'21080, 북구,'050002, 46세,2019,4441,2067,2374,87.1,4400,2053,2347,87.5
'21080, 북구,'050003, 47세,2019,4383,2107,2276,92.6,4348,2091,2257,92.6
'21080, 북구,'050004, 48세,2019,4771,2243,2528,88.7,4729,2221,2508,88.6
'21080, 북구,'050005, 49세,2019,4986,2318,2668,86.9,4943,2301,2642,87.1
'21080, 북구,'055,50~54세,2019,26354,12266,14088,87.1,26197,12202,13995,87.2
'21080, 북구,'055001, 50세,2019,5174,2396,2778,86.2,5138,2382,2756,86.4
'21080, 북구,'055002, 51세,2019,5420,2471,2949,83.8,5386,2453,2933,83.6
'21080, 북구,'055003, 52세,2019,5242,2411,2831,85.2,5214,2401,2813,85.4
'21080, 북구,'055004, 53세,2019,5225,2487,2738,90.8,5188,2475,2713,91.2
'21080, 북구,'055005, 54세,2019,5293,2501,2792,89.6,5271,2491,2780,89.6
'21080, 북구,'060,55~59세,2019,28956,14161,14795,95.7,28820,14102,14718,95.8
'21080, 북구,'060001, 55세,2019,4965,2361,2604,90.7,4935,2352,2583,91.1
'21080, 북구,'060002, 56세,2019,5578,2731,2847,95.9,5551,2719,2832,96
'21080, 북구,'060003, 57세,2019,5707,2808,2899,96.9,5675,2792,2883,96.8
'21080, 북구,'060004, 58세,2019,6497,3201,3296,97.1,6475,3190,3285,97.1
'21080, 북구,'060005, 59세,2019,6209,3060,3149,97.2,6184,3049,3135,97.3
'21080, 북구,'065,60~64세,2019,25070,12433,12637,98.4,25005,12401,12604,98.4
'21080, 북구,'065001, 60세,2019,5521,2752,2769,99.4,5510,2746,2764,99.3
'21080, 북구,'065002, 61세,2019,5086,2548,2538,100.4,5073,2542,2531,100.4
'21080, 북구,'065003, 62세,2019,5114,2582,2532,102,5099,2575,2524,102
'21080, 북구,'065004, 63세,2019,4558,2246,2312,97.1,4541,2237,2304,97.1
'21080, 북구,'065005, 64세,2019,4791,2305,2486,92.7,4782,2301,2481,92.7
'21080, 북구,'070,65~69세,2019,16407,8087,8320,97.2,16382,8079,8303,97.3
'21080, 북구,'070001, 65세,2019,3856,1905,1951,97.6,3845,1901,1944,97.8
'21080, 북구,'070002, 66세,2019,3322,1617,1705,94.8,3316,1615,1701,94.9
'21080, 북구,'070003, 67세,2019,3591,1791,1800,99.5,3589,1790,1799,99.5
'21080, 북구,'070004, 68세,2019,2734,1321,1413,93.5,2729,1320,1409,93.7
'21080, 북구,'070005, 69세,2019,2904,1453,1451,100.1,2903,1453,1450,100.2
'21080, 북구,'075,70~74세,2019,11351,5347,6004,89.1,11335,5343,5992,89.2
'21080, 북구,'075001, 70세,2019,2712,1272,1440,88.3,2707,1270,1437,88.4
'21080, 북구,'075002, 71세,2019,2606,1215,1391,87.3,2602,1215,1387,87.6
'21080, 북구,'075003, 72세,2019,2492,1171,1321,88.6,2488,1169,1319,88.6
'21080, 북구,'075004, 73세,2019,1837,881,956,92.2,1835,881,954,92.3
'21080, 북구,'075005, 74세,2019,1704,808,896,90.2,1703,808,895,90.3
'21080, 북구,'080,75~79세,2019,8656,3702,4954,74.7,8645,3696,4949,74.7
'21080, 북구,'080001, 75세,2019,1740,770,970,79.4,1736,768,968,79.3
'21080, 북구,'080002, 76세,2019,1842,838,1004,83.5,1841,837,1004,83.4
'21080, 북구,'080003, 77세,2019,2042,876,1166,75.1,2039,875,1164,75.2
'21080, 북구,'080004, 78세,2019,1599,651,948,68.7,1598,650,948,68.6
'21080, 북구,'080005, 79세,2019,1433,567,866,65.5,1431,566,865,65.4
'21080, 북구,'085,80~84세,2019,5193,1831,3362,54.5,5185,1828,3357,54.5
'21080, 북구,'085001, 80세,2019,1337,501,836,59.9,1334,499,835,59.8
'21080, 북구,'085002, 81세,2019,1140,409,731,56,1139,409,730,56
'21080, 북구,'085003, 82세,2019,1009,370,639,57.9,1008,370,638,58
'21080, 북구,'085004, 83세,2019,854,276,578,47.8,853,276,577,47.8
'21080, 북구,'085005, 84세,2019,853,275,578,47.6,851,274,577,47.5
'21080, 북구,'086,85세이상,2019,3254,754,2500,30.2,3251,753,2498,30.1
'21080, 북구,'090,85~89세,2019,2303,574,1729,33.2,2301,574,1727,33.2
'21080, 북구,'090001, 85세,2019,674,190,484,39.3,673,190,483,39.3
'21080, 북구,'090002, 86세,2019,545,165,380,43.4,545,165,380,43.4
'21080, 북구,'090003, 87세,2019,453,101,352,28.7,453,101,352,28.7
'21080, 북구,'090004, 88세,2019,363,72,291,24.7,362,72,290,24.8
'21080, 북구,'090005, 89세,2019,268,46,222,20.7,268,46,222,20.7
'21080, 북구,'095,90~94세,2019,778,157,621,25.3,778,157,621,25.3
'21080, 북구,'095001, 90세,2019,245,54,191,28.3,245,54,191,28.3
'21080, 북구,'095002, 91세,2019,212,42,170,24.7,212,42,170,24.7
'21080, 북구,'095003, 92세,2019,140,32,108,29.6,140,32,108,29.6
'21080, 북구,'095004, 93세,2019,98,21,77,27.3,98,21,77,27.3
'21080, 북구,'095005, 94세,2019,83,8,75,10.7,83,8,75,10.7
'21080, 북구,'100,95~99세,2019,153,19,134,14.2,153,19,134,14.2
'21080, 북구,'100001, 95세,2019,43,9,34,26.5,43,9,34,26.5
'21080, 북구,'100002, 96세,2019,54,X,50,8,54,X,50,8
'21080, 북구,'100003, 97세,2019,24,X,21,14.3,24,X,21,14.3
'21080, 북구,'100004, 98세,2019,21,X,21,0,21,X,21,0
'21080, 북구,'100005, 99세,2019,11,X,8,37.5,11,X,8,37.5
'21080, 북구,'101,100세이상,2019,20,X,16,25,19,X,16,18.8
'21080, 북구,'102,15세미만,2019,31031,16009,15022,106.6,31002,15996,15006,106.6
'21080, 북구,'103,15~64세,2019,209206,105158,104048,101.1,206175,103754,102421,101.3
'21080, 북구,'104,65세이상,2019,44861,19721,25140,78.4,44798,19699,25099,78.5
'21080, 북구,'126,평균연령,2019,43.8,42.5,45.1,,43.9,42.6,45.2,
'21080, 북구,'127,중위연령,2019,46.3,44.4,47.9,,46.5,44.7,48.1,
'21090, 해운대구,'000,합계,2019,392846,190184,202662,93.8,387764,187573,200191,93.7
'21090, 해운대구,'005,0~4세,2019,12522,6446,6076,106.1,12289,6327,5962,106.1
'21090, 해운대구,'005001, 0세,2019,1973,1017,956,106.4,1945,1000,945,105.8
'21090, 해운대구,'005002, 1세,2019,2212,1116,1096,101.8,2178,1099,1079,101.9
'21090, 해운대구,'005003, 2세,2019,2409,1265,1144,110.6,2355,1240,1115,111.2
'21090, 해운대구,'005004, 3세,2019,2827,1448,1379,105,2772,1417,1355,104.6
'21090, 해운대구,'005005, 4세,2019,3101,1600,1501,106.6,3039,1571,1468,107
'21090, 해운대구,'010,5~9세,2019,16653,8670,7983,108.6,16504,8614,7890,109.2
'21090, 해운대구,'010001, 5세,2019,3059,1598,1461,109.4,3019,1581,1438,109.9
'21090, 해운대구,'010002, 6세,2019,3218,1698,1520,111.7,3190,1687,1503,112.2
'21090, 해운대구,'010003, 7세,2019,3489,1808,1681,107.6,3455,1795,1660,108.1
'21090, 해운대구,'010004, 8세,2019,3513,1820,1693,107.5,3487,1813,1674,108.3
'21090, 해운대구,'010005, 9세,2019,3374,1746,1628,107.2,3353,1738,1615,107.6
'21090, 해운대구,'015,10~14세,2019,17467,8960,8507,105.3,17384,8920,8464,105.4
'21090, 해운대구,'015001, 10세,2019,3308,1719,1589,108.2,3292,1711,1581,108.2
'21090, 해운대구,'015002, 11세,2019,3542,1818,1724,105.5,3522,1808,1714,105.5
'21090, 해운대구,'015003, 12세,2019,3641,1832,1809,101.3,3621,1825,1796,101.6
'21090, 해운대구,'015004, 13세,2019,3479,1794,1685,106.5,3465,1788,1677,106.6
'21090, 해운대구,'015005, 14세,2019,3497,1797,1700,105.7,3484,1788,1696,105.4
'21090, 해운대구,'020,15~19세,2019,21556,11573,9983,115.9,21377,11481,9896,116
'21090, 해운대구,'020001, 15세,2019,3769,1957,1812,108,3753,1948,1805,107.9
'21090, 해운대구,'020002, 16세,2019,4162,2287,1875,122,4144,2280,1864,122.3
'21090, 해운대구,'020003, 17세,2019,4423,2366,2057,115,4403,2353,2050,114.8
'21090, 해운대구,'020004, 18세,2019,4837,2582,2255,114.5,4791,2557,2234,114.5
'21090, 해운대구,'020005, 19세,2019,4365,2381,1984,120,4286,2343,1943,120.6
'21090, 해운대구,'025,20~24세,2019,23078,12336,10742,114.8,22349,11991,10358,115.8
'21090, 해운대구,'025001, 20세,2019,4343,2410,1933,124.7,4213,2345,1868,125.5
'21090, 해운대구,'025002, 21세,2019,4481,2505,1976,126.8,4311,2416,1895,127.5
'21090, 해운대구,'025003, 22세,2019,4558,2401,2157,111.3,4417,2333,2084,111.9
'21090, 해운대구,'025004, 23세,2019,4932,2592,2340,110.8,4795,2531,2264,111.8
'21090, 해운대구,'025005, 24세,2019,4764,2428,2336,103.9,4613,2366,2247,105.3
'21090, 해운대구,'030,25~29세,2019,23387,12037,11350,106.1,22686,11685,11001,106.2
'21090, 해운대구,'030001, 25세,2019,4915,2594,2321,111.8,4761,2515,2246,112
'21090, 해운대구,'030002, 26세,2019,4832,2499,2333,107.1,4681,2422,2259,107.2
'21090, 해운대구,'030003, 27세,2019,4880,2520,2360,106.8,4746,2446,2300,106.3
'21090, 해운대구,'030004, 28세,2019,4526,2270,2256,100.6,4397,2205,2192,100.6
'21090, 해운대구,'030005, 29세,2019,4234,2154,2080,103.6,4101,2097,2004,104.6
'21090, 해운대구,'035,30~34세,2019,20288,10040,10248,98,19607,9692,9915,97.8
'21090, 해운대구,'035001, 30세,2019,4175,2095,2080,100.7,4032,2028,2004,101.2
'21090, 해운대구,'035002, 31세,2019,3927,1999,1928,103.7,3795,1925,1870,102.9
'21090, 해운대구,'035003, 32세,2019,3962,1920,2042,94,3810,1843,1967,93.7
'21090, 해운대구,'035004, 33세,2019,4075,1971,2104,93.7,3938,1911,2027,94.3
'21090, 해운대구,'035005, 34세,2019,4149,2055,2094,98.1,4032,1985,2047,97
'21090, 해운대구,'040,35~39세,2019,27122,13047,14075,92.7,26564,12761,13803,92.5
'21090, 해운대구,'040001, 35세,2019,4405,2138,2267,94.3,4282,2082,2200,94.6
'21090, 해운대구,'040002, 36세,2019,4958,2345,2613,89.7,4848,2284,2564,89.1
'21090, 해운대구,'040003, 37세,2019,5658,2784,2874,96.9,5523,2709,2814,96.3
'21090, 해운대구,'040004, 38세,2019,5867,2827,3040,93,5772,2777,2995,92.7
'21090, 해운대구,'040005, 39세,2019,6234,2953,3281,90,6139,2909,3230,90.1
'21090, 해운대구,'045,40~44세,2019,29306,14054,15252,92.1,28851,13800,15051,91.7
'21090, 해운대구,'045001, 40세,2019,5914,2766,3148,87.9,5806,2710,3096,87.5
'21090, 해운대구,'045002, 41세,2019,5564,2710,2854,95,5477,2661,2816,94.5
'21090, 해운대구,'045003, 42세,2019,5906,2894,3012,96.1,5810,2838,2972,95.5
'21090, 해운대구,'045004, 43세,2019,5780,2843,2937,96.8,5685,2790,2895,96.4
'21090, 해운대구,'045005, 44세,2019,6142,2841,3301,86.1,6073,2801,3272,85.6
'21090, 해운대구,'050,45~49세,2019,36414,17226,19188,89.8,36007,16993,19014,89.4
'21090, 해운대구,'050001, 45세,2019,6866,3194,3672,87,6777,3147,3630,86.7
'21090, 해운대구,'050002, 46세,2019,6873,3262,3611,90.3,6788,3212,3576,89.8
'21090, 해운대구,'050003, 47세,2019,7365,3494,3871,90.3,7301,3452,3849,89.7
'21090, 해운대구,'050004, 48세,2019,7737,3647,4090,89.2,7648,3598,4050,88.8
'21090, 해운대구,'050005, 49세,2019,7573,3629,3944,92,7493,3584,3909,91.7
'21090, 해운대구,'055,50~54세,2019,34656,16556,18100,91.5,34369,16396,17973,91.2
'21090, 해운대구,'055001, 50세,2019,7297,3520,3777,93.2,7240,3486,3754,92.9
'21090, 해운대구,'055002, 51세,2019,7495,3589,3906,91.9,7430,3553,3877,91.6
'21090, 해운대구,'055003, 52세,2019,6849,3216,3633,88.5,6795,3181,3614,88
'21090, 해운대구,'055004, 53세,2019,6455,3107,3348,92.8,6400,3081,3319,92.8
'21090, 해운대구,'055005, 54세,2019,6560,3124,3436,90.9,6504,3095,3409,90.8
'21090, 해운대구,'060,55~59세,2019,34837,16529,18308,90.3,34583,16396,18187,90.2
'21090, 해운대구,'060001, 55세,2019,6273,2951,3322,88.8,6224,2927,3297,88.8
'21090, 해운대구,'060002, 56세,2019,6946,3334,3612,92.3,6884,3299,3585,92
'21090, 해운대구,'060003, 57세,2019,6899,3305,3594,92,6843,3279,3564,92
'21090, 해운대구,'060004, 58세,2019,7373,3466,3907,88.7,7331,3444,3887,88.6
'21090, 해운대구,'060005, 59세,2019,7346,3473,3873,89.7,7301,3447,3854,89.4
'21090, 해운대구,'065,60~64세,2019,31681,15067,16614,90.7,31521,14991,16530,90.7
'21090, 해운대구,'065001, 60세,2019,6622,3183,3439,92.6,6585,3159,3426,92.2
'21090, 해운대구,'065002, 61세,2019,6496,3091,3405,90.8,6464,3076,3388,90.8
'21090, 해운대구,'065003, 62세,2019,6330,2931,3399,86.2,6297,2919,3378,86.4
'21090, 해운대구,'065004, 63세,2019,6069,2993,3076,97.3,6040,2983,3057,97.6
'21090, 해운대구,'065005, 64세,2019,6164,2869,3295,87.1,6135,2854,3281,87
'21090, 해운대구,'070,65~69세,2019,21888,10316,11572,89.1,21789,10255,11534,88.9
'21090, 해운대구,'070001, 65세,2019,5021,2517,2504,100.5,4988,2497,2491,100.2
'21090, 해운대구,'070002, 66세,2019,4537,2102,2435,86.3,4521,2091,2430,86
'21090, 해운대구,'070003, 67세,2019,4901,2262,2639,85.7,4881,2248,2633,85.4
'21090, 해운대구,'070004, 68세,2019,3673,1734,1939,89.4,3662,1729,1933,89.4
'21090, 해운대구,'070005, 69세,2019,3756,1701,2055,82.8,3737,1690,2047,82.6
'21090, 해운대구,'075,70~74세,2019,16379,7521,8858,84.9,16329,7492,8837,84.8
'21090, 해운대구,'075001, 70세,2019,3881,1740,2141,81.3,3871,1732,2139,81
'21090, 해운대구,'075002, 71세,2019,3764,1759,2005,87.7,3753,1754,1999,87.7
'21090, 해운대구,'075003, 72세,2019,3558,1644,1914,85.9,3547,1639,1908,85.9
'21090, 해운대구,'075004, 73세,2019,2532,1152,1380,83.5,2526,1149,1377,83.4
'21090, 해운대구,'075005, 74세,2019,2644,1226,1418,86.5,2632,1218,1414,86.1
'21090, 해운대구,'080,75~79세,2019,12843,5422,7421,73.1,12815,5410,7405,73.1
'21090, 해운대구,'080001, 75세,2019,2678,1227,1451,84.6,2671,1224,1447,84.6
'21090, 해운대구,'080002, 76세,2019,2698,1130,1568,72.1,2697,1130,1567,72.1
'21090, 해운대구,'080003, 77세,2019,2862,1181,1681,70.3,2854,1176,1678,70.1
'21090, 해운대구,'080004, 78세,2019,2443,994,1449,68.6,2436,992,1444,68.7
'21090, 해운대구,'080005, 79세,2019,2162,890,1272,70,2157,888,1269,70
'21090, 해운대구,'085,80~84세,2019,7973,2966,5007,59.2,7958,2958,5000,59.2
'21090, 해운대구,'085001, 80세,2019,2050,811,1239,65.5,2045,809,1236,65.5
'21090, 해운대구,'085002, 81세,2019,1734,682,1052,64.8,1733,681,1052,64.7
'21090, 해운대구,'085003, 82세,2019,1573,580,993,58.4,1569,578,991,58.3
'21090, 해운대구,'085004, 83세,2019,1387,481,906,53.1,1384,478,906,52.8
'21090, 해운대구,'085005, 84세,2019,1229,412,817,50.4,1227,412,815,50.6
'21090, 해운대구,'086,85세이상,2019,4796,1418,3378,42,4782,1411,3371,41.9
'21090, 해운대구,'090,85~89세,2019,3449,1074,2375,45.2,3443,1071,2372,45.2
'21090, 해운대구,'090001, 85세,2019,976,357,619,57.7,974,356,618,57.6
'21090, 해운대구,'090002, 86세,2019,837,269,568,47.4,834,268,566,47.3
'21090, 해운대구,'090003, 87세,2019,692,203,489,41.5,691,202,489,41.3
'21090, 해운대구,'090004, 88세,2019,522,145,377,38.5,522,145,377,38.5
'21090, 해운대구,'090005, 89세,2019,422,100,322,31.1,422,100,322,31.1
'21090, 해운대구,'095,90~94세,2019,1118,282,836,33.7,1110,278,832,33.4
'21090, 해운대구,'095001, 90세,2019,388,114,274,41.6,385,113,272,41.5
'21090, 해운대구,'095002, 91세,2019,293,63,230,27.4,290,62,228,27.2
'21090, 해운대구,'095003, 92세,2019,214,57,157,36.3,213,56,157,35.7
'21090, 해운대구,'095004, 93세,2019,120,26,94,27.7,120,26,94,27.7
'21090, 해운대구,'095005, 94세,2019,103,22,81,27.2,102,21,81,25.9
'21090, 해운대구,'100,95~99세,2019,210,57,153,37.3,210,57,153,37.3
'21090, 해운대구,'100001, 95세,2019,68,13,55,23.6,68,13,55,23.6
'21090, 해운대구,'100002, 96세,2019,68,20,48,41.7,68,20,48,41.7
'21090, 해운대구,'100003, 97세,2019,47,17,30,56.7,47,17,30,56.7
'21090, 해운대구,'100004, 98세,2019,18,X,15,20,18,X,15,20
'21090, 해운대구,'100005, 99세,2019,9,X,5,80,9,X,5,80
'21090, 해운대구,'101,100세이상,2019,19,5,14,35.7,19,5,14,35.7
'21090, 해운대구,'102,15세미만,2019,46642,24076,22566,106.7,46177,23861,22316,106.9
'21090, 해운대구,'103,15~64세,2019,282325,138465,143860,96.2,277914,136186,141728,96.1
'21090, 해운대구,'104,65세이상,2019,63879,27643,36236,76.3,63673,27526,36147,76.2
'21090, 해운대구,'126,평균연령,2019,43.6,42.2,44.8,,43.7,42.3,45,
'21090, 해운대구,'127,중위연령,2019,45.7,44.3,47,,45.9,44.5,47.1,
'21100, 사하구,'000,합계,2019,319828,159399,160429,99.4,313995,155824,158171,98.5
'21100, 사하구,'005,0~4세,2019,9860,5088,4772,106.6,9802,5064,4738,106.9
'21100, 사하구,'005001, 0세,2019,1538,790,748,105.6,1530,786,744,105.6
'21100, 사하구,'005002, 1세,2019,1829,914,915,99.9,1815,907,908,99.9
'21100, 사하구,'005003, 2세,2019,1950,1030,920,112,1940,1026,914,112.3
'21100, 사하구,'005004, 3세,2019,2224,1139,1085,105,2209,1135,1074,105.7
'21100, 사하구,'005005, 4세,2019,2319,1215,1104,110.1,2308,1210,1098,110.2
'21100, 사하구,'010,5~9세,2019,12039,6118,5921,103.3,12002,6104,5898,103.5
'21100, 사하구,'010001, 5세,2019,2314,1171,1143,102.4,2308,1170,1138,102.8
'21100, 사하구,'010002, 6세,2019,2281,1165,1116,104.4,2269,1158,1111,104.2
'21100, 사하구,'010003, 7세,2019,2572,1295,1277,101.4,2562,1292,1270,101.7
'21100, 사하구,'010004, 8세,2019,2574,1305,1269,102.8,2572,1305,1267,103
'21100, 사하구,'010005, 9세,2019,2298,1182,1116,105.9,2291,1179,1112,106
'21100, 사하구,'015,10~14세,2019,11724,6033,5691,106,11695,6025,5670,106.3
'21100, 사하구,'015001, 10세,2019,2315,1216,1099,110.6,2309,1213,1096,110.7
'21100, 사하구,'015002, 11세,2019,2412,1238,1174,105.5,2407,1236,1171,105.6
'21100, 사하구,'015003, 12세,2019,2474,1283,1191,107.7,2469,1282,1187,108
'21100, 사하구,'015004, 13세,2019,2226,1140,1086,105,2218,1138,1080,105.4
'21100, 사하구,'015005, 14세,2019,2297,1156,1141,101.3,2292,1156,1136,101.8
'21100, 사하구,'020,15~19세,2019,15932,8424,7508,112.2,15857,8393,7464,112.4
'21100, 사하구,'020001, 15세,2019,2563,1312,1251,104.9,2557,1309,1248,104.9
'21100, 사하구,'020002, 16세,2019,2832,1576,1256,125.5,2830,1575,1255,125.5
'21100, 사하구,'020003, 17세,2019,3017,1629,1388,117.4,3006,1626,1380,117.8
'21100, 사하구,'020004, 18세,2019,3499,1874,1625,115.3,3480,1861,1619,114.9
'21100, 사하구,'020005, 19세,2019,4021,2033,1988,102.3,3984,2022,1962,103.1
'21100, 사하구,'025,20~24세,2019,21447,11363,10084,112.7,20761,10964,9797,111.9
'21100, 사하구,'025001, 20세,2019,3730,1927,1803,106.9,3670,1899,1771,107.2
'21100, 사하구,'025002, 21세,2019,4244,2164,2080,104,4164,2125,2039,104.2
'21100, 사하구,'025003, 22세,2019,4360,2235,2125,105.2,4204,2154,2050,105.1
'21100, 사하구,'025004, 23세,2019,4610,2529,2081,121.5,4421,2415,2006,120.4
'21100, 사하구,'025005, 24세,2019,4503,2508,1995,125.7,4302,2371,1931,122.8
'21100, 사하구,'030,25~29세,2019,21206,11694,9512,122.9,20070,10952,9118,120.1
'21100, 사하구,'030001, 25세,2019,4507,2538,1969,128.9,4303,2413,1890,127.7
'21100, 사하구,'030002, 26세,2019,4367,2454,1913,128.3,4158,2311,1847,125.1
'21100, 사하구,'030003, 27세,2019,4378,2345,2033,115.3,4162,2211,1951,113.3
'21100, 사하구,'030004, 28세,2019,4026,2180,1846,118.1,3771,2017,1754,115
'21100, 사하구,'030005, 29세,2019,3928,2177,1751,124.3,3676,2000,1676,119.3
'21100, 사하구,'035,30~34세,2019,18052,9735,8317,117,16989,9028,7961,113.4
'21100, 사하구,'035001, 30세,2019,3668,1959,1709,114.6,3437,1808,1629,111
'21100, 사하구,'035002, 31세,2019,3553,1948,1605,121.4,3340,1797,1543,116.5
'21100, 사하구,'035003, 32세,2019,3480,1867,1613,115.7,3258,1707,1551,110.1
'21100, 사하구,'035004, 33세,2019,3545,1927,1618,119.1,3351,1813,1538,117.9
'21100, 사하구,'035005, 34세,2019,3806,2034,1772,114.8,3603,1903,1700,111.9
'21100, 사하구,'040,35~39세,2019,23083,12222,10861,112.5,22224,11630,10594,109.8
'21100, 사하구,'040001, 35세,2019,3986,2139,1847,115.8,3784,1998,1786,111.9
'21100, 사하구,'040002, 36세,2019,4312,2254,2058,109.5,4136,2136,2000,106.8
'21100, 사하구,'040003, 37세,2019,4728,2482,2246,110.5,4562,2368,2194,107.9
'21100, 사하구,'040004, 38세,2019,5028,2657,2371,112.1,4849,2532,2317,109.3
'21100, 사하구,'040005, 39세,2019,5029,2690,2339,115,4893,2596,2297,113
'21100, 사하구,'045,40~44세,2019,21338,11088,10250,108.2,20763,10742,10021,107.2
'21100, 사하구,'045001, 40세,2019,4521,2417,2104,114.9,4388,2332,2056,113.4
'21100, 사하구,'045002, 41세,2019,4163,2188,1975,110.8,4064,2129,1935,110
'21100, 사하구,'045003, 42세,2019,4207,2221,1986,111.8,4084,2136,1948,109.7
'21100, 사하구,'045004, 43세,2019,4012,2028,1984,102.2,3909,1971,1938,101.7
'21100, 사하구,'045005, 44세,2019,4435,2234,2201,101.5,4318,2174,2144,101.4
'21100, 사하구,'050,45~49세,2019,25689,12835,12854,99.9,25233,12561,12672,99.1
'21100, 사하구,'050001, 45세,2019,4914,2472,2442,101.2,4816,2407,2409,99.9
'21100, 사하구,'050002, 46세,2019,5021,2523,2498,101,4926,2473,2453,100.8
'21100, 사하구,'050003, 47세,2019,4943,2472,2471,100,4856,2420,2436,99.3
'21100, 사하구,'050004, 48세,2019,5428,2737,2691,101.7,5347,2685,2662,100.9
'21100, 사하구,'050005, 49세,2019,5383,2631,2752,95.6,5288,2576,2712,95
'21100, 사하구,'055,50~54세,2019,26783,12976,13807,94,26435,12797,13638,93.8
'21100, 사하구,'055001, 50세,2019,5513,2649,2864,92.5,5430,2604,2826,92.1
'21100, 사하구,'055002, 51세,2019,5603,2770,2833,97.8,5528,2730,2798,97.6
'21100, 사하구,'055003, 52세,2019,5231,2509,2722,92.2,5164,2480,2684,92.4
'21100, 사하구,'055004, 53세,2019,5172,2549,2623,97.2,5107,2514,2593,97
'21100, 사하구,'055005, 54세,2019,5264,2499,2765,90.4,5206,2469,2737,90.2
'21100, 사하구,'060,55~59세,2019,29608,14247,15361,92.7,29375,14126,15249,92.6
'21100, 사하구,'060001, 55세,2019,4972,2426,2546,95.3,4926,2406,2520,95.5
'21100, 사하구,'060002, 56세,2019,5582,2728,2854,95.6,5517,2688,2829,95
'21100, 사하구,'060003, 57세,2019,5948,2891,3057,94.6,5903,2868,3035,94.5
'21100, 사하구,'060004, 58세,2019,6443,3039,3404,89.3,6412,3022,3390,89.1
'21100, 사하구,'060005, 59세,2019,6663,3163,3500,90.4,6617,3142,3475,90.4
'21100, 사하구,'065,60~64세,2019,27922,13393,14529,92.2,27764,13317,14447,92.2
'21100, 사하구,'065001, 60세,2019,5833,2768,3065,90.3,5797,2750,3047,90.3
'21100, 사하구,'065002, 61세,2019,5641,2749,2892,95.1,5603,2730,2873,95
'21100, 사하구,'065003, 62세,2019,5843,2809,3034,92.6,5798,2784,3014,92.4
'21100, 사하구,'065004, 63세,2019,5152,2460,2692,91.4,5130,2450,2680,91.4
'21100, 사하구,'065005, 64세,2019,5453,2607,2846,91.6,5436,2603,2833,91.9
'21100, 사하구,'070,65~69세,2019,19694,9570,10124,94.5,19623,9529,10094,94.4
'21100, 사하구,'070001, 65세,2019,4605,2297,2308,99.5,4583,2284,2299,99.3
'21100, 사하구,'070002, 66세,2019,4100,1958,2142,91.4,4085,1951,2134,91.4
'21100, 사하구,'070003, 67세,2019,4236,2095,2141,97.9,4223,2088,2135,97.8
'21100, 사하구,'070004, 68세,2019,3363,1599,1764,90.6,3352,1591,1761,90.3
'21100, 사하구,'070005, 69세,2019,3390,1621,1769,91.6,3380,1615,1765,91.5
'21100, 사하구,'075,70~74세,2019,14361,6760,7601,88.9,14344,6751,7593,88.9
'21100, 사하구,'075001, 70세,2019,3392,1633,1759,92.8,3386,1630,1756,92.8
'21100, 사하구,'075002, 71세,2019,3286,1541,1745,88.3,3284,1539,1745,88.2
'21100, 사하구,'075003, 72세,2019,3064,1380,1684,81.9,3062,1379,1683,81.9
'21100, 사하구,'075004, 73세,2019,2341,1113,1228,90.6,2338,1113,1225,90.9
'21100, 사하구,'075005, 74세,2019,2278,1093,1185,92.2,2274,1090,1184,92.1
'21100, 사하구,'080,75~79세,2019,10533,4616,5917,78,10520,4610,5910,78
'21100, 사하구,'080001, 75세,2019,2181,993,1188,83.6,2178,991,1187,83.5
'21100, 사하구,'080002, 76세,2019,2202,1010,1192,84.7,2201,1010,1191,84.8
'21100, 사하구,'080003, 77세,2019,2451,1083,1368,79.2,2448,1080,1368,78.9
'21100, 사하구,'080004, 78세,2019,1984,828,1156,71.6,1981,828,1153,71.8
'21100, 사하구,'080005, 79세,2019,1715,702,1013,69.3,1712,701,1011,69.3
'21100, 사하구,'085,80~84세,2019,6363,2252,4111,54.8,6358,2251,4107,54.8
'21100, 사하구,'085001, 80세,2019,1660,640,1020,62.7,1658,639,1019,62.7
'21100, 사하구,'085002, 81세,2019,1410,517,893,57.9,1410,517,893,57.9
'21100, 사하구,'085003, 82세,2019,1317,468,849,55.1,1316,468,848,55.2
'21100, 사하구,'085004, 83세,2019,1024,324,700,46.3,1022,324,698,46.4
'21100, 사하구,'085005, 84세,2019,952,303,649,46.7,952,303,649,46.7
'21100, 사하구,'086,85세이상,2019,4194,985,3209,30.7,4180,980,3200,30.6
'21100, 사하구,'090,85~89세,2019,2896,753,2143,35.1,2886,750,2136,35.1
'21100, 사하구,'090001, 85세,2019,840,249,591,42.1,838,249,589,42.3
'21100, 사하구,'090002, 86세,2019,655,178,477,37.3,653,178,475,37.5
'21100, 사하구,'090003, 87세,2019,554,142,412,34.5,551,141,410,34.4
'21100, 사하구,'090004, 88세,2019,436,98,338,29,435,97,338,28.7
'21100, 사하구,'090005, 89세,2019,411,86,325,26.5,409,85,324,26.2
'21100, 사하구,'095,90~94세,2019,1053,202,851,23.7,1050,200,850,23.5
'21100, 사하구,'095001, 90세,2019,348,74,274,27,347,73,274,26.6
'21100, 사하구,'095002, 91세,2019,278,60,218,27.5,278,60,218,27.5
'21100, 사하구,'095003, 92세,2019,213,34,179,19,213,34,179,19
'21100, 사하구,'095004, 93세,2019,108,20,88,22.7,108,20,88,22.7
'21100, 사하구,'095005, 94세,2019,106,14,92,15.2,104,13,91,14.3
'21100, 사하구,'100,95~99세,2019,221,28,193,14.5,220,28,192,14.6
'21100, 사하구,'100001, 95세,2019,80,10,70,14.3,79,10,69,14.5
'21100, 사하구,'100002, 96세,2019,61,8,53,15.1,61,8,53,15.1
'21100, 사하구,'100003, 97세,2019,41,6,35,17.1,41,6,35,17.1
'21100, 사하구,'100004, 98세,2019,20,X,17,17.6,20,X,17,17.6
'21100, 사하구,'100005, 99세,2019,19,X,18,5.6,19,X,18,5.6
'21100, 사하구,'101,100세이상,2019,24,X,22,9.1,24,X,22,9.1
'21100, 사하구,'102,15세미만,2019,33623,17239,16384,105.2,33499,17193,16306,105.4
'21100, 사하구,'103,15~64세,2019,231060,117977,113083,104.3,225471,114510,110961,103.2
'21100, 사하구,'104,65세이상,2019,55145,24183,30962,78.1,55025,24121,30904,78.1
'21100, 사하구,'126,평균연령,2019,44.2,42.8,45.5,,44.3,42.9,45.7,
'21100, 사하구,'127,중위연령,2019,46.1,44.1,48,,46.4,44.5,48.2,
'21110, 금정구,'000,합계,2019,244726,119368,125358,95.2,239104,116936,122168,95.7
'21110, 금정구,'005,0~4세,2019,6083,3119,2964,105.2,6004,3088,2916,105.9
'21110, 금정구,'005001, 0세,2019,952,489,463,105.6,940,483,457,105.7
'21110, 금정구,'005002, 1세,2019,1086,560,526,106.5,1067,550,517,106.4
'21110, 금정구,'005003, 2세,2019,1221,621,600,103.5,1203,613,590,103.9
'21110, 금정구,'005004, 3세,2019,1305,695,610,113.9,1291,690,601,114.8
'21110, 금정구,'005005, 4세,2019,1519,754,765,98.6,1503,752,751,100.1
'21110, 금정구,'010,5~9세,2019,7829,4043,3786,106.8,7801,4031,3770,106.9
'21110, 금정구,'010001, 5세,2019,1492,782,710,110.1,1486,778,708,109.9
'21110, 금정구,'010002, 6세,2019,1494,759,735,103.3,1487,756,731,103.4
'21110, 금정구,'010003, 7세,2019,1625,849,776,109.4,1618,847,771,109.9
'21110, 금정구,'010004, 8세,2019,1657,845,812,104.1,1652,843,809,104.2
'21110, 금정구,'010005, 9세,2019,1561,808,753,107.3,1558,807,751,107.5
'21110, 금정구,'015,10~14세,2019,7989,4195,3794,110.6,7970,4182,3788,110.4
'21110, 금정구,'015001, 10세,2019,1541,841,700,120.1,1538,839,699,120
'21110, 금정구,'015002, 11세,2019,1558,813,745,109.1,1551,807,744,108.5
'21110, 금정구,'015003, 12세,2019,1707,876,831,105.4,1706,875,831,105.3
'21110, 금정구,'015004, 13세,2019,1596,849,747,113.7,1589,846,743,113.9
'21110, 금정구,'015005, 14세,2019,1587,816,771,105.8,1586,815,771,105.7
'21110, 금정구,'020,15~19세,2019,12825,6377,6448,98.9,12486,6247,6239,100.1
'21110, 금정구,'020001, 15세,2019,1767,892,875,101.9,1765,892,873,102.2
'21110, 금정구,'020002, 16세,2019,1989,1031,958,107.6,1986,1029,957,107.5
'21110, 금정구,'020003, 17세,2019,1947,977,970,100.7,1931,972,959,101.4
'21110, 금정구,'020004, 18세,2019,2711,1329,1382,96.2,2625,1292,1333,96.9
'21110, 금정구,'020005, 19세,2019,4411,2148,2263,94.9,4179,2062,2117,97.4
'21110, 금정구,'025,20~24세,2019,22540,11256,11284,99.8,20628,10621,10007,106.1
'21110, 금정구,'025001, 20세,2019,4221,1880,2341,80.3,3841,1763,2078,84.8
'21110, 금정구,'025002, 21세,2019,4288,1882,2406,78.2,3846,1755,2091,83.9
'21110, 금정구,'025003, 22세,2019,4684,2329,2355,98.9,4316,2198,2118,103.8
'21110, 금정구,'025004, 23세,2019,4836,2561,2275,112.6,4449,2437,2012,121.1
'21110, 금정구,'025005, 24세,2019,4511,2604,1907,136.5,4176,2468,1708,144.5
'21110, 금정구,'030,25~29세,2019,17988,10244,7744,132.3,16958,9766,7192,135.8
'21110, 금정구,'030001, 25세,2019,4292,2489,1803,138,4022,2371,1651,143.6
'21110, 금정구,'030002, 26세,2019,3932,2250,1682,133.8,3687,2144,1543,139
'21110, 금정구,'030003, 27세,2019,3645,2099,1546,135.8,3469,2022,1447,139.7
'21110, 금정구,'030004, 28세,2019,3190,1796,1394,128.8,3027,1711,1316,130
'21110, 금정구,'030005, 29세,2019,2929,1610,1319,122.1,2753,1518,1235,122.9
'21110, 금정구,'035,30~34세,2019,12530,6711,5819,115.3,11870,6348,5522,115
'21110, 금정구,'035001, 30세,2019,2742,1442,1300,110.9,2586,1355,1231,110.1
'21110, 금정구,'035002, 31세,2019,2520,1387,1133,122.4,2383,1308,1075,121.7
'21110, 금정구,'035003, 32세,2019,2495,1294,1201,107.7,2355,1222,1133,107.9
'21110, 금정구,'035004, 33세,2019,2412,1345,1067,126.1,2288,1274,1014,125.6
'21110, 금정구,'035005, 34세,2019,2361,1243,1118,111.2,2258,1189,1069,111.2
'21110, 금정구,'040,35~39세,2019,14790,7513,7277,103.2,14354,7295,7059,103.3
'21110, 금정구,'040001, 35세,2019,2493,1280,1213,105.5,2392,1231,1161,106
'21110, 금정구,'040002, 36세,2019,2798,1426,1372,103.9,2709,1375,1334,103.1
'21110, 금정구,'040003, 37세,2019,3036,1555,1481,105,2921,1498,1423,105.3
'21110, 금정구,'040004, 38세,2019,3188,1599,1589,100.6,3124,1567,1557,100.6
'21110, 금정구,'040005, 39세,2019,3275,1653,1622,101.9,3208,1624,1584,102.5
'21110, 금정구,'045,40~44세,2019,14539,7363,7176,102.6,14248,7205,7043,102.3
'21110, 금정구,'045001, 40세,2019,3090,1565,1525,102.6,3032,1532,1500,102.1
'21110, 금정구,'045002, 41세,2019,2914,1509,1405,107.4,2846,1475,1371,107.6
'21110, 금정구,'045003, 42세,2019,2860,1445,1415,102.1,2807,1413,1394,101.4
'21110, 금정구,'045004, 43세,2019,2703,1381,1322,104.5,2649,1354,1295,104.6
'21110, 금정구,'045005, 44세,2019,2972,1463,1509,97,2914,1431,1483,96.5
'21110, 금정구,'050,45~49세,2019,18085,8807,9278,94.9,17795,8671,9124,95
'21110, 금정구,'050001, 45세,2019,3356,1707,1649,103.5,3305,1682,1623,103.6
'21110, 금정구,'050002, 46세,2019,3520,1702,1818,93.6,3458,1665,1793,92.9
'21110, 금정구,'050003, 47세,2019,3540,1731,1809,95.7,3481,1708,1773,96.3
'21110, 금정구,'050004, 48세,2019,3886,1857,2029,91.5,3825,1830,1995,91.7
'21110, 금정구,'050005, 49세,2019,3783,1810,1973,91.7,3726,1786,1940,92.1
'21110, 금정구,'055,50~54세,2019,19712,9306,10406,89.4,19493,9201,10292,89.4
'21110, 금정구,'055001, 50세,2019,3981,1853,2128,87.1,3934,1827,2107,86.7
'21110, 금정구,'055002, 51세,2019,4031,1938,2093,92.6,3977,1917,2060,93.1
'21110, 금정구,'055003, 52세,2019,3901,1767,2134,82.8,3860,1746,2114,82.6
'21110, 금정구,'055004, 53세,2019,3883,1853,2030,91.3,3847,1838,2009,91.5
'21110, 금정구,'055005, 54세,2019,3916,1895,2021,93.8,3875,1873,2002,93.6
'21110, 금정구,'060,55~59세,2019,22387,10523,11864,88.7,22221,10442,11779,88.6
'21110, 금정구,'060001, 55세,2019,3877,1844,2033,90.7,3827,1817,2010,90.4
'21110, 금정구,'060002, 56세,2019,4270,2031,2239,90.7,4224,2012,2212,91
'21110, 금정구,'060003, 57세,2019,4528,2145,2383,90,4503,2132,2371,89.9
'21110, 금정구,'060004, 58세,2019,4883,2270,2613,86.9,4868,2262,2606,86.8
'21110, 금정구,'060005, 59세,2019,4829,2233,2596,86,4799,2219,2580,86
'21110, 금정구,'065,60~64세,2019,21232,10009,11223,89.2,21147,9967,11180,89.2
'21110, 금정구,'065001, 60세,2019,4471,2119,2352,90.1,4451,2109,2342,90.1
'21110, 금정구,'065002, 61세,2019,4187,1964,2223,88.3,4170,1956,2214,88.3
'21110, 금정구,'065003, 62세,2019,4295,2061,2234,92.3,4279,2054,2225,92.3
'21110, 금정구,'065004, 63세,2019,3961,1869,2092,89.3,3951,1864,2087,89.3
'21110, 금정구,'065005, 64세,2019,4318,1996,2322,86,4296,1984,2312,85.8
'21110, 금정구,'070,65~69세,2019,15455,7235,8220,88,15426,7224,8202,88.1
'21110, 금정구,'070001, 65세,2019,3438,1626,1812,89.7,3428,1621,1807,89.7
'21110, 금정구,'070002, 66세,2019,3240,1481,1759,84.2,3232,1478,1754,84.3
'21110, 금정구,'070003, 67세,2019,3366,1573,1793,87.7,3363,1571,1792,87.7
'21110, 금정구,'070004, 68세,2019,2672,1245,1427,87.2,2669,1244,1425,87.3
'21110, 금정구,'070005, 69세,2019,2739,1310,1429,91.7,2734,1310,1424,92
'21110, 금정구,'075,70~74세,2019,11803,5453,6350,85.9,11784,5440,6344,85.8
'21110, 금정구,'075001, 70세,2019,2848,1290,1558,82.8,2840,1284,1556,82.5
'21110, 금정구,'075002, 71세,2019,2719,1291,1428,90.4,2716,1289,1427,90.3
'21110, 금정구,'075003, 72세,2019,2473,1125,1348,83.5,2470,1123,1347,83.4
'21110, 금정구,'075004, 73세,2019,1891,881,1010,87.2,1889,880,1009,87.2
'21110, 금정구,'075005, 74세,2019,1872,866,1006,86.1,1869,864,1005,86
'21110, 금정구,'080,75~79세,2019,9260,4084,5176,78.9,9253,4082,5171,78.9
'21110, 금정구,'080001, 75세,2019,1949,883,1066,82.8,1948,883,1065,82.9
'21110, 금정구,'080002, 76세,2019,1974,935,1039,90,1973,934,1039,89.9
'21110, 금정구,'080003, 77세,2019,2052,902,1150,78.4,2051,902,1149,78.5
'21110, 금정구,'080004, 78세,2019,1734,746,988,75.5,1732,745,987,75.5
'21110, 금정구,'080005, 79세,2019,1551,618,933,66.2,1549,618,931,66.4
'21110, 금정구,'085,80~84세,2019,5693,2104,3589,58.6,5684,2102,3582,58.7
'21110, 금정구,'085001, 80세,2019,1447,582,865,67.3,1446,582,864,67.4
'21110, 금정구,'085002, 81세,2019,1251,493,758,65,1249,493,756,65.2
'21110, 금정구,'085003, 82세,2019,1051,392,659,59.5,1049,392,657,59.7
'21110, 금정구,'085004, 83세,2019,975,328,647,50.7,971,326,645,50.5
'21110, 금정구,'085005, 84세,2019,969,309,660,46.8,969,309,660,46.8
'21110, 금정구,'086,85세이상,2019,3986,1026,2960,34.7,3982,1024,2958,34.6
'21110, 금정구,'090,85~89세,2019,2793,787,2006,39.2,2789,785,2004,39.2
'21110, 금정구,'090001, 85세,2019,809,253,556,45.5,809,253,556,45.5
'21110, 금정구,'090002, 86세,2019,616,186,430,43.3,614,185,429,43.1
'21110, 금정구,'090003, 87세,2019,554,151,403,37.5,553,151,402,37.6
'21110, 금정구,'090004, 88세,2019,447,104,343,30.3,446,103,343,30
'21110, 금정구,'090005, 89세,2019,367,93,274,33.9,367,93,274,33.9
'21110, 금정구,'095,90~94세,2019,966,201,765,26.3,966,201,765,26.3
'21110, 금정구,'095001, 90세,2019,312,69,243,28.4,312,69,243,28.4
'21110, 금정구,'095002, 91세,2019,248,54,194,27.8,248,54,194,27.8
'21110, 금정구,'095003, 92세,2019,184,36,148,24.3,184,36,148,24.3
'21110, 금정구,'095004, 93세,2019,124,24,100,24,124,24,100,24
'21110, 금정구,'095005, 94세,2019,98,18,80,22.5,98,18,80,22.5
'21110, 금정구,'100,95~99세,2019,204,36,168,21.4,204,36,168,21.4
'21110, 금정구,'100001, 95세,2019,66,12,54,22.2,66,12,54,22.2
'21110, 금정구,'100002, 96세,2019,57,10,47,21.3,57,10,47,21.3
'21110, 금정구,'100003, 97세,2019,45,5,40,12.5,45,5,40,12.5
'21110, 금정구,'100004, 98세,2019,21,6,15,40,21,6,15,40
'21110, 금정구,'100005, 99세,2019,15,X,12,25,15,X,12,25
'21110, 금정구,'101,100세이상,2019,23,X,21,9.5,23,X,21,9.5
'21110, 금정구,'102,15세미만,2019,21901,11357,10544,107.7,21775,11301,10474,107.9
'21110, 금정구,'103,15~64세,2019,176628,88109,88519,99.5,171200,85763,85437,100.4
'21110, 금정구,'104,65세이상,2019,46197,19902,26295,75.7,46129,19872,26257,75.7
'21110, 금정구,'126,평균연령,2019,44.7,43.2,46.1,,45,43.4,46.5,
'21110, 금정구,'127,중위연령,2019,46.5,44.2,48.5,,47.1,44.8,49.2,
'21120, 강서구,'000,합계,2019,128809,68244,60565,112.7,122060,62519,59541,105
'21120, 강서구,'005,0~4세,2019,9594,4923,4671,105.4,9560,4909,4651,105.5
'21120, 강서구,'005001, 0세,2019,1506,802,704,113.9,1502,800,702,114
'21120, 강서구,'005002, 1세,2019,1759,886,873,101.5,1753,885,868,102
'21120, 강서구,'005003, 2세,2019,1956,1005,951,105.7,1949,1001,948,105.6
'21120, 강서구,'005004, 3세,2019,2212,1130,1082,104.4,2201,1124,1077,104.4
'21120, 강서구,'005005, 4세,2019,2161,1100,1061,103.7,2155,1099,1056,104.1
'21120, 강서구,'010,5~9세,2019,9545,4896,4649,105.3,9513,4872,4641,105
'21120, 강서구,'010001, 5세,2019,2112,1081,1031,104.8,2104,1078,1026,105.1
'21120, 강서구,'010002, 6세,2019,1928,995,933,106.6,1924,992,932,106.4
'21120, 강서구,'010003, 7세,2019,2042,1066,976,109.2,2033,1057,976,108.3
'21120, 강서구,'010004, 8세,2019,1845,931,914,101.9,1838,925,913,101.3
'21120, 강서구,'010005, 9세,2019,1618,823,795,103.5,1614,820,794,103.3
'21120, 강서구,'015,10~14세,2019,5815,2921,2894,100.9,5800,2912,2888,100.8
'21120, 강서구,'015001, 10세,2019,1404,719,685,105,1401,716,685,104.5
'21120, 강서구,'015002, 11세,2019,1360,689,671,102.7,1356,686,670,102.4
'21120, 강서구,'015003, 12세,2019,1148,545,603,90.4,1145,544,601,90.5
'21120, 강서구,'015004, 13세,2019,953,477,476,100.2,950,476,474,100.4
'21120, 강서구,'015005, 14세,2019,950,491,459,107,948,490,458,107
'21120, 강서구,'020,15~19세,2019,4071,2127,1944,109.4,4037,2100,1937,108.4
'21120, 강서구,'020001, 15세,2019,931,483,448,107.8,927,480,447,107.4
'21120, 강서구,'020002, 16세,2019,764,389,375,103.7,761,387,374,103.5
'21120, 강서구,'020003, 17세,2019,797,386,411,93.9,792,383,409,93.6
'21120, 강서구,'020004, 18세,2019,841,426,415,102.7,830,417,413,101
'21120, 강서구,'020005, 19세,2019,738,443,295,150.2,727,433,294,147.3
'21120, 강서구,'025,20~24세,2019,5011,3038,1973,154,4263,2391,1872,127.7
'21120, 강서구,'025001, 20세,2019,786,477,309,154.4,741,439,302,145.4
'21120, 강서구,'025002, 21세,2019,952,567,385,147.3,856,482,374,128.9
'21120, 강서구,'025003, 22세,2019,946,570,376,151.6,785,439,346,126.9
'21120, 강서구,'025004, 23세,2019,1130,670,460,145.7,925,487,438,111.2
'21120, 강서구,'025005, 24세,2019,1197,754,443,170.2,956,544,412,132
'21120, 강서구,'030,25~29세,2019,8089,4698,3391,138.5,6561,3362,3199,105.1
'21120, 강서구,'030001, 25세,2019,1294,770,524,146.9,1068,571,497,114.9
'21120, 강서구,'030002, 26세,2019,1556,927,629,147.4,1260,661,599,110.4
'21120, 강서구,'030003, 27세,2019,1629,944,685,137.8,1323,680,643,105.8
'21120, 강서구,'030004, 28세,2019,1729,989,740,133.6,1396,706,690,102.3
'21120, 강서구,'030005, 29세,2019,1881,1068,813,131.4,1514,744,770,96.6
'21120, 강서구,'035,30~34세,2019,11680,6388,5292,120.7,9938,4849,5089,95.3
'21120, 강서구,'035001, 30세,2019,2043,1146,897,127.8,1688,832,856,97.2
'21120, 강서구,'035002, 31세,2019,2136,1172,964,121.6,1787,870,917,94.9
'21120, 강서구,'035003, 32세,2019,2387,1295,1092,118.6,1992,942,1050,89.7
'21120, 강서구,'035004, 33세,2019,2465,1346,1119,120.3,2146,1065,1081,98.5
'21120, 강서구,'035005, 34세,2019,2649,1429,1220,117.1,2325,1140,1185,96.2
'21120, 강서구,'040,35~39세,2019,16811,9182,7629,120.4,15586,8108,7478,108.4
'21120, 강서구,'040001, 35세,2019,3031,1627,1404,115.9,2712,1346,1366,98.5
'21120, 강서구,'040002, 36세,2019,3369,1823,1546,117.9,3106,1592,1514,105.2
'21120, 강서구,'040003, 37세,2019,3596,2001,1595,125.5,3338,1777,1561,113.8
'21120, 강서구,'040004, 38세,2019,3504,1881,1623,115.9,3307,1708,1599,106.8
'21120, 강서구,'040005, 39세,2019,3311,1850,1461,126.6,3123,1685,1438,117.2
'21120, 강서구,'045,40~44세,2019,11903,6791,5112,132.8,11290,6279,5011,125.3
'21120, 강서구,'045001, 40세,2019,2975,1667,1308,127.4,2797,1510,1287,117.3
'21120, 강서구,'045002, 41세,2019,2541,1473,1068,137.9,2405,1361,1044,130.4
'21120, 강서구,'045003, 42세,2019,2313,1299,1014,128.1,2203,1205,998,120.7
'21120, 강서구,'045004, 43세,2019,2037,1187,850,139.6,1942,1115,827,134.8
'21120, 강서구,'045005, 44세,2019,2037,1165,872,133.6,1943,1088,855,127.3
'21120, 강서구,'050,45~49세,2019,8793,4973,3820,130.2,8451,4713,3738,126.1
'21120, 강서구,'050001, 45세,2019,1953,1143,810,141.1,1878,1086,792,137.1
'21120, 강서구,'050002, 46세,2019,1834,1023,811,126.1,1747,961,786,122.3
'21120, 강서구,'050003, 47세,2019,1655,951,704,135.1,1595,902,693,130.2
'21120, 강서구,'050004, 48세,2019,1721,976,745,131,1656,922,734,125.6
'21120, 강서구,'050005, 49세,2019,1630,880,750,117.3,1575,842,733,114.9
'21120, 강서구,'055,50~54세,2019,7409,3862,3547,108.9,7206,3706,3500,105.9
'21120, 강서구,'055001, 50세,2019,1576,863,713,121,1521,821,700,117.3
'21120, 강서구,'055002, 51세,2019,1552,795,757,105,1515,763,752,101.5
'21120, 강서구,'055003, 52세,2019,1412,699,713,98,1367,664,703,94.5
'21120, 강서구,'055004, 53세,2019,1415,777,638,121.8,1371,745,626,119
'21120, 강서구,'055005, 54세,2019,1454,728,726,100.3,1432,713,719,99.2
'21120, 강서구,'060,55~59세,2019,8342,4060,4282,94.8,8217,3985,4232,94.2
'21120, 강서구,'060001, 55세,2019,1383,670,713,94,1358,656,702,93.4
'21120, 강서구,'060002, 56세,2019,1550,794,756,105,1517,775,742,104.4
'21120, 강서구,'060003, 57세,2019,1706,820,886,92.6,1681,804,877,91.7
'21120, 강서구,'060004, 58세,2019,1857,887,970,91.4,1837,875,962,91
'21120, 강서구,'060005, 59세,2019,1846,889,957,92.9,1824,875,949,92.2
'21120, 강서구,'065,60~64세,2019,8116,4032,4084,98.7,8060,4003,4057,98.7
'21120, 강서구,'065001, 60세,2019,1711,837,874,95.8,1699,832,867,96
'21120, 강서구,'065002, 61세,2019,1664,835,829,100.7,1653,830,823,100.9
'21120, 강서구,'065003, 62세,2019,1688,831,857,97,1680,826,854,96.7
'21120, 강서구,'065004, 63세,2019,1504,733,771,95.1,1489,724,765,94.6
'21120, 강서구,'065005, 64세,2019,1549,796,753,105.7,1539,791,748,105.7
'21120, 강서구,'070,65~69세,2019,5263,2683,2580,104,5225,2669,2556,104.4
'21120, 강서구,'070001, 65세,2019,1235,621,614,101.1,1225,615,610,100.8
'21120, 강서구,'070002, 66세,2019,1124,571,553,103.3,1114,567,547,103.7
'21120, 강서구,'070003, 67세,2019,1124,561,563,99.6,1116,560,556,100.7
'21120, 강서구,'070004, 68세,2019,940,497,443,112.2,935,496,439,113
'21120, 강서구,'070005, 69세,2019,840,433,407,106.4,835,431,404,106.7
'21120, 강서구,'075,70~74세,2019,3419,1734,1685,102.9,3412,1727,1685,102.5
'21120, 강서구,'075001, 70세,2019,843,405,438,92.5,840,402,438,91.8
'21120, 강서구,'075002, 71세,2019,787,403,384,104.9,785,401,384,104.4
'21120, 강서구,'075003, 72세,2019,751,411,340,120.9,751,411,340,120.9
'21120, 강서구,'075004, 73세,2019,544,278,266,104.5,542,276,266,103.8
'21120, 강서구,'075005, 74세,2019,494,237,257,92.2,494,237,257,92.2
'21120, 강서구,'080,75~79세,2019,2521,1155,1366,84.6,2517,1154,1363,84.7
'21120, 강서구,'080001, 75세,2019,540,268,272,98.5,538,267,271,98.5
'21120, 강서구,'080002, 76세,2019,496,223,273,81.7,495,223,272,82
'21120, 강서구,'080003, 77세,2019,591,271,320,84.7,591,271,320,84.7
'21120, 강서구,'080004, 78세,2019,467,215,252,85.3,466,215,251,85.7
'21120, 강서구,'080005, 79세,2019,427,178,249,71.5,427,178,249,71.5
'21120, 강서구,'085,80~84세,2019,1477,527,950,55.5,1476,527,949,55.5
'21120, 강서구,'085001, 80세,2019,396,160,236,67.8,396,160,236,67.8
'21120, 강서구,'085002, 81세,2019,327,115,212,54.2,326,115,211,54.5
'21120, 강서구,'085003, 82세,2019,287,112,175,64,287,112,175,64
'21120, 강서구,'085004, 83세,2019,235,66,169,39.1,235,66,169,39.1
'21120, 강서구,'085005, 84세,2019,232,74,158,46.8,232,74,158,46.8
'21120, 강서구,'086,85세이상,2019,950,254,696,36.5,948,253,695,36.4
'21120, 강서구,'090,85~89세,2019,687,200,487,41.1,685,199,486,40.9
'21120, 강서구,'090001, 85세,2019,205,68,137,49.6,204,67,137,48.9
'21120, 강서구,'090002, 86세,2019,148,50,98,51,147,50,97,51.5
'21120, 강서구,'090003, 87세,2019,128,32,96,33.3,128,32,96,33.3
'21120, 강서구,'090004, 88세,2019,114,34,80,42.5,114,34,80,42.5
'21120, 강서구,'090005, 89세,2019,92,16,76,21.1,92,16,76,21.1
'21120, 강서구,'095,90~94세,2019,222,44,178,24.7,222,44,178,24.7
'21120, 강서구,'095001, 90세,2019,90,19,71,26.8,90,19,71,26.8
'21120, 강서구,'095002, 91세,2019,48,10,38,26.3,48,10,38,26.3
'21120, 강서구,'095003, 92세,2019,40,6,34,17.6,40,6,34,17.6
'21120, 강서구,'095004, 93세,2019,23,X,19,21.1,23,X,19,21.1
'21120, 강서구,'095005, 94세,2019,21,5,16,31.3,21,5,16,31.3
'21120, 강서구,'100,95~99세,2019,38,9,29,31,38,9,29,31
'21120, 강서구,'100001, 95세,2019,12,X,8,50,12,X,8,50
'21120, 강서구,'100002, 96세,2019,10,X,9,11.1,10,X,9,11.1
'21120, 강서구,'100003, 97세,2019,8,X,5,60,8,X,5,60
'21120, 강서구,'100004, 98세,2019,X,X,X,0,X,X,X,0
'21120, 강서구,'100005, 99세,2019,X,X,X,33.3,X,X,X,33.3
'21120, 강서구,'101,100세이상,2019,X,X,X,50,X,X,X,50
'21120, 강서구,'102,15세미만,2019,24954,12740,12214,104.3,24873,12693,12180,104.2
'21120, 강서구,'103,15~64세,2019,90225,49151,41074,119.7,83609,43496,40113,108.4
'21120, 강서구,'104,65세이상,2019,13630,6353,7277,87.3,13578,6330,7248,87.3
'21120, 강서구,'126,평균연령,2019,37.9,37.3,38.6,,38.2,37.7,38.7,
'21120, 강서구,'127,중위연령,2019,38.2,37.8,38.6,,38.7,38.7,38.7,
'21130, 연제구,'000,합계,2019,203959,98035,105924,92.6,202851,97589,105262,92.7
'21130, 연제구,'005,0~4세,2019,7147,3645,3502,104.1,7132,3634,3498,103.9
'21130, 연제구,'005001, 0세,2019,1275,631,644,98,1271,628,643,97.7
'21130, 연제구,'005002, 1세,2019,1232,666,566,117.7,1230,664,566,117.3
'21130, 연제구,'005003, 2세,2019,1354,667,687,97.1,1351,665,686,96.9
'21130, 연제구,'005004, 3세,2019,1653,855,798,107.1,1649,852,797,106.9
'21130, 연제구,'005005, 4세,2019,1633,826,807,102.4,1631,825,806,102.4
'21130, 연제구,'010,5~9세,2019,8016,4045,3971,101.9,8005,4041,3964,101.9
'21130, 연제구,'010001, 5세,2019,1607,822,785,104.7,1607,822,785,104.7
'21130, 연제구,'010002, 6세,2019,1566,751,815,92.1,1562,749,813,92.1
'21130, 연제구,'010003, 7세,2019,1646,814,832,97.8,1642,813,829,98.1
'21130, 연제구,'010004, 8세,2019,1638,867,771,112.5,1638,867,771,112.5
'21130, 연제구,'010005, 9세,2019,1559,791,768,103,1556,790,766,103.1
'21130, 연제구,'015,10~14세,2019,7500,3892,3608,107.9,7496,3889,3607,107.8
'21130, 연제구,'015001, 10세,2019,1448,762,686,111.1,1448,762,686,111.1
'21130, 연제구,'015002, 11세,2019,1525,792,733,108,1524,791,733,107.9
'21130, 연제구,'015003, 12세,2019,1598,848,750,113.1,1597,847,750,112.9
'21130, 연제구,'015004, 13세,2019,1461,753,708,106.4,1461,753,708,106.4
'21130, 연제구,'015005, 14세,2019,1468,737,731,100.8,1466,736,730,100.8
'21130, 연제구,'020,15~19세,2019,8884,4599,4285,107.3,8870,4591,4279,107.3
'21130, 연제구,'020001, 15세,2019,1557,791,766,103.3,1557,791,766,103.3
'21130, 연제구,'020002, 16세,2019,1599,812,787,103.2,1596,811,785,103.3
'21130, 연제구,'020003, 17세,2019,1626,822,804,102.2,1623,821,802,102.4
'21130, 연제구,'020004, 18세,2019,1886,1014,872,116.3,1884,1013,871,116.3
'21130, 연제구,'020005, 19세,2019,2216,1160,1056,109.8,2210,1155,1055,109.5
'21130, 연제구,'025,20~24세,2019,12192,6222,5970,104.2,12090,6193,5897,105
'21130, 연제구,'025001, 20세,2019,2151,1120,1031,108.6,2138,1115,1023,109
'21130, 연제구,'025002, 21세,2019,2458,1303,1155,112.8,2436,1296,1140,113.7
'21130, 연제구,'025003, 22세,2019,2446,1224,1222,100.2,2430,1222,1208,101.2
'21130, 연제구,'025004, 23세,2019,2561,1317,1244,105.9,2533,1309,1224,106.9
'21130, 연제구,'025005, 24세,2019,2576,1258,1318,95.4,2553,1251,1302,96.1
'21130, 연제구,'030,25~29세,2019,13368,6705,6663,100.6,13208,6659,6549,101.7
'21130, 연제구,'030001, 25세,2019,2688,1353,1335,101.3,2659,1342,1317,101.9
'21130, 연제구,'030002, 26세,2019,2740,1397,1343,104,2715,1388,1327,104.6
'21130, 연제구,'030003, 27세,2019,2820,1420,1400,101.4,2786,1409,1377,102.3
'21130, 연제구,'030004, 28세,2019,2590,1282,1308,98,2545,1273,1272,100.1
'21130, 연제구,'030005, 29세,2019,2530,1253,1277,98.1,2503,1247,1256,99.3
'21130, 연제구,'035,30~34세,2019,12252,6091,6161,98.9,12060,6014,6046,99.5
'21130, 연제구,'035001, 30세,2019,2527,1275,1252,101.8,2497,1265,1232,102.7
'21130, 연제구,'035002, 31세,2019,2314,1100,1214,90.6,2275,1087,1188,91.5
'21130, 연제구,'035003, 32세,2019,2371,1187,1184,100.3,2323,1164,1159,100.4
'21130, 연제구,'035004, 33세,2019,2521,1287,1234,104.3,2486,1270,1216,104.4
'21130, 연제구,'035005, 34세,2019,2519,1242,1277,97.3,2479,1228,1251,98.2
'21130, 연제구,'040,35~39세,2019,15338,7691,7647,100.6,15196,7639,7557,101.1
'21130, 연제구,'040001, 35세,2019,2638,1316,1322,99.5,2610,1309,1301,100.6
'21130, 연제구,'040002, 36세,2019,2886,1450,1436,101,2858,1434,1424,100.7
'21130, 연제구,'040003, 37세,2019,3179,1572,1607,97.8,3143,1561,1582,98.7
'21130, 연제구,'040004, 38세,2019,3267,1673,1594,105,3241,1663,1578,105.4
'21130, 연제구,'040005, 39세,2019,3368,1680,1688,99.5,3344,1672,1672,100
'21130, 연제구,'045,40~44세,2019,14296,7016,7280,96.4,14182,6965,7217,96.5
'21130, 연제구,'045001, 40세,2019,3130,1558,1572,99.1,3104,1545,1559,99.1
'21130, 연제구,'045002, 41세,2019,2789,1342,1447,92.7,2764,1329,1435,92.6
'21130, 연제구,'045003, 42세,2019,2775,1330,1445,92,2753,1320,1433,92.1
'21130, 연제구,'045004, 43세,2019,2735,1381,1354,102,2721,1376,1345,102.3
'21130, 연제구,'045005, 44세,2019,2867,1405,1462,96.1,2840,1395,1445,96.5
'21130, 연제구,'050,45~49세,2019,16515,8055,8460,95.2,16420,8010,8410,95.2
'21130, 연제구,'050001, 45세,2019,3230,1609,1621,99.3,3207,1602,1605,99.8
'21130, 연제구,'050002, 46세,2019,3221,1556,1665,93.5,3201,1546,1655,93.4
'21130, 연제구,'050003, 47세,2019,3285,1633,1652,98.8,3270,1623,1647,98.5
'21130, 연제구,'050004, 48세,2019,3417,1645,1772,92.8,3404,1637,1767,92.6
'21130, 연제구,'050005, 49세,2019,3362,1612,1750,92.1,3338,1602,1736,92.3
'21130, 연제구,'055,50~54세,2019,16393,7722,8671,89.1,16301,7676,8625,89
'21130, 연제구,'055001, 50세,2019,3321,1563,1758,88.9,3302,1551,1751,88.6
'21130, 연제구,'055002, 51세,2019,3525,1663,1862,89.3,3503,1654,1849,89.5
'21130, 연제구,'055003, 52세,2019,3274,1513,1761,85.9,3253,1501,1752,85.7
'21130, 연제구,'055004, 53세,2019,3108,1517,1591,95.3,3096,1512,1584,95.5
'21130, 연제구,'055005, 54세,2019,3165,1466,1699,86.3,3147,1458,1689,86.3
'21130, 연제구,'060,55~59세,2019,17462,8041,9421,85.4,17386,8014,9372,85.5
'21130, 연제구,'060001, 55세,2019,2939,1398,1541,90.7,2919,1391,1528,91
'21130, 연제구,'060002, 56세,2019,3202,1476,1726,85.5,3184,1473,1711,86.1
'21130, 연제구,'060003, 57세,2019,3496,1626,1870,87,3480,1622,1858,87.3
'21130, 연제구,'060004, 58세,2019,3920,1773,2147,82.6,3910,1768,2142,82.5
'21130, 연제구,'060005, 59세,2019,3905,1768,2137,82.7,3893,1760,2133,82.5
'21130, 연제구,'065,60~64세,2019,17410,8039,9371,85.8,17364,8017,9347,85.8
'21130, 연제구,'065001, 60세,2019,3562,1613,1949,82.8,3554,1606,1948,82.4
'21130, 연제구,'065002, 61세,2019,3471,1607,1864,86.2,3454,1601,1853,86.4
'21130, 연제구,'065003, 62세,2019,3541,1637,1904,86,3533,1633,1900,85.9
'21130, 연제구,'065004, 63세,2019,3393,1592,1801,88.4,3384,1588,1796,88.4
'21130, 연제구,'065005, 64세,2019,3443,1590,1853,85.8,3439,1589,1850,85.9
'21130, 연제구,'070,65~69세,2019,12817,6005,6812,88.2,12793,5993,6800,88.1
'21130, 연제구,'070001, 65세,2019,2951,1442,1509,95.6,2942,1440,1502,95.9
'21130, 연제구,'070002, 66세,2019,2686,1254,1432,87.6,2682,1251,1431,87.4
'21130, 연제구,'070003, 67세,2019,2787,1247,1540,81,2782,1243,1539,80.8
'21130, 연제구,'070004, 68세,2019,2188,1007,1181,85.3,2184,1005,1179,85.2
'21130, 연제구,'070005, 69세,2019,2205,1055,1150,91.7,2203,1054,1149,91.7
'21130, 연제구,'075,70~74세,2019,9634,4464,5170,86.3,9622,4455,5167,86.2
'21130, 연제구,'075001, 70세,2019,2289,1066,1223,87.2,2287,1065,1222,87.2
'21130, 연제구,'075002, 71세,2019,2249,1023,1226,83.4,2244,1019,1225,83.2
'21130, 연제구,'075003, 72세,2019,2108,960,1148,83.6,2107,959,1148,83.5
'21130, 연제구,'075004, 73세,2019,1499,726,773,93.9,1496,723,773,93.5
'21130, 연제구,'075005, 74세,2019,1489,689,800,86.1,1488,689,799,86.2
'21130, 연제구,'080,75~79세,2019,7524,3355,4169,80.5,7517,3351,4166,80.4
'21130, 연제구,'080001, 75세,2019,1524,664,860,77.2,1524,664,860,77.2
'21130, 연제구,'080002, 76세,2019,1652,758,894,84.8,1650,756,894,84.6
'21130, 연제구,'080003, 77세,2019,1692,797,895,89.1,1689,797,892,89.3
'21130, 연제구,'080004, 78세,2019,1426,613,813,75.4,1425,612,813,75.3
'21130, 연제구,'080005, 79세,2019,1230,523,707,74,1229,522,707,73.8
'21130, 연제구,'085,80~84세,2019,4432,1761,2671,65.9,4431,1761,2670,66
'21130, 연제구,'085001, 80세,2019,1160,490,670,73.1,1160,490,670,73.1
'21130, 연제구,'085002, 81세,2019,920,396,524,75.6,919,396,523,75.7
'21130, 연제구,'085003, 82세,2019,902,347,555,62.5,902,347,555,62.5
'21130, 연제구,'085004, 83세,2019,785,301,484,62.2,785,301,484,62.2
'21130, 연제구,'085005, 84세,2019,665,227,438,51.8,665,227,438,51.8
'21130, 연제구,'086,85세이상,2019,2779,687,2092,32.8,2778,687,2091,32.9
'21130, 연제구,'090,85~89세,2019,1932,530,1402,37.8,1931,530,1401,37.8
'21130, 연제구,'090001, 85세,2019,558,169,389,43.4,558,169,389,43.4
'21130, 연제구,'090002, 86세,2019,438,134,304,44.1,437,134,303,44.2
'21130, 연제구,'090003, 87세,2019,362,81,281,28.8,362,81,281,28.8
'21130, 연제구,'090004, 88세,2019,315,86,229,37.6,315,86,229,37.6
'21130, 연제구,'090005, 89세,2019,259,60,199,30.2,259,60,199,30.2
'21130, 연제구,'095,90~94세,2019,689,136,553,24.6,689,136,553,24.6
'21130, 연제구,'095001, 90세,2019,252,58,194,29.9,252,58,194,29.9
'21130, 연제구,'095002, 91세,2019,165,31,134,23.1,165,31,134,23.1
'21130, 연제구,'095003, 92세,2019,131,24,107,22.4,131,24,107,22.4
'21130, 연제구,'095004, 93세,2019,70,9,61,14.8,70,9,61,14.8
'21130, 연제구,'095005, 94세,2019,71,14,57,24.6,71,14,57,24.6
'21130, 연제구,'100,95~99세,2019,137,17,120,14.2,137,17,120,14.2
'21130, 연제구,'100001, 95세,2019,37,6,31,19.4,37,6,31,19.4
'21130, 연제구,'100002, 96세,2019,46,6,40,15,46,6,40,15
'21130, 연제구,'100003, 97세,2019,26,X,23,13,26,X,23,13
'21130, 연제구,'100004, 98세,2019,19,X,17,11.8,19,X,17,11.8
'21130, 연제구,'100005, 99세,2019,9,X,9,0,9,X,9,0
'21130, 연제구,'101,100세이상,2019,21,X,17,23.5,21,X,17,23.5
'21130, 연제구,'102,15세미만,2019,22663,11582,11081,104.5,22633,11564,11069,104.5
'21130, 연제구,'103,15~64세,2019,144110,70181,73929,94.9,143077,69778,73299,95.2
'21130, 연제구,'104,65세이상,2019,37186,16272,20914,77.8,37141,16247,20894,77.8
'21130, 연제구,'126,평균연령,2019,44.4,43.1,45.5,,44.4,43.1,45.6,
'21130, 연제구,'127,중위연령,2019,45.9,44.4,47.4,,46,44.4,47.5,
'21140, 수영구,'000,합계,2019,170414,80762,89652,90.1,168562,79836,88726,90
'21140, 수영구,'005,0~4세,2019,5039,2561,2478,103.3,4996,2541,2455,103.5
'21140, 수영구,'005001, 0세,2019,873,435,438,99.3,866,433,433,100
'21140, 수영구,'005002, 1세,2019,906,469,437,107.3,899,463,436,106.2
'21140, 수영구,'005003, 2세,2019,1008,504,504,100,997,501,496,101
'21140, 수영구,'005004, 3세,2019,1100,576,524,109.9,1093,572,521,109.8
'21140, 수영구,'005005, 4세,2019,1152,577,575,100.3,1141,572,569,100.5
'21140, 수영구,'010,5~9세,2019,5282,2773,2509,110.5,5252,2764,2488,111.1
'21140, 수영구,'010001, 5세,2019,1060,569,491,115.9,1057,568,489,116.2
'21140, 수영구,'010002, 6세,2019,1047,539,508,106.1,1042,538,504,106.7
'21140, 수영구,'010003, 7세,2019,1097,581,516,112.6,1091,579,512,113.1
'21140, 수영구,'010004, 8세,2019,1086,543,543,100,1079,541,538,100.6
'21140, 수영구,'010005, 9세,2019,992,541,451,120,983,538,445,120.9
'21140, 수영구,'015,10~14세,2019,5169,2684,2485,108,5147,2675,2472,108.2
'21140, 수영구,'015001, 10세,2019,993,499,494,101,987,496,491,101
'21140, 수영구,'015002, 11세,2019,1057,551,506,108.9,1054,550,504,109.1
'21140, 수영구,'015003, 12세,2019,1079,543,536,101.3,1073,542,531,102.1
'21140, 수영구,'015004, 13세,2019,957,514,443,116,952,512,440,116.4
'21140, 수영구,'015005, 14세,2019,1083,577,506,114,1081,575,506,113.6
'21140, 수영구,'020,15~19세,2019,6276,3225,3051,105.7,6249,3209,3040,105.6
'21140, 수영구,'020001, 15세,2019,1189,626,563,111.2,1187,625,562,111.2
'21140, 수영구,'020002, 16세,2019,1071,541,530,102.1,1070,541,529,102.3
'21140, 수영구,'020003, 17세,2019,1163,578,585,98.8,1161,577,584,98.8
'21140, 수영구,'020004, 18세,2019,1354,696,658,105.8,1349,692,657,105.3
'21140, 수영구,'020005, 19세,2019,1499,784,715,109.7,1482,774,708,109.3
'21140, 수영구,'025,20~24세,2019,9739,4924,4815,102.3,9569,4841,4728,102.4
'21140, 수영구,'025001, 20세,2019,1508,806,702,114.8,1484,797,687,116
'21140, 수영구,'025002, 21세,2019,1717,905,812,111.5,1690,892,798,111.8
'21140, 수영구,'025003, 22세,2019,1961,945,1016,93,1932,929,1003,92.6
'21140, 수영구,'025004, 23세,2019,2187,1116,1071,104.2,2145,1092,1053,103.7
'21140, 수영구,'025005, 24세,2019,2366,1152,1214,94.9,2318,1131,1187,95.3
'21140, 수영구,'030,25~29세,2019,13100,6430,6670,96.4,12776,6276,6500,96.6
'21140, 수영구,'030001, 25세,2019,2533,1197,1336,89.6,2475,1169,1306,89.5
'21140, 수영구,'030002, 26세,2019,2684,1360,1324,102.7,2613,1323,1290,102.6
'21140, 수영구,'030003, 27세,2019,2751,1327,1424,93.2,2683,1299,1384,93.9
'21140, 수영구,'030004, 28세,2019,2623,1278,1345,95,2563,1248,1315,94.9
'21140, 수영구,'030005, 29세,2019,2509,1268,1241,102.2,2442,1237,1205,102.7
'21140, 수영구,'035,30~34세,2019,10956,5442,5514,98.7,10662,5298,5364,98.8
'21140, 수영구,'035001, 30세,2019,2335,1190,1145,103.9,2269,1154,1115,103.5
'21140, 수영구,'035002, 31세,2019,2157,1058,1099,96.3,2107,1039,1068,97.3
'21140, 수영구,'035003, 32세,2019,2157,1060,1097,96.6,2082,1028,1054,97.5
'21140, 수영구,'035004, 33세,2019,2223,1110,1113,99.7,2171,1077,1094,98.4
'21140, 수영구,'035005, 34세,2019,2084,1024,1060,96.6,2033,1000,1033,96.8
'21140, 수영구,'040,35~39세,2019,12588,6411,6177,103.8,12321,6258,6063,103.2
'21140, 수영구,'040001, 35세,2019,2231,1130,1101,102.6,2174,1098,1076,102
'21140, 수영구,'040002, 36세,2019,2464,1242,1222,101.6,2409,1212,1197,101.3
'21140, 수영구,'040003, 37세,2019,2591,1331,1260,105.6,2540,1303,1237,105.3
'21140, 수영구,'040004, 38세,2019,2608,1319,1289,102.3,2565,1296,1269,102.1
'21140, 수영구,'040005, 39세,2019,2694,1389,1305,106.4,2633,1349,1284,105.1
'21140, 수영구,'045,40~44세,2019,11205,5607,5598,100.2,11038,5522,5516,100.1
'21140, 수영구,'045001, 40세,2019,2482,1243,1239,100.3,2447,1226,1221,100.4
'21140, 수영구,'045002, 41세,2019,2214,1128,1086,103.9,2180,1111,1069,103.9
'21140, 수영구,'045003, 42세,2019,2192,1086,1106,98.2,2156,1065,1091,97.6
'21140, 수영구,'045004, 43세,2019,2089,1062,1027,103.4,2055,1046,1009,103.7
'21140, 수영구,'045005, 44세,2019,2228,1088,1140,95.4,2200,1074,1126,95.4
'21140, 수영구,'050,45~49세,2019,13196,6343,6853,92.6,13042,6255,6787,92.2
'21140, 수영구,'050001, 45세,2019,2502,1212,1290,94,2473,1195,1278,93.5
'21140, 수영구,'050002, 46세,2019,2541,1203,1338,89.9,2509,1184,1325,89.4
'21140, 수영구,'050003, 47세,2019,2606,1260,1346,93.6,2579,1245,1334,93.3
'21140, 수영구,'050004, 48세,2019,2765,1320,1445,91.3,2728,1301,1427,91.2
'21140, 수영구,'050005, 49세,2019,2782,1348,1434,94,2753,1330,1423,93.5
'21140, 수영구,'055,50~54세,2019,12820,5973,6847,87.2,12709,5919,6790,87.2
'21140, 수영구,'055001, 50세,2019,2652,1242,1410,88.1,2624,1231,1393,88.4
'21140, 수영구,'055002, 51세,2019,2709,1276,1433,89,2688,1265,1423,88.9
'21140, 수영구,'055003, 52세,2019,2521,1166,1355,86.1,2500,1155,1345,85.9
'21140, 수영구,'055004, 53세,2019,2434,1144,1290,88.7,2412,1132,1280,88.4
'21140, 수영구,'055005, 54세,2019,2504,1145,1359,84.3,2485,1136,1349,84.2
'21140, 수영구,'060,55~59세,2019,14377,6343,8034,79,14279,6298,7981,78.9
'21140, 수영구,'060001, 55세,2019,2373,1064,1309,81.3,2358,1057,1301,81.2
'21140, 수영구,'060002, 56세,2019,2743,1227,1516,80.9,2719,1216,1503,80.9
'21140, 수영구,'060003, 57세,2019,2838,1265,1573,80.4,2815,1256,1559,80.6
'21140, 수영구,'060004, 58세,2019,3173,1373,1800,76.3,3154,1361,1793,75.9
'21140, 수영구,'060005, 59세,2019,3250,1414,1836,77,3233,1408,1825,77.2
'21140, 수영구,'065,60~64세,2019,15350,6824,8526,80,15268,6784,8484,80
'21140, 수영구,'065001, 60세,2019,3115,1392,1723,80.8,3097,1382,1715,80.6
'21140, 수영구,'065002, 61세,2019,3032,1348,1684,80,3009,1338,1671,80.1
'21140, 수영구,'065003, 62세,2019,3141,1404,1737,80.8,3124,1393,1731,80.5
'21140, 수영구,'065004, 63세,2019,2945,1304,1641,79.5,2931,1298,1633,79.5
'21140, 수영구,'065005, 64세,2019,3117,1376,1741,79,3107,1373,1734,79.2
'21140, 수영구,'070,65~69세,2019,11705,5283,6422,82.3,11674,5270,6404,82.3
'21140, 수영구,'070001, 65세,2019,2659,1218,1441,84.5,2653,1215,1438,84.5
'21140, 수영구,'070002, 66세,2019,2403,1113,1290,86.3,2394,1111,1283,86.6
'21140, 수영구,'070003, 67세,2019,2587,1187,1400,84.8,2579,1182,1397,84.6
'21140, 수영구,'070004, 68세,2019,1970,879,1091,80.6,1966,876,1090,80.4
'21140, 수영구,'070005, 69세,2019,2086,886,1200,73.8,2082,886,1196,74.1
'21140, 수영구,'075,70~74세,2019,9316,4301,5015,85.8,9298,4294,5004,85.8
'21140, 수영구,'075001, 70세,2019,2174,1030,1144,90,2165,1026,1139,90.1
'21140, 수영구,'075002, 71세,2019,2137,978,1159,84.4,2134,977,1157,84.4
'21140, 수영구,'075003, 72세,2019,2097,906,1191,76.1,2095,906,1189,76.2
'21140, 수영구,'075004, 73세,2019,1528,753,775,97.2,1526,752,774,97.2
'21140, 수영구,'075005, 74세,2019,1380,634,746,85,1378,633,745,85
'21140, 수영구,'080,75~79세,2019,7022,3138,3884,80.8,7014,3134,3880,80.8
'21140, 수영구,'080001, 75세,2019,1470,669,801,83.5,1469,668,801,83.4
'21140, 수영구,'080002, 76세,2019,1469,675,794,85,1469,675,794,85
'21140, 수영구,'080003, 77세,2019,1609,728,881,82.6,1607,726,881,82.4
'21140, 수영구,'080004, 78세,2019,1298,554,744,74.5,1296,554,742,74.7
'21140, 수영구,'080005, 79세,2019,1176,512,664,77.1,1173,511,662,77.2
'21140, 수영구,'085,80~84세,2019,4338,1698,2640,64.3,4334,1696,2638,64.3
'21140, 수영구,'085001, 80세,2019,1126,482,644,74.8,1125,481,644,74.7
'21140, 수영구,'085002, 81세,2019,934,380,554,68.6,933,380,553,68.7
'21140, 수영구,'085003, 82세,2019,887,335,552,60.7,886,335,551,60.8
'21140, 수영구,'085004, 83세,2019,721,280,441,63.5,720,279,441,63.3
'21140, 수영구,'085005, 84세,2019,670,221,449,49.2,670,221,449,49.2
'21140, 수영구,'086,85세이상,2019,2936,802,2134,37.6,2934,802,2132,37.6
'21140, 수영구,'090,85~89세,2019,2038,598,1440,41.5,2037,598,1439,41.6
'21140, 수영구,'090001, 85세,2019,568,170,398,42.7,567,170,397,42.8
'21140, 수영구,'090002, 86세,2019,474,146,328,44.5,474,146,328,44.5
'21140, 수영구,'090003, 87세,2019,398,112,286,39.2,398,112,286,39.2
'21140, 수영구,'090004, 88세,2019,330,100,230,43.5,330,100,230,43.5
'21140, 수영구,'090005, 89세,2019,268,70,198,35.4,268,70,198,35.4
'21140, 수영구,'095,90~94세,2019,748,175,573,30.5,748,175,573,30.5
'21140, 수영구,'095001, 90세,2019,245,65,180,36.1,245,65,180,36.1
'21140, 수영구,'095002, 91세,2019,200,44,156,28.2,200,44,156,28.2
'21140, 수영구,'095003, 92세,2019,131,33,98,33.7,131,33,98,33.7
'21140, 수영구,'095004, 93세,2019,101,24,77,31.2,101,24,77,31.2
'21140, 수영구,'095005, 94세,2019,71,9,62,14.5,71,9,62,14.5
'21140, 수영구,'100,95~99세,2019,131,26,105,24.8,131,26,105,24.8
'21140, 수영구,'100001, 95세,2019,47,9,38,23.7,47,9,38,23.7
'21140, 수영구,'100002, 96세,2019,32,6,26,23.1,32,6,26,23.1
'21140, 수영구,'100003, 97세,2019,22,7,15,46.7,22,7,15,46.7
'21140, 수영구,'100004, 98세,2019,16,X,14,14.3,16,X,14,14.3
'21140, 수영구,'100005, 99세,2019,14,X,12,16.7,14,X,12,16.7
'21140, 수영구,'101,100세이상,2019,19,X,16,18.8,18,X,15,20
'21140, 수영구,'102,15세미만,2019,15490,8018,7472,107.3,15395,7980,7415,107.6
'21140, 수영구,'103,15~64세,2019,119607,57522,62085,92.7,117913,56660,61253,92.5
'21140, 수영구,'104,65세이상,2019,35317,15222,20095,75.8,35254,15196,20058,75.8
'21140, 수영구,'126,평균연령,2019,45.9,44.4,47.3,,46,44.5,47.4,
'21140, 수영구,'127,중위연령,2019,47.3,45.3,49.1,,47.5,45.4,49.3,
'21150, 사상구,'000,합계,2019,222618,111847,110771,101,215898,108251,107647,100.6
'21150, 사상구,'005,0~4세,2019,6341,3240,3101,104.5,6281,3210,3071,104.5
'21150, 사상구,'005001, 0세,2019,1008,504,504,100,994,498,496,100.4
'21150, 사상구,'005002, 1세,2019,1168,628,540,116.3,1159,624,535,116.6
'21150, 사상구,'005003, 2세,2019,1272,646,626,103.2,1261,639,622,102.7
'21150, 사상구,'005004, 3세,2019,1414,723,691,104.6,1398,714,684,104.4
'21150, 사상구,'005005, 4세,2019,1479,739,740,99.9,1469,735,734,100.1
'21150, 사상구,'010,5~9세,2019,7434,3761,3673,102.4,7391,3741,3650,102.5
'21150, 사상구,'010001, 5세,2019,1441,722,719,100.4,1430,716,714,100.3
'21150, 사상구,'010002, 6세,2019,1475,726,749,96.9,1467,722,745,96.9
'21150, 사상구,'010003, 7세,2019,1604,824,780,105.6,1598,823,775,106.2
'21150, 사상구,'010004, 8세,2019,1494,757,737,102.7,1488,755,733,103
'21150, 사상구,'010005, 9세,2019,1420,732,688,106.4,1408,725,683,106.1
'21150, 사상구,'015,10~14세,2019,6919,3597,3322,108.3,6885,3582,3303,108.4
'21150, 사상구,'015001, 10세,2019,1341,694,647,107.3,1336,692,644,107.5
'21150, 사상구,'015002, 11세,2019,1473,750,723,103.7,1465,745,720,103.5
'21150, 사상구,'015003, 12세,2019,1423,744,679,109.6,1414,741,673,110.1
'21150, 사상구,'015004, 13세,2019,1365,728,637,114.3,1362,727,635,114.5
'21150, 사상구,'015005, 14세,2019,1317,681,636,107.1,1308,677,631,107.3
'21150, 사상구,'020,15~19세,2019,10253,5254,4999,105.1,9888,5081,4807,105.7
'21150, 사상구,'020001, 15세,2019,1544,798,746,107,1535,792,743,106.6
'21150, 사상구,'020002, 16세,2019,1502,774,728,106.3,1498,772,726,106.3
'21150, 사상구,'020003, 17세,2019,1604,849,755,112.5,1582,836,746,112.1
'21150, 사상구,'020004, 18세,2019,2213,1183,1030,114.9,2140,1144,996,114.9
'21150, 사상구,'020005, 19세,2019,3390,1650,1740,94.8,3133,1537,1596,96.3
'21150, 사상구,'025,20~24세,2019,17292,8819,8473,104.1,15629,8044,7585,106.1
'21150, 사상구,'025001, 20세,2019,3329,1491,1838,81.1,2812,1295,1517,85.4
'21150, 사상구,'025002, 21세,2019,3430,1632,1798,90.8,3039,1459,1580,92.3
'21150, 사상구,'025003, 22세,2019,3480,1793,1687,106.3,3168,1641,1527,107.5
'21150, 사상구,'025004, 23세,2019,3504,1914,1590,120.4,3282,1784,1498,119.1
'21150, 사상구,'025005, 24세,2019,3549,1989,1560,127.5,3328,1865,1463,127.5
'21150, 사상구,'030,25~29세,2019,16339,8949,7390,121.1,15328,8384,6944,120.7
'21150, 사상구,'030001, 25세,2019,3524,1891,1633,115.8,3302,1786,1516,117.8
'21150, 사상구,'030002, 26세,2019,3443,1929,1514,127.4,3238,1798,1440,124.9
'21150, 사상구,'030003, 27세,2019,3338,1853,1485,124.8,3130,1735,1395,124.4
'21150, 사상구,'030004, 28세,2019,3077,1681,1396,120.4,2898,1573,1325,118.7
'21150, 사상구,'030005, 29세,2019,2957,1595,1362,117.1,2760,1492,1268,117.7
'21150, 사상구,'035,30~34세,2019,13171,7161,6010,119.2,12119,6573,5546,118.5
'21150, 사상구,'035001, 30세,2019,2799,1494,1305,114.5,2604,1392,1212,114.9
'21150, 사상구,'035002, 31세,2019,2635,1432,1203,119,2403,1304,1099,118.7
'21150, 사상구,'035003, 32세,2019,2609,1416,1193,118.7,2396,1299,1097,118.4
'21150, 사상구,'035004, 33세,2019,2559,1436,1123,127.9,2334,1299,1035,125.5
'21150, 사상구,'035005, 34세,2019,2569,1383,1186,116.6,2382,1279,1103,116
'21150, 사상구,'040,35~39세,2019,15121,8054,7067,114,14357,7585,6772,112
'21150, 사상구,'040001, 35세,2019,2547,1346,1201,112.1,2389,1248,1141,109.4
'21150, 사상구,'040002, 36세,2019,2864,1552,1312,118.3,2702,1445,1257,115
'21150, 사상구,'040003, 37세,2019,3161,1642,1519,108.1,2981,1538,1443,106.6
'21150, 사상구,'040004, 38세,2019,3234,1734,1500,115.6,3101,1653,1448,114.2
'21150, 사상구,'040005, 39세,2019,3315,1780,1535,116,3184,1701,1483,114.7
'21150, 사상구,'045,40~44세,2019,13933,7433,6500,114.4,13476,7173,6303,113.8
'21150, 사상구,'045001, 40세,2019,2979,1578,1401,112.6,2868,1515,1353,112
'21150, 사상구,'045002, 41세,2019,2708,1504,1204,124.9,2622,1451,1171,123.9
'21150, 사상구,'045003, 42세,2019,2726,1442,1284,112.3,2632,1386,1246,111.2
'21150, 사상구,'045004, 43세,2019,2644,1421,1223,116.2,2566,1377,1189,115.8
'21150, 사상구,'045005, 44세,2019,2876,1488,1388,107.2,2788,1444,1344,107.4
'21150, 사상구,'050,45~49세,2019,16651,8504,8147,104.4,16210,8254,7956,103.7
'21150, 사상구,'050001, 45세,2019,3108,1669,1439,116,3007,1614,1393,115.9
'21150, 사상구,'050002, 46세,2019,3182,1635,1547,105.7,3097,1577,1520,103.8
'21150, 사상구,'050003, 47세,2019,3279,1652,1627,101.5,3192,1606,1586,101.3
'21150, 사상구,'050004, 48세,2019,3436,1730,1706,101.4,3350,1682,1668,100.8
'21150, 사상구,'050005, 49세,2019,3646,1818,1828,99.5,3564,1775,1789,99.2
'21150, 사상구,'055,50~54세,2019,19898,9658,10240,94.3,19581,9471,10110,93.7
'21150, 사상구,'055001, 50세,2019,3864,1900,1964,96.7,3786,1858,1928,96.4
'21150, 사상구,'055002, 51세,2019,4093,1952,2141,91.2,4029,1914,2115,90.5
'21150, 사상구,'055003, 52세,2019,3911,1862,2049,90.9,3865,1832,2033,90.1
'21150, 사상구,'055004, 53세,2019,3977,1990,1987,100.2,3898,1939,1959,99
'21150, 사상구,'055005, 54세,2019,4053,1954,2099,93.1,4003,1928,2075,92.9
'21150, 사상구,'060,55~59세,2019,22891,11365,11526,98.6,22648,11237,11411,98.5
'21150, 사상구,'060001, 55세,2019,3922,1967,1955,100.6,3865,1935,1930,100.3
'21150, 사상구,'060002, 56세,2019,4218,2141,2077,103.1,4163,2109,2054,102.7
'21150, 사상구,'060003, 57세,2019,4583,2297,2286,100.5,4522,2267,2255,100.5
'21150, 사상구,'060004, 58세,2019,5155,2527,2628,96.2,5128,2517,2611,96.4
'21150, 사상구,'060005, 59세,2019,5013,2433,2580,94.3,4970,2409,2561,94.1
'21150, 사상구,'065,60~64세,2019,20243,10094,10149,99.5,20103,10011,10092,99.2
'21150, 사상구,'065001, 60세,2019,4478,2273,2205,103.1,4449,2255,2194,102.8
'21150, 사상구,'065002, 61세,2019,4108,2060,2048,100.6,4074,2045,2029,100.8
'21150, 사상구,'065003, 62세,2019,4094,2064,2030,101.7,4064,2044,2020,101.2
'21150, 사상구,'065004, 63세,2019,3722,1819,1903,95.6,3698,1803,1895,95.1
'21150, 사상구,'065005, 64세,2019,3841,1878,1963,95.7,3818,1864,1954,95.4
'21150, 사상구,'070,65~69세,2019,13703,6709,6994,95.9,13631,6677,6954,96
'21150, 사상구,'070001, 65세,2019,3262,1631,1631,100,3245,1621,1624,99.8
'21150, 사상구,'070002, 66세,2019,2774,1365,1409,96.9,2753,1354,1399,96.8
'21150, 사상구,'070003, 67세,2019,2929,1423,1506,94.5,2915,1421,1494,95.1
'21150, 사상구,'070004, 68세,2019,2443,1180,1263,93.4,2432,1173,1259,93.2
'21150, 사상구,'070005, 69세,2019,2295,1110,1185,93.7,2286,1108,1178,94.1
'21150, 사상구,'075,70~74세,2019,9453,4473,4980,89.8,9423,4460,4963,89.9
'21150, 사상구,'075001, 70세,2019,2330,1124,1206,93.2,2325,1122,1203,93.3
'21150, 사상구,'075002, 71세,2019,2219,1062,1157,91.8,2207,1059,1148,92.2
'21150, 사상구,'075003, 72세,2019,2030,958,1072,89.4,2024,953,1071,89
'21150, 사상구,'075004, 73세,2019,1460,705,755,93.4,1457,704,753,93.5
'21150, 사상구,'075005, 74세,2019,1414,624,790,79,1410,622,788,78.9
'21150, 사상구,'080,75~79세,2019,6721,2977,3744,79.5,6705,2971,3734,79.6
'21150, 사상구,'080001, 75세,2019,1442,656,786,83.5,1442,656,786,83.5
'21150, 사상구,'080002, 76세,2019,1434,644,790,81.5,1429,643,786,81.8
'21150, 사상구,'080003, 77세,2019,1489,688,801,85.9,1485,686,799,85.9
'21150, 사상구,'080004, 78세,2019,1278,554,724,76.5,1274,551,723,76.2
'21150, 사상구,'080005, 79세,2019,1078,435,643,67.7,1075,435,640,68
'21150, 사상구,'085,80~84세,2019,3873,1290,2583,49.9,3868,1290,2578,50
'21150, 사상구,'085001, 80세,2019,964,367,597,61.5,964,367,597,61.5
'21150, 사상구,'085002, 81세,2019,883,306,577,53,881,306,575,53.2
'21150, 사상구,'085003, 82세,2019,772,253,519,48.7,772,253,519,48.7
'21150, 사상구,'085004, 83세,2019,659,208,451,46.1,656,208,448,46.4
'21150, 사상구,'085005, 84세,2019,595,156,439,35.5,595,156,439,35.5
'21150, 사상구,'086,85세이상,2019,2382,509,1873,27.2,2375,507,1868,27.1
'21150, 사상구,'090,85~89세,2019,1667,408,1259,32.4,1664,407,1257,32.4
'21150, 사상구,'090001, 85세,2019,488,127,361,35.2,487,127,360,35.3
'21150, 사상구,'090002, 86세,2019,419,111,308,36,419,111,308,36
'21150, 사상구,'090003, 87세,2019,335,85,250,34,335,85,250,34
'21150, 사상구,'090004, 88세,2019,218,43,175,24.6,217,42,175,24
'21150, 사상구,'090005, 89세,2019,207,42,165,25.5,206,42,164,25.6
'21150, 사상구,'095,90~94세,2019,581,91,490,18.6,577,90,487,18.5
'21150, 사상구,'095001, 90세,2019,182,31,151,20.5,182,31,151,20.5
'21150, 사상구,'095002, 91세,2019,133,25,108,23.1,131,25,106,23.6
'21150, 사상구,'095003, 92세,2019,117,15,102,14.7,117,15,102,14.7
'21150, 사상구,'095004, 93세,2019,83,10,73,13.7,82,10,72,13.9
'21150, 사상구,'095005, 94세,2019,66,10,56,17.9,65,9,56,16.1
'21150, 사상구,'100,95~99세,2019,115,9,106,8.5,115,9,106,8.5
'21150, 사상구,'100001, 95세,2019,49,X,46,6.5,49,X,46,6.5
'21150, 사상구,'100002, 96세,2019,25,X,23,8.7,25,X,23,8.7
'21150, 사상구,'100003, 97세,2019,19,X,17,11.8,19,X,17,11.8
'21150, 사상구,'100004, 98세,2019,13,X,11,18.2,13,X,11,18.2
'21150, 사상구,'100005, 99세,2019,9,X,9,0,9,X,9,0
'21150, 사상구,'101,100세이상,2019,19,X,18,5.6,19,X,18,5.6
'21150, 사상구,'102,15세미만,2019,20694,10598,10096,105,20557,10533,10024,105.1
'21150, 사상구,'103,15~64세,2019,165792,85291,80501,106,159339,81813,77526,105.5
'21150, 사상구,'104,65세이상,2019,36132,15958,20174,79.1,36002,15905,20097,79.1
'21150, 사상구,'126,평균연령,2019,44.2,43.1,45.3,,44.6,43.4,45.7,
'21150, 사상구,'127,중위연령,2019,46.4,44.8,48.1,,47.2,45.5,48.8,
'21310, 기장군,'000,합계,2019,160732,79609,81123,98.1,158011,77736,80275,96.8
'21310, 기장군,'005,0~4세,2019,8304,4202,4102,102.4,8276,4183,4093,102.2
'21310, 기장군,'005001, 0세,2019,1196,626,570,109.8,1192,622,570,109.1
'21310, 기장군,'005002, 1세,2019,1422,708,714,99.2,1413,705,708,99.6
'21310, 기장군,'005003, 2세,2019,1644,855,789,108.4,1640,853,787,108.4
'21310, 기장군,'005004, 3세,2019,1962,955,1007,94.8,1958,951,1007,94.4
'21310, 기장군,'005005, 4세,2019,2080,1058,1022,103.5,2073,1052,1021,103
'21310, 기장군,'010,5~9세,2019,10449,5361,5088,105.4,10434,5355,5079,105.4
'21310, 기장군,'010001, 5세,2019,2111,1109,1002,110.7,2106,1107,999,110.8
'21310, 기장군,'010002, 6세,2019,2087,1075,1012,106.2,2081,1073,1008,106.4
'21310, 기장군,'010003, 7세,2019,2174,1118,1056,105.9,2171,1117,1054,106
'21310, 기장군,'010004, 8세,2019,2170,1098,1072,102.4,2169,1097,1072,102.3
'21310, 기장군,'010005, 9세,2019,1907,961,946,101.6,1907,961,946,101.6
'21310, 기장군,'015,10~14세,2019,8398,4371,4027,108.5,8393,4371,4022,108.7
'21310, 기장군,'015001, 10세,2019,1740,881,859,102.6,1739,881,858,102.7
'21310, 기장군,'015002, 11세,2019,1811,949,862,110.1,1810,949,861,110.2
'21310, 기장군,'015003, 12세,2019,1768,913,855,106.8,1768,913,855,106.8
'21310, 기장군,'015004, 13세,2019,1549,806,743,108.5,1548,806,742,108.6
'21310, 기장군,'015005, 14세,2019,1530,822,708,116.1,1528,822,706,116.4
'21310, 기장군,'020,15~19세,2019,7520,3913,3607,108.5,7492,3897,3595,108.4
'21310, 기장군,'020001, 15세,2019,1617,854,763,111.9,1613,852,761,112
'21310, 기장군,'020002, 16세,2019,1562,792,770,102.9,1559,791,768,103
'21310, 기장군,'020003, 17세,2019,1500,757,743,101.9,1496,757,739,102.4
'21310, 기장군,'020004, 18세,2019,1541,818,723,113.1,1534,813,721,112.8
'21310, 기장군,'020005, 19세,2019,1300,692,608,113.8,1290,684,606,112.9
'21310, 기장군,'025,20~24세,2019,7015,3908,3107,125.8,6759,3723,3036,122.6
'21310, 기장군,'025001, 20세,2019,1288,729,559,130.4,1270,718,552,130.1
'21310, 기장군,'025002, 21세,2019,1371,791,580,136.4,1341,771,570,135.3
'21310, 기장군,'025003, 22세,2019,1406,779,627,124.2,1355,743,612,121.4
'21310, 기장군,'025004, 23세,2019,1455,791,664,119.1,1382,739,643,114.9
'21310, 기장군,'025005, 24세,2019,1495,818,677,120.8,1411,752,659,114.1
'21310, 기장군,'030,25~29세,2019,8085,4391,3694,118.9,7533,3981,3552,112.1
'21310, 기장군,'030001, 25세,2019,1541,846,695,121.7,1448,774,674,114.8
'21310, 기장군,'030002, 26세,2019,1612,854,758,112.7,1506,782,724,108
'21310, 기장군,'030003, 27세,2019,1648,909,739,123,1544,828,716,115.6
'21310, 기장군,'030004, 28세,2019,1662,909,753,120.7,1533,810,723,112
'21310, 기장군,'030005, 29세,2019,1622,873,749,116.6,1502,787,715,110.1
'21310, 기장군,'035,30~34세,2019,9448,4770,4678,102,8863,4332,4531,95.6
'21310, 기장군,'035001, 30세,2019,1681,870,811,107.3,1567,782,785,99.6
'21310, 기장군,'035002, 31세,2019,1817,942,875,107.7,1682,833,849,98.1
'21310, 기장군,'035003, 32세,2019,1867,916,951,96.3,1745,836,909,92
'21310, 기장군,'035004, 33세,2019,1966,969,997,97.2,1856,887,969,91.5
'21310, 기장군,'035005, 34세,2019,2117,1073,1044,102.8,2013,994,1019,97.5
'21310, 기장군,'040,35~39세,2019,15604,7805,7799,100.1,15160,7486,7674,97.6
'21310, 기장군,'040001, 35세,2019,2488,1236,1252,98.7,2381,1155,1226,94.2
'21310, 기장군,'040002, 36세,2019,2766,1337,1429,93.6,2676,1278,1398,91.4
'21310, 기장군,'040003, 37세,2019,3270,1640,1630,100.6,3172,1574,1598,98.5
'21310, 기장군,'040004, 38세,2019,3433,1754,1679,104.5,3344,1686,1658,101.7
'21310, 기장군,'040005, 39세,2019,3647,1838,1809,101.6,3587,1793,1794,99.9
'21310, 기장군,'045,40~44세,2019,15132,7717,7415,104.1,14876,7549,7327,103
'21310, 기장군,'045001, 40세,2019,3377,1705,1672,102,3315,1665,1650,100.9
'21310, 기장군,'045002, 41세,2019,3036,1526,1510,101.1,2976,1485,1491,99.6
'21310, 기장군,'045003, 42세,2019,2947,1521,1426,106.7,2902,1491,1411,105.7
'21310, 기장군,'045004, 43세,2019,2823,1452,1371,105.9,2781,1423,1358,104.8
'21310, 기장군,'045005, 44세,2019,2949,1513,1436,105.4,2902,1485,1417,104.8
'21310, 기장군,'050,45~49세,2019,14086,7356,6730,109.3,13872,7226,6646,108.7
'21310, 기장군,'050001, 45세,2019,3010,1538,1472,104.5,2960,1507,1453,103.7
'21310, 기장군,'050002, 46세,2019,2867,1465,1402,104.5,2820,1434,1386,103.5
'21310, 기장군,'050003, 47세,2019,2822,1477,1345,109.8,2789,1457,1332,109.4
'21310, 기장군,'050004, 48세,2019,2794,1507,1287,117.1,2749,1479,1270,116.5
'21310, 기장군,'050005, 49세,2019,2593,1369,1224,111.8,2554,1349,1205,112
'21310, 기장군,'055,50~54세,2019,11054,5567,5487,101.5,10929,5499,5430,101.3
'21310, 기장군,'055001, 50세,2019,2509,1274,1235,103.2,2476,1257,1219,103.1
'21310, 기장군,'055002, 51세,2019,2341,1176,1165,100.9,2310,1159,1151,100.7
'21310, 기장군,'055003, 52세,2019,2167,1094,1073,102,2149,1082,1067,101.4
'21310, 기장군,'055004, 53세,2019,2055,1092,963,113.4,2030,1081,949,113.9
'21310, 기장군,'055005, 54세,2019,1982,931,1051,88.6,1964,920,1044,88.1
'21310, 기장군,'060,55~59세,2019,10628,5182,5446,95.2,10554,5139,5415,94.9
'21310, 기장군,'060001, 55세,2019,1866,963,903,106.6,1848,952,896,106.3
'21310, 기장군,'060002, 56세,2019,2077,1014,1063,95.4,2059,1007,1052,95.7
'21310, 기장군,'060003, 57세,2019,2128,1045,1083,96.5,2118,1038,1080,96.1
'21310, 기장군,'060004, 58세,2019,2227,1068,1159,92.1,2214,1056,1158,91.2
'21310, 기장군,'060005, 59세,2019,2330,1092,1238,88.2,2315,1086,1229,88.4
'21310, 기장군,'065,60~64세,2019,10492,4823,5669,85.1,10427,4797,5630,85.2
'21310, 기장군,'065001, 60세,2019,2236,1042,1194,87.3,2222,1038,1184,87.7
'21310, 기장군,'065002, 61세,2019,2024,940,1084,86.7,2008,929,1079,86.1
'21310, 기장군,'065003, 62세,2019,2161,959,1202,79.8,2149,956,1193,80.1
'21310, 기장군,'065004, 63세,2019,1995,903,1092,82.7,1980,898,1082,83
'21310, 기장군,'065005, 64세,2019,2076,979,1097,89.2,2068,976,1092,89.4
'21310, 기장군,'070,65~69세,2019,8007,3656,4351,84,7968,3634,4334,83.8
'21310, 기장군,'070001, 65세,2019,1771,812,959,84.7,1754,802,952,84.2
'21310, 기장군,'070002, 66세,2019,1628,707,921,76.8,1623,705,918,76.8
'21310, 기장군,'070003, 67세,2019,1762,817,945,86.5,1756,813,943,86.2
'21310, 기장군,'070004, 68세,2019,1449,682,767,88.9,1444,680,764,89
'21310, 기장군,'070005, 69세,2019,1397,638,759,84.1,1391,634,757,83.8
'21310, 기장군,'075,70~74세,2019,6257,2890,3367,85.8,6236,2877,3359,85.7
'21310, 기장군,'075001, 70세,2019,1440,676,764,88.5,1434,671,763,87.9
'21310, 기장군,'075002, 71세,2019,1405,651,754,86.3,1403,650,753,86.3
'21310, 기장군,'075003, 72세,2019,1375,657,718,91.5,1371,656,715,91.7
'21310, 기장군,'075004, 73세,2019,1034,455,579,78.6,1028,450,578,77.9
'21310, 기장군,'075005, 74세,2019,1003,451,552,81.7,1000,450,550,81.8
'21310, 기장군,'080,75~79세,2019,4902,2095,2807,74.6,4897,2092,2805,74.6
'21310, 기장군,'080001, 75세,2019,1074,483,591,81.7,1072,482,590,81.7
'21310, 기장군,'080002, 76세,2019,1040,474,566,83.7,1039,473,566,83.6
'21310, 기장군,'080003, 77세,2019,1091,458,633,72.4,1090,458,632,72.5
'21310, 기장군,'080004, 78세,2019,859,360,499,72.1,858,359,499,71.9
'21310, 기장군,'080005, 79세,2019,838,320,518,61.8,838,320,518,61.8
'21310, 기장군,'085,80~84세,2019,3129,1096,2033,53.9,3125,1093,2032,53.8
'21310, 기장군,'085001, 80세,2019,832,302,530,57,830,301,529,56.9
'21310, 기장군,'085002, 81세,2019,679,249,430,57.9,678,248,430,57.7
'21310, 기장군,'085003, 82세,2019,612,216,396,54.5,611,215,396,54.3
'21310, 기장군,'085004, 83세,2019,516,165,351,47,516,165,351,47
'21310, 기장군,'085005, 84세,2019,490,164,326,50.3,490,164,326,50.3
'21310, 기장군,'086,85세이상,2019,2222,506,1716,29.5,2217,502,1715,29.3
'21310, 기장군,'090,85~89세,2019,1571,407,1164,35,1569,406,1163,34.9
'21310, 기장군,'090001, 85세,2019,422,109,313,34.8,421,109,312,34.9
'21310, 기장군,'090002, 86세,2019,357,97,260,37.3,357,97,260,37.3
'21310, 기장군,'090003, 87세,2019,327,91,236,38.6,326,90,236,38.1
'21310, 기장군,'090004, 88세,2019,259,68,191,35.6,259,68,191,35.6
'21310, 기장군,'090005, 89세,2019,206,42,164,25.6,206,42,164,25.6
'21310, 기장군,'095,90~94세,2019,510,85,425,20,510,85,425,20
'21310, 기장군,'095001, 90세,2019,144,32,112,28.6,144,32,112,28.6
'21310, 기장군,'095002, 91세,2019,130,26,104,25,130,26,104,25
'21310, 기장군,'095003, 92세,2019,113,13,100,13,113,13,100,13
'21310, 기장군,'095004, 93세,2019,58,9,49,18.4,58,9,49,18.4
'21310, 기장군,'095005, 94세,2019,65,5,60,8.3,65,5,60,8.3
'21310, 기장군,'100,95~99세,2019,129,14,115,12.2,126,11,115,9.6
'21310, 기장군,'100001, 95세,2019,39,X,36,8.3,39,X,36,8.3
'21310, 기장군,'100002, 96세,2019,36,X,32,12.5,35,X,32,9.4
'21310, 기장군,'100003, 97세,2019,25,X,21,19,24,X,21,14.3
'21310, 기장군,'100004, 98세,2019,17,X,15,13.3,17,X,15,13.3
'21310, 기장군,'100005, 99세,2019,12,X,11,9.1,11,X,11,0
'21310, 기장군,'101,100세이상,2019,12,X,12,0,12,X,12,0
'21310, 기장군,'102,15세미만,2019,27151,13934,13217,105.4,27103,13909,13194,105.4
'21310, 기장군,'103,15~64세,2019,109064,55432,53632,103.4,106465,53629,52836,101.5
'21310, 기장군,'104,65세이상,2019,24517,10243,14274,71.8,24443,10198,14245,71.6
'21310, 기장군,'126,평균연령,2019,41,39.6,42.5,,41.1,39.7,42.5,
'21310, 기장군,'127,중위연령,2019,41.7,40.6,42.9,,41.9,40.9,43,
'22,대구광역시,'000,합계,2019,2429940,1203754,1226186,98.2,2389848,1181573,1208275,97.8
'22,대구광역시,'005,0~4세,2019,83746,42957,40789,105.3,83044,42613,40431,105.4
'22,대구광역시,'005001, 0세,2019,13390,6965,6425,108.4,13269,6913,6356,108.8
'22,대구광역시,'005002, 1세,2019,14850,7517,7333,102.5,14697,7435,7262,102.4
'22,대구광역시,'005003, 2세,2019,16592,8563,8029,106.7,16452,8495,7957,106.8
'22,대구광역시,'005004, 3세,2019,19050,9742,9308,104.7,18898,9661,9237,104.6
'22,대구광역시,'005005, 4세,2019,19864,10170,9694,104.9,19728,10109,9619,105.1
'22,대구광역시,'010,5~9세,2019,103487,53001,50486,105,103047,52798,50249,105.1
'22,대구광역시,'010001, 5세,2019,19646,9980,9666,103.2,19528,9933,9595,103.5
'22,대구광역시,'010002, 6세,2019,19990,10190,9800,104,19893,10143,9750,104
'22,대구광역시,'010003, 7세,2019,21883,11180,10703,104.5,21803,11143,10660,104.5
'22,대구광역시,'010004, 8세,2019,21316,10986,10330,106.4,21233,10950,10283,106.5
'22,대구광역시,'010005, 9세,2019,20652,10665,9987,106.8,20590,10629,9961,106.7
'22,대구광역시,'015,10~14세,2019,104830,54519,50311,108.4,104538,54381,50157,108.4
'22,대구광역시,'015001, 10세,2019,20018,10438,9580,109,19943,10403,9540,109
'22,대구광역시,'015002, 11세,2019,21349,11101,10248,108.3,21290,11073,10217,108.4
'22,대구광역시,'015003, 12세,2019,22110,11327,10783,105,22048,11293,10755,105
'22,대구광역시,'015004, 13세,2019,20532,10778,9754,110.5,20490,10758,9732,110.5
'22,대구광역시,'015005, 14세,2019,20821,10875,9946,109.3,20767,10854,9913,109.5
'22,대구광역시,'020,15~19세,2019,131202,69196,62006,111.6,129326,68252,61074,111.8
'22,대구광역시,'020001, 15세,2019,22684,11889,10795,110.1,22627,11858,10769,110.1
'22,대구광역시,'020002, 16세,2019,23614,12495,11119,112.4,23566,12477,11089,112.5
'22,대구광역시,'020003, 17세,2019,24219,12845,11374,112.9,24098,12788,11310,113.1
'22,대구광역시,'020004, 18세,2019,28682,15002,13680,109.7,28107,14715,13392,109.9
'22,대구광역시,'020005, 19세,2019,32003,16965,15038,112.8,30928,16414,14514,113.1
'22,대구광역시,'025,20~24세,2019,167561,89812,77749,115.5,161473,86609,74864,115.7
'22,대구광역시,'025001, 20세,2019,30833,16379,14454,113.3,29645,15795,13850,114
'22,대구광역시,'025002, 21세,2019,32581,17518,15063,116.3,31435,16922,14513,116.6
'22,대구광역시,'025003, 22세,2019,34291,18168,16123,112.7,33158,17586,15572,112.9
'22,대구광역시,'025004, 23세,2019,35138,18965,16173,117.3,33854,18254,15600,117
'22,대구광역시,'025005, 24세,2019,34718,18782,15936,117.9,33381,18052,15329,117.8
'22,대구광역시,'030,25~29세,2019,161994,88259,73735,119.7,155216,84404,70812,119.2
'22,대구광역시,'030001, 25세,2019,34050,18566,15484,119.9,32802,17877,14925,119.8
'22,대구광역시,'030002, 26세,2019,33532,18382,15150,121.3,32194,17613,14581,120.8
'22,대구광역시,'030003, 27세,2019,33584,18229,15355,118.7,32245,17470,14775,118.2
'22,대구광역시,'030004, 28세,2019,31009,16829,14180,118.7,29609,16026,13583,118
'22,대구광역시,'030005, 29세,2019,29819,16253,13566,119.8,28366,15418,12948,119.1
'22,대구광역시,'035,30~34세,2019,138781,74498,64283,115.9,131908,70502,61406,114.8
'22,대구광역시,'035001, 30세,2019,28897,15770,13127,120.1,27489,14941,12548,119.1
'22,대구광역시,'035002, 31세,2019,26884,14597,12287,118.8,25471,13791,11680,118.1
'22,대구광역시,'035003, 32세,2019,27602,14719,12883,114.3,26157,13875,12282,113
'22,대구광역시,'035004, 33세,2019,27596,14774,12822,115.2,26275,13992,12283,113.9
'22,대구광역시,'035005, 34세,2019,27802,14638,13164,111.2,26516,13903,12613,110.2
'22,대구광역시,'040,35~39세,2019,172733,87192,85541,101.9,167704,84174,83530,100.8
'22,대구광역시,'040001, 35세,2019,29111,15058,14053,107.2,28010,14370,13640,105.4
'22,대구광역시,'040002, 36세,2019,32813,16561,16252,101.9,31708,15913,15795,100.7
'22,대구광역시,'040003, 37세,2019,36343,18231,18112,100.7,35285,17588,17697,99.4
'22,대구광역시,'040004, 38세,2019,36584,18384,18200,101,35660,17844,17816,100.2
'22,대구광역시,'040005, 39세,2019,37882,18958,18924,100.2,37041,18459,18582,99.3
'22,대구광역시,'045,40~44세,2019,175876,87458,88418,98.9,172443,85466,86977,98.3
'22,대구광역시,'045001, 40세,2019,35887,17787,18100,98.3,35087,17313,17774,97.4
'22,대구광역시,'045002, 41세,2019,33126,16583,16543,100.2,32361,16141,16220,99.5
'22,대구광역시,'045003, 42세,2019,34875,17399,17476,99.6,34217,17026,17191,99
'22,대구광역시,'045004, 43세,2019,34940,17551,17389,100.9,34308,17171,17137,100.2
'22,대구광역시,'045005, 44세,2019,37048,18138,18910,95.9,36470,17815,18655,95.5
'22,대구광역시,'050,45~49세,2019,213400,104788,108612,96.5,210465,103132,107333,96.1
'22,대구광역시,'050001, 45세,2019,40885,20173,20712,97.4,40277,19844,20433,97.1
'22,대구광역시,'050002, 46세,2019,41449,20209,21240,95.1,40909,19884,21025,94.6
'22,대구광역시,'050003, 47세,2019,42354,20868,21486,97.1,41761,20509,21252,96.5
'22,대구광역시,'050004, 48세,2019,44683,22013,22670,97.1,44098,21690,22408,96.8
'22,대구광역시,'050005, 49세,2019,44029,21525,22504,95.6,43420,21205,22215,95.5
'22,대구광역시,'055,50~54세,2019,214280,104751,109529,95.6,212064,103547,108517,95.4
'22,대구광역시,'055001, 50세,2019,44277,21571,22706,95,43787,21288,22499,94.6
'22,대구광역시,'055002, 51세,2019,45501,22351,23150,96.5,45008,22078,22930,96.3
'22,대구광역시,'055003, 52세,2019,42314,20411,21903,93.2,41906,20204,21702,93.1
'22,대구광역시,'055004, 53세,2019,40701,20365,20336,100.1,40300,20159,20141,100.1
'22,대구광역시,'055005, 54세,2019,41487,20053,21434,93.6,41063,19818,21245,93.3
'22,대구광역시,'060,55~59세,2019,211437,103324,108113,95.6,209875,102566,107309,95.6
'22,대구광역시,'060001, 55세,2019,38848,19020,19828,95.9,38477,18845,19632,96
'22,대구광역시,'060002, 56세,2019,40992,20266,20726,97.8,40605,20073,20532,97.8
'22,대구광역시,'060003, 57세,2019,42245,20860,21385,97.5,41924,20708,21216,97.6
'22,대구광역시,'060004, 58세,2019,45497,22067,23430,94.2,45311,21982,23329,94.2
'22,대구광역시,'060005, 59세,2019,43855,21111,22744,92.8,43558,20958,22600,92.7
'22,대구광역시,'065,60~64세,2019,177148,85958,91190,94.3,176238,85505,90733,94.2
'22,대구광역시,'065001, 60세,2019,40088,19429,20659,94,39861,19314,20547,94
'22,대구광역시,'065002, 61세,2019,34523,17072,17451,97.8,34321,16973,17348,97.8
'22,대구광역시,'065003, 62세,2019,36009,17690,18319,96.6,35827,17594,18233,96.5
'22,대구광역시,'065004, 63세,2019,33096,16071,17025,94.4,32941,15995,16946,94.4
'22,대구광역시,'065005, 64세,2019,33432,15696,17736,88.5,33288,15629,17659,88.5
'22,대구광역시,'070,65~69세,2019,124986,58624,66362,88.3,124465,58390,66075,88.4
'22,대구광역시,'070001, 65세,2019,27508,13252,14256,93,27358,13184,14174,93
'22,대구광역시,'070002, 66세,2019,26565,12275,14290,85.9,26448,12218,14230,85.9
'22,대구광역시,'070003, 67세,2019,28066,13042,15024,86.8,27963,12998,14965,86.9
'22,대구광역시,'070004, 68세,2019,21334,9931,11403,87.1,21244,9889,11355,87.1
'22,대구광역시,'070005, 69세,2019,21513,10124,11389,88.9,21452,10101,11351,89
'22,대구광역시,'075,70~74세,2019,91533,41253,50280,82,91331,41161,50170,82
'22,대구광역시,'075001, 70세,2019,22948,10509,12439,84.5,22879,10477,12402,84.5
'22,대구광역시,'075002, 71세,2019,21414,9748,11666,83.6,21382,9733,11649,83.6
'22,대구광역시,'075003, 72세,2019,19938,8888,11050,80.4,19900,8871,11029,80.4
'22,대구광역시,'075004, 73세,2019,13437,6125,7312,83.8,13401,6110,7291,83.8
'22,대구광역시,'075005, 74세,2019,13796,5983,7813,76.6,13769,5970,7799,76.5
'22,대구광역시,'080,75~79세,2019,76857,31797,45060,70.6,76747,31752,44995,70.6
'22,대구광역시,'080001, 75세,2019,15762,6659,9103,73.2,15729,6641,9088,73.1
'22,대구광역시,'080002, 76세,2019,16394,7020,9374,74.9,16377,7015,9362,74.9
'22,대구광역시,'080003, 77세,2019,17626,7441,10185,73.1,17612,7436,10176,73.1
'22,대구광역시,'080004, 78세,2019,14282,5776,8506,67.9,14255,5765,8490,67.9
'22,대구광역시,'080005, 79세,2019,12793,4901,7892,62.1,12774,4895,7879,62.1
'22,대구광역시,'085,80~84세,2019,49325,18005,31320,57.5,49263,17989,31274,57.5
'22,대구광역시,'085001, 80세,2019,12499,4899,7600,64.5,12484,4892,7592,64.4
'22,대구광역시,'085002, 81세,2019,10678,3945,6733,58.6,10662,3944,6718,58.7
'22,대구광역시,'085003, 82세,2019,9657,3507,6150,57,9648,3504,6144,57
'22,대구광역시,'085004, 83세,2019,8653,2996,5657,53,8639,2992,5647,53
'22,대구광역시,'085005, 84세,2019,7838,2658,5180,51.3,7830,2657,5173,51.4
'22,대구광역시,'086,85세이상,2019,30764,8362,22402,37.3,30701,8332,22369,37.2
'22,대구광역시,'090,85~89세,2019,22443,6574,15869,41.4,22403,6551,15852,41.3
'22,대구광역시,'090001, 85세,2019,6599,2136,4463,47.9,6588,2128,4460,47.7
'22,대구광역시,'090002, 86세,2019,5221,1595,3626,44,5207,1589,3618,43.9
'22,대구광역시,'090003, 87세,2019,4541,1351,3190,42.4,4537,1348,3189,42.3
'22,대구광역시,'090004, 88세,2019,3388,878,2510,35,3382,875,2507,34.9
'22,대구광역시,'090005, 89세,2019,2694,614,2080,29.5,2689,611,2078,29.4
'22,대구광역시,'095,90~94세,2019,6870,1529,5341,28.6,6855,1523,5332,28.6
'22,대구광역시,'095001, 90세,2019,2181,525,1656,31.7,2180,525,1655,31.7
'22,대구광역시,'095002, 91세,2019,1776,413,1363,30.3,1772,410,1362,30.1
'22,대구광역시,'095003, 92세,2019,1393,290,1103,26.3,1391,289,1102,26.2
'22,대구광역시,'095004, 93세,2019,813,160,653,24.5,808,159,649,24.5
'22,대구광역시,'095005, 94세,2019,707,141,566,24.9,704,140,564,24.8
'22,대구광역시,'100,95~99세,2019,1301,239,1062,22.5,1297,239,1058,22.6
'22,대구광역시,'100001, 95세,2019,438,86,352,24.4,438,86,352,24.4
'22,대구광역시,'100002, 96세,2019,334,66,268,24.6,333,66,267,24.7
'22,대구광역시,'100003, 97세,2019,259,50,209,23.9,258,50,208,24
'22,대구광역시,'100004, 98세,2019,159,23,136,16.9,159,23,136,16.9
'22,대구광역시,'100005, 99세,2019,111,14,97,14.4,109,14,95,14.7
'22,대구광역시,'101,100세이상,2019,150,20,130,15.4,146,19,127,15
'22,대구광역시,'102,15세미만,2019,292063,150477,141586,106.3,290629,149792,140837,106.4
'22,대구광역시,'103,15~64세,2019,1764412,895236,869176,103,1726712,874157,852555,102.5
'22,대구광역시,'104,65세이상,2019,373465,158041,215424,73.4,372507,157624,214883,73.4
'22,대구광역시,'126,평균연령,2019,42.7,41.3,44.1,,42.8,41.4,44.2,
'22,대구광역시,'127,중위연령,2019,44.3,42.5,46,,44.6,42.8,46.2,
'22004, 읍부,'000,합계,2019,236543,120694,115849,104.2,229372,116242,113130,102.8
'22004, 읍부,'005,0~4세,2019,14353,7239,7114,101.8,14191,7173,7018,102.2
'22004, 읍부,'005001, 0세,2019,2526,1298,1228,105.7,2494,1287,1207,106.6
'22004, 읍부,'005002, 1세,2019,2716,1363,1353,100.7,2678,1348,1330,101.4
'22004, 읍부,'005003, 2세,2019,2865,1430,1435,99.7,2836,1414,1422,99.4
'22004, 읍부,'005004, 3세,2019,3181,1594,1587,100.4,3145,1576,1569,100.4
'22004, 읍부,'005005, 4세,2019,3065,1554,1511,102.8,3038,1548,1490,103.9
'22004, 읍부,'010,5~9세,2019,14183,7268,6915,105.1,14055,7207,6848,105.2
'22004, 읍부,'010001, 5세,2019,2928,1484,1444,102.8,2893,1473,1420,103.7
'22004, 읍부,'010002, 6세,2019,2872,1493,1379,108.3,2841,1477,1364,108.3
'22004, 읍부,'010003, 7세,2019,2952,1518,1434,105.9,2935,1510,1425,106
'22004, 읍부,'010004, 8세,2019,2833,1439,1394,103.2,2805,1427,1378,103.6
'22004, 읍부,'010005, 9세,2019,2598,1334,1264,105.5,2581,1320,1261,104.7
'22004, 읍부,'015,10~14세,2019,11226,5787,5439,106.4,11129,5748,5381,106.8
'22004, 읍부,'015001, 10세,2019,2351,1195,1156,103.4,2328,1184,1144,103.5
'22004, 읍부,'015002, 11세,2019,2408,1264,1144,110.5,2389,1255,1134,110.7
'22004, 읍부,'015003, 12세,2019,2319,1156,1163,99.4,2297,1149,1148,100.1
'22004, 읍부,'015004, 13세,2019,2053,1092,961,113.6,2038,1086,952,114.1
'22004, 읍부,'015005, 14세,2019,2095,1080,1015,106.4,2077,1074,1003,107.1
'22004, 읍부,'020,15~19세,2019,11042,5876,5166,113.7,10956,5832,5124,113.8
'22004, 읍부,'020001, 15세,2019,2047,1041,1006,103.5,2035,1033,1002,103.1
'22004, 읍부,'020002, 16세,2019,2286,1187,1099,108,2268,1179,1089,108.3
'22004, 읍부,'020003, 17세,2019,2216,1183,1033,114.5,2204,1175,1029,114.2
'22004, 읍부,'020004, 18세,2019,2321,1240,1081,114.7,2305,1227,1078,113.8
'22004, 읍부,'020005, 19세,2019,2172,1225,947,129.4,2144,1218,926,131.5
'22004, 읍부,'025,20~24세,2019,12958,7431,5527,134.4,12405,7096,5309,133.7
'22004, 읍부,'025001, 20세,2019,2269,1345,924,145.6,2225,1324,901,146.9
'22004, 읍부,'025002, 21세,2019,2547,1484,1063,139.6,2473,1447,1026,141
'22004, 읍부,'025003, 22세,2019,2675,1475,1200,122.9,2571,1416,1155,122.6
'22004, 읍부,'025004, 23세,2019,2724,1573,1151,136.7,2572,1476,1096,134.7
'22004, 읍부,'025005, 24세,2019,2743,1554,1189,130.7,2564,1433,1131,126.7
'22004, 읍부,'030,25~29세,2019,15242,8414,6828,123.2,14010,7593,6417,118.3
'22004, 읍부,'030001, 25세,2019,2768,1544,1224,126.1,2577,1414,1163,121.6
'22004, 읍부,'030002, 26세,2019,2928,1671,1257,132.9,2704,1519,1185,128.2
'22004, 읍부,'030003, 27세,2019,3198,1753,1445,121.3,2941,1583,1358,116.6
'22004, 읍부,'030004, 28세,2019,3122,1703,1419,120,2837,1517,1320,114.9
'22004, 읍부,'030005, 29세,2019,3226,1743,1483,117.5,2951,1560,1391,112.1
'22004, 읍부,'035,30~34세,2019,18311,9738,8573,113.6,16864,8738,8126,107.5
'22004, 읍부,'035001, 30세,2019,3392,1858,1534,121.1,3094,1643,1451,113.2
'22004, 읍부,'035002, 31세,2019,3433,1816,1617,112.3,3131,1607,1524,105.4
'22004, 읍부,'035003, 32세,2019,3663,1906,1757,108.5,3378,1706,1672,102
'22004, 읍부,'035004, 33세,2019,3832,2063,1769,116.6,3563,1875,1688,111.1
'22004, 읍부,'035005, 34세,2019,3991,2095,1896,110.5,3698,1907,1791,106.5
'22004, 읍부,'040,35~39세,2019,23738,12270,11468,107,22622,11533,11089,104
'22004, 읍부,'040001, 35세,2019,4101,2173,1928,112.7,3834,1982,1852,107
'22004, 읍부,'040002, 36세,2019,4639,2335,2304,101.3,4395,2170,2225,97.5
'22004, 읍부,'040003, 37세,2019,5059,2608,2451,106.4,4836,2456,2380,103.2
'22004, 읍부,'040004, 38세,2019,4946,2590,2356,109.9,4745,2470,2275,108.6
'22004, 읍부,'040005, 39세,2019,4993,2564,2429,105.6,4812,2455,2357,104.2
'22004, 읍부,'045,40~44세,2019,20180,10633,9547,111.4,19442,10177,9265,109.8
'22004, 읍부,'045001, 40세,2019,4465,2321,2144,108.3,4304,2218,2086,106.3
'22004, 읍부,'045002, 41세,2019,4018,2109,1909,110.5,3826,1987,1839,108
'22004, 읍부,'045003, 42세,2019,4086,2177,1909,114,3952,2094,1858,112.7
'22004, 읍부,'045004, 43세,2019,3739,1994,1745,114.3,3606,1915,1691,113.2
'22004, 읍부,'045005, 44세,2019,3872,2032,1840,110.4,3754,1963,1791,109.6
'22004, 읍부,'050,45~49세,2019,19453,10054,9399,107,18874,9704,9170,105.8
'22004, 읍부,'050001, 45세,2019,4051,2134,1917,111.3,3922,2057,1865,110.3
'22004, 읍부,'050002, 46세,2019,3835,2001,1834,109.1,3725,1931,1794,107.6
'22004, 읍부,'050003, 47세,2019,3845,2027,1818,111.5,3716,1942,1774,109.5
'22004, 읍부,'050004, 48세,2019,3882,1972,1910,103.2,3778,1915,1863,102.8
'22004, 읍부,'050005, 49세,2019,3840,1920,1920,100,3733,1859,1874,99.2
'22004, 읍부,'055,50~54세,2019,18601,9046,9555,94.7,18157,8801,9356,94.1
'22004, 읍부,'055001, 50세,2019,3802,1817,1985,91.5,3714,1763,1951,90.4
'22004, 읍부,'055002, 51세,2019,3932,1918,2014,95.2,3832,1868,1964,95.1
'22004, 읍부,'055003, 52세,2019,3659,1755,1904,92.2,3575,1717,1858,92.4
'22004, 읍부,'055004, 53세,2019,3578,1787,1791,99.8,3495,1741,1754,99.3
'22004, 읍부,'055005, 54세,2019,3630,1769,1861,95.1,3541,1712,1829,93.6
'22004, 읍부,'060,55~59세,2019,18203,9055,9148,99,17911,8910,9001,99
'22004, 읍부,'060001, 55세,2019,3331,1649,1682,98,3250,1607,1643,97.8
'22004, 읍부,'060002, 56세,2019,3517,1741,1776,98,3455,1711,1744,98.1
'22004, 읍부,'060003, 57세,2019,3763,1879,1884,99.7,3715,1856,1859,99.8
'22004, 읍부,'060004, 58세,2019,3949,1979,1970,100.5,3907,1961,1946,100.8
'22004, 읍부,'060005, 59세,2019,3643,1807,1836,98.4,3584,1775,1809,98.1
'22004, 읍부,'065,60~64세,2019,14236,7111,7125,99.8,14072,7018,7054,99.5
'22004, 읍부,'065001, 60세,2019,3323,1662,1661,100.1,3284,1639,1645,99.6
'22004, 읍부,'065002, 61세,2019,2884,1444,1440,100.3,2845,1423,1422,100.1
'22004, 읍부,'065003, 62세,2019,2918,1476,1442,102.4,2884,1458,1426,102.2
'22004, 읍부,'065004, 63세,2019,2596,1311,1285,102,2568,1294,1274,101.6
'22004, 읍부,'065005, 64세,2019,2515,1218,1297,93.9,2491,1204,1287,93.6
'22004, 읍부,'070,65~69세,2019,9024,4460,4564,97.7,8946,4423,4523,97.8
'22004, 읍부,'070001, 65세,2019,2002,1018,984,103.5,1977,1004,973,103.2
'22004, 읍부,'070002, 66세,2019,1911,926,985,94,1891,916,975,93.9
'22004, 읍부,'070003, 67세,2019,2079,1034,1045,98.9,2067,1028,1039,98.9
'22004, 읍부,'070004, 68세,2019,1515,746,769,97,1503,743,760,97.8
'22004, 읍부,'070005, 69세,2019,1517,736,781,94.2,1508,732,776,94.3
'22004, 읍부,'075,70~74세,2019,6086,2891,3195,90.5,6055,2874,3181,90.3
'22004, 읍부,'075001, 70세,2019,1598,760,838,90.7,1587,754,833,90.5
'22004, 읍부,'075002, 71세,2019,1415,680,735,92.5,1414,679,735,92.4
'22004, 읍부,'075003, 72세,2019,1311,613,698,87.8,1303,610,693,88
'22004, 읍부,'075004, 73세,2019,902,443,459,96.5,894,438,456,96.1
'22004, 읍부,'075005, 74세,2019,860,395,465,84.9,857,393,464,84.7
'22004, 읍부,'080,75~79세,2019,4695,1890,2805,67.4,4685,1887,2798,67.4
'22004, 읍부,'080001, 75세,2019,965,441,524,84.2,961,439,522,84.1
'22004, 읍부,'080002, 76세,2019,1002,426,576,74,999,426,573,74.3
'22004, 읍부,'080003, 77세,2019,1086,439,647,67.9,1085,439,646,68
'22004, 읍부,'080004, 78세,2019,880,325,555,58.6,878,324,554,58.5
'22004, 읍부,'080005, 79세,2019,762,259,503,51.5,762,259,503,51.5
'22004, 읍부,'085,80~84세,2019,3077,1042,2035,51.2,3069,1041,2028,51.3
'22004, 읍부,'085001, 80세,2019,771,284,487,58.3,770,284,486,58.4
'22004, 읍부,'085002, 81세,2019,691,238,453,52.5,687,238,449,53
'22004, 읍부,'085003, 82세,2019,598,207,391,52.9,598,207,391,52.9
'22004, 읍부,'085004, 83세,2019,523,167,356,46.9,520,166,354,46.9
'22004, 읍부,'085005, 84세,2019,494,146,348,42,494,146,348,42
'22004, 읍부,'086,85세이상,2019,1935,489,1446,33.8,1929,487,1442,33.8
'22004, 읍부,'090,85~89세,2019,1429,390,1039,37.5,1427,389,1038,37.5
'22004, 읍부,'090001, 85세,2019,428,123,305,40.3,427,122,305,40
'22004, 읍부,'090002, 86세,2019,337,105,232,45.3,336,105,231,45.5
'22004, 읍부,'090003, 87세,2019,284,79,205,38.5,284,79,205,38.5
'22004, 읍부,'090004, 88세,2019,214,54,160,33.8,214,54,160,33.8
'22004, 읍부,'090005, 89세,2019,166,29,137,21.2,166,29,137,21.2
'22004, 읍부,'095,90~94세,2019,421,83,338,24.6,417,82,335,24.5
'22004, 읍부,'095001, 90세,2019,135,28,107,26.2,134,28,106,26.4
'22004, 읍부,'095002, 91세,2019,97,19,78,24.4,97,19,78,24.4
'22004, 읍부,'095003, 92세,2019,96,16,80,20,95,16,79,20.3
'22004, 읍부,'095004, 93세,2019,51,9,42,21.4,50,9,41,22
'22004, 읍부,'095005, 94세,2019,42,11,31,35.5,41,10,31,32.3
'22004, 읍부,'100,95~99세,2019,79,16,63,25.4,79,16,63,25.4
'22004, 읍부,'100001, 95세,2019,27,5,22,22.7,27,5,22,22.7
'22004, 읍부,'100002, 96세,2019,25,X,21,19,25,X,21,19
'22004, 읍부,'100003, 97세,2019,16,7,9,77.8,16,7,9,77.8
'22004, 읍부,'100004, 98세,2019,7,X,7,0,7,X,7,0
'22004, 읍부,'100005, 99세,2019,X,X,X,0,X,X,X,0
'22004, 읍부,'101,100세이상,2019,6,X,6,0,6,X,6,0
'22004, 읍부,'102,15세미만,2019,39762,20294,19468,104.2,39375,20128,19247,104.6
'22004, 읍부,'103,15~64세,2019,171964,89628,82336,108.9,165313,85402,79911,106.9
'22004, 읍부,'104,65세이상,2019,24817,10772,14045,76.7,24684,10712,13972,76.7
'22004, 읍부,'126,평균연령,2019,38.9,37.9,39.9,,39,38,40,
'22004, 읍부,'127,중위연령,2019,39.4,38.6,40.4,,39.7,38.9,40.6,
'22005, 면부,'000,합계,2019,21931,11597,10334,112.2,20400,10370,10030,103.4
'22005, 면부,'005,0~4세,2019,877,446,431,103.5,862,438,424,103.3
'22005, 면부,'005001, 0세,2019,153,80,73,109.6,151,79,72,109.7
'22005, 면부,'005002, 1세,2019,168,86,82,104.9,164,83,81,102.5
'22005, 면부,'005003, 2세,2019,179,92,87,105.7,173,89,84,106
'22005, 면부,'005004, 3세,2019,190,96,94,102.1,188,96,92,104.3
'22005, 면부,'005005, 4세,2019,187,92,95,96.8,186,91,95,95.8
'22005, 면부,'010,5~9세,2019,944,471,473,99.6,933,467,466,100.2
'22005, 면부,'010001, 5세,2019,198,87,111,78.4,192,86,106,81.1
'22005, 면부,'010002, 6세,2019,183,86,97,88.7,180,85,95,89.5
'22005, 면부,'010003, 7세,2019,190,102,88,115.9,189,101,88,114.8
'22005, 면부,'010004, 8세,2019,198,102,96,106.3,197,101,96,105.2
'22005, 면부,'010005, 9세,2019,175,94,81,116,175,94,81,116
'22005, 면부,'015,10~14세,2019,571,284,287,99,568,283,285,99.3
'22005, 면부,'015001, 10세,2019,131,64,67,95.5,130,64,66,97
'22005, 면부,'015002, 11세,2019,130,67,63,106.3,129,66,63,104.8
'22005, 면부,'015003, 12세,2019,116,56,60,93.3,115,56,59,94.9
'22005, 면부,'015004, 13세,2019,101,53,48,110.4,101,53,48,110.4
'22005, 면부,'015005, 14세,2019,93,44,49,89.8,93,44,49,89.8
'22005, 면부,'020,15~19세,2019,683,425,258,164.7,678,421,257,163.8
'22005, 면부,'020001, 15세,2019,101,49,52,94.2,101,49,52,94.2
'22005, 면부,'020002, 16세,2019,154,108,46,234.8,153,107,46,232.6
'22005, 면부,'020003, 17세,2019,144,100,44,227.3,144,100,44,227.3
'22005, 면부,'020004, 18세,2019,159,95,64,148.4,157,93,64,145.3
'22005, 면부,'020005, 19세,2019,125,73,52,140.4,123,72,51,141.2
'22005, 면부,'025,20~24세,2019,905,589,316,186.4,750,457,293,156
'22005, 면부,'025001, 20세,2019,130,91,39,233.3,119,83,36,230.6
'22005, 면부,'025002, 21세,2019,158,100,58,172.4,139,86,53,162.3
'22005, 면부,'025003, 22세,2019,177,111,66,168.2,148,87,61,142.6
'22005, 면부,'025004, 23세,2019,200,131,69,189.9,164,96,68,141.2
'22005, 면부,'025005, 24세,2019,240,156,84,185.7,180,105,75,140
'22005, 면부,'030,25~29세,2019,1419,892,527,169.3,1055,589,466,126.4
'22005, 면부,'030001, 25세,2019,235,149,86,173.3,177,99,78,126.9
'22005, 면부,'030002, 26세,2019,268,174,94,185.1,202,118,84,140.5
'22005, 면부,'030003, 27세,2019,277,161,116,138.8,212,107,105,101.9
'22005, 면부,'030004, 28세,2019,299,186,113,164.6,216,115,101,113.9
'22005, 면부,'030005, 29세,2019,340,222,118,188.1,248,150,98,153.1
'22005, 면부,'035,30~34세,2019,1675,1077,598,180.1,1290,750,540,138.9
'22005, 면부,'035001, 30세,2019,306,212,94,225.5,228,145,83,174.7
'22005, 면부,'035002, 31세,2019,328,204,124,164.5,246,133,113,117.7
'22005, 면부,'035003, 32세,2019,352,220,132,166.7,265,155,110,140.9
'22005, 면부,'035004, 33세,2019,343,208,135,154.1,271,145,126,115.1
'22005, 면부,'035005, 34세,2019,346,233,113,206.2,280,172,108,159.3
'22005, 면부,'040,35~39세,2019,1776,1093,683,160,1511,867,644,134.6
'22005, 면부,'040001, 35세,2019,349,223,126,177,291,171,120,142.5
'22005, 면부,'040002, 36세,2019,353,211,142,148.6,295,163,132,123.5
'22005, 면부,'040003, 37세,2019,356,217,139,156.1,305,173,132,131.1
'22005, 면부,'040004, 38세,2019,363,222,141,157.4,316,182,134,135.8
'22005, 면부,'040005, 39세,2019,355,220,135,163,304,178,126,141.3
'22005, 면부,'045,40~44세,2019,1412,845,567,149,1286,749,537,139.5
'22005, 면부,'045001, 40세,2019,342,189,153,123.5,307,162,145,111.7
'22005, 면부,'045002, 41세,2019,307,182,125,145.6,274,156,118,132.2
'22005, 면부,'045003, 42세,2019,267,155,112,138.4,244,139,105,132.4
'22005, 면부,'045004, 43세,2019,246,167,79,211.4,228,152,76,200
'22005, 면부,'045005, 44세,2019,250,152,98,155.1,233,140,93,150.5
'22005, 면부,'050,45~49세,2019,1383,777,606,128.2,1296,717,579,123.8
'22005, 면부,'050001, 45세,2019,264,163,101,161.4,245,148,97,152.6
'22005, 면부,'050002, 46세,2019,266,145,121,119.8,244,127,117,108.5
'22005, 면부,'050003, 47세,2019,267,144,123,117.1,253,136,117,116.2
'22005, 면부,'050004, 48세,2019,270,147,123,119.5,256,136,120,113.3
'22005, 면부,'050005, 49세,2019,316,178,138,129,298,170,128,132.8
'22005, 면부,'055,50~54세,2019,1448,784,664,118.1,1406,754,652,115.6
'22005, 면부,'055001, 50세,2019,275,155,120,129.2,266,148,118,125.4
'22005, 면부,'055002, 51세,2019,306,166,140,118.6,291,155,136,114
'22005, 면부,'055003, 52세,2019,281,153,128,119.5,274,147,127,115.7
'22005, 면부,'055004, 53세,2019,291,147,144,102.1,285,144,141,102.1
'22005, 면부,'055005, 54세,2019,295,163,132,123.5,290,160,130,123.1
'22005, 면부,'060,55~59세,2019,1741,873,868,100.6,1712,861,851,101.2
'22005, 면부,'060001, 55세,2019,311,175,136,128.7,306,172,134,128.4
'22005, 면부,'060002, 56세,2019,324,150,174,86.2,315,149,166,89.8
'22005, 면부,'060003, 57세,2019,337,176,161,109.3,330,171,159,107.5
'22005, 면부,'060004, 58세,2019,381,184,197,93.4,378,183,195,93.8
'22005, 면부,'060005, 59세,2019,388,188,200,94,383,186,197,94.4
'22005, 면부,'065,60~64세,2019,1784,885,899,98.4,1757,869,888,97.9
'22005, 면부,'065001, 60세,2019,390,191,199,96,386,189,197,95.9
'22005, 면부,'065002, 61세,2019,343,169,174,97.1,338,165,173,95.4
'22005, 면부,'065003, 62세,2019,355,179,176,101.7,345,172,173,99.4
'22005, 면부,'065004, 63세,2019,344,174,170,102.4,340,172,168,102.4
'22005, 면부,'065005, 64세,2019,352,172,180,95.6,348,171,177,96.6
'22005, 면부,'070,65~69세,2019,1365,654,711,92,1355,648,707,91.7
'22005, 면부,'070001, 65세,2019,291,151,140,107.9,290,150,140,107.1
'22005, 면부,'070002, 66세,2019,270,126,144,87.5,268,124,144,86.1
'22005, 면부,'070003, 67세,2019,309,138,171,80.7,309,138,171,80.7
'22005, 면부,'070004, 68세,2019,231,111,120,92.5,228,108,120,90
'22005, 면부,'070005, 69세,2019,264,128,136,94.1,260,128,132,97
'22005, 면부,'075,70~74세,2019,1070,543,527,103,1067,542,525,103.2
'22005, 면부,'075001, 70세,2019,265,150,115,130.4,265,150,115,130.4
'22005, 면부,'075002, 71세,2019,255,132,123,107.3,254,131,123,106.5
'22005, 면부,'075003, 72세,2019,237,115,122,94.3,235,115,120,95.8
'22005, 면부,'075004, 73세,2019,139,64,75,85.3,139,64,75,85.3
'22005, 면부,'075005, 74세,2019,174,82,92,89.1,174,82,92,89.1
'22005, 면부,'080,75~79세,2019,1024,406,618,65.7,1021,405,616,65.7
'22005, 면부,'080001, 75세,2019,211,104,107,97.2,210,103,107,96.3
'22005, 면부,'080002, 76세,2019,182,70,112,62.5,182,70,112,62.5
'22005, 면부,'080003, 77세,2019,225,91,134,67.9,225,91,134,67.9
'22005, 면부,'080004, 78세,2019,215,76,139,54.7,213,76,137,55.5
'22005, 면부,'080005, 79세,2019,191,65,126,51.6,191,65,126,51.6
'22005, 면부,'085,80~84세,2019,974,331,643,51.5,973,331,642,51.6
'22005, 면부,'085001, 80세,2019,235,78,157,49.7,235,78,157,49.7
'22005, 면부,'085002, 81세,2019,192,72,120,60,191,72,119,60.5
'22005, 면부,'085003, 82세,2019,210,72,138,52.2,210,72,138,52.2
'22005, 면부,'085004, 83세,2019,155,53,102,52,155,53,102,52
'22005, 면부,'085005, 84세,2019,182,56,126,44.4,182,56,126,44.4
'22005, 면부,'086,85세이상,2019,880,222,658,33.7,880,222,658,33.7
'22005, 면부,'090,85~89세,2019,598,155,443,35,598,155,443,35
'22005, 면부,'090001, 85세,2019,173,39,134,29.1,173,39,134,29.1
'22005, 면부,'090002, 86세,2019,117,33,84,39.3,117,33,84,39.3
'22005, 면부,'090003, 87세,2019,127,39,88,44.3,127,39,88,44.3
'22005, 면부,'090004, 88세,2019,111,26,85,30.6,111,26,85,30.6
'22005, 면부,'090005, 89세,2019,70,18,52,34.6,70,18,52,34.6
'22005, 면부,'095,90~94세,2019,236,57,179,31.8,236,57,179,31.8
'22005, 면부,'095001, 90세,2019,70,16,54,29.6,70,16,54,29.6
'22005, 면부,'095002, 91세,2019,66,18,48,37.5,66,18,48,37.5
'22005, 면부,'095003, 92세,2019,40,11,29,37.9,40,11,29,37.9
'22005, 면부,'095004, 93세,2019,32,7,25,28,32,7,25,28
'22005, 면부,'095005, 94세,2019,28,5,23,21.7,28,5,23,21.7
'22005, 면부,'100,95~99세,2019,41,8,33,24.2,41,8,33,24.2
'22005, 면부,'100001, 95세,2019,11,X,8,37.5,11,X,8,37.5
'22005, 면부,'100002, 96세,2019,12,X,11,9.1,12,X,11,9.1
'22005, 면부,'100003, 97세,2019,5,X,X,25,5,X,X,25
'22005, 면부,'100004, 98세,2019,8,X,6,33.3,8,X,6,33.3
'22005, 면부,'100005, 99세,2019,5,X,X,25,5,X,X,25
'22005, 면부,'101,100세이상,2019,5,X,X,66.7,5,X,X,66.7
'22005, 면부,'102,15세미만,2019,2392,1201,1191,100.8,2363,1188,1175,101.1
'22005, 면부,'103,15~64세,2019,14226,8240,5986,137.7,12741,7034,5707,123.3
'22005, 면부,'104,65세이상,2019,5313,2156,3157,68.3,5296,2148,3148,68.2
'22005, 면부,'126,평균연령,2019,47,44,50.2,,47.9,45.3,50.6,
'22005, 면부,'127,중위연령,2019,47.6,43,53.2,,49.9,46.1,54,
'22003, 동부,'000,합계,2019,2171466,1071463,1100003,97.4,2140076,1054961,1085115,97.2
'22003, 동부,'005,0~4세,2019,68516,35272,33244,106.1,67991,35002,32989,106.1
'22003, 동부,'005001, 0세,2019,10711,5587,5124,109,10624,5547,5077,109.3
'22003, 동부,'005002, 1세,2019,11966,6068,5898,102.9,11855,6004,5851,102.6
'22003, 동부,'005003, 2세,2019,13548,7041,6507,108.2,13443,6992,6451,108.4
'22003, 동부,'005004, 3세,2019,15679,8052,7627,105.6,15565,7989,7576,105.5
'22003, 동부,'005005, 4세,2019,16612,8524,8088,105.4,16504,8470,8034,105.4
'22003, 동부,'010,5~9세,2019,88360,45262,43098,105,88059,45124,42935,105.1
'22003, 동부,'010001, 5세,2019,16520,8409,8111,103.7,16443,8374,8069,103.8
'22003, 동부,'010002, 6세,2019,16935,8611,8324,103.4,16872,8581,8291,103.5
'22003, 동부,'010003, 7세,2019,18741,9560,9181,104.1,18679,9532,9147,104.2
'22003, 동부,'010004, 8세,2019,18285,9445,8840,106.8,18231,9422,8809,107
'22003, 동부,'010005, 9세,2019,17879,9237,8642,106.9,17834,9215,8619,106.9
'22003, 동부,'015,10~14세,2019,93033,48448,44585,108.7,92841,48350,44491,108.7
'22003, 동부,'015001, 10세,2019,17536,9179,8357,109.8,17485,9155,8330,109.9
'22003, 동부,'015002, 11세,2019,18811,9770,9041,108.1,18772,9752,9020,108.1
'22003, 동부,'015003, 12세,2019,19675,10115,9560,105.8,19636,10088,9548,105.7
'22003, 동부,'015004, 13세,2019,18378,9633,8745,110.2,18351,9619,8732,110.2
'22003, 동부,'015005, 14세,2019,18633,9751,8882,109.8,18597,9736,8861,109.9
'22003, 동부,'020,15~19세,2019,119477,62895,56582,111.2,117692,61999,55693,111.3
'22003, 동부,'020001, 15세,2019,20536,10799,9737,110.9,20491,10776,9715,110.9
'22003, 동부,'020002, 16세,2019,21174,11200,9974,112.3,21145,11191,9954,112.4
'22003, 동부,'020003, 17세,2019,21859,11562,10297,112.3,21750,11513,10237,112.5
'22003, 동부,'020004, 18세,2019,26202,13667,12535,109,25645,13395,12250,109.3
'22003, 동부,'020005, 19세,2019,29706,15667,14039,111.6,28661,15124,13537,111.7
'22003, 동부,'025,20~24세,2019,153698,81792,71906,113.7,148318,79056,69262,114.1
'22003, 동부,'025001, 20세,2019,28434,14943,13491,110.8,27301,14388,12913,111.4
'22003, 동부,'025002, 21세,2019,29876,15934,13942,114.3,28823,15389,13434,114.6
'22003, 동부,'025003, 22세,2019,31439,16582,14857,111.6,30439,16083,14356,112
'22003, 동부,'025004, 23세,2019,32214,17261,14953,115.4,31118,16682,14436,115.6
'22003, 동부,'025005, 24세,2019,31735,17072,14663,116.4,30637,16514,14123,116.9
'22003, 동부,'030,25~29세,2019,145333,78953,66380,118.9,140151,76222,63929,119.2
'22003, 동부,'030001, 25세,2019,31047,16873,14174,119,30048,16364,13684,119.6
'22003, 동부,'030002, 26세,2019,30336,16537,13799,119.8,29288,15976,13312,120
'22003, 동부,'030003, 27세,2019,30109,16315,13794,118.3,29092,15780,13312,118.5
'22003, 동부,'030004, 28세,2019,27588,14940,12648,118.1,26556,14394,12162,118.4
'22003, 동부,'030005, 29세,2019,26253,14288,11965,119.4,25167,13708,11459,119.6
'22003, 동부,'035,30~34세,2019,118795,63683,55112,115.6,113754,61014,52740,115.7
'22003, 동부,'035001, 30세,2019,25199,13700,11499,119.1,24167,13153,11014,119.4
'22003, 동부,'035002, 31세,2019,23123,12577,10546,119.3,22094,12051,10043,120
'22003, 동부,'035003, 32세,2019,23587,12593,10994,114.5,22514,12014,10500,114.4
'22003, 동부,'035004, 33세,2019,23421,12503,10918,114.5,22441,11972,10469,114.4
'22003, 동부,'035005, 34세,2019,23465,12310,11155,110.4,22538,11824,10714,110.4
'22003, 동부,'040,35~39세,2019,147219,73829,73390,100.6,143571,71774,71797,100
'22003, 동부,'040001, 35세,2019,24661,12662,11999,105.5,23885,12217,11668,104.7
'22003, 동부,'040002, 36세,2019,27821,14015,13806,101.5,27018,13580,13438,101.1
'22003, 동부,'040003, 37세,2019,30928,15406,15522,99.3,30144,14959,15185,98.5
'22003, 동부,'040004, 38세,2019,31275,15572,15703,99.2,30599,15192,15407,98.6
'22003, 동부,'040005, 39세,2019,32534,16174,16360,98.9,31925,15826,16099,98.3
'22003, 동부,'045,40~44세,2019,154284,75980,78304,97,151715,74540,77175,96.6
'22003, 동부,'045001, 40세,2019,31080,15277,15803,96.7,30476,14933,15543,96.1
'22003, 동부,'045002, 41세,2019,28801,14292,14509,98.5,28261,13998,14263,98.1
'22003, 동부,'045003, 42세,2019,30522,15067,15455,97.5,30021,14793,15228,97.1
'22003, 동부,'045004, 43세,2019,30955,15390,15565,98.9,30474,15104,15370,98.3
'22003, 동부,'045005, 44세,2019,32926,15954,16972,94,32483,15712,16771,93.7
'22003, 동부,'050,45~49세,2019,192564,93957,98607,95.3,190295,92711,97584,95
'22003, 동부,'050001, 45세,2019,36570,17876,18694,95.6,36110,17639,18471,95.5
'22003, 동부,'050002, 46세,2019,37348,18063,19285,93.7,36940,17826,19114,93.3
'22003, 동부,'050003, 47세,2019,38242,18697,19545,95.7,37792,18431,19361,95.2
'22003, 동부,'050004, 48세,2019,40531,19894,20637,96.4,40064,19639,20425,96.2
'22003, 동부,'050005, 49세,2019,39873,19427,20446,95,39389,19176,20213,94.9
'22003, 동부,'055,50~54세,2019,194231,94921,99310,95.6,192501,93992,98509,95.4
'22003, 동부,'055001, 50세,2019,40200,19599,20601,95.1,39807,19377,20430,94.8
'22003, 동부,'055002, 51세,2019,41263,20267,20996,96.5,40885,20055,20830,96.3
'22003, 동부,'055003, 52세,2019,38374,18503,19871,93.1,38057,18340,19717,93
'22003, 동부,'055004, 53세,2019,36832,18431,18401,100.2,36520,18274,18246,100.2
'22003, 동부,'055005, 54세,2019,37562,18121,19441,93.2,37232,17946,19286,93.1
'22003, 동부,'060,55~59세,2019,191493,93396,98097,95.2,190252,92795,97457,95.2
'22003, 동부,'060001, 55세,2019,35206,17196,18010,95.5,34921,17066,17855,95.6
'22003, 동부,'060002, 56세,2019,37151,18375,18776,97.9,36835,18213,18622,97.8
'22003, 동부,'060003, 57세,2019,38145,18805,19340,97.2,37879,18681,19198,97.3
'22003, 동부,'060004, 58세,2019,41167,19904,21263,93.6,41026,19838,21188,93.6
'22003, 동부,'060005, 59세,2019,39824,19116,20708,92.3,39591,18997,20594,92.2
'22003, 동부,'065,60~64세,2019,161128,77962,83166,93.7,160409,77618,82791,93.8
'22003, 동부,'065001, 60세,2019,36375,17576,18799,93.5,36191,17486,18705,93.5
'22003, 동부,'065002, 61세,2019,31296,15459,15837,97.6,31138,15385,15753,97.7
'22003, 동부,'065003, 62세,2019,32736,16035,16701,96,32598,15964,16634,96
'22003, 동부,'065004, 63세,2019,30156,14586,15570,93.7,30033,14529,15504,93.7
'22003, 동부,'065005, 64세,2019,30565,14306,16259,88,30449,14254,16195,88
'22003, 동부,'070,65~69세,2019,114597,53510,61087,87.6,114164,53319,60845,87.6
'22003, 동부,'070001, 65세,2019,25215,12083,13132,92,25091,12030,13061,92.1
'22003, 동부,'070002, 66세,2019,24384,11223,13161,85.3,24289,11178,13111,85.3
'22003, 동부,'070003, 67세,2019,25678,11870,13808,86,25587,11832,13755,86
'22003, 동부,'070004, 68세,2019,19588,9074,10514,86.3,19513,9038,10475,86.3
'22003, 동부,'070005, 69세,2019,19732,9260,10472,88.4,19684,9241,10443,88.5
'22003, 동부,'075,70~74세,2019,84377,37819,46558,81.2,84209,37745,46464,81.2
'22003, 동부,'075001, 70세,2019,21085,9599,11486,83.6,21027,9573,11454,83.6
'22003, 동부,'075002, 71세,2019,19744,8936,10808,82.7,19714,8923,10791,82.7
'22003, 동부,'075003, 72세,2019,18390,8160,10230,79.8,18362,8146,10216,79.7
'22003, 동부,'075004, 73세,2019,12396,5618,6778,82.9,12368,5608,6760,83
'22003, 동부,'075005, 74세,2019,12762,5506,7256,75.9,12738,5495,7243,75.9
'22003, 동부,'080,75~79세,2019,71138,29501,41637,70.9,71041,29460,41581,70.8
'22003, 동부,'080001, 75세,2019,14586,6114,8472,72.2,14558,6099,8459,72.1
'22003, 동부,'080002, 76세,2019,15210,6524,8686,75.1,15196,6519,8677,75.1
'22003, 동부,'080003, 77세,2019,16315,6911,9404,73.5,16302,6906,9396,73.5
'22003, 동부,'080004, 78세,2019,13187,5375,7812,68.8,13164,5365,7799,68.8
'22003, 동부,'080005, 79세,2019,11840,4577,7263,63,11821,4571,7250,63
'22003, 동부,'085,80~84세,2019,45274,16632,28642,58.1,45221,16617,28604,58.1
'22003, 동부,'085001, 80세,2019,11493,4537,6956,65.2,11479,4530,6949,65.2
'22003, 동부,'085002, 81세,2019,9795,3635,6160,59,9784,3634,6150,59.1
'22003, 동부,'085003, 82세,2019,8849,3228,5621,57.4,8840,3225,5615,57.4
'22003, 동부,'085004, 83세,2019,7975,2776,5199,53.4,7964,2773,5191,53.4
'22003, 동부,'085005, 84세,2019,7162,2456,4706,52.2,7154,2455,4699,52.2
'22003, 동부,'086,85세이상,2019,27949,7651,20298,37.7,27892,7623,20269,37.6
'22003, 동부,'090,85~89세,2019,20416,6029,14387,41.9,20378,6007,14371,41.8
'22003, 동부,'090001, 85세,2019,5998,1974,4024,49.1,5988,1967,4021,48.9
'22003, 동부,'090002, 86세,2019,4767,1457,3310,44,4754,1451,3303,43.9
'22003, 동부,'090003, 87세,2019,4130,1233,2897,42.6,4126,1230,2896,42.5
'22003, 동부,'090004, 88세,2019,3063,798,2265,35.2,3057,795,2262,35.1
'22003, 동부,'090005, 89세,2019,2458,567,1891,30,2453,564,1889,29.9
'22003, 동부,'095,90~94세,2019,6213,1389,4824,28.8,6202,1384,4818,28.7
'22003, 동부,'095001, 90세,2019,1976,481,1495,32.2,1976,481,1495,32.2
'22003, 동부,'095002, 91세,2019,1613,376,1237,30.4,1609,373,1236,30.2
'22003, 동부,'095003, 92세,2019,1257,263,994,26.5,1256,262,994,26.4
'22003, 동부,'095004, 93세,2019,730,144,586,24.6,726,143,583,24.5
'22003, 동부,'095005, 94세,2019,637,125,512,24.4,635,125,510,24.5
'22003, 동부,'100,95~99세,2019,1181,215,966,22.3,1177,215,962,22.3
'22003, 동부,'100001, 95세,2019,400,78,322,24.2,400,78,322,24.2
'22003, 동부,'100002, 96세,2019,297,61,236,25.8,296,61,235,26
'22003, 동부,'100003, 97세,2019,238,42,196,21.4,237,42,195,21.5
'22003, 동부,'100004, 98세,2019,144,21,123,17.1,144,21,123,17.1
'22003, 동부,'100005, 99세,2019,102,13,89,14.6,100,13,87,14.9
'22003, 동부,'101,100세이상,2019,139,18,121,14.9,135,17,118,14.4
'22003, 동부,'102,15세미만,2019,249909,128982,120927,106.7,248891,128476,120415,106.7
'22003, 동부,'103,15~64세,2019,1578222,797368,780854,102.1,1548658,781721,766937,101.9
'22003, 동부,'104,65세이상,2019,343335,145113,198222,73.2,342527,144764,197763,73.2
'22003, 동부,'126,평균연령,2019,43.1,41.6,44.5,,43.2,41.7,44.6,
'22003, 동부,'127,중위연령,2019,44.9,43.1,46.5,,45.2,43.3,46.7,
'22010, 중구,'000,합계,2019,75561,36413,39148,93,74662,35964,38698,92.9
'22010, 중구,'005,0~4세,2019,2771,1418,1353,104.8,2745,1401,1344,104.2
'22010, 중구,'005001, 0세,2019,475,254,221,114.9,471,251,220,114.1
'22010, 중구,'005002, 1세,2019,518,270,248,108.9,509,264,245,107.8
'22010, 중구,'005003, 2세,2019,560,292,268,109,557,289,268,107.8
'22010, 중구,'005004, 3세,2019,634,320,314,101.9,628,317,311,101.9
'22010, 중구,'005005, 4세,2019,584,282,302,93.4,580,280,300,93.3
'22010, 중구,'010,5~9세,2019,2759,1425,1334,106.8,2749,1421,1328,107
'22010, 중구,'010001, 5세,2019,556,292,264,110.6,554,292,262,111.5
'22010, 중구,'010002, 6세,2019,564,275,289,95.2,559,272,287,94.8
'22010, 중구,'010003, 7세,2019,576,318,258,123.3,576,318,258,123.3
'22010, 중구,'010004, 8세,2019,572,278,294,94.6,571,278,293,94.9
'22010, 중구,'010005, 9세,2019,491,262,229,114.4,489,261,228,114.5
'22010, 중구,'015,10~14세,2019,2189,1150,1039,110.7,2177,1142,1035,110.3
'22010, 중구,'015001, 10세,2019,448,253,195,129.7,446,251,195,128.7
'22010, 중구,'015002, 11세,2019,451,224,227,98.7,448,222,226,98.2
'22010, 중구,'015003, 12세,2019,451,250,201,124.4,449,248,201,123.4
'22010, 중구,'015004, 13세,2019,424,207,217,95.4,422,206,216,95.4
'22010, 중구,'015005, 14세,2019,415,216,199,108.5,412,215,197,109.1
'22010, 중구,'020,15~19세,2019,2805,1362,1443,94.4,2787,1350,1437,93.9
'22010, 중구,'020001, 15세,2019,502,228,274,83.2,499,227,272,83.5
'22010, 중구,'020002, 16세,2019,518,244,274,89.1,518,244,274,89.1
'22010, 중구,'020003, 17세,2019,553,269,284,94.7,552,268,284,94.4
'22010, 중구,'020004, 18세,2019,572,284,288,98.6,569,283,286,99
'22010, 중구,'020005, 19세,2019,660,337,323,104.3,649,328,321,102.2
'22010, 중구,'025,20~24세,2019,5204,2427,2777,87.4,5105,2379,2726,87.3
'22010, 중구,'025001, 20세,2019,856,416,440,94.5,841,407,434,93.8
'22010, 중구,'025002, 21세,2019,863,404,459,88,848,396,452,87.6
'22010, 중구,'025003, 22세,2019,1059,489,570,85.8,1045,480,565,85
'22010, 중구,'025004, 23세,2019,1163,537,626,85.8,1144,531,613,86.6
'22010, 중구,'025005, 24세,2019,1263,581,682,85.2,1227,565,662,85.3
'22010, 중구,'030,25~29세,2019,6558,3338,3220,103.7,6430,3273,3157,103.7
'22010, 중구,'030001, 25세,2019,1332,650,682,95.3,1305,635,670,94.8
'22010, 중구,'030002, 26세,2019,1347,682,665,102.6,1326,671,655,102.4
'22010, 중구,'030003, 27세,2019,1427,734,693,105.9,1399,717,682,105.1
'22010, 중구,'030004, 28세,2019,1261,653,608,107.4,1242,648,594,109.1
'22010, 중구,'030005, 29세,2019,1191,619,572,108.2,1158,602,556,108.3
'22010, 중구,'035,30~34세,2019,5264,2732,2532,107.9,5116,2657,2459,108.1
'22010, 중구,'035001, 30세,2019,1144,575,569,101.1,1113,558,555,100.5
'22010, 중구,'035002, 31세,2019,962,526,436,120.6,932,511,421,121.4
'22010, 중구,'035003, 32세,2019,1055,525,530,99.1,1027,515,512,100.6
'22010, 중구,'035004, 33세,2019,1035,532,503,105.8,1005,517,488,105.9
'22010, 중구,'035005, 34세,2019,1068,574,494,116.2,1039,556,483,115.1
'22010, 중구,'040,35~39세,2019,5953,3062,2891,105.9,5852,3010,2842,105.9
'22010, 중구,'040001, 35세,2019,1090,552,538,102.6,1072,540,532,101.5
'22010, 중구,'040002, 36세,2019,1189,598,591,101.2,1171,590,581,101.5
'22010, 중구,'040003, 37세,2019,1238,611,627,97.4,1211,603,608,99.2
'22010, 중구,'040004, 38세,2019,1220,663,557,119,1202,653,549,118.9
'22010, 중구,'040005, 39세,2019,1216,638,578,110.4,1196,624,572,109.1
'22010, 중구,'045,40~44세,2019,4917,2529,2388,105.9,4857,2508,2349,106.8
'22010, 중구,'045001, 40세,2019,1091,549,542,101.3,1079,543,536,101.3
'22010, 중구,'045002, 41세,2019,881,454,427,106.3,871,450,421,106.9
'22010, 중구,'045003, 42세,2019,965,516,449,114.9,953,515,438,117.6
'22010, 중구,'045004, 43세,2019,980,504,476,105.9,971,502,469,107
'22010, 중구,'045005, 44세,2019,1000,506,494,102.4,983,498,485,102.7
'22010, 중구,'050,45~49세,2019,5670,2846,2824,100.8,5608,2808,2800,100.3
'22010, 중구,'050001, 45세,2019,1119,560,559,100.2,1107,553,554,99.8
'22010, 중구,'050002, 46세,2019,1094,545,549,99.3,1082,536,546,98.2
'22010, 중구,'050003, 47세,2019,1121,571,550,103.8,1110,562,548,102.6
'22010, 중구,'050004, 48세,2019,1197,601,596,100.8,1185,595,590,100.8
'22010, 중구,'050005, 49세,2019,1139,569,570,99.8,1124,562,562,100
'22010, 중구,'055,50~54세,2019,5466,2686,2780,96.6,5398,2646,2752,96.1
'22010, 중구,'055001, 50세,2019,1107,570,537,106.1,1094,562,532,105.6
'22010, 중구,'055002, 51세,2019,1143,572,571,100.2,1127,562,565,99.5
'22010, 중구,'055003, 52세,2019,1114,529,585,90.4,1105,522,583,89.5
'22010, 중구,'055004, 53세,2019,1017,485,532,91.2,1003,482,521,92.5
'22010, 중구,'055005, 54세,2019,1085,530,555,95.5,1069,518,551,94
'22010, 중구,'060,55~59세,2019,5757,2793,2964,94.2,5700,2766,2934,94.3
'22010, 중구,'060001, 55세,2019,1057,518,539,96.1,1052,515,537,95.9
'22010, 중구,'060002, 56세,2019,1065,531,534,99.4,1054,526,528,99.6
'22010, 중구,'060003, 57세,2019,1159,567,592,95.8,1142,560,582,96.2
'22010, 중구,'060004, 58세,2019,1219,572,647,88.4,1210,568,642,88.5
'22010, 중구,'060005, 59세,2019,1257,605,652,92.8,1242,597,645,92.6
'22010, 중구,'065,60~64세,2019,5504,2589,2915,88.8,5468,2575,2893,89
'22010, 중구,'065001, 60세,2019,1170,560,610,91.8,1164,555,609,91.1
'22010, 중구,'065002, 61세,2019,1020,521,499,104.4,1011,521,490,106.3
'22010, 중구,'065003, 62세,2019,1148,517,631,81.9,1140,514,626,82.1
'22010, 중구,'065004, 63세,2019,1074,499,575,86.8,1064,494,570,86.7
'22010, 중구,'065005, 64세,2019,1092,492,600,82,1089,491,598,82.1
'22010, 중구,'070,65~69세,2019,4255,1879,2376,79.1,4223,1867,2356,79.2
'22010, 중구,'070001, 65세,2019,868,406,462,87.9,862,405,457,88.6
'22010, 중구,'070002, 66세,2019,861,377,484,77.9,854,375,479,78.3
'22010, 중구,'070003, 67세,2019,990,425,565,75.2,986,424,562,75.4
'22010, 중구,'070004, 68세,2019,732,321,411,78.1,721,314,407,77.1
'22010, 중구,'070005, 69세,2019,804,350,454,77.1,800,349,451,77.4
'22010, 중구,'075,70~74세,2019,3728,1567,2161,72.5,3715,1559,2156,72.3
'22010, 중구,'075001, 70세,2019,828,342,486,70.4,824,340,484,70.2
'22010, 중구,'075002, 71세,2019,875,382,493,77.5,870,379,491,77.2
'22010, 중구,'075003, 72세,2019,799,330,469,70.4,799,330,469,70.4
'22010, 중구,'075004, 73세,2019,612,254,358,70.9,609,252,357,70.6
'22010, 중구,'075005, 74세,2019,614,259,355,73,613,258,355,72.7
'22010, 중구,'080,75~79세,2019,3373,1437,1936,74.2,3362,1434,1928,74.4
'22010, 중구,'080001, 75세,2019,746,302,444,68,741,299,442,67.6
'22010, 중구,'080002, 76세,2019,723,328,395,83,721,328,393,83.5
'22010, 중구,'080003, 77세,2019,775,350,425,82.4,773,350,423,82.7
'22010, 중구,'080004, 78세,2019,566,229,337,68,564,229,335,68.4
'22010, 중구,'080005, 79세,2019,563,228,335,68.1,563,228,335,68.1
'22010, 중구,'085,80~84세,2019,2084,806,1278,63.1,2076,806,1270,63.5
'22010, 중구,'085001, 80세,2019,525,204,321,63.6,525,204,321,63.6
'22010, 중구,'085002, 81세,2019,480,180,300,60,476,180,296,60.8
'22010, 중구,'085003, 82세,2019,401,152,249,61,400,152,248,61.3
'22010, 중구,'085004, 83세,2019,373,149,224,66.5,371,149,222,67.1
'22010, 중구,'085005, 84세,2019,305,121,184,65.8,304,121,183,66.1
'22010, 중구,'086,85세이상,2019,1304,367,937,39.2,1294,362,932,38.8
'22010, 중구,'090,85~89세,2019,923,273,650,42,915,269,646,41.6
'22010, 중구,'090001, 85세,2019,272,90,182,49.5,269,89,180,49.4
'22010, 중구,'090002, 86세,2019,218,64,154,41.6,215,62,153,40.5
'22010, 중구,'090003, 87세,2019,188,61,127,48,188,61,127,48
'22010, 중구,'090004, 88세,2019,139,38,101,37.6,138,38,100,38
'22010, 중구,'090005, 89세,2019,106,20,86,23.3,105,19,86,22.1
'22010, 중구,'095,90~94세,2019,300,77,223,34.5,299,76,223,34.1
'22010, 중구,'095001, 90세,2019,88,25,63,39.7,88,25,63,39.7
'22010, 중구,'095002, 91세,2019,87,27,60,45,87,27,60,45
'22010, 중구,'095003, 92세,2019,61,12,49,24.5,61,12,49,24.5
'22010, 중구,'095004, 93세,2019,32,7,25,28,31,6,25,24
'22010, 중구,'095005, 94세,2019,32,6,26,23.1,32,6,26,23.1
'22010, 중구,'100,95~99세,2019,74,17,57,29.8,73,17,56,30.4
'22010, 중구,'100001, 95세,2019,23,8,15,53.3,23,8,15,53.3
'22010, 중구,'100002, 96세,2019,15,X,12,25,15,X,12,25
'22010, 중구,'100003, 97세,2019,16,X,15,6.7,15,X,14,7.1
'22010, 중구,'100004, 98세,2019,8,X,8,0,8,X,8,0
'22010, 중구,'100005, 99세,2019,12,5,7,71.4,12,5,7,71.4
'22010, 중구,'101,100세이상,2019,7,X,7,0,7,X,7,0
'22010, 중구,'102,15세미만,2019,7719,3993,3726,107.2,7671,3964,3707,106.9
'22010, 중구,'103,15~64세,2019,53098,26364,26734,98.6,52321,25972,26349,98.6
'22010, 중구,'104,65세이상,2019,14744,6056,8688,69.7,14670,6028,8642,69.8
'22010, 중구,'126,평균연령,2019,44.2,42.8,45.6,,44.3,42.9,45.6,
'22010, 중구,'127,중위연령,2019,44.4,42.6,46.1,,44.5,42.7,46.2,
'22020, 동구,'000,합계,2019,337439,165927,171512,96.7,334898,165031,169867,97.2
'22020, 동구,'005,0~4세,2019,12692,6456,6236,103.5,12618,6415,6203,103.4
'22020, 동구,'005001, 0세,2019,2027,1024,1003,102.1,2019,1019,1000,101.9
'22020, 동구,'005002, 1세,2019,2319,1175,1144,102.7,2305,1164,1141,102
'22020, 동구,'005003, 2세,2019,2539,1334,1205,110.7,2526,1326,1200,110.5
'22020, 동구,'005004, 3세,2019,2798,1368,1430,95.7,2777,1362,1415,96.3
'22020, 동구,'005005, 4세,2019,3009,1555,1454,106.9,2991,1544,1447,106.7
'22020, 동구,'010,5~9세,2019,14381,7425,6956,106.7,14335,7406,6929,106.9
'22020, 동구,'010001, 5세,2019,2906,1476,1430,103.2,2895,1470,1425,103.2
'22020, 동구,'010002, 6세,2019,2814,1427,1387,102.9,2802,1424,1378,103.3
'22020, 동구,'010003, 7세,2019,3042,1563,1479,105.7,3034,1559,1475,105.7
'22020, 동구,'010004, 8세,2019,2832,1490,1342,111,2822,1488,1334,111.5
'22020, 동구,'010005, 9세,2019,2787,1469,1318,111.5,2782,1465,1317,111.2
'22020, 동구,'015,10~14세,2019,12629,6611,6018,109.9,12597,6595,6002,109.9
'22020, 동구,'015001, 10세,2019,2626,1385,1241,111.6,2616,1380,1236,111.7
'22020, 동구,'015002, 11세,2019,2664,1337,1327,100.8,2656,1333,1323,100.8
'22020, 동구,'015003, 12세,2019,2615,1357,1258,107.9,2610,1354,1256,107.8
'22020, 동구,'015004, 13세,2019,2317,1236,1081,114.3,2313,1234,1079,114.4
'22020, 동구,'015005, 14세,2019,2407,1296,1111,116.7,2402,1294,1108,116.8
'22020, 동구,'020,15~19세,2019,13973,7480,6493,115.2,13927,7462,6465,115.4
'22020, 동구,'020001, 15세,2019,2516,1309,1207,108.5,2507,1305,1202,108.6
'22020, 동구,'020002, 16세,2019,2525,1314,1211,108.5,2519,1310,1209,108.4
'22020, 동구,'020003, 17세,2019,2704,1468,1236,118.8,2695,1462,1233,118.6
'22020, 동구,'020004, 18세,2019,2983,1575,1408,111.9,2976,1575,1401,112.4
'22020, 동구,'020005, 19세,2019,3245,1814,1431,126.8,3230,1810,1420,127.5
'22020, 동구,'025,20~24세,2019,18967,10125,8842,114.5,18716,10062,8654,116.3
'22020, 동구,'025001, 20세,2019,3271,1823,1448,125.9,3234,1812,1422,127.4
'22020, 동구,'025002, 21세,2019,3558,2001,1557,128.5,3517,1990,1527,130.3
'22020, 동구,'025003, 22세,2019,3855,1994,1861,107.1,3808,1980,1828,108.3
'22020, 동구,'025004, 23세,2019,4053,2095,1958,107,3986,2080,1906,109.1
'22020, 동구,'025005, 24세,2019,4230,2212,2018,109.6,4171,2200,1971,111.6
'22020, 동구,'030,25~29세,2019,21550,11636,9914,117.4,21186,11538,9648,119.6
'22020, 동구,'030001, 25세,2019,4308,2316,1992,116.3,4235,2298,1937,118.6
'22020, 동구,'030002, 26세,2019,4340,2339,2001,116.9,4273,2323,1950,119.1
'22020, 동구,'030003, 27세,2019,4458,2377,2081,114.2,4386,2360,2026,116.5
'22020, 동구,'030004, 28세,2019,4300,2320,1980,117.2,4222,2291,1931,118.6
'22020, 동구,'030005, 29세,2019,4144,2284,1860,122.8,4070,2266,1804,125.6
'22020, 동구,'035,30~34세,2019,20371,10696,9675,110.6,19968,10576,9392,112.6
'22020, 동구,'035001, 30세,2019,4169,2222,1947,114.1,4089,2197,1892,116.1
'22020, 동구,'035002, 31세,2019,3902,2043,1859,109.9,3812,2018,1794,112.5
'22020, 동구,'035003, 32세,2019,4185,2189,1996,109.7,4108,2164,1944,111.3
'22020, 동구,'035004, 33세,2019,4031,2131,1900,112.2,3950,2108,1842,114.4
'22020, 동구,'035005, 34세,2019,4084,2111,1973,107,4009,2089,1920,108.8
'22020, 동구,'040,35~39세,2019,25517,12991,12526,103.7,25220,12898,12322,104.7
'22020, 동구,'040001, 35세,2019,4272,2230,2042,109.2,4218,2215,2003,110.6
'22020, 동구,'040002, 36세,2019,4804,2453,2351,104.3,4741,2438,2303,105.9
'22020, 동구,'040003, 37세,2019,5408,2725,2683,101.6,5337,2704,2633,102.7
'22020, 동구,'040004, 38세,2019,5474,2773,2701,102.7,5415,2748,2667,103
'22020, 동구,'040005, 39세,2019,5559,2810,2749,102.2,5509,2793,2716,102.8
'22020, 동구,'045,40~44세,2019,24218,12624,11594,108.9,23976,12523,11453,109.3
'22020, 동구,'045001, 40세,2019,5106,2602,2504,103.9,5052,2582,2470,104.5
'22020, 동구,'045002, 41세,2019,4679,2455,2224,110.4,4624,2434,2190,111.1
'22020, 동구,'045003, 42세,2019,4809,2464,2345,105.1,4760,2444,2316,105.5
'22020, 동구,'045004, 43세,2019,4693,2491,2202,113.1,4652,2472,2180,113.4
'22020, 동구,'045005, 44세,2019,4931,2612,2319,112.6,4888,2591,2297,112.8
'22020, 동구,'050,45~49세,2019,26662,13551,13111,103.4,26453,13472,12981,103.8
'22020, 동구,'050001, 45세,2019,5185,2663,2522,105.6,5138,2649,2489,106.4
'22020, 동구,'050002, 46세,2019,5251,2655,2596,102.3,5220,2643,2577,102.6
'22020, 동구,'050003, 47세,2019,5237,2683,2554,105.1,5202,2669,2533,105.4
'22020, 동구,'050004, 48세,2019,5529,2853,2676,106.6,5484,2834,2650,106.9
'22020, 동구,'050005, 49세,2019,5460,2697,2763,97.6,5409,2677,2732,98
'22020, 동구,'055,50~54세,2019,27336,13217,14119,93.6,27137,13129,14008,93.7
'22020, 동구,'055001, 50세,2019,5519,2659,2860,93,5472,2637,2835,93
'22020, 동구,'055002, 51세,2019,5695,2771,2924,94.8,5657,2758,2899,95.1
'22020, 동구,'055003, 52세,2019,5340,2536,2804,90.4,5308,2521,2787,90.5
'22020, 동구,'055004, 53세,2019,5304,2628,2676,98.2,5259,2606,2653,98.2
'22020, 동구,'055005, 54세,2019,5478,2623,2855,91.9,5441,2607,2834,92
'22020, 동구,'060,55~59세,2019,29378,13924,15454,90.1,29210,13863,15347,90.3
'22020, 동구,'060001, 55세,2019,5228,2524,2704,93.3,5189,2515,2674,94.1
'22020, 동구,'060002, 56세,2019,5583,2687,2896,92.8,5533,2668,2865,93.1
'22020, 동구,'060003, 57세,2019,5818,2803,3015,93,5791,2791,3000,93
'22020, 동구,'060004, 58세,2019,6405,2997,3408,87.9,6384,2988,3396,88
'22020, 동구,'060005, 59세,2019,6344,2913,3431,84.9,6313,2901,3412,85
'22020, 동구,'065,60~64세,2019,27247,12772,14475,88.2,27140,12722,14418,88.2
'22020, 동구,'065001, 60세,2019,5848,2719,3129,86.9,5824,2710,3114,87
'22020, 동구,'065002, 61세,2019,5266,2536,2730,92.9,5237,2522,2715,92.9
'22020, 동구,'065003, 62세,2019,5501,2605,2896,90,5485,2597,2888,89.9
'22020, 동구,'065004, 63세,2019,5231,2453,2778,88.3,5211,2443,2768,88.3
'22020, 동구,'065005, 64세,2019,5401,2459,2942,83.6,5383,2450,2933,83.5
'22020, 동구,'070,65~69세,2019,20546,9489,11057,85.8,20494,9461,11033,85.8
'22020, 동구,'070001, 65세,2019,4477,2066,2411,85.7,4462,2057,2405,85.5
'22020, 동구,'070002, 66세,2019,4267,1937,2330,83.1,4255,1930,2325,83
'22020, 동구,'070003, 67세,2019,4578,2135,2443,87.4,4567,2130,2437,87.4
'22020, 동구,'070004, 68세,2019,3606,1656,1950,84.9,3598,1652,1946,84.9
'22020, 동구,'070005, 69세,2019,3618,1695,1923,88.1,3612,1692,1920,88.1
'22020, 동구,'075,70~74세,2019,15682,7014,8668,80.9,15653,7000,8653,80.9
'22020, 동구,'075001, 70세,2019,3981,1798,2183,82.4,3972,1794,2178,82.4
'22020, 동구,'075002, 71세,2019,3616,1645,1971,83.5,3614,1644,1970,83.5
'22020, 동구,'075003, 72세,2019,3366,1502,1864,80.6,3359,1500,1859,80.7
'22020, 동구,'075004, 73세,2019,2298,1041,1257,82.8,2290,1036,1254,82.6
'22020, 동구,'075005, 74세,2019,2421,1028,1393,73.8,2418,1026,1392,73.7
'22020, 동구,'080,75~79세,2019,13153,5498,7655,71.8,13143,5495,7648,71.8
'22020, 동구,'080001, 75세,2019,2706,1152,1554,74.1,2701,1151,1550,74.3
'22020, 동구,'080002, 76세,2019,2821,1220,1601,76.2,2821,1220,1601,76.2
'22020, 동구,'080003, 77세,2019,2960,1225,1735,70.6,2960,1225,1735,70.6
'22020, 동구,'080004, 78세,2019,2467,1024,1443,71,2464,1023,1441,71
'22020, 동구,'080005, 79세,2019,2199,877,1322,66.3,2197,876,1321,66.3
'22020, 동구,'085,80~84세,2019,8237,3070,5167,59.4,8229,3068,5161,59.4
'22020, 동구,'085001, 80세,2019,2123,860,1263,68.1,2121,860,1261,68.2
'22020, 동구,'085002, 81세,2019,1758,632,1126,56.1,1757,632,1125,56.2
'22020, 동구,'085003, 82세,2019,1630,611,1019,60,1629,610,1019,59.9
'22020, 동구,'085004, 83세,2019,1448,520,928,56,1446,519,927,56
'22020, 동구,'085005, 84세,2019,1278,447,831,53.8,1276,447,829,53.9
'22020, 동구,'086,85세이상,2019,4900,1348,3552,38,4896,1346,3550,37.9
'22020, 동구,'090,85~89세,2019,3560,1068,2492,42.9,3558,1067,2491,42.8
'22020, 동구,'090001, 85세,2019,1077,343,734,46.7,1076,342,734,46.6
'22020, 동구,'090002, 86세,2019,826,249,577,43.2,825,249,576,43.2
'22020, 동구,'090003, 87세,2019,730,225,505,44.6,730,225,505,44.6
'22020, 동구,'090004, 88세,2019,523,146,377,38.7,523,146,377,38.7
'22020, 동구,'090005, 89세,2019,404,105,299,35.1,404,105,299,35.1
'22020, 동구,'095,90~94세,2019,1087,232,855,27.1,1086,231,855,27
'22020, 동구,'095001, 90세,2019,307,75,232,32.3,307,75,232,32.3
'22020, 동구,'095002, 91세,2019,289,71,218,32.6,288,70,218,32.1
'22020, 동구,'095003, 92세,2019,226,42,184,22.8,226,42,184,22.8
'22020, 동구,'095004, 93세,2019,128,18,110,16.4,128,18,110,16.4
'22020, 동구,'095005, 94세,2019,137,26,111,23.4,137,26,111,23.4
'22020, 동구,'100,95~99세,2019,221,42,179,23.5,220,42,178,23.6
'22020, 동구,'100001, 95세,2019,71,12,59,20.3,71,12,59,20.3
'22020, 동구,'100002, 96세,2019,57,12,45,26.7,57,12,45,26.7
'22020, 동구,'100003, 97세,2019,48,9,39,23.1,48,9,39,23.1
'22020, 동구,'100004, 98세,2019,28,7,21,33.3,28,7,21,33.3
'22020, 동구,'100005, 99세,2019,17,X,15,13.3,16,X,14,14.3
'22020, 동구,'101,100세이상,2019,32,6,26,23.1,32,6,26,23.1
'22020, 동구,'102,15세미만,2019,39702,20492,19210,106.7,39550,20416,19134,106.7
'22020, 동구,'103,15~64세,2019,235219,119016,116203,102.4,232933,118245,114688,103.1
'22020, 동구,'104,65세이상,2019,62518,26419,36099,73.2,62415,26370,36045,73.2
'22020, 동구,'126,평균연령,2019,44.3,42.7,45.9,,44.4,42.7,46,
'22020, 동구,'127,중위연령,2019,45.9,43.8,47.9,,46,43.9,48.1,
'22030, 서구,'000,합계,2019,175243,87869,87374,100.6,171891,86010,85881,100.2
'22030, 서구,'005,0~4세,2019,3732,1938,1794,108,3682,1917,1765,108.6
'22030, 서구,'005001, 0세,2019,529,294,235,125.1,522,292,230,127
'22030, 서구,'005002, 1세,2019,663,323,340,95,647,312,335,93.1
'22030, 서구,'005003, 2세,2019,767,396,371,106.7,761,396,365,108.5
'22030, 서구,'005004, 3세,2019,892,469,423,110.9,884,464,420,110.5
'22030, 서구,'005005, 4세,2019,881,456,425,107.3,868,453,415,109.2
'22030, 서구,'010,5~9세,2019,4607,2305,2302,100.1,4575,2286,2289,99.9
'22030, 서구,'010001, 5세,2019,871,438,433,101.2,863,434,429,101.2
'22030, 서구,'010002, 6세,2019,893,439,454,96.7,888,435,453,96
'22030, 서구,'010003, 7세,2019,1002,501,501,100,996,498,498,100
'22030, 서구,'010004, 8세,2019,963,493,470,104.9,956,488,468,104.3
'22030, 서구,'010005, 9세,2019,878,434,444,97.7,872,431,441,97.7
'22030, 서구,'015,10~14세,2019,4818,2478,2340,105.9,4796,2465,2331,105.7
'22030, 서구,'015001, 10세,2019,914,465,449,103.6,911,464,447,103.8
'22030, 서구,'015002, 11세,2019,943,486,457,106.3,935,482,453,106.4
'22030, 서구,'015003, 12세,2019,1010,508,502,101.2,1006,505,501,100.8
'22030, 서구,'015004, 13세,2019,959,494,465,106.2,955,491,464,105.8
'22030, 서구,'015005, 14세,2019,992,525,467,112.4,989,523,466,112.2
'22030, 서구,'020,15~19세,2019,7384,4080,3304,123.5,7342,4056,3286,123.4
'22030, 서구,'020001, 15세,2019,1149,649,500,129.8,1148,648,500,129.6
'22030, 서구,'020002, 16세,2019,1417,761,656,116,1415,761,654,116.4
'22030, 서구,'020003, 17세,2019,1404,775,629,123.2,1401,775,626,123.8
'22030, 서구,'020004, 18세,2019,1685,925,760,121.7,1674,917,757,121.1
'22030, 서구,'020005, 19세,2019,1729,970,759,127.8,1704,955,749,127.5
'22030, 서구,'025,20~24세,2019,10877,6016,4861,123.8,10561,5840,4721,123.7
'22030, 서구,'025001, 20세,2019,1729,943,786,120,1690,922,768,120.1
'22030, 서구,'025002, 21세,2019,2008,1150,858,134,1959,1123,836,134.3
'22030, 서구,'025003, 22세,2019,2259,1239,1020,121.5,2191,1198,993,120.6
'22030, 서구,'025004, 23세,2019,2375,1301,1074,121.1,2297,1257,1040,120.9
'22030, 서구,'025005, 24세,2019,2506,1383,1123,123.2,2424,1340,1084,123.6
'22030, 서구,'030,25~29세,2019,12135,6812,5323,128,11632,6540,5092,128.4
'22030, 서구,'030001, 25세,2019,2479,1374,1105,124.3,2394,1330,1064,125
'22030, 서구,'030002, 26세,2019,2554,1463,1091,134.1,2457,1402,1055,132.9
'22030, 서구,'030003, 27세,2019,2612,1469,1143,128.5,2514,1420,1094,129.8
'22030, 서구,'030004, 28세,2019,2350,1274,1076,118.4,2247,1216,1031,117.9
'22030, 서구,'030005, 29세,2019,2140,1232,908,135.7,2020,1172,848,138.2
'22030, 서구,'035,30~34세,2019,9109,5304,3805,139.4,8494,4972,3522,141.2
'22030, 서구,'035001, 30세,2019,1995,1164,831,140.1,1877,1100,777,141.6
'22030, 서구,'035002, 31세,2019,1785,1078,707,152.5,1672,1023,649,157.6
'22030, 서구,'035003, 32세,2019,1812,1065,747,142.6,1659,973,686,141.8
'22030, 서구,'035004, 33세,2019,1826,1035,791,130.8,1703,968,735,131.7
'22030, 서구,'035005, 34세,2019,1691,962,729,132,1583,908,675,134.5
'22030, 서구,'040,35~39세,2019,10259,5623,4636,121.3,9806,5357,4449,120.4
'22030, 서구,'040001, 35세,2019,1728,969,759,127.7,1633,908,725,125.2
'22030, 서구,'040002, 36세,2019,2002,1092,910,120,1900,1039,861,120.7
'22030, 서구,'040003, 37세,2019,2129,1146,983,116.6,2052,1099,953,115.3
'22030, 서구,'040004, 38세,2019,2140,1213,927,130.9,2048,1160,888,130.6
'22030, 서구,'040005, 39세,2019,2260,1203,1057,113.8,2173,1151,1022,112.6
'22030, 서구,'045,40~44세,2019,10336,5619,4717,119.1,9969,5410,4559,118.7
'22030, 서구,'045001, 40세,2019,2104,1153,951,121.2,2006,1096,910,120.4
'22030, 서구,'045002, 41세,2019,1902,1013,889,113.9,1825,971,854,113.7
'22030, 서구,'045003, 42세,2019,2037,1138,899,126.6,1969,1099,870,126.3
'22030, 서구,'045004, 43세,2019,2009,1094,915,119.6,1945,1052,893,117.8
'22030, 서구,'045005, 44세,2019,2284,1221,1063,114.9,2224,1192,1032,115.5
'22030, 서구,'050,45~49세,2019,13657,7141,6516,109.6,13336,6954,6382,109
'22030, 서구,'050001, 45세,2019,2494,1373,1121,122.5,2432,1340,1092,122.7
'22030, 서구,'050002, 46세,2019,2631,1388,1243,111.7,2581,1361,1220,111.6
'22030, 서구,'050003, 47세,2019,2625,1367,1258,108.7,2553,1319,1234,106.9
'22030, 서구,'050004, 48세,2019,2927,1495,1432,104.4,2859,1461,1398,104.5
'22030, 서구,'050005, 49세,2019,2980,1518,1462,103.8,2911,1473,1438,102.4
'22030, 서구,'055,50~54세,2019,16503,8239,8264,99.7,16270,8100,8170,99.1
'22030, 서구,'055001, 50세,2019,3137,1555,1582,98.3,3080,1519,1561,97.3
'22030, 서구,'055002, 51세,2019,3332,1683,1649,102.1,3287,1656,1631,101.5
'22030, 서구,'055003, 52세,2019,3164,1579,1585,99.6,3124,1560,1564,99.7
'22030, 서구,'055004, 53세,2019,3352,1678,1674,100.2,3315,1655,1660,99.7
'22030, 서구,'055005, 54세,2019,3518,1744,1774,98.3,3464,1710,1754,97.5
'22030, 서구,'060,55~59세,2019,18636,9145,9491,96.4,18442,9043,9399,96.2
'22030, 서구,'060001, 55세,2019,3348,1673,1675,99.9,3304,1649,1655,99.6
'22030, 서구,'060002, 56세,2019,3432,1735,1697,102.2,3380,1708,1672,102.2
'22030, 서구,'060003, 57세,2019,3797,1862,1935,96.2,3751,1840,1911,96.3
'22030, 서구,'060004, 58세,2019,4107,1981,2126,93.2,4086,1968,2118,92.9
'22030, 서구,'060005, 59세,2019,3952,1894,2058,92,3921,1878,2043,91.9
'22030, 서구,'065,60~64세,2019,16468,7800,8668,90,16372,7752,8620,89.9
'22030, 서구,'065001, 60세,2019,3701,1746,1955,89.3,3676,1736,1940,89.5
'22030, 서구,'065002, 61세,2019,3091,1504,1587,94.8,3070,1495,1575,94.9
'22030, 서구,'065003, 62세,2019,3350,1641,1709,96,3332,1630,1702,95.8
'22030, 서구,'065004, 63세,2019,3136,1478,1658,89.1,3118,1469,1649,89.1
'22030, 서구,'065005, 64세,2019,3190,1431,1759,81.4,3176,1422,1754,81.1
'22030, 서구,'070,65~69세,2019,12622,5858,6764,86.6,12557,5828,6729,86.6
'22030, 서구,'070001, 65세,2019,2752,1304,1448,90.1,2736,1293,1443,89.6
'22030, 서구,'070002, 66세,2019,2689,1249,1440,86.7,2673,1240,1433,86.5
'22030, 서구,'070003, 67세,2019,2956,1311,1645,79.7,2942,1307,1635,79.9
'22030, 서구,'070004, 68세,2019,2134,972,1162,83.6,2123,970,1153,84.1
'22030, 서구,'070005, 69세,2019,2091,1022,1069,95.6,2083,1018,1065,95.6
'22030, 서구,'075,70~74세,2019,9116,4087,5029,81.3,9097,4079,5018,81.3
'22030, 서구,'075001, 70세,2019,2316,1073,1243,86.3,2311,1070,1241,86.2
'22030, 서구,'075002, 71세,2019,2164,967,1197,80.8,2160,966,1194,80.9
'22030, 서구,'075003, 72세,2019,1988,870,1118,77.8,1985,867,1118,77.5
'22030, 서구,'075004, 73세,2019,1302,564,738,76.4,1299,563,736,76.5
'22030, 서구,'075005, 74세,2019,1346,613,733,83.6,1342,613,729,84.1
'22030, 서구,'080,75~79세,2019,7574,3120,4454,70,7561,3112,4449,69.9
'22030, 서구,'080001, 75세,2019,1609,659,950,69.4,1606,657,949,69.2
'22030, 서구,'080002, 76세,2019,1649,724,925,78.3,1648,724,924,78.4
'22030, 서구,'080003, 77세,2019,1736,714,1022,69.9,1735,713,1022,69.8
'22030, 서구,'080004, 78세,2019,1391,575,816,70.5,1386,571,815,70.1
'22030, 서구,'080005, 79세,2019,1189,448,741,60.5,1186,447,739,60.5
'22030, 서구,'085,80~84세,2019,4626,1659,2967,55.9,4625,1659,2966,55.9
'22030, 서구,'085001, 80세,2019,1237,476,761,62.5,1237,476,761,62.5
'22030, 서구,'085002, 81세,2019,1000,366,634,57.7,999,366,633,57.8
'22030, 서구,'085003, 82세,2019,911,312,599,52.1,911,312,599,52.1
'22030, 서구,'085004, 83세,2019,802,291,511,56.9,802,291,511,56.9
'22030, 서구,'085005, 84세,2019,676,214,462,46.3,676,214,462,46.3
'22030, 서구,'086,85세이상,2019,2784,645,2139,30.2,2774,640,2134,30
'22030, 서구,'090,85~89세,2019,1976,516,1460,35.3,1970,512,1458,35.1
'22030, 서구,'090001, 85세,2019,588,191,397,48.1,588,191,397,48.1
'22030, 서구,'090002, 86세,2019,451,123,328,37.5,448,122,326,37.4
'22030, 서구,'090003, 87세,2019,398,100,298,33.6,396,98,298,32.9
'22030, 서구,'090004, 88세,2019,289,60,229,26.2,289,60,229,26.2
'22030, 서구,'090005, 89세,2019,250,42,208,20.2,249,41,208,19.7
'22030, 서구,'095,90~94세,2019,647,111,536,20.7,645,110,535,20.6
'22030, 서구,'095001, 90세,2019,201,36,165,21.8,201,36,165,21.8
'22030, 서구,'095002, 91세,2019,169,32,137,23.4,168,31,137,22.6
'22030, 서구,'095003, 92세,2019,136,23,113,20.4,136,23,113,20.4
'22030, 서구,'095004, 93세,2019,81,12,69,17.4,80,12,68,17.6
'22030, 서구,'095005, 94세,2019,60,8,52,15.4,60,8,52,15.4
'22030, 서구,'100,95~99세,2019,144,17,127,13.4,144,17,127,13.4
'22030, 서구,'100001, 95세,2019,49,5,44,11.4,49,5,44,11.4
'22030, 서구,'100002, 96세,2019,45,7,38,18.4,45,7,38,18.4
'22030, 서구,'100003, 97세,2019,21,X,20,5,21,X,20,5
'22030, 서구,'100004, 98세,2019,19,X,15,26.7,19,X,15,26.7
'22030, 서구,'100005, 99세,2019,10,X,10,0,10,X,10,0
'22030, 서구,'101,100세이상,2019,17,X,16,6.3,15,X,14,7.1
'22030, 서구,'102,15세미만,2019,13157,6721,6436,104.4,13053,6668,6385,104.4
'22030, 서구,'103,15~64세,2019,125364,65779,59585,110.4,122224,64024,58200,110
'22030, 서구,'104,65세이상,2019,36722,15369,21353,72,36614,15318,21296,71.9
'22030, 서구,'126,평균연령,2019,47.2,45.3,49.2,,47.4,45.5,49.4,
'22030, 서구,'127,중위연령,2019,50.2,47.7,52.5,,50.6,48.1,52.9,
'22040, 남구,'000,합계,2019,147500,70522,76978,91.6,145655,69762,75893,91.9
'22040, 남구,'005,0~4세,2019,3249,1688,1561,108.1,3214,1674,1540,108.7
'22040, 남구,'005001, 0세,2019,564,325,239,136,559,325,234,138.9
'22040, 남구,'005002, 1세,2019,604,304,300,101.3,595,299,296,101
'22040, 남구,'005003, 2세,2019,619,318,301,105.6,611,313,298,105
'22040, 남구,'005004, 3세,2019,735,363,372,97.6,727,359,368,97.6
'22040, 남구,'005005, 4세,2019,727,378,349,108.3,722,378,344,109.9
'22040, 남구,'010,5~9세,2019,3848,2001,1847,108.3,3827,1992,1835,108.6
'22040, 남구,'010001, 5세,2019,746,383,363,105.5,744,382,362,105.5
'22040, 남구,'010002, 6세,2019,785,404,381,106,780,401,379,105.8
'22040, 남구,'010003, 7세,2019,791,409,382,107.1,789,409,380,107.6
'22040, 남구,'010004, 8세,2019,776,412,364,113.2,771,409,362,113
'22040, 남구,'010005, 9세,2019,750,393,357,110.1,743,391,352,111.1
'22040, 남구,'015,10~14세,2019,4107,2173,1934,112.4,4090,2164,1926,112.4
'22040, 남구,'015001, 10세,2019,745,374,371,100.8,741,371,370,100.3
'22040, 남구,'015002, 11세,2019,810,444,366,121.3,808,443,365,121.4
'22040, 남구,'015003, 12세,2019,873,455,418,108.9,869,452,417,108.4
'22040, 남구,'015004, 13세,2019,841,456,385,118.4,838,455,383,118.8
'22040, 남구,'015005, 14세,2019,838,444,394,112.7,834,443,391,113.3
'22040, 남구,'020,15~19세,2019,6361,3070,3291,93.3,6215,2992,3223,92.8
'22040, 남구,'020001, 15세,2019,974,484,490,98.8,970,482,488,98.8
'22040, 남구,'020002, 16세,2019,1057,525,532,98.7,1055,525,530,99.1
'22040, 남구,'020003, 17세,2019,1097,527,570,92.5,1090,524,566,92.6
'22040, 남구,'020004, 18세,2019,1408,666,742,89.8,1377,649,728,89.1
'22040, 남구,'020005, 19세,2019,1825,868,957,90.7,1723,812,911,89.1
'22040, 남구,'025,20~24세,2019,10610,5251,5359,98,10215,5073,5142,98.7
'22040, 남구,'025001, 20세,2019,1877,920,957,96.1,1714,844,870,97
'22040, 남구,'025002, 21세,2019,2012,975,1037,94,1931,932,999,93.3
'22040, 남구,'025003, 22세,2019,2210,1081,1129,95.7,2155,1061,1094,97
'22040, 남구,'025004, 23세,2019,2256,1147,1109,103.4,2215,1133,1082,104.7
'22040, 남구,'025005, 24세,2019,2255,1128,1127,100.1,2200,1103,1097,100.5
'22040, 남구,'030,25~29세,2019,10595,5485,5110,107.3,10372,5416,4956,109.3
'22040, 남구,'030001, 25세,2019,2208,1145,1063,107.7,2171,1130,1041,108.5
'22040, 남구,'030002, 26세,2019,2188,1121,1067,105.1,2140,1102,1038,106.2
'22040, 남구,'030003, 27세,2019,2271,1187,1084,109.5,2228,1178,1050,112.2
'22040, 남구,'030004, 28세,2019,2029,1052,977,107.7,1984,1044,940,111.1
'22040, 남구,'030005, 29세,2019,1899,980,919,106.6,1849,962,887,108.5
'22040, 남구,'035,30~34세,2019,8284,4438,3846,115.4,8060,4364,3696,118.1
'22040, 남구,'035001, 30세,2019,1794,987,807,122.3,1740,972,768,126.6
'22040, 남구,'035002, 31세,2019,1637,856,781,109.6,1586,837,749,111.7
'22040, 남구,'035003, 32세,2019,1592,864,728,118.7,1561,854,707,120.8
'22040, 남구,'035004, 33세,2019,1615,868,747,116.2,1577,855,722,118.4
'22040, 남구,'035005, 34세,2019,1646,863,783,110.2,1596,846,750,112.8
'22040, 남구,'040,35~39세,2019,9259,4660,4599,101.3,9085,4609,4476,103
'22040, 남구,'040001, 35세,2019,1635,805,830,97,1590,793,797,99.5
'22040, 남구,'040002, 36세,2019,1787,927,860,107.8,1749,913,836,109.2
'22040, 남구,'040003, 37세,2019,1955,946,1009,93.8,1926,937,989,94.7
'22040, 남구,'040004, 38세,2019,1908,956,952,100.4,1879,949,930,102
'22040, 남구,'040005, 39세,2019,1974,1026,948,108.2,1941,1017,924,110.1
'22040, 남구,'045,40~44세,2019,8925,4485,4440,101,8804,4433,4371,101.4
'22040, 남구,'045001, 40세,2019,1817,909,908,100.1,1797,900,897,100.3
'22040, 남구,'045002, 41세,2019,1721,869,852,102,1692,859,833,103.1
'22040, 남구,'045003, 42세,2019,1779,908,871,104.2,1757,899,858,104.8
'22040, 남구,'045004, 43세,2019,1738,880,858,102.6,1711,866,845,102.5
'22040, 남구,'045005, 44세,2019,1870,919,951,96.6,1847,909,938,96.9
'22040, 남구,'050,45~49세,2019,11417,5738,5679,101,11287,5674,5613,101.1
'22040, 남구,'050001, 45세,2019,2079,1063,1016,104.6,2049,1049,1000,104.9
'22040, 남구,'050002, 46세,2019,2223,1124,1099,102.3,2200,1112,1088,102.2
'22040, 남구,'050003, 47세,2019,2284,1150,1134,101.4,2254,1136,1118,101.6
'22040, 남구,'050004, 48세,2019,2417,1224,1193,102.6,2395,1213,1182,102.6
'22040, 남구,'050005, 49세,2019,2414,1177,1237,95.1,2389,1164,1225,95
'22040, 남구,'055,50~54세,2019,11864,5840,6024,96.9,11767,5792,5975,96.9
'22040, 남구,'055001, 50세,2019,2380,1203,1177,102.2,2363,1196,1167,102.5
'22040, 남구,'055002, 51세,2019,2515,1265,1250,101.2,2494,1251,1243,100.6
'22040, 남구,'055003, 52세,2019,2422,1152,1270,90.7,2402,1146,1256,91.2
'22040, 남구,'055004, 53세,2019,2214,1132,1082,104.6,2193,1120,1073,104.4
'22040, 남구,'055005, 54세,2019,2333,1088,1245,87.4,2315,1079,1236,87.3
'22040, 남구,'060,55~59세,2019,13134,6141,6993,87.8,13049,6106,6943,87.9
'22040, 남구,'060001, 55세,2019,2249,1006,1243,80.9,2231,1000,1231,81.2
'22040, 남구,'060002, 56세,2019,2479,1186,1293,91.7,2461,1177,1284,91.7
'22040, 남구,'060003, 57세,2019,2669,1294,1375,94.1,2654,1289,1365,94.4
'22040, 남구,'060004, 58세,2019,2894,1368,1526,89.6,2880,1363,1517,89.8
'22040, 남구,'060005, 59세,2019,2843,1287,1556,82.7,2823,1277,1546,82.6
'22040, 남구,'065,60~64세,2019,12954,6008,6946,86.5,12879,5973,6906,86.5
'22040, 남구,'065001, 60세,2019,2787,1256,1531,82,2774,1253,1521,82.4
'22040, 남구,'065002, 61세,2019,2467,1164,1303,89.3,2450,1155,1295,89.2
'22040, 남구,'065003, 62세,2019,2608,1228,1380,89,2595,1220,1375,88.7
'22040, 남구,'065004, 63세,2019,2438,1137,1301,87.4,2416,1127,1289,87.4
'22040, 남구,'065005, 64세,2019,2654,1223,1431,85.5,2644,1218,1426,85.4
'22040, 남구,'070,65~69세,2019,9982,4524,5458,82.9,9936,4502,5434,82.8
'22040, 남구,'070001, 65세,2019,2144,1003,1141,87.9,2129,998,1131,88.2
'22040, 남구,'070002, 66세,2019,2085,920,1165,79,2079,917,1162,78.9
'22040, 남구,'070003, 67세,2019,2256,1034,1222,84.6,2243,1027,1216,84.5
'22040, 남구,'070004, 68세,2019,1738,745,993,75,1729,739,990,74.6
'22040, 남구,'070005, 69세,2019,1759,822,937,87.7,1756,821,935,87.8
'22040, 남구,'075,70~74세,2019,7957,3460,4497,76.9,7933,3451,4482,77
'22040, 남구,'075001, 70세,2019,1926,855,1071,79.8,1917,850,1067,79.7
'22040, 남구,'075002, 71세,2019,1846,818,1028,79.6,1843,818,1025,79.8
'22040, 남구,'075003, 72세,2019,1758,762,996,76.5,1753,759,994,76.4
'22040, 남구,'075004, 73세,2019,1236,539,697,77.3,1232,539,693,77.8
'22040, 남구,'075005, 74세,2019,1191,486,705,68.9,1188,485,703,69
'22040, 남구,'080,75~79세,2019,7039,2928,4111,71.2,7023,2923,4100,71.3
'22040, 남구,'080001, 75세,2019,1354,583,771,75.6,1350,582,768,75.8
'22040, 남구,'080002, 76세,2019,1549,642,907,70.8,1547,641,906,70.8
'22040, 남구,'080003, 77세,2019,1569,686,883,77.7,1564,684,880,77.7
'22040, 남구,'080004, 78세,2019,1379,566,813,69.6,1377,566,811,69.8
'22040, 남구,'080005, 79세,2019,1188,451,737,61.2,1185,450,735,61.2
'22040, 남구,'085,80~84세,2019,4707,1731,2976,58.2,4699,1728,2971,58.2
'22040, 남구,'085001, 80세,2019,1181,484,697,69.4,1177,482,695,69.4
'22040, 남구,'085002, 81세,2019,999,367,632,58.1,998,367,631,58.2
'22040, 남구,'085003, 82세,2019,944,335,609,55,944,335,609,55
'22040, 남구,'085004, 83세,2019,815,287,528,54.4,813,286,527,54.3
'22040, 남구,'085005, 84세,2019,768,258,510,50.6,767,258,509,50.7
'22040, 남구,'086,85세이상,2019,3208,901,2307,39.1,3200,896,2304,38.9
'22040, 남구,'090,85~89세,2019,2292,701,1591,44.1,2286,696,1590,43.8
'22040, 남구,'090001, 85세,2019,639,228,411,55.5,636,225,411,54.7
'22040, 남구,'090002, 86세,2019,523,170,353,48.2,522,169,353,47.9
'22040, 남구,'090003, 87세,2019,456,141,315,44.8,456,141,315,44.8
'22040, 남구,'090004, 88세,2019,372,91,281,32.4,370,90,280,32.1
'22040, 남구,'090005, 89세,2019,302,71,231,30.7,302,71,231,30.7
'22040, 남구,'095,90~94세,2019,740,174,566,30.7,738,174,564,30.9
'22040, 남구,'095001, 90세,2019,238,58,180,32.2,238,58,180,32.2
'22040, 남구,'095002, 91세,2019,188,53,135,39.3,188,53,135,39.3
'22040, 남구,'095003, 92세,2019,148,33,115,28.7,148,33,115,28.7
'22040, 남구,'095004, 93세,2019,107,20,87,23,106,20,86,23.3
'22040, 남구,'095005, 94세,2019,59,10,49,20.4,58,10,48,20.8
'22040, 남구,'100,95~99세,2019,165,23,142,16.2,165,23,142,16.2
'22040, 남구,'100001, 95세,2019,58,7,51,13.7,58,7,51,13.7
'22040, 남구,'100002, 96세,2019,36,7,29,24.1,36,7,29,24.1
'22040, 남구,'100003, 97세,2019,32,5,27,18.5,32,5,27,18.5
'22040, 남구,'100004, 98세,2019,20,X,18,11.1,20,X,18,11.1
'22040, 남구,'100005, 99세,2019,19,X,17,11.8,19,X,17,11.8
'22040, 남구,'101,100세이상,2019,11,X,8,37.5,11,X,8,37.5
'22040, 남구,'102,15세미만,2019,11204,5862,5342,109.7,11131,5830,5301,110
'22040, 남구,'103,15~64세,2019,103403,51116,52287,97.8,101733,50432,51301,98.3
'22040, 남구,'104,65세이상,2019,32893,13544,19349,70,32791,13500,19291,70
'22040, 남구,'126,평균연령,2019,47,45.3,48.5,,47.1,45.4,48.7,
'22040, 남구,'127,중위연령,2019,48.8,46.8,50.7,,49,47,51,
'22050, 북구,'000,합계,2019,446050,222873,223177,99.9,439084,219367,219717,99.8
'22050, 북구,'005,0~4세,2019,16063,8260,7803,105.9,15938,8186,7752,105.6
'22050, 북구,'005001, 0세,2019,2520,1340,1180,113.6,2497,1328,1169,113.6
'22050, 북구,'005002, 1세,2019,2883,1453,1430,101.6,2856,1440,1416,101.7
'22050, 북구,'005003, 2세,2019,3217,1628,1589,102.5,3190,1613,1577,102.3
'22050, 북구,'005004, 3세,2019,3642,1874,1768,106,3620,1857,1763,105.3
'22050, 북구,'005005, 4세,2019,3801,1965,1836,107,3775,1948,1827,106.6
'22050, 북구,'010,5~9세,2019,19430,9971,9459,105.4,19367,9942,9425,105.5
'22050, 북구,'010001, 5세,2019,3728,1876,1852,101.3,3707,1866,1841,101.4
'22050, 북구,'010002, 6세,2019,3766,1924,1842,104.5,3757,1920,1837,104.5
'22050, 북구,'010003, 7세,2019,4112,2110,2002,105.4,4095,2101,1994,105.4
'22050, 북구,'010004, 8세,2019,4031,2089,1942,107.6,4020,2086,1934,107.9
'22050, 북구,'010005, 9세,2019,3793,1972,1821,108.3,3788,1969,1819,108.2
'22050, 북구,'015,10~14세,2019,19995,10311,9684,106.5,19964,10292,9672,106.4
'22050, 북구,'015001, 10세,2019,3715,1906,1809,105.4,3706,1901,1805,105.3
'22050, 북구,'015002, 11세,2019,4072,2124,1948,109,4069,2122,1947,109
'22050, 북구,'015003, 12세,2019,4255,2190,2065,106.1,4247,2182,2065,105.7
'22050, 북구,'015004, 13세,2019,3924,2024,1900,106.5,3921,2023,1898,106.6
'22050, 북구,'015005, 14세,2019,4029,2067,1962,105.4,4021,2064,1957,105.5
'22050, 북구,'020,15~19세,2019,26948,14039,12909,108.8,26529,13830,12699,108.9
'22050, 북구,'020001, 15세,2019,4381,2318,2063,112.4,4373,2315,2058,112.5
'22050, 북구,'020002, 16세,2019,4396,2290,2106,108.7,4389,2289,2100,109
'22050, 북구,'020003, 17세,2019,4534,2378,2156,110.3,4506,2366,2140,110.6
'22050, 북구,'020004, 18세,2019,5792,3010,2782,108.2,5655,2940,2715,108.3
'22050, 북구,'020005, 19세,2019,7845,4043,3802,106.3,7606,3920,3686,106.3
'22050, 북구,'025,20~24세,2019,37439,20010,17429,114.8,35961,19324,16637,116.2
'22050, 북구,'025001, 20세,2019,7181,3519,3662,96.1,6862,3375,3487,96.8
'22050, 북구,'025002, 21세,2019,7314,3678,3636,101.2,7025,3541,3484,101.6
'22050, 북구,'025003, 22세,2019,7881,4241,3640,116.5,7607,4121,3486,118.2
'22050, 북구,'025004, 23세,2019,7790,4421,3369,131.2,7487,4271,3216,132.8
'22050, 북구,'025005, 24세,2019,7273,4151,3122,133,6980,4016,2964,135.5
'22050, 북구,'030,25~29세,2019,30314,16903,13411,126,29078,16293,12785,127.4
'22050, 북구,'030001, 25세,2019,6885,3881,3004,129.2,6622,3763,2859,131.6
'22050, 북구,'030002, 26세,2019,6458,3678,2780,132.3,6183,3533,2650,133.3
'22050, 북구,'030003, 27세,2019,6068,3423,2645,129.4,5828,3303,2525,130.8
'22050, 북구,'030004, 28세,2019,5552,3018,2534,119.1,5336,2916,2420,120.5
'22050, 북구,'030005, 29세,2019,5351,2903,2448,118.6,5109,2778,2331,119.2
'22050, 북구,'035,30~34세,2019,25081,13447,11634,115.6,24005,12895,11110,116.1
'22050, 북구,'035001, 30세,2019,5120,2760,2360,116.9,4890,2651,2239,118.4
'22050, 북구,'035002, 31세,2019,4880,2665,2215,120.3,4674,2568,2106,121.9
'22050, 북구,'035003, 32세,2019,5062,2667,2395,111.4,4825,2537,2288,110.9
'22050, 북구,'035004, 33세,2019,5103,2701,2402,112.4,4896,2599,2297,113.1
'22050, 북구,'035005, 34세,2019,4916,2654,2262,117.3,4720,2540,2180,116.5
'22050, 북구,'040,35~39세,2019,31375,15885,15490,102.6,30645,15476,15169,102
'22050, 북구,'040001, 35세,2019,5389,2805,2584,108.6,5220,2703,2517,107.4
'22050, 북구,'040002, 36세,2019,5921,2996,2925,102.4,5773,2923,2850,102.6
'22050, 북구,'040003, 37세,2019,6485,3300,3185,103.6,6333,3209,3124,102.7
'22050, 북구,'040004, 38세,2019,6692,3335,3357,99.3,6553,3261,3292,99.1
'22050, 북구,'040005, 39세,2019,6888,3449,3439,100.3,6766,3380,3386,99.8
'22050, 북구,'045,40~44세,2019,32834,16183,16651,97.2,32326,15906,16420,96.9
'22050, 북구,'045001, 40세,2019,6505,3230,3275,98.6,6381,3160,3221,98.1
'22050, 북구,'045002, 41세,2019,6083,3019,3064,98.5,5988,2965,3023,98.1
'22050, 북구,'045003, 42세,2019,6497,3200,3297,97.1,6401,3154,3247,97.1
'22050, 북구,'045004, 43세,2019,6549,3250,3299,98.5,6450,3189,3261,97.8
'22050, 북구,'045005, 44세,2019,7200,3484,3716,93.8,7106,3438,3668,93.7
'22050, 북구,'050,45~49세,2019,41069,20091,20978,95.8,40628,19861,20767,95.6
'22050, 북구,'050001, 45세,2019,7933,3848,4085,94.2,7831,3799,4032,94.2
'22050, 북구,'050002, 46세,2019,8004,3887,4117,94.4,7924,3842,4082,94.1
'22050, 북구,'050003, 47세,2019,8247,4077,4170,97.8,8163,4027,4136,97.4
'22050, 북구,'050004, 48세,2019,8488,4180,4308,97,8397,4130,4267,96.8
'22050, 북구,'050005, 49세,2019,8397,4099,4298,95.4,8313,4063,4250,95.6
'22050, 북구,'055,50~54세,2019,39625,19695,19930,98.8,39281,19527,19754,98.9
'22050, 북구,'055001, 50세,2019,8295,4109,4186,98.2,8217,4072,4145,98.2
'22050, 북구,'055002, 51세,2019,8551,4294,4257,100.9,8475,4253,4222,100.7
'22050, 북구,'055003, 52세,2019,7772,3813,3959,96.3,7710,3783,3927,96.3
'22050, 북구,'055004, 53세,2019,7530,3848,3682,104.5,7473,3822,3651,104.7
'22050, 북구,'055005, 54세,2019,7477,3631,3846,94.4,7406,3597,3809,94.4
'22050, 북구,'060,55~59세,2019,37102,18479,18623,99.2,36867,18360,18507,99.2
'22050, 북구,'060001, 55세,2019,6755,3360,3395,99,6698,3334,3364,99.1
'22050, 북구,'060002, 56세,2019,7213,3597,3616,99.5,7150,3565,3585,99.4
'22050, 북구,'060003, 57세,2019,7489,3796,3693,102.8,7439,3771,3668,102.8
'22050, 북구,'060004, 58세,2019,8032,3981,4051,98.3,8008,3969,4039,98.3
'22050, 북구,'060005, 59세,2019,7613,3745,3868,96.8,7572,3721,3851,96.6
'22050, 북구,'065,60~64세,2019,29210,14563,14647,99.4,29080,14501,14579,99.5
'22050, 북구,'065001, 60세,2019,6711,3383,3328,101.7,6671,3358,3313,101.4
'22050, 북구,'065002, 61세,2019,5927,3014,2913,103.5,5902,3000,2902,103.4
'22050, 북구,'065003, 62세,2019,5868,2981,2887,103.3,5843,2972,2871,103.5
'22050, 북구,'065004, 63세,2019,5412,2661,2751,96.7,5391,2651,2740,96.8
'22050, 북구,'065005, 64세,2019,5292,2524,2768,91.2,5273,2520,2753,91.5
'22050, 북구,'070,65~69세,2019,19899,9419,10480,89.9,19812,9380,10432,89.9
'22050, 북구,'070001, 65세,2019,4474,2182,2292,95.2,4445,2170,2275,95.4
'22050, 북구,'070002, 66세,2019,4235,1962,2273,86.3,4213,1952,2261,86.3
'22050, 북구,'070003, 67세,2019,4386,2101,2285,91.9,4372,2093,2279,91.8
'22050, 북구,'070004, 68세,2019,3408,1599,1809,88.4,3395,1594,1801,88.5
'22050, 북구,'070005, 69세,2019,3396,1575,1821,86.5,3387,1571,1816,86.5
'22050, 북구,'075,70~74세,2019,14653,6476,8177,79.2,14622,6463,8159,79.2
'22050, 북구,'075001, 70세,2019,3679,1650,2029,81.3,3671,1647,2024,81.4
'22050, 북구,'075002, 71세,2019,3472,1545,1927,80.2,3464,1540,1924,80
'22050, 북구,'075003, 72세,2019,3117,1404,1713,82,3113,1402,1711,81.9
'22050, 북구,'075004, 73세,2019,2149,937,1212,77.3,2142,937,1205,77.8
'22050, 북구,'075005, 74세,2019,2236,940,1296,72.5,2232,937,1295,72.4
'22050, 북구,'080,75~79세,2019,12624,5115,7509,68.1,12609,5110,7499,68.1
'22050, 북구,'080001, 75세,2019,2586,1020,1566,65.1,2585,1019,1566,65.1
'22050, 북구,'080002, 76세,2019,2619,1091,1528,71.4,2614,1089,1525,71.4
'22050, 북구,'080003, 77세,2019,2951,1279,1672,76.5,2951,1279,1672,76.5
'22050, 북구,'080004, 78세,2019,2321,913,1408,64.8,2318,912,1406,64.9
'22050, 북구,'080005, 79세,2019,2147,812,1335,60.8,2141,811,1330,61
'22050, 북구,'085,80~84세,2019,7739,2826,4913,57.5,7730,2822,4908,57.5
'22050, 북구,'085001, 80세,2019,2024,794,1230,64.6,2023,793,1230,64.5
'22050, 북구,'085002, 81세,2019,1665,628,1037,60.6,1663,627,1036,60.5
'22050, 북구,'085003, 82세,2019,1479,549,930,59,1475,548,927,59.1
'22050, 북구,'085004, 83세,2019,1329,440,889,49.5,1328,440,888,49.5
'22050, 북구,'085005, 84세,2019,1242,415,827,50.2,1241,414,827,50.1
'22050, 북구,'086,85세이상,2019,4650,1200,3450,34.8,4642,1199,3443,34.8
'22050, 북구,'090,85~89세,2019,3448,963,2485,38.8,3442,962,2480,38.8
'22050, 북구,'090001, 85세,2019,1053,315,738,42.7,1052,315,737,42.7
'22050, 북구,'090002, 86세,2019,793,235,558,42.1,791,235,556,42.3
'22050, 북구,'090003, 87세,2019,683,198,485,40.8,682,198,484,40.9
'22050, 북구,'090004, 88세,2019,510,131,379,34.6,508,130,378,34.4
'22050, 북구,'090005, 89세,2019,409,84,325,25.8,409,84,325,25.8
'22050, 북구,'095,90~94세,2019,994,212,782,27.1,994,212,782,27.1
'22050, 북구,'095001, 90세,2019,305,76,229,33.2,305,76,229,33.2
'22050, 북구,'095002, 91세,2019,252,51,201,25.4,252,51,201,25.4
'22050, 북구,'095003, 92세,2019,221,47,174,27,221,47,174,27
'22050, 북구,'095004, 93세,2019,103,19,84,22.6,103,19,84,22.6
'22050, 북구,'095005, 94세,2019,113,19,94,20.2,113,19,94,20.2
'22050, 북구,'100,95~99세,2019,188,25,163,15.3,187,25,162,15.4
'22050, 북구,'100001, 95세,2019,49,9,40,22.5,49,9,40,22.5
'22050, 북구,'100002, 96세,2019,58,6,52,11.5,57,6,51,11.8
'22050, 북구,'100003, 97세,2019,45,7,38,18.4,45,7,38,18.4
'22050, 북구,'100004, 98세,2019,17,X,15,13.3,17,X,15,13.3
'22050, 북구,'100005, 99세,2019,19,X,18,5.6,19,X,18,5.6
'22050, 북구,'101,100세이상,2019,20,X,20,0,19,X,19,0
'22050, 북구,'102,15세미만,2019,55488,28542,26946,105.9,55269,28420,26849,105.9
'22050, 북구,'103,15~64세,2019,330997,169295,161702,104.7,324400,165973,158427,104.8
'22050, 북구,'104,65세이상,2019,59565,25036,34529,72.5,59415,24974,34441,72.5
'22050, 북구,'126,평균연령,2019,41.2,40,42.5,,41.4,40.1,42.7,
'22050, 북구,'127,중위연령,2019,42.6,40.8,44.2,,42.9,41.1,44.5,
'22060, 수성구,'000,합계,2019,415283,202137,213146,94.8,412809,201042,211767,94.9
'22060, 수성구,'005,0~4세,2019,11304,5832,5472,106.6,11258,5815,5443,106.8
'22060, 수성구,'005001, 0세,2019,1641,858,783,109.6,1634,855,779,109.8
'22060, 수성구,'005002, 1세,2019,1827,926,901,102.8,1819,925,894,103.5
'22060, 수성구,'005003, 2세,2019,2205,1118,1087,102.9,2194,1115,1079,103.3
'22060, 수성구,'005004, 3세,2019,2678,1409,1269,111,2668,1403,1265,110.9
'22060, 수성구,'005005, 4세,2019,2953,1521,1432,106.2,2943,1517,1426,106.4
'22060, 수성구,'010,5~9세,2019,18844,9655,9189,105.1,18806,9636,9170,105.1
'22060, 수성구,'010001, 5세,2019,3174,1636,1538,106.4,3165,1630,1535,106.2
'22060, 수성구,'010002, 6세,2019,3501,1789,1712,104.5,3490,1784,1706,104.6
'22060, 수성구,'010003, 7세,2019,4001,2032,1969,103.2,3992,2030,1962,103.5
'22060, 수성구,'010004, 8세,2019,4049,2085,1964,106.2,4042,2081,1961,106.1
'22060, 수성구,'010005, 9세,2019,4119,2113,2006,105.3,4117,2111,2006,105.2
'22060, 수성구,'015,10~14세,2019,23704,12452,11252,110.7,23684,12442,11242,110.7
'22060, 수성구,'015001, 10세,2019,4190,2198,1992,110.3,4185,2195,1990,110.3
'22060, 수성구,'015002, 11세,2019,4708,2472,2236,110.6,4704,2470,2234,110.6
'22060, 수성구,'015003, 12세,2019,5087,2632,2455,107.2,5084,2630,2454,107.2
'22060, 수성구,'015004, 13세,2019,4899,2616,2283,114.6,4895,2615,2280,114.7
'22060, 수성구,'015005, 14세,2019,4820,2534,2286,110.8,4816,2532,2284,110.9
'22060, 수성구,'020,15~19세,2019,28163,15190,12973,117.1,28064,15137,12927,117.1
'22060, 수성구,'020001, 15세,2019,5308,2818,2490,113.2,5298,2814,2484,113.3
'22060, 수성구,'020002, 16세,2019,5434,2972,2462,120.7,5427,2970,2457,120.9
'22060, 수성구,'020003, 17세,2019,5375,2881,2494,115.5,5368,2877,2491,115.5
'22060, 수성구,'020004, 18세,2019,6168,3317,2851,116.3,6160,3311,2849,116.2
'22060, 수성구,'020005, 19세,2019,5878,3202,2676,119.7,5811,3165,2646,119.6
'22060, 수성구,'025,20~24세,2019,27342,14991,12351,121.4,26949,14816,12133,122.1
'22060, 수성구,'025001, 20세,2019,5380,3018,2362,127.8,5308,2983,2325,128.3
'22060, 수성구,'025002, 21세,2019,5499,3115,2384,130.7,5405,3066,2339,131.1
'22060, 수성구,'025003, 22세,2019,5530,3011,2519,119.5,5453,2981,2472,120.6
'22060, 수성구,'025004, 23세,2019,5575,2993,2582,115.9,5494,2958,2536,116.6
'22060, 수성구,'025005, 24세,2019,5358,2854,2504,114,5289,2828,2461,114.9
'22060, 수성구,'030,25~29세,2019,23891,12761,11130,114.7,23466,12596,10870,115.9
'22060, 수성구,'030001, 25세,2019,5273,2842,2431,116.9,5192,2807,2385,117.7
'22060, 수성구,'030002, 26세,2019,4947,2675,2272,117.7,4856,2641,2215,119.2
'22060, 수성구,'030003, 27세,2019,4933,2645,2288,115.6,4843,2614,2229,117.3
'22060, 수성구,'030004, 28세,2019,4508,2398,2110,113.6,4420,2364,2056,115
'22060, 수성구,'030005, 29세,2019,4230,2201,2029,108.5,4155,2170,1985,109.3
'22060, 수성구,'035,30~34세,2019,17887,9243,8644,106.9,17556,9116,8440,108
'22060, 수성구,'035001, 30세,2019,3849,2080,1769,117.6,3771,2054,1717,119.6
'22060, 수성구,'035002, 31세,2019,3501,1845,1656,111.4,3439,1818,1621,112.2
'22060, 수성구,'035003, 32세,2019,3454,1769,1685,105,3397,1753,1644,106.6
'22060, 수성구,'035004, 33세,2019,3442,1772,1670,106.1,3374,1739,1635,106.4
'22060, 수성구,'035005, 34세,2019,3641,1777,1864,95.3,3575,1752,1823,96.1
'22060, 수성구,'040,35~39세,2019,25061,11530,13531,85.2,24784,11408,13376,85.3
'22060, 수성구,'040001, 35세,2019,3864,1872,1992,94,3801,1846,1955,94.4
'22060, 수성구,'040002, 36세,2019,4503,2039,2464,82.8,4429,2010,2419,83.1
'22060, 수성구,'040003, 37세,2019,5277,2446,2831,86.4,5223,2422,2801,86.5
'22060, 수성구,'040004, 38세,2019,5495,2455,3040,80.8,5455,2436,3019,80.7
'22060, 수성구,'040005, 39세,2019,5922,2718,3204,84.8,5876,2694,3182,84.7
'22060, 수성구,'045,40~44세,2019,31419,14140,17279,81.8,31235,14049,17186,81.7
'22060, 수성구,'045001, 40세,2019,5998,2703,3295,82,5955,2677,3278,81.7
'22060, 수성구,'045002, 41세,2019,5690,2560,3130,81.8,5650,2544,3106,81.9
'22060, 수성구,'045003, 42세,2019,6187,2796,3391,82.5,6154,2782,3372,82.5
'22060, 수성구,'045004, 43세,2019,6543,2985,3558,83.9,6508,2966,3542,83.7
'22060, 수성구,'045005, 44세,2019,7001,3096,3905,79.3,6968,3080,3888,79.2
'22060, 수성구,'050,45~49세,2019,42034,19431,22603,86,41833,19334,22499,85.9
'22060, 수성구,'050001, 45세,2019,7895,3532,4363,81,7856,3508,4348,80.7
'22060, 수성구,'050002, 46세,2019,8139,3677,4462,82.4,8104,3658,4446,82.3
'22060, 수성구,'050003, 47세,2019,8400,3917,4483,87.4,8358,3897,4461,87.4
'22060, 수성구,'050004, 48세,2019,8883,4209,4674,90.1,8846,4194,4652,90.2
'22060, 수성구,'050005, 49세,2019,8717,4096,4621,88.6,8669,4077,4592,88.8
'22060, 수성구,'055,50~54세,2019,39571,19324,20247,95.4,39404,19247,20157,95.5
'22060, 수성구,'055001, 50세,2019,8533,4071,4462,91.2,8499,4054,4445,91.2
'22060, 수성구,'055002, 51세,2019,8602,4211,4391,95.9,8571,4194,4377,95.8
'22060, 수성구,'055003, 52세,2019,7894,3846,4048,95,7853,3827,4026,95.1
'22060, 수성구,'055004, 53세,2019,7224,3648,3576,102,7195,3638,3557,102.3
'22060, 수성구,'055005, 54세,2019,7318,3548,3770,94.1,7286,3534,3752,94.2
'22060, 수성구,'060,55~59세,2019,35104,17230,17874,96.4,34972,17166,17806,96.4
'22060, 수성구,'060001, 55세,2019,6888,3417,3471,98.4,6854,3400,3454,98.4
'22060, 수성구,'060002, 56세,2019,7086,3462,3624,95.5,7057,3447,3610,95.5
'22060, 수성구,'060003, 57세,2019,6843,3368,3475,96.9,6815,3353,3462,96.9
'22060, 수성구,'060004, 58세,2019,7208,3512,3696,95,7190,3505,3685,95.1
'22060, 수성구,'060005, 59세,2019,7079,3471,3608,96.2,7056,3461,3595,96.3
'22060, 수성구,'065,60~64세,2019,28762,13894,14868,93.4,28678,13851,14827,93.4
'22060, 수성구,'065001, 60세,2019,6509,3175,3334,95.2,6481,3162,3319,95.3
'22060, 수성구,'065002, 61세,2019,5592,2721,2871,94.8,5579,2715,2864,94.8
'22060, 수성구,'065003, 62세,2019,5893,2853,3040,93.8,5871,2841,3030,93.8
'22060, 수성구,'065004, 63세,2019,5372,2558,2814,90.9,5362,2553,2809,90.9
'22060, 수성구,'065005, 64세,2019,5396,2587,2809,92.1,5385,2580,2805,92
'22060, 수성구,'070,65~69세,2019,20191,9403,10788,87.2,20155,9387,10768,87.2
'22060, 수성구,'070001, 65세,2019,4431,2133,2298,92.8,4421,2128,2293,92.8
'22060, 수성구,'070002, 66세,2019,4380,2014,2366,85.1,4371,2010,2361,85.1
'22060, 수성구,'070003, 67세,2019,4409,2037,2372,85.9,4401,2034,2367,85.9
'22060, 수성구,'070004, 68세,2019,3419,1568,1851,84.7,3415,1565,1850,84.6
'22060, 수성구,'070005, 69세,2019,3552,1651,1901,86.8,3547,1650,1897,87
'22060, 수성구,'075,70~74세,2019,14993,6713,8280,81.1,14973,6705,8268,81.1
'22060, 수성구,'075001, 70세,2019,3697,1669,2028,82.3,3689,1666,2023,82.4
'22060, 수성구,'075002, 71세,2019,3424,1535,1889,81.3,3423,1535,1888,81.3
'22060, 수성구,'075003, 72세,2019,3360,1479,1881,78.6,3355,1477,1878,78.6
'22060, 수성구,'075004, 73세,2019,2200,1019,1181,86.3,2200,1019,1181,86.3
'22060, 수성구,'075005, 74세,2019,2312,1011,1301,77.7,2306,1008,1298,77.7
'22060, 수성구,'080,75~79세,2019,12849,5425,7424,73.1,12839,5419,7420,73
'22060, 수성구,'080001, 75세,2019,2604,1138,1466,77.6,2599,1134,1465,77.4
'22060, 수성구,'080002, 76세,2019,2795,1196,1599,74.8,2794,1196,1598,74.8
'22060, 수성구,'080003, 77세,2019,2886,1237,1649,75,2885,1237,1648,75.1
'22060, 수성구,'080004, 78세,2019,2398,1007,1391,72.4,2397,1006,1391,72.3
'22060, 수성구,'080005, 79세,2019,2166,847,1319,64.2,2164,846,1318,64.2
'22060, 수성구,'085,80~84세,2019,8581,3244,5337,60.8,8576,3243,5333,60.8
'22060, 수성구,'085001, 80세,2019,2067,852,1215,70.1,2067,852,1215,70.1
'22060, 수성구,'085002, 81세,2019,1856,698,1158,60.3,1855,698,1157,60.3
'22060, 수성구,'085003, 82세,2019,1675,641,1034,62,1675,641,1034,62
'22060, 수성구,'085004, 83세,2019,1532,541,991,54.6,1529,540,989,54.6
'22060, 수성구,'085005, 84세,2019,1451,512,939,54.5,1450,512,938,54.6
'22060, 수성구,'086,85세이상,2019,5583,1679,3904,43,5577,1675,3902,42.9
'22060, 수성구,'090,85~89세,2019,4119,1326,2793,47.5,4116,1324,2792,47.4
'22060, 수성구,'090001, 85세,2019,1183,421,762,55.2,1183,421,762,55.2
'22060, 수성구,'090002, 86세,2019,990,333,657,50.7,988,332,656,50.6
'22060, 수성구,'090003, 87세,2019,828,264,564,46.8,828,264,564,46.8
'22060, 수성구,'090004, 88세,2019,638,178,460,38.7,638,178,460,38.7
'22060, 수성구,'090005, 89세,2019,480,130,350,37.1,479,129,350,36.9
'22060, 수성구,'095,90~94세,2019,1240,304,936,32.5,1239,303,936,32.4
'22060, 수성구,'095001, 90세,2019,422,103,319,32.3,422,103,319,32.3
'22060, 수성구,'095002, 91세,2019,316,71,245,29,316,71,245,29
'22060, 수성구,'095003, 92세,2019,234,54,180,30,233,53,180,29.4
'22060, 수성구,'095004, 93세,2019,154,43,111,38.7,154,43,111,38.7
'22060, 수성구,'095005, 94세,2019,114,33,81,40.7,114,33,81,40.7
'22060, 수성구,'100,95~99세,2019,193,43,150,28.7,192,43,149,28.9
'22060, 수성구,'100001, 95세,2019,71,14,57,24.6,71,14,57,24.6
'22060, 수성구,'100002, 96세,2019,48,16,32,50,48,16,32,50
'22060, 수성구,'100003, 97세,2019,36,10,26,38.5,36,10,26,38.5
'22060, 수성구,'100004, 98세,2019,22,X,20,10,22,X,20,10
'22060, 수성구,'100005, 99세,2019,16,X,15,6.7,15,X,14,7.1
'22060, 수성구,'101,100세이상,2019,31,6,25,24,30,5,25,20
'22060, 수성구,'102,15세미만,2019,53852,27939,25913,107.8,53748,27893,25855,107.9
'22060, 수성구,'103,15~64세,2019,299234,147734,151500,97.5,296941,146720,150221,97.7
'22060, 수성구,'104,65세이상,2019,62197,26464,35733,74.1,62120,26429,35691,74
'22060, 수성구,'126,평균연령,2019,42.4,41,43.8,,42.5,41,43.9,
'22060, 수성구,'127,중위연령,2019,45,43.5,46.1,,45.1,43.5,46.2,
'22070, 달서구,'000,합계,2019,574390,285722,288668,99,561077,277785,283292,98.1
'22070, 달서구,'005,0~4세,2019,18705,9680,9025,107.3,18536,9594,8942,107.3
'22070, 달서구,'005001, 0세,2019,2955,1492,1463,102,2922,1477,1445,102.2
'22070, 달서구,'005002, 1세,2019,3152,1617,1535,105.3,3124,1600,1524,105
'22070, 달서구,'005003, 2세,2019,3641,1955,1686,116,3604,1940,1664,116.6
'22070, 달서구,'005004, 3세,2019,4300,2249,2051,109.7,4261,2227,2034,109.5
'22070, 달서구,'005005, 4세,2019,4657,2367,2290,103.4,4625,2350,2275,103.3
'22070, 달서구,'010,5~9세,2019,24491,12480,12011,103.9,24400,12441,11959,104
'22070, 달서구,'010001, 5세,2019,4539,2308,2231,103.5,4515,2300,2215,103.8
'22070, 달서구,'010002, 6세,2019,4612,2353,2259,104.2,4596,2345,2251,104.2
'22070, 달서구,'010003, 7세,2019,5217,2627,2590,101.4,5197,2617,2580,101.4
'22070, 달서구,'010004, 8세,2019,5062,2598,2464,105.4,5049,2592,2457,105.5
'22070, 달서구,'010005, 9세,2019,5061,2594,2467,105.1,5043,2587,2456,105.3
'22070, 달서구,'015,10~14세,2019,25591,13273,12318,107.8,25533,13250,12283,107.9
'22070, 달서구,'015001, 10세,2019,4898,2598,2300,113,4880,2593,2287,113.4
'22070, 달서구,'015002, 11세,2019,5163,2683,2480,108.2,5152,2680,2472,108.4
'22070, 달서구,'015003, 12세,2019,5384,2723,2661,102.3,5371,2717,2654,102.4
'22070, 달서구,'015004, 13세,2019,5014,2600,2414,107.7,5007,2595,2412,107.6
'22070, 달서구,'015005, 14세,2019,5132,2669,2463,108.4,5123,2665,2458,108.4
'22070, 달서구,'020,15~19세,2019,33843,17674,16169,109.3,32828,17172,15656,109.7
'22070, 달서구,'020001, 15세,2019,5706,2993,2713,110.3,5696,2985,2711,110.1
'22070, 달서구,'020002, 16세,2019,5827,3094,2733,113.2,5822,3092,2730,113.3
'22070, 달서구,'020003, 17세,2019,6192,3264,2928,111.5,6138,3241,2897,111.9
'22070, 달서구,'020004, 18세,2019,7594,3890,3704,105,7234,3720,3514,105.9
'22070, 달서구,'020005, 19세,2019,8524,4433,4091,108.4,7938,4134,3804,108.7
'22070, 달서구,'025,20~24세,2019,43259,22972,20287,113.2,40811,21562,19249,112
'22070, 달서구,'025001, 20세,2019,8140,4304,3836,112.2,7652,4045,3607,112.1
'22070, 달서구,'025002, 21세,2019,8622,4611,4011,115,8138,4341,3797,114.3
'22070, 달서구,'025003, 22세,2019,8645,4527,4118,109.9,8180,4262,3918,108.8
'22070, 달서구,'025004, 23세,2019,9002,4767,4235,112.6,8495,4452,4043,110.1
'22070, 달서구,'025005, 24세,2019,8850,4763,4087,116.5,8346,4462,3884,114.9
'22070, 달서구,'030,25~29세,2019,40290,22018,18272,120.5,37987,20566,17421,118.1
'22070, 달서구,'030001, 25세,2019,8562,4665,3897,119.7,8129,4401,3728,118.1
'22070, 달서구,'030002, 26세,2019,8502,4579,3923,116.7,8053,4304,3749,114.8
'22070, 달서구,'030003, 27세,2019,8340,4480,3860,116.1,7894,4188,3706,113
'22070, 달서구,'030004, 28세,2019,7588,4225,3363,125.6,7105,3915,3190,122.7
'22070, 달서구,'030005, 29세,2019,7298,4069,3229,126,6806,3758,3048,123.3
'22070, 달서구,'035,30~34세,2019,32799,17823,14976,119,30555,16434,14121,116.4
'22070, 달서구,'035001, 30세,2019,7128,3912,3216,121.6,6687,3621,3066,118.1
'22070, 달서구,'035002, 31세,2019,6456,3564,2892,123.2,5979,3276,2703,121.2
'22070, 달서구,'035003, 32세,2019,6427,3514,2913,120.6,5937,3218,2719,118.4
'22070, 달서구,'035004, 33세,2019,6369,3464,2905,119.2,5936,3186,2750,115.9
'22070, 달서구,'035005, 34세,2019,6419,3369,3050,110.5,6016,3133,2883,108.7
'22070, 달서구,'040,35~39세,2019,39795,20078,19717,101.8,38179,19016,19163,99.2
'22070, 달서구,'040001, 35세,2019,6683,3429,3254,105.4,6351,3212,3139,102.3
'22070, 달서구,'040002, 36세,2019,7615,3910,3705,105.5,7255,3667,3588,102.2
'22070, 달서구,'040003, 37세,2019,8436,4232,4204,100.7,8062,3985,4077,97.7
'22070, 달서구,'040004, 38세,2019,8346,4177,4169,100.2,8047,3985,4062,98.1
'22070, 달서구,'040005, 39세,2019,8715,4330,4385,98.7,8464,4167,4297,97
'22070, 달서구,'045,40~44세,2019,41635,20400,21235,96.1,40548,19711,20837,94.6
'22070, 달서구,'045001, 40세,2019,8459,4131,4328,95.4,8206,3975,4231,93.9
'22070, 달서구,'045002, 41세,2019,7845,3922,3923,100,7611,3775,3836,98.4
'22070, 달서구,'045003, 42세,2019,8248,4045,4203,96.2,8027,3900,4127,94.5
'22070, 달서구,'045004, 43세,2019,8443,4186,4257,98.3,8237,4057,4180,97.1
'22070, 달서구,'045005, 44세,2019,8640,4116,4524,91,8467,4004,4463,89.7
'22070, 달서구,'050,45~49세,2019,52055,25159,26896,93.5,51150,24608,26542,92.7
'22070, 달서구,'050001, 45세,2019,9865,4837,5028,96.2,9697,4741,4956,95.7
'22070, 달서구,'050002, 46세,2019,10006,4787,5219,91.7,9829,4674,5155,90.7
'22070, 달서구,'050003, 47세,2019,10328,4932,5396,91.4,10152,4821,5331,90.4
'22070, 달서구,'050004, 48세,2019,11090,5332,5758,92.6,10898,5212,5686,91.7
'22070, 달서구,'050005, 49세,2019,10766,5271,5495,95.9,10574,5160,5414,95.3
'22070, 달서구,'055,50~54세,2019,53866,25920,27946,92.8,53244,25551,27693,92.3
'22070, 달서구,'055001, 50세,2019,11229,5432,5797,93.7,11082,5337,5745,92.9
'22070, 달서구,'055002, 51세,2019,11425,5471,5954,91.9,11274,5381,5893,91.3
'22070, 달서구,'055003, 52세,2019,10668,5048,5620,89.8,10555,4981,5574,89.4
'22070, 달서구,'055004, 53세,2019,10191,5012,5179,96.8,10082,4951,5131,96.5
'22070, 달서구,'055005, 54세,2019,10353,4957,5396,91.9,10251,4901,5350,91.6
'22070, 달서구,'060,55~59세,2019,52382,25684,26698,96.2,52012,25491,26521,96.1
'22070, 달서구,'060001, 55세,2019,9681,4698,4983,94.3,9593,4653,4940,94.2
'22070, 달서구,'060002, 56세,2019,10293,5177,5116,101.2,10200,5122,5078,100.9
'22070, 달서구,'060003, 57세,2019,10370,5115,5255,97.3,10287,5077,5210,97.4
'22070, 달서구,'060004, 58세,2019,11302,5493,5809,94.6,11268,5477,5791,94.6
'22070, 달서구,'060005, 59세,2019,10736,5201,5535,94,10664,5162,5502,93.8
'22070, 달서구,'065,60~64세,2019,40983,20336,20647,98.5,40792,20244,20548,98.5
'22070, 달서구,'065001, 60세,2019,9649,4737,4912,96.4,9601,4712,4889,96.4
'22070, 달서구,'065002, 61세,2019,7933,3999,3934,101.7,7889,3977,3912,101.7
'22070, 달서구,'065003, 62세,2019,8368,4210,4158,101.3,8332,4190,4142,101.2
'22070, 달서구,'065004, 63세,2019,7493,3800,3693,102.9,7471,3792,3679,103.1
'22070, 달서구,'065005, 64세,2019,7540,3590,3950,90.9,7499,3573,3926,91
'22070, 달서구,'070,65~69세,2019,27102,12938,14164,91.3,26987,12894,14093,91.5
'22070, 달서구,'070001, 65세,2019,6069,2989,3080,97,6036,2979,3057,97.4
'22070, 달서구,'070002, 66세,2019,5867,2764,3103,89.1,5844,2754,3090,89.1
'22070, 달서구,'070003, 67세,2019,6103,2827,3276,86.3,6076,2817,3259,86.4
'22070, 달서구,'070004, 68세,2019,4551,2213,2338,94.7,4532,2204,2328,94.7
'22070, 달서구,'070005, 69세,2019,4512,2145,2367,90.6,4499,2140,2359,90.7
'22070, 달서구,'075,70~74세,2019,18248,8502,9746,87.2,18216,8488,9728,87.3
'22070, 달서구,'075001, 70세,2019,4658,2212,2446,90.4,4643,2206,2437,90.5
'22070, 달서구,'075002, 71세,2019,4347,2044,2303,88.8,4340,2041,2299,88.8
'22070, 달서구,'075003, 72세,2019,4002,1813,2189,82.8,3998,1811,2187,82.8
'22070, 달서구,'075004, 73세,2019,2599,1264,1335,94.7,2596,1262,1334,94.6
'22070, 달서구,'075005, 74세,2019,2642,1169,1473,79.4,2639,1168,1471,79.4
'22070, 달서구,'080,75~79세,2019,14526,5978,8548,69.9,14504,5967,8537,69.9
'22070, 달서구,'080001, 75세,2019,2981,1260,1721,73.2,2976,1257,1719,73.1
'22070, 달서구,'080002, 76세,2019,3054,1323,1731,76.4,3051,1321,1730,76.4
'22070, 달서구,'080003, 77세,2019,3438,1420,2018,70.4,3434,1418,2016,70.3
'22070, 달서구,'080004, 78세,2019,2665,1061,1604,66.1,2658,1058,1600,66.1
'22070, 달서구,'080005, 79세,2019,2388,914,1474,62,2385,913,1472,62
'22070, 달서구,'085,80~84세,2019,9300,3296,6004,54.9,9286,3291,5995,54.9
'22070, 달서구,'085001, 80세,2019,2336,867,1469,59,2329,863,1466,58.9
'22070, 달서구,'085002, 81세,2019,2037,764,1273,60,2036,764,1272,60.1
'22070, 달서구,'085003, 82세,2019,1809,628,1181,53.2,1806,627,1179,53.2
'22070, 달서구,'085004, 83세,2019,1676,548,1128,48.6,1675,548,1127,48.6
'22070, 달서구,'085005, 84세,2019,1442,489,953,51.3,1440,489,951,51.4
'22070, 달서구,'086,85세이상,2019,5520,1511,4009,37.7,5509,1505,4004,37.6
'22070, 달서구,'090,85~89세,2019,4098,1182,2916,40.5,4091,1177,2914,40.4
'22070, 달서구,'090001, 85세,2019,1186,386,800,48.3,1184,384,800,48
'22070, 달서구,'090002, 86세,2019,966,283,683,41.4,965,282,683,41.3
'22070, 달서구,'090003, 87세,2019,847,244,603,40.5,846,243,603,40.3
'22070, 달서구,'090004, 88세,2019,592,154,438,35.2,591,153,438,34.9
'22070, 달서구,'090005, 89세,2019,507,115,392,29.3,505,115,390,29.5
'22070, 달서구,'095,90~94세,2019,1205,279,926,30.1,1201,278,923,30.1
'22070, 달서구,'095001, 90세,2019,415,108,307,35.2,415,108,307,35.2
'22070, 달서구,'095002, 91세,2019,312,71,241,29.5,310,70,240,29.2
'22070, 달서구,'095003, 92세,2019,231,52,179,29.1,231,52,179,29.1
'22070, 달서구,'095004, 93세,2019,125,25,100,25,124,25,99,25.3
'22070, 달서구,'095005, 94세,2019,122,23,99,23.2,121,23,98,23.5
'22070, 달서구,'100,95~99세,2019,196,48,148,32.4,196,48,148,32.4
'22070, 달서구,'100001, 95세,2019,79,23,56,41.1,79,23,56,41.1
'22070, 달서구,'100002, 96세,2019,38,10,28,35.7,38,10,28,35.7
'22070, 달서구,'100003, 97세,2019,40,9,31,29,40,9,31,29
'22070, 달서구,'100004, 98세,2019,30,X,26,15.4,30,X,26,15.4
'22070, 달서구,'100005, 99세,2019,9,X,7,28.6,9,X,7,28.6
'22070, 달서구,'101,100세이상,2019,21,X,19,10.5,21,X,19,10.5
'22070, 달서구,'102,15세미만,2019,68787,35433,33354,106.2,68469,35285,33184,106.3
'22070, 달서구,'103,15~64세,2019,430907,218064,212843,102.5,418106,210355,207751,101.3
'22070, 달서구,'104,65세이상,2019,74696,32225,42471,75.9,74502,32145,42357,75.9
'22070, 달서구,'126,평균연령,2019,41.7,40.5,42.9,,41.9,40.7,43.1,
'22070, 달서구,'127,중위연령,2019,43.5,41.7,45.1,,44,42.3,45.4,
'22310, 달성군,'000,합계,2019,258474,132291,126183,104.8,249772,126612,123160,102.8
'22310, 달성군,'005,0~4세,2019,15230,7685,7545,101.9,15053,7611,7442,102.3
'22310, 달성군,'005001, 0세,2019,2679,1378,1301,105.9,2645,1366,1279,106.8
'22310, 달성군,'005002, 1세,2019,2884,1449,1435,101,2842,1431,1411,101.4
'22310, 달성군,'005003, 2세,2019,3044,1522,1522,100,3009,1503,1506,99.8
'22310, 달성군,'005004, 3세,2019,3371,1690,1681,100.5,3333,1672,1661,100.7
'22310, 달성군,'005005, 4세,2019,3252,1646,1606,102.5,3224,1639,1585,103.4
'22310, 달성군,'010,5~9세,2019,15127,7739,7388,104.8,14988,7674,7314,104.9
'22310, 달성군,'010001, 5세,2019,3126,1571,1555,101,3085,1559,1526,102.2
'22310, 달성군,'010002, 6세,2019,3055,1579,1476,107,3021,1562,1459,107.1
'22310, 달성군,'010003, 7세,2019,3142,1620,1522,106.4,3124,1611,1513,106.5
'22310, 달성군,'010004, 8세,2019,3031,1541,1490,103.4,3002,1528,1474,103.7
'22310, 달성군,'010005, 9세,2019,2773,1428,1345,106.2,2756,1414,1342,105.4
'22310, 달성군,'015,10~14세,2019,11797,6071,5726,106,11697,6031,5666,106.4
'22310, 달성군,'015001, 10세,2019,2482,1259,1223,102.9,2458,1248,1210,103.1
'22310, 달성군,'015002, 11세,2019,2538,1331,1207,110.3,2518,1321,1197,110.4
'22310, 달성군,'015003, 12세,2019,2435,1212,1223,99.1,2412,1205,1207,99.8
'22310, 달성군,'015004, 13세,2019,2154,1145,1009,113.5,2139,1139,1000,113.9
'22310, 달성군,'015005, 14세,2019,2188,1124,1064,105.6,2170,1118,1052,106.3
'22310, 달성군,'020,15~19세,2019,11725,6301,5424,116.2,11634,6253,5381,116.2
'22310, 달성군,'020001, 15세,2019,2148,1090,1058,103,2136,1082,1054,102.7
'22310, 달성군,'020002, 16세,2019,2440,1295,1145,113.1,2421,1286,1135,113.3
'22310, 달성군,'020003, 17세,2019,2360,1283,1077,119.1,2348,1275,1073,118.8
'22310, 달성군,'020004, 18세,2019,2480,1335,1145,116.6,2462,1320,1142,115.6
'22310, 달성군,'020005, 19세,2019,2297,1298,999,129.9,2267,1290,977,132
'22310, 달성군,'025,20~24세,2019,13863,8020,5843,137.3,13155,7553,5602,134.8
'22310, 달성군,'025001, 20세,2019,2399,1436,963,149.1,2344,1407,937,150.2
'22310, 달성군,'025002, 21세,2019,2705,1584,1121,141.3,2612,1533,1079,142.1
'22310, 달성군,'025003, 22세,2019,2852,1586,1266,125.3,2719,1503,1216,123.6
'22310, 달성군,'025004, 23세,2019,2924,1704,1220,139.7,2736,1572,1164,135.1
'22310, 달성군,'025005, 24세,2019,2983,1710,1273,134.3,2744,1538,1206,127.5
'22310, 달성군,'030,25~29세,2019,16661,9306,7355,126.5,15065,8182,6883,118.9
'22310, 달성군,'030001, 25세,2019,3003,1693,1310,129.2,2754,1513,1241,121.9
'22310, 달성군,'030002, 26세,2019,3196,1845,1351,136.6,2906,1637,1269,129
'22310, 달성군,'030003, 27세,2019,3475,1914,1561,122.6,3153,1690,1463,115.5
'22310, 달성군,'030004, 28세,2019,3421,1889,1532,123.3,3053,1632,1421,114.8
'22310, 달성군,'030005, 29세,2019,3566,1965,1601,122.7,3199,1710,1489,114.8
'22310, 달성군,'035,30~34세,2019,19986,10815,9171,117.9,18154,9488,8666,109.5
'22310, 달성군,'035001, 30세,2019,3698,2070,1628,127.1,3322,1788,1534,116.6
'22310, 달성군,'035002, 31세,2019,3761,2020,1741,116,3377,1740,1637,106.3
'22310, 달성군,'035003, 32세,2019,4015,2126,1889,112.5,3643,1861,1782,104.4
'22310, 달성군,'035004, 33세,2019,4175,2271,1904,119.3,3834,2020,1814,111.4
'22310, 달성군,'035005, 34세,2019,4337,2328,2009,115.9,3978,2079,1899,109.5
'22310, 달성군,'040,35~39세,2019,25514,13363,12151,110,24133,12400,11733,105.7
'22310, 달성군,'040001, 35세,2019,4450,2396,2054,116.7,4125,2153,1972,109.2
'22310, 달성군,'040002, 36세,2019,4992,2546,2446,104.1,4690,2333,2357,99
'22310, 달성군,'040003, 37세,2019,5415,2825,2590,109.1,5141,2629,2512,104.7
'22310, 달성군,'040004, 38세,2019,5309,2812,2497,112.6,5061,2652,2409,110.1
'22310, 달성군,'040005, 39세,2019,5348,2784,2564,108.6,5116,2633,2483,106
'22310, 달성군,'045,40~44세,2019,21592,11478,10114,113.5,20728,10926,9802,111.5
'22310, 달성군,'045001, 40세,2019,4807,2510,2297,109.3,4611,2380,2231,106.7
'22310, 달성군,'045002, 41세,2019,4325,2291,2034,112.6,4100,2143,1957,109.5
'22310, 달성군,'045003, 42세,2019,4353,2332,2021,115.4,4196,2233,1963,113.8
'22310, 달성군,'045004, 43세,2019,3985,2161,1824,118.5,3834,2067,1767,117
'22310, 달성군,'045005, 44세,2019,4122,2184,1938,112.7,3987,2103,1884,111.6
'22310, 달성군,'050,45~49세,2019,20836,10831,10005,108.3,20170,10421,9749,106.9
'22310, 달성군,'050001, 45세,2019,4315,2297,2018,113.8,4167,2205,1962,112.4
'22310, 달성군,'050002, 46세,2019,4101,2146,1955,109.8,3969,2058,1911,107.7
'22310, 달성군,'050003, 47세,2019,4112,2171,1941,111.8,3969,2078,1891,109.9
'22310, 달성군,'050004, 48세,2019,4152,2119,2033,104.2,4034,2051,1983,103.4
'22310, 달성군,'050005, 49세,2019,4156,2098,2058,101.9,4031,2029,2002,101.3
'22310, 달성군,'055,50~54세,2019,20049,9830,10219,96.2,19563,9555,10008,95.5
'22310, 달성군,'055001, 50세,2019,4077,1972,2105,93.7,3980,1911,2069,92.4
'22310, 달성군,'055002, 51세,2019,4238,2084,2154,96.8,4123,2023,2100,96.3
'22310, 달성군,'055003, 52세,2019,3940,1908,2032,93.9,3849,1864,1985,93.9
'22310, 달성군,'055004, 53세,2019,3869,1934,1935,99.9,3780,1885,1895,99.5
'22310, 달성군,'055005, 54세,2019,3925,1932,1993,96.9,3831,1872,1959,95.6
'22310, 달성군,'060,55~59세,2019,19944,9928,10016,99.1,19623,9771,9852,99.2
'22310, 달성군,'060001, 55세,2019,3642,1824,1818,100.3,3556,1779,1777,100.1
'22310, 달성군,'060002, 56세,2019,3841,1891,1950,97,3770,1860,1910,97.4
'22310, 달성군,'060003, 57세,2019,4100,2055,2045,100.5,4045,2027,2018,100.4
'22310, 달성군,'060004, 58세,2019,4330,2163,2167,99.8,4285,2144,2141,100.1
'22310, 달성군,'060005, 59세,2019,4031,1995,2036,98,3967,1961,2006,97.8
'22310, 달성군,'065,60~64세,2019,16020,7996,8024,99.7,15829,7887,7942,99.3
'22310, 달성군,'065001, 60세,2019,3713,1853,1860,99.6,3670,1828,1842,99.2
'22310, 달성군,'065002, 61세,2019,3227,1613,1614,99.9,3183,1588,1595,99.6
'22310, 달성군,'065003, 62세,2019,3273,1655,1618,102.3,3229,1630,1599,101.9
'22310, 달성군,'065004, 63세,2019,2940,1485,1455,102.1,2908,1466,1442,101.7
'22310, 달성군,'065005, 64세,2019,2867,1390,1477,94.1,2839,1375,1464,93.9
'22310, 달성군,'070,65~69세,2019,10389,5114,5275,96.9,10301,5071,5230,97
'22310, 달성군,'070001, 65세,2019,2293,1169,1124,104,2267,1154,1113,103.7
'22310, 달성군,'070002, 66세,2019,2181,1052,1129,93.2,2159,1040,1119,92.9
'22310, 달성군,'070003, 67세,2019,2388,1172,1216,96.4,2376,1166,1210,96.4
'22310, 달성군,'070004, 68세,2019,1746,857,889,96.4,1731,851,880,96.7
'22310, 달성군,'070005, 69세,2019,1781,864,917,94.2,1768,860,908,94.7
'22310, 달성군,'075,70~74세,2019,7156,3434,3722,92.3,7122,3416,3706,92.2
'22310, 달성군,'075001, 70세,2019,1863,910,953,95.5,1852,904,948,95.4
'22310, 달성군,'075002, 71세,2019,1670,812,858,94.6,1668,810,858,94.4
'22310, 달성군,'075003, 72세,2019,1548,728,820,88.8,1538,725,813,89.2
'22310, 달성군,'075004, 73세,2019,1041,507,534,94.9,1033,502,531,94.5
'22310, 달성군,'075005, 74세,2019,1034,477,557,85.6,1031,475,556,85.4
'22310, 달성군,'080,75~79세,2019,5719,2296,3423,67.1,5706,2292,3414,67.1
'22310, 달성군,'080001, 75세,2019,1176,545,631,86.4,1171,542,629,86.2
'22310, 달성군,'080002, 76세,2019,1184,496,688,72.1,1181,496,685,72.4
'22310, 달성군,'080003, 77세,2019,1311,530,781,67.9,1310,530,780,67.9
'22310, 달성군,'080004, 78세,2019,1095,401,694,57.8,1091,400,691,57.9
'22310, 달성군,'080005, 79세,2019,953,324,629,51.5,953,324,629,51.5
'22310, 달성군,'085,80~84세,2019,4051,1373,2678,51.3,4042,1372,2670,51.4
'22310, 달성군,'085001, 80세,2019,1006,362,644,56.2,1005,362,643,56.3
'22310, 달성군,'085002, 81세,2019,883,310,573,54.1,878,310,568,54.6
'22310, 달성군,'085003, 82세,2019,808,279,529,52.7,808,279,529,52.7
'22310, 달성군,'085004, 83세,2019,678,220,458,48,675,219,456,48
'22310, 달성군,'085005, 84세,2019,676,202,474,42.6,676,202,474,42.6
'22310, 달성군,'086,85세이상,2019,2815,711,2104,33.8,2809,709,2100,33.8
'22310, 달성군,'090,85~89세,2019,2027,545,1482,36.8,2025,544,1481,36.7
'22310, 달성군,'090001, 85세,2019,601,162,439,36.9,600,161,439,36.7
'22310, 달성군,'090002, 86세,2019,454,138,316,43.7,453,138,315,43.8
'22310, 달성군,'090003, 87세,2019,411,118,293,40.3,411,118,293,40.3
'22310, 달성군,'090004, 88세,2019,325,80,245,32.7,325,80,245,32.7
'22310, 달성군,'090005, 89세,2019,236,47,189,24.9,236,47,189,24.9
'22310, 달성군,'095,90~94세,2019,657,140,517,27.1,653,139,514,27
'22310, 달성군,'095001, 90세,2019,205,44,161,27.3,204,44,160,27.5
'22310, 달성군,'095002, 91세,2019,163,37,126,29.4,163,37,126,29.4
'22310, 달성군,'095003, 92세,2019,136,27,109,24.8,135,27,108,25
'22310, 달성군,'095004, 93세,2019,83,16,67,23.9,82,16,66,24.2
'22310, 달성군,'095005, 94세,2019,70,16,54,29.6,69,15,54,27.8
'22310, 달성군,'100,95~99세,2019,120,24,96,25,120,24,96,25
'22310, 달성군,'100001, 95세,2019,38,8,30,26.7,38,8,30,26.7
'22310, 달성군,'100002, 96세,2019,37,5,32,15.6,37,5,32,15.6
'22310, 달성군,'100003, 97세,2019,21,8,13,61.5,21,8,13,61.5
'22310, 달성군,'100004, 98세,2019,15,X,13,15.4,15,X,13,15.4
'22310, 달성군,'100005, 99세,2019,9,X,8,12.5,9,X,8,12.5
'22310, 달성군,'101,100세이상,2019,11,X,9,22.2,11,X,9,22.2
'22310, 달성군,'102,15세미만,2019,42154,21495,20659,104,41738,21316,20422,104.4
'22310, 달성군,'103,15~64세,2019,186190,97868,88322,110.8,178054,92436,85618,108
'22310, 달성군,'104,65세이상,2019,30130,12928,17202,75.2,29980,12860,17120,75.1
'22310, 달성군,'126,평균연령,2019,39.6,38.5,40.8,,39.7,38.6,40.9,
'22310, 달성군,'127,중위연령,2019,39.9,38.9,41.1,,40.2,39.3,41.3,
'23,인천광역시,'000,합계,2019,2952237,1484528,1467709,101.1,2852063,1427538,1424525,100.2
'23,인천광역시,'005,0~4세,2019,111320,57101,54219,105.3,107591,55163,52428,105.2
'23,인천광역시,'005001, 0세,2019,19010,9806,9204,106.5,18342,9474,8868,106.8
'23,인천광역시,'005002, 1세,2019,19819,10220,9599,106.5,19028,9789,9239,106
'23,인천광역시,'005003, 2세,2019,21729,11181,10548,106,20966,10776,10190,105.8
'23,인천광역시,'005004, 3세,2019,24662,12555,12107,103.7,23835,12127,11708,103.6
'23,인천광역시,'005005, 4세,2019,26100,13339,12761,104.5,25420,12997,12423,104.6
'23,인천광역시,'010,5~9세,2019,133686,68645,65041,105.5,131348,67446,63902,105.5
'23,인천광역시,'010001, 5세,2019,25666,13141,12525,104.9,25027,12813,12214,104.9
'23,인천광역시,'010002, 6세,2019,25781,13145,12636,104,25292,12910,12382,104.3
'23,인천광역시,'010003, 7세,2019,27933,14333,13600,105.4,27462,14097,13365,105.5
'23,인천광역시,'010004, 8세,2019,27879,14449,13430,107.6,27475,14223,13252,107.3
'23,인천광역시,'010005, 9세,2019,26427,13577,12850,105.7,26092,13403,12689,105.6
'23,인천광역시,'015,10~14세,2019,130218,66916,63302,105.7,128848,66175,62673,105.6
'23,인천광역시,'015001, 10세,2019,25814,13247,12567,105.4,25511,13096,12415,105.5
'23,인천광역시,'015002, 11세,2019,26927,13706,13221,103.7,26615,13525,13090,103.3
'23,인천광역시,'015003, 12세,2019,27788,14316,13472,106.3,27525,14178,13347,106.2
'23,인천광역시,'015004, 13세,2019,25139,13017,12122,107.4,24897,12877,12020,107.1
'23,인천광역시,'015005, 14세,2019,24550,12630,11920,106,24300,12499,11801,105.9
'23,인천광역시,'020,15~19세,2019,148004,76109,71895,105.9,144931,74614,70317,106.1
'23,인천광역시,'020001, 15세,2019,26608,13655,12953,105.4,26403,13566,12837,105.7
'23,인천광역시,'020002, 16세,2019,27349,14087,13262,106.2,27166,13996,13170,106.3
'23,인천광역시,'020003, 17세,2019,27916,14517,13399,108.3,27676,14385,13291,108.2
'23,인천광역시,'020004, 18세,2019,31819,16335,15484,105.5,31123,16008,15115,105.9
'23,인천광역시,'020005, 19세,2019,34312,17515,16797,104.3,32563,16659,15904,104.7
'23,인천광역시,'025,20~24세,2019,187191,98715,88476,111.6,178713,93696,85017,110.2
'23,인천광역시,'025001, 20세,2019,33651,18026,15625,115.4,32344,17317,15027,115.2
'23,인천광역시,'025002, 21세,2019,35303,19154,16149,118.6,33842,18301,15541,117.8
'23,인천광역시,'025003, 22세,2019,37439,19735,17704,111.5,35756,18710,17046,109.8
'23,인천광역시,'025004, 23세,2019,39548,20401,19147,106.5,37618,19243,18375,104.7
'23,인천광역시,'025005, 24세,2019,41250,21399,19851,107.8,39153,20125,19028,105.8
'23,인천광역시,'030,25~29세,2019,217524,115323,102201,112.8,204276,107152,97124,110.3
'23,인천광역시,'030001, 25세,2019,43136,22954,20182,113.7,40963,21604,19359,111.6
'23,인천광역시,'030002, 26세,2019,44638,23719,20919,113.4,42207,22199,20008,111
'23,인천광역시,'030003, 27세,2019,45534,23904,21630,110.5,42900,22240,20660,107.6
'23,인천광역시,'030004, 28세,2019,43365,23021,20344,113.2,40511,21321,19190,111.1
'23,인천광역시,'030005, 29세,2019,40851,21725,19126,113.6,37695,19788,17907,110.5
'23,인천광역시,'035,30~34세,2019,195774,103261,92513,111.6,179654,93239,86415,107.9
'23,인천광역시,'035001, 30세,2019,39431,20854,18577,112.3,36361,18953,17408,108.9
'23,인천광역시,'035002, 31세,2019,38433,20215,18218,111,35059,18141,16918,107.2
'23,인천광역시,'035003, 32세,2019,38413,20145,18268,110.3,35093,18065,17028,106.1
'23,인천광역시,'035004, 33세,2019,39547,20933,18614,112.5,36265,18899,17366,108.8
'23,인천광역시,'035005, 34세,2019,39950,21114,18836,112.1,36876,19181,17695,108.4
'23,인천광역시,'040,35~39세,2019,239555,124551,115004,108.3,226943,116706,110237,105.9
'23,인천광역시,'040001, 35세,2019,41526,21687,19839,109.3,38700,19955,18745,106.5
'23,인천광역시,'040002, 36세,2019,46275,23939,22336,107.2,43546,22211,21335,104.1
'23,인천광역시,'040003, 37세,2019,50296,26148,24148,108.3,47631,24482,23149,105.8
'23,인천광역시,'040004, 38세,2019,50267,26348,23919,110.2,47979,24926,23053,108.1
'23,인천광역시,'040005, 39세,2019,51191,26429,24762,106.7,49087,25132,23955,104.9
'23,인천광역시,'045,40~44세,2019,228183,117893,110290,106.9,219597,112671,106926,105.4
'23,인천광역시,'045001, 40세,2019,48541,25304,23237,108.9,46395,23976,22419,106.9
'23,인천광역시,'045002, 41세,2019,44423,22826,21597,105.7,42553,21689,20864,104
'23,인천광역시,'045003, 42세,2019,45121,23313,21808,106.9,43501,22314,21187,105.3
'23,인천광역시,'045004, 43세,2019,43549,22520,21029,107.1,42048,21621,20427,105.8
'23,인천광역시,'045005, 44세,2019,46549,23930,22619,105.8,45100,23071,22029,104.7
'23,인천광역시,'050,45~49세,2019,258677,131290,127387,103.1,250778,126838,123940,102.3
'23,인천광역시,'050001, 45세,2019,50151,25899,24252,106.8,48694,25032,23662,105.8
'23,인천광역시,'050002, 46세,2019,50941,25579,25362,100.9,49346,24674,24672,100
'23,인천광역시,'050003, 47세,2019,51130,26056,25074,103.9,49535,25175,24360,103.3
'23,인천광역시,'050004, 48세,2019,53979,27309,26670,102.4,52343,26410,25933,101.8
'23,인천광역시,'050005, 49세,2019,52476,26447,26029,101.6,50860,25547,25313,100.9
'23,인천광역시,'055,50~54세,2019,256421,126446,129975,97.3,249493,122841,126652,97
'23,인천광역시,'055001, 50세,2019,53545,26381,27164,97.1,52036,25598,26438,96.8
'23,인천광역시,'055002, 51세,2019,53735,26223,27512,95.3,52199,25407,26792,94.8
'23,인천광역시,'055003, 52세,2019,48916,23978,24938,96.2,47756,23358,24398,95.7
'23,인천광역시,'055004, 53세,2019,48571,24319,24252,100.3,47302,23682,23620,100.3
'23,인천광역시,'055005, 54세,2019,51654,25545,26109,97.8,50200,24796,25404,97.6
'23,인천광역시,'060,55~59세,2019,258996,130128,128868,101,252658,127081,125577,101.2
'23,인천광역시,'060001, 55세,2019,48131,24005,24126,99.5,46672,23294,23378,99.6
'23,인천광역시,'060002, 56세,2019,51070,25823,25247,102.3,49518,25080,24438,102.6
'23,인천광역시,'060003, 57세,2019,51481,25872,25609,101,50268,25270,24998,101.1
'23,인천광역시,'060004, 58세,2019,54578,27504,27074,101.6,53714,27112,26602,101.9
'23,인천광역시,'060005, 59세,2019,53736,26924,26812,100.4,52486,26325,26161,100.6
'23,인천광역시,'065,60~64세,2019,208358,103782,104576,99.2,203564,101489,102075,99.4
'23,인천광역시,'065001, 60세,2019,47213,23620,23593,100.1,46190,23109,23081,100.1
'23,인천광역시,'065002, 61세,2019,44274,22250,22024,101,43200,21718,21482,101.1
'23,인천광역시,'065003, 62세,2019,41930,21044,20886,100.8,40907,20551,20356,101
'23,인천광역시,'065004, 63세,2019,37213,18404,18809,97.8,36363,18020,18343,98.2
'23,인천광역시,'065005, 64세,2019,37728,18464,19264,95.8,36904,18091,18813,96.2
'23,인천광역시,'070,65~69세,2019,126286,61745,64541,95.7,123622,60539,63083,96
'23,인천광역시,'070001, 65세,2019,30645,15009,15636,96,29916,14678,15238,96.3
'23,인천광역시,'070002, 66세,2019,26438,12904,13534,95.3,25821,12624,13197,95.7
'23,인천광역시,'070003, 67세,2019,28575,13999,14576,96,28029,13751,14278,96.3
'23,인천광역시,'070004, 68세,2019,18991,9241,9750,94.8,18578,9040,9538,94.8
'23,인천광역시,'070005, 69세,2019,21637,10592,11045,95.9,21278,10446,10832,96.4
'23,인천광역시,'075,70~74세,2019,95646,45011,50635,88.9,94641,44589,50052,89.1
'23,인천광역시,'075001, 70세,2019,22001,10614,11387,93.2,21689,10483,11206,93.5
'23,인천광역시,'075002, 71세,2019,21082,10182,10900,93.4,20859,10085,10774,93.6
'23,인천광역시,'075003, 72세,2019,21282,9825,11457,85.8,21094,9742,11352,85.8
'23,인천광역시,'075004, 73세,2019,16177,7496,8681,86.3,16027,7438,8589,86.6
'23,인천광역시,'075005, 74세,2019,15104,6894,8210,84,14972,6841,8131,84.1
'23,인천광역시,'080,75~79세,2019,73266,31179,42087,74.1,72779,31011,41768,74.2
'23,인천광역시,'080001, 75세,2019,14976,6740,8236,81.8,14859,6704,8155,82.2
'23,인천광역시,'080002, 76세,2019,15321,6699,8622,77.7,15240,6682,8558,78.1
'23,인천광역시,'080003, 77세,2019,17220,7290,9930,73.4,17114,7240,9874,73.3
'23,인천광역시,'080004, 78세,2019,13642,5640,8002,70.5,13551,5609,7942,70.6
'23,인천광역시,'080005, 79세,2019,12107,4810,7297,65.9,12015,4776,7239,66
'23,인천광역시,'085,80~84세,2019,48528,17580,30948,56.8,48205,17486,30719,56.9
'23,인천광역시,'085001, 80세,2019,11881,4566,7315,62.4,11802,4550,7252,62.7
'23,인천광역시,'085002, 81세,2019,10767,4075,6692,60.9,10696,4059,6637,61.2
'23,인천광역시,'085003, 82세,2019,9226,3305,5921,55.8,9170,3280,5890,55.7
'23,인천광역시,'085004, 83세,2019,8680,2959,5721,51.7,8610,2937,5673,51.8
'23,인천광역시,'085005, 84세,2019,7974,2675,5299,50.5,7927,2660,5267,50.5
'23,인천광역시,'086,85세이상,2019,34604,8853,25751,34.4,34422,8802,25620,34.4
'23,인천광역시,'090,85~89세,2019,23659,6469,17190,37.6,23534,6443,17091,37.7
'23,인천광역시,'090001, 85세,2019,6414,1977,4437,44.6,6378,1971,4407,44.7
'23,인천광역시,'090002, 86세,2019,5532,1598,3934,40.6,5505,1595,3910,40.8
'23,인천광역시,'090003, 87세,2019,4711,1260,3451,36.5,4690,1254,3436,36.5
'23,인천광역시,'090004, 88세,2019,3660,916,2744,33.4,3640,911,2729,33.4
'23,인천광역시,'090005, 89세,2019,3342,718,2624,27.4,3321,712,2609,27.3
'23,인천광역시,'095,90~94세,2019,8679,1889,6790,27.8,8638,1876,6762,27.7
'23,인천광역시,'095001, 90세,2019,2844,687,2157,31.8,2834,683,2151,31.8
'23,인천광역시,'095002, 91세,2019,2133,468,1665,28.1,2126,466,1660,28.1
'23,인천광역시,'095003, 92세,2019,1664,353,1311,26.9,1654,351,1303,26.9
'23,인천광역시,'095004, 93세,2019,1116,221,895,24.7,1107,217,890,24.4
'23,인천광역시,'095005, 94세,2019,922,160,762,21,917,159,758,21
'23,인천광역시,'100,95~99세,2019,1993,441,1552,28.4,1981,433,1548,28
'23,인천광역시,'100001, 95세,2019,639,137,502,27.3,635,135,500,27
'23,인천광역시,'100002, 96세,2019,556,141,415,34,552,138,414,33.3
'23,인천광역시,'100003, 97세,2019,376,71,305,23.3,373,69,304,22.7
'23,인천광역시,'100004, 98세,2019,261,55,206,26.7,260,54,206,26.2
'23,인천광역시,'100005, 99세,2019,161,37,124,29.8,161,37,124,29.8
'23,인천광역시,'101,100세이상,2019,273,54,219,24.7,269,50,219,22.8
'23,인천광역시,'102,15세미만,2019,375224,192662,182562,105.5,367787,188784,179003,105.5
'23,인천광역시,'103,15~64세,2019,2198683,1127498,1071185,105.3,2110607,1076327,1034280,104.1
'23,인천광역시,'104,65세이상,2019,378330,164368,213962,76.8,373669,162427,211242,76.9
'23,인천광역시,'126,평균연령,2019,41.5,40.5,42.5,,41.7,40.7,42.7,
'23,인천광역시,'127,중위연령,2019,42.4,41.3,43.7,,42.8,41.7,44,
'23004, 읍부,'000,합계,2019,21707,10746,10961,98,21367,10585,10782,98.2
'23004, 읍부,'005,0~4세,2019,610,327,283,115.5,609,326,283,115.2
'23004, 읍부,'005001, 0세,2019,113,67,46,145.7,113,67,46,145.7
'23004, 읍부,'005002, 1세,2019,108,56,52,107.7,107,55,52,105.8
'23004, 읍부,'005003, 2세,2019,119,65,54,120.4,119,65,54,120.4
'23004, 읍부,'005004, 3세,2019,123,67,56,119.6,123,67,56,119.6
'23004, 읍부,'005005, 4세,2019,147,72,75,96,147,72,75,96
'23004, 읍부,'010,5~9세,2019,817,403,414,97.3,814,402,412,97.6
'23004, 읍부,'010001, 5세,2019,143,70,73,95.9,142,69,73,94.5
'23004, 읍부,'010002, 6세,2019,158,78,80,97.5,158,78,80,97.5
'23004, 읍부,'010003, 7세,2019,153,75,78,96.2,152,75,77,97.4
'23004, 읍부,'010004, 8세,2019,184,87,97,89.7,184,87,97,89.7
'23004, 읍부,'010005, 9세,2019,179,93,86,108.1,178,93,85,109.4
'23004, 읍부,'015,10~14세,2019,945,454,491,92.5,943,453,490,92.4
'23004, 읍부,'015001, 10세,2019,171,89,82,108.5,170,89,81,109.9
'23004, 읍부,'015002, 11세,2019,190,77,113,68.1,189,76,113,67.3
'23004, 읍부,'015003, 12세,2019,190,100,90,111.1,190,100,90,111.1
'23004, 읍부,'015004, 13세,2019,205,94,111,84.7,205,94,111,84.7
'23004, 읍부,'015005, 14세,2019,189,94,95,98.9,189,94,95,98.9
'23004, 읍부,'020,15~19세,2019,1621,805,816,98.7,1616,803,813,98.8
'23004, 읍부,'020001, 15세,2019,260,146,114,128.1,258,145,113,128.3
'23004, 읍부,'020002, 16세,2019,463,258,205,125.9,463,258,205,125.9
'23004, 읍부,'020003, 17세,2019,399,181,218,83,397,180,217,82.9
'23004, 읍부,'020004, 18세,2019,325,129,196,65.8,325,129,196,65.8
'23004, 읍부,'020005, 19세,2019,174,91,83,109.6,173,91,82,111
'23004, 읍부,'025,20~24세,2019,991,570,421,135.4,958,552,406,136
'23004, 읍부,'025001, 20세,2019,184,106,78,135.9,183,106,77,137.7
'23004, 읍부,'025002, 21세,2019,215,129,86,150,209,125,84,148.8
'23004, 읍부,'025003, 22세,2019,182,110,72,152.8,176,107,69,155.1
'23004, 읍부,'025004, 23세,2019,190,102,88,115.9,174,93,81,114.8
'23004, 읍부,'025005, 24세,2019,220,123,97,126.8,216,121,95,127.4
'23004, 읍부,'030,25~29세,2019,1090,616,474,130,1027,584,443,131.8
'23004, 읍부,'030001, 25세,2019,239,138,101,136.6,229,133,96,138.5
'23004, 읍부,'030002, 26세,2019,206,117,89,131.5,193,109,84,129.8
'23004, 읍부,'030003, 27세,2019,220,130,90,144.4,204,124,80,155
'23004, 읍부,'030004, 28세,2019,217,111,106,104.7,206,105,101,104
'23004, 읍부,'030005, 29세,2019,208,120,88,136.4,195,113,82,137.8
'23004, 읍부,'035,30~34세,2019,895,474,421,112.6,854,453,401,113
'23004, 읍부,'035001, 30세,2019,195,102,93,109.7,188,98,90,108.9
'23004, 읍부,'035002, 31세,2019,166,85,81,104.9,158,81,77,105.2
'23004, 읍부,'035003, 32세,2019,173,96,77,124.7,167,93,74,125.7
'23004, 읍부,'035004, 33세,2019,162,84,78,107.7,151,78,73,106.8
'23004, 읍부,'035005, 34세,2019,199,107,92,116.3,190,103,87,118.4
'23004, 읍부,'040,35~39세,2019,1284,643,641,100.3,1245,625,620,100.8
'23004, 읍부,'040001, 35세,2019,220,114,106,107.5,205,107,98,109.2
'23004, 읍부,'040002, 36세,2019,254,130,124,104.8,245,127,118,107.6
'23004, 읍부,'040003, 37세,2019,261,127,134,94.8,254,123,131,93.9
'23004, 읍부,'040004, 38세,2019,271,133,138,96.4,268,133,135,98.5
'23004, 읍부,'040005, 39세,2019,278,139,139,100,273,135,138,97.8
'23004, 읍부,'045,40~44세,2019,1345,672,673,99.9,1319,658,661,99.5
'23004, 읍부,'045001, 40세,2019,251,121,130,93.1,246,119,127,93.7
'23004, 읍부,'045002, 41세,2019,238,112,126,88.9,232,110,122,90.2
'23004, 읍부,'045003, 42세,2019,290,159,131,121.4,288,158,130,121.5
'23004, 읍부,'045004, 43세,2019,255,121,134,90.3,248,116,132,87.9
'23004, 읍부,'045005, 44세,2019,311,159,152,104.6,305,155,150,103.3
'23004, 읍부,'050,45~49세,2019,1762,924,838,110.3,1732,908,824,110.2
'23004, 읍부,'050001, 45세,2019,332,177,155,114.2,326,175,151,115.9
'23004, 읍부,'050002, 46세,2019,354,185,169,109.5,352,183,169,108.3
'23004, 읍부,'050003, 47세,2019,329,156,173,90.2,323,152,171,88.9
'23004, 읍부,'050004, 48세,2019,374,196,178,110.1,366,192,174,110.3
'23004, 읍부,'050005, 49세,2019,373,210,163,128.8,365,206,159,129.6
'23004, 읍부,'055,50~54세,2019,1707,870,837,103.9,1677,857,820,104.5
'23004, 읍부,'055001, 50세,2019,344,184,160,115,341,184,157,117.2
'23004, 읍부,'055002, 51세,2019,340,169,171,98.8,333,166,167,99.4
'23004, 읍부,'055003, 52세,2019,335,170,165,103,325,165,160,103.1
'23004, 읍부,'055004, 53세,2019,336,175,161,108.7,334,174,160,108.8
'23004, 읍부,'055005, 54세,2019,352,172,180,95.6,344,168,176,95.5
'23004, 읍부,'060,55~59세,2019,1903,935,968,96.6,1872,924,948,97.5
'23004, 읍부,'060001, 55세,2019,331,160,171,93.6,320,156,164,95.1
'23004, 읍부,'060002, 56세,2019,355,172,183,94,347,170,177,96
'23004, 읍부,'060003, 57세,2019,400,205,195,105.1,396,205,191,107.3
'23004, 읍부,'060004, 58세,2019,422,196,226,86.7,420,195,225,86.7
'23004, 읍부,'060005, 59세,2019,395,202,193,104.7,389,198,191,103.7
'23004, 읍부,'065,60~64세,2019,1859,912,947,96.3,1841,905,936,96.7
'23004, 읍부,'065001, 60세,2019,397,200,197,101.5,390,196,194,101
'23004, 읍부,'065002, 61세,2019,393,178,215,82.8,389,178,211,84.4
'23004, 읍부,'065003, 62세,2019,374,191,183,104.4,371,190,181,105
'23004, 읍부,'065004, 63세,2019,331,168,163,103.1,328,166,162,102.5
'23004, 읍부,'065005, 64세,2019,364,175,189,92.6,363,175,188,93.1
'23004, 읍부,'070,65~69세,2019,1332,644,688,93.6,1327,643,684,94
'23004, 읍부,'070001, 65세,2019,298,140,158,88.6,296,139,157,88.5
'23004, 읍부,'070002, 66세,2019,310,152,158,96.2,310,152,158,96.2
'23004, 읍부,'070003, 67세,2019,311,153,158,96.8,310,153,157,97.5
'23004, 읍부,'070004, 68세,2019,187,85,102,83.3,185,85,100,85
'23004, 읍부,'070005, 69세,2019,226,114,112,101.8,226,114,112,101.8
'23004, 읍부,'075,70~74세,2019,1248,558,690,80.9,1241,554,687,80.6
'23004, 읍부,'075001, 70세,2019,261,115,146,78.8,259,114,145,78.6
'23004, 읍부,'075002, 71세,2019,269,126,143,88.1,269,126,143,88.1
'23004, 읍부,'075003, 72세,2019,300,133,167,79.6,298,131,167,78.4
'23004, 읍부,'075004, 73세,2019,208,90,118,76.3,207,90,117,76.9
'23004, 읍부,'075005, 74세,2019,210,94,116,81,208,93,115,80.9
'23004, 읍부,'080,75~79세,2019,1070,474,596,79.5,1068,474,594,79.8
'23004, 읍부,'080001, 75세,2019,217,104,113,92,217,104,113,92
'23004, 읍부,'080002, 76세,2019,229,111,118,94.1,228,111,117,94.9
'23004, 읍부,'080003, 77세,2019,238,100,138,72.5,238,100,138,72.5
'23004, 읍부,'080004, 78세,2019,218,96,122,78.7,218,96,122,78.7
'23004, 읍부,'080005, 79세,2019,168,63,105,60,167,63,104,60.6
'23004, 읍부,'085,80~84세,2019,753,306,447,68.5,750,305,445,68.5
'23004, 읍부,'085001, 80세,2019,177,73,104,70.2,176,73,103,70.9
'23004, 읍부,'085002, 81세,2019,172,71,101,70.3,172,71,101,70.3
'23004, 읍부,'085003, 82세,2019,138,68,70,97.1,138,68,70,97.1
'23004, 읍부,'085004, 83세,2019,128,44,84,52.4,128,44,84,52.4
'23004, 읍부,'085005, 84세,2019,138,50,88,56.8,136,49,87,56.3
'23004, 읍부,'086,85세이상,2019,475,159,316,50.3,474,159,315,50.5
'23004, 읍부,'090,85~89세,2019,348,124,224,55.4,348,124,224,55.4
'23004, 읍부,'090001, 85세,2019,98,36,62,58.1,98,36,62,58.1
'23004, 읍부,'090002, 86세,2019,92,32,60,53.3,92,32,60,53.3
'23004, 읍부,'090003, 87세,2019,76,25,51,49,76,25,51,49
'23004, 읍부,'090004, 88세,2019,46,18,28,64.3,46,18,28,64.3
'23004, 읍부,'090005, 89세,2019,36,13,23,56.5,36,13,23,56.5
'23004, 읍부,'095,90~94세,2019,98,22,76,28.9,97,22,75,29.3
'23004, 읍부,'095001, 90세,2019,34,9,25,36,33,9,24,37.5
'23004, 읍부,'095002, 91세,2019,25,X,21,19,25,X,21,19
'23004, 읍부,'095003, 92세,2019,15,X,12,25,15,X,12,25
'23004, 읍부,'095004, 93세,2019,12,X,10,20,12,X,10,20
'23004, 읍부,'095005, 94세,2019,12,X,8,50,12,X,8,50
'23004, 읍부,'100,95~99세,2019,26,10,16,62.5,26,10,16,62.5
'23004, 읍부,'100001, 95세,2019,11,X,9,22.2,11,X,9,22.2
'23004, 읍부,'100002, 96세,2019,7,X,X,133.3,7,X,X,133.3
'23004, 읍부,'100003, 97세,2019,X,X,X,100,X,X,X,100
'23004, 읍부,'100004, 98세,2019,X,X,X,100,X,X,X,100
'23004, 읍부,'100005, 99세,2019,X,X,X,,X,X,X,
'23004, 읍부,'101,100세이상,2019,X,X,X,,X,X,X,
'23004, 읍부,'102,15세미만,2019,2372,1184,1188,99.7,2366,1181,1185,99.7
'23004, 읍부,'103,15~64세,2019,14457,7421,7036,105.5,14141,7269,6872,105.8
'23004, 읍부,'104,65세이상,2019,4878,2141,2737,78.2,4860,2135,2725,78.3
'23004, 읍부,'126,평균연령,2019,46.1,44.8,47.4,,46.2,44.9,47.5,
'23004, 읍부,'127,중위연령,2019,48.6,47.3,50.1,,48.8,47.5,50.2,
'23005, 면부,'000,합계,2019,62568,32961,29607,111.3,61343,32087,29256,109.7
'23005, 면부,'005,0~4세,2019,1258,638,620,102.9,1254,634,620,102.3
'23005, 면부,'005001, 0세,2019,269,134,135,99.3,268,133,135,98.5
'23005, 면부,'005002, 1세,2019,233,128,105,121.9,231,126,105,120
'23005, 면부,'005003, 2세,2019,214,105,109,96.3,214,105,109,96.3
'23005, 면부,'005004, 3세,2019,269,130,139,93.5,269,130,139,93.5
'23005, 면부,'005005, 4세,2019,273,141,132,106.8,272,140,132,106.1
'23005, 면부,'010,5~9세,2019,1530,792,738,107.3,1524,788,736,107.1
'23005, 면부,'010001, 5세,2019,274,130,144,90.3,271,128,143,89.5
'23005, 면부,'010002, 6세,2019,289,144,145,99.3,288,143,145,98.6
'23005, 면부,'010003, 7세,2019,323,170,153,111.1,323,170,153,111.1
'23005, 면부,'010004, 8세,2019,333,186,147,126.5,331,185,146,126.7
'23005, 면부,'010005, 9세,2019,311,162,149,108.7,311,162,149,108.7
'23005, 면부,'015,10~14세,2019,1586,847,739,114.6,1583,844,739,114.2
'23005, 면부,'015001, 10세,2019,334,189,145,130.3,333,188,145,129.7
'23005, 면부,'015002, 11세,2019,337,172,165,104.2,337,172,165,104.2
'23005, 면부,'015003, 12세,2019,314,162,152,106.6,314,162,152,106.6
'23005, 면부,'015004, 13세,2019,304,167,137,121.9,303,166,137,121.2
'23005, 면부,'015005, 14세,2019,297,157,140,112.1,296,156,140,111.4
'23005, 면부,'020,15~19세,2019,1535,850,685,124.1,1529,845,684,123.5
'23005, 면부,'020001, 15세,2019,321,148,173,85.5,319,147,172,85.5
'23005, 면부,'020002, 16세,2019,315,170,145,117.2,315,170,145,117.2
'23005, 면부,'020003, 17세,2019,279,163,116,140.5,279,163,116,140.5
'23005, 면부,'020004, 18세,2019,330,190,140,135.7,329,189,140,135
'23005, 면부,'020005, 19세,2019,290,179,111,161.3,287,176,111,158.6
'23005, 면부,'025,20~24세,2019,2531,1788,743,240.6,2386,1678,708,237
'23005, 면부,'025001, 20세,2019,387,270,117,230.8,370,257,113,227.4
'23005, 면부,'025002, 21세,2019,505,372,133,279.7,482,354,128,276.6
'23005, 면부,'025003, 22세,2019,497,354,143,247.6,475,335,140,239.3
'23005, 면부,'025004, 23세,2019,544,372,172,216.3,508,346,162,213.6
'23005, 면부,'025005, 24세,2019,598,420,178,236,551,386,165,233.9
'23005, 면부,'030,25~29세,2019,2967,1955,1012,193.2,2700,1742,958,181.8
'23005, 면부,'030001, 25세,2019,638,447,191,234,591,408,183,223
'23005, 면부,'030002, 26세,2019,610,395,215,183.7,545,343,202,169.8
'23005, 면부,'030003, 27세,2019,601,391,210,186.2,543,345,198,174.2
'23005, 면부,'030004, 28세,2019,590,371,219,169.4,547,339,208,163
'23005, 면부,'030005, 29세,2019,528,351,177,198.3,474,307,167,183.8
'23005, 면부,'035,30~34세,2019,2411,1475,936,157.6,2166,1284,882,145.6
'23005, 면부,'035001, 30세,2019,519,348,171,203.5,459,301,158,190.5
'23005, 면부,'035002, 31세,2019,496,308,188,163.8,438,260,178,146.1
'23005, 면부,'035003, 32세,2019,484,295,189,156.1,441,264,177,149.2
'23005, 면부,'035004, 33세,2019,460,274,186,147.3,413,237,176,134.7
'23005, 면부,'035005, 34세,2019,452,250,202,123.8,415,222,193,115
'23005, 면부,'040,35~39세,2019,2760,1592,1168,136.3,2595,1476,1119,131.9
'23005, 면부,'040001, 35세,2019,482,263,219,120.1,446,240,206,116.5
'23005, 면부,'040002, 36세,2019,542,314,228,137.7,498,283,215,131.6
'23005, 면부,'040003, 37세,2019,608,358,250,143.2,570,332,238,139.5
'23005, 면부,'040004, 38세,2019,556,324,232,139.7,530,303,227,133.5
'23005, 면부,'040005, 39세,2019,572,333,239,139.3,551,318,233,136.5
'23005, 면부,'045,40~44세,2019,2931,1711,1220,140.2,2837,1649,1188,138.8
'23005, 면부,'045001, 40세,2019,564,315,249,126.5,541,297,244,121.7
'23005, 면부,'045002, 41세,2019,573,340,233,145.9,554,329,225,146.2
'23005, 면부,'045003, 42세,2019,581,335,246,136.2,566,325,241,134.9
'23005, 면부,'045004, 43세,2019,598,343,255,134.5,580,332,248,133.9
'23005, 면부,'045005, 44세,2019,615,378,237,159.5,596,366,230,159.1
'23005, 면부,'050,45~49세,2019,3749,2236,1513,147.8,3663,2182,1481,147.3
'23005, 면부,'050001, 45세,2019,675,414,261,158.6,653,401,252,159.1
'23005, 면부,'050002, 46세,2019,728,445,283,157.2,714,436,278,156.8
'23005, 면부,'050003, 47세,2019,735,444,291,152.6,718,436,282,154.6
'23005, 면부,'050004, 48세,2019,820,472,348,135.6,805,461,344,134
'23005, 면부,'050005, 49세,2019,791,461,330,139.7,773,448,325,137.8
'23005, 면부,'055,50~54세,2019,4752,2527,2225,113.6,4686,2490,2196,113.4
'23005, 면부,'055001, 50세,2019,869,469,400,117.3,855,462,393,117.6
'23005, 면부,'055002, 51세,2019,912,482,430,112.1,900,475,425,111.8
'23005, 면부,'055003, 52세,2019,904,491,413,118.9,890,483,407,118.7
'23005, 면부,'055004, 53세,2019,955,519,436,119,942,511,431,118.6
'23005, 면부,'055005, 54세,2019,1112,566,546,103.7,1099,559,540,103.5
'23005, 면부,'060,55~59세,2019,6719,3476,3243,107.2,6672,3448,3224,106.9
'23005, 면부,'060001, 55세,2019,1034,553,481,115,1020,548,472,116.1
'23005, 면부,'060002, 56세,2019,1173,616,557,110.6,1162,609,553,110.1
'23005, 면부,'060003, 57세,2019,1375,707,668,105.8,1365,699,666,105
'23005, 면부,'060004, 58세,2019,1532,794,738,107.6,1529,791,738,107.2
'23005, 면부,'060005, 59세,2019,1605,806,799,100.9,1596,801,795,100.8
'23005, 면부,'065,60~64세,2019,7367,3731,3636,102.6,7323,3711,3612,102.7
'23005, 면부,'065001, 60세,2019,1584,784,800,98,1575,781,794,98.4
'23005, 면부,'065002, 61세,2019,1452,744,708,105.1,1445,742,703,105.5
'23005, 면부,'065003, 62세,2019,1439,749,690,108.6,1437,747,690,108.3
'23005, 면부,'065004, 63세,2019,1428,702,726,96.7,1418,697,721,96.7
'23005, 면부,'065005, 64세,2019,1464,752,712,105.6,1448,744,704,105.7
'23005, 면부,'070,65~69세,2019,5346,2710,2636,102.8,5326,2699,2627,102.7
'23005, 면부,'070001, 65세,2019,1176,595,581,102.4,1171,593,578,102.6
'23005, 면부,'070002, 66세,2019,1135,594,541,109.8,1133,593,540,109.8
'23005, 면부,'070003, 67세,2019,1220,598,622,96.1,1214,594,620,95.8
'23005, 면부,'070004, 68세,2019,777,388,389,99.7,773,385,388,99.2
'23005, 면부,'070005, 69세,2019,1038,535,503,106.4,1035,534,501,106.6
'23005, 면부,'075,70~74세,2019,4898,2468,2430,101.6,4883,2459,2424,101.4
'23005, 면부,'075001, 70세,2019,1030,550,480,114.6,1024,545,479,113.8
'23005, 면부,'075002, 71세,2019,983,504,479,105.2,978,503,475,105.9
'23005, 면부,'075003, 72세,2019,1162,570,592,96.3,1160,569,591,96.3
'23005, 면부,'075004, 73세,2019,905,443,462,95.9,904,442,462,95.7
'23005, 면부,'075005, 74세,2019,818,401,417,96.2,817,400,417,95.9
'23005, 면부,'080,75~79세,2019,4220,1973,2247,87.8,4215,1970,2245,87.8
'23005, 면부,'080001, 75세,2019,811,368,443,83.1,811,368,443,83.1
'23005, 면부,'080002, 76세,2019,917,443,474,93.5,916,442,474,93.2
'23005, 면부,'080003, 77세,2019,946,439,507,86.6,945,439,506,86.8
'23005, 면부,'080004, 78세,2019,825,381,444,85.8,824,380,444,85.6
'23005, 면부,'080005, 79세,2019,721,342,379,90.2,719,341,378,90.2
'23005, 면부,'085,80~84세,2019,3321,1405,1916,73.3,3317,1403,1914,73.3
'23005, 면부,'085001, 80세,2019,730,313,417,75.1,730,313,417,75.1
'23005, 면부,'085002, 81세,2019,692,328,364,90.1,691,327,364,89.8
'23005, 면부,'085003, 82세,2019,633,258,375,68.8,631,257,374,68.7
'23005, 면부,'085004, 83세,2019,682,274,408,67.2,681,274,407,67.3
'23005, 면부,'085005, 84세,2019,584,232,352,65.9,584,232,352,65.9
'23005, 면부,'086,85세이상,2019,2687,787,1900,41.4,2684,785,1899,41.3
'23005, 면부,'090,85~89세,2019,1838,579,1259,46,1837,578,1259,45.9
'23005, 면부,'090001, 85세,2019,492,177,315,56.2,492,177,315,56.2
'23005, 면부,'090002, 86세,2019,420,153,267,57.3,420,153,267,57.3
'23005, 면부,'090003, 87세,2019,383,105,278,37.8,383,105,278,37.8
'23005, 면부,'090004, 88세,2019,295,82,213,38.5,294,81,213,38
'23005, 면부,'090005, 89세,2019,248,62,186,33.3,248,62,186,33.3
'23005, 면부,'095,90~94세,2019,660,153,507,30.2,658,152,506,30
'23005, 면부,'095001, 90세,2019,200,53,147,36.1,200,53,147,36.1
'23005, 면부,'095002, 91세,2019,162,39,123,31.7,162,39,123,31.7
'23005, 면부,'095003, 92세,2019,124,27,97,27.8,123,26,97,26.8
'23005, 면부,'095004, 93세,2019,90,17,73,23.3,89,17,72,23.6
'23005, 면부,'095005, 94세,2019,84,17,67,25.4,84,17,67,25.4
'23005, 면부,'100,95~99세,2019,162,49,113,43.4,162,49,113,43.4
'23005, 면부,'100001, 95세,2019,61,16,45,35.6,61,16,45,35.6
'23005, 면부,'100002, 96세,2019,40,14,26,53.8,40,14,26,53.8
'23005, 면부,'100003, 97세,2019,28,6,22,27.3,28,6,22,27.3
'23005, 면부,'100004, 98세,2019,19,7,12,58.3,19,7,12,58.3
'23005, 면부,'100005, 99세,2019,14,6,8,75,14,6,8,75
'23005, 면부,'101,100세이상,2019,27,6,21,28.6,27,6,21,28.6
'23005, 면부,'102,15세미만,2019,4374,2277,2097,108.6,4361,2266,2095,108.2
'23005, 면부,'103,15~64세,2019,37722,21341,16381,130.3,36557,20505,16052,127.7
'23005, 면부,'104,65세이상,2019,20472,9343,11129,84,20425,9316,11109,83.9
'23005, 면부,'126,평균연령,2019,53.3,51,56,,53.7,51.4,56.2,
'23005, 면부,'127,중위연령,2019,57.8,55.1,60,,58.1,55.8,60.1,
'23003, 동부,'000,합계,2019,2867962,1440821,1427141,101,2769353,1384866,1384487,100
'23003, 동부,'005,0~4세,2019,109452,56136,53316,105.3,105728,54203,51525,105.2
'23003, 동부,'005001, 0세,2019,18628,9605,9023,106.5,17961,9274,8687,106.8
'23003, 동부,'005002, 1세,2019,19478,10036,9442,106.3,18690,9608,9082,105.8
'23003, 동부,'005003, 2세,2019,21396,11011,10385,106,20633,10606,10027,105.8
'23003, 동부,'005004, 3세,2019,24270,12358,11912,103.7,23443,11930,11513,103.6
'23003, 동부,'005005, 4세,2019,25680,13126,12554,104.6,25001,12785,12216,104.7
'23003, 동부,'010,5~9세,2019,131339,67450,63889,105.6,129010,66256,62754,105.6
'23003, 동부,'010001, 5세,2019,25249,12941,12308,105.1,24614,12616,11998,105.2
'23003, 동부,'010002, 6세,2019,25334,12923,12411,104.1,24846,12689,12157,104.4
'23003, 동부,'010003, 7세,2019,27457,14088,13369,105.4,26987,13852,13135,105.5
'23003, 동부,'010004, 8세,2019,27362,14176,13186,107.5,26960,13951,13009,107.2
'23003, 동부,'010005, 9세,2019,25937,13322,12615,105.6,25603,13148,12455,105.6
'23003, 동부,'015,10~14세,2019,127687,65615,62072,105.7,126322,64878,61444,105.6
'23003, 동부,'015001, 10세,2019,25309,12969,12340,105.1,25008,12819,12189,105.2
'23003, 동부,'015002, 11세,2019,26400,13457,12943,104,26089,13277,12812,103.6
'23003, 동부,'015003, 12세,2019,27284,14054,13230,106.2,27021,13916,13105,106.2
'23003, 동부,'015004, 13세,2019,24630,12756,11874,107.4,24389,12617,11772,107.2
'23003, 동부,'015005, 14세,2019,24064,12379,11685,105.9,23815,12249,11566,105.9
'23003, 동부,'020,15~19세,2019,144848,74454,70394,105.8,141786,72966,68820,106
'23003, 동부,'020001, 15세,2019,26027,13361,12666,105.5,25826,13274,12552,105.8
'23003, 동부,'020002, 16세,2019,26571,13659,12912,105.8,26388,13568,12820,105.8
'23003, 동부,'020003, 17세,2019,27238,14173,13065,108.5,27000,14042,12958,108.4
'23003, 동부,'020004, 18세,2019,31164,16016,15148,105.7,30469,15690,14779,106.2
'23003, 동부,'020005, 19세,2019,33848,17245,16603,103.9,32103,16392,15711,104.3
'23003, 동부,'025,20~24세,2019,183669,96357,87312,110.4,175369,91466,83903,109
'23003, 동부,'025001, 20세,2019,33080,17650,15430,114.4,31791,16954,14837,114.3
'23003, 동부,'025002, 21세,2019,34583,18653,15930,117.1,33151,17822,15329,116.3
'23003, 동부,'025003, 22세,2019,36760,19271,17489,110.2,35105,18268,16837,108.5
'23003, 동부,'025004, 23세,2019,38814,19927,18887,105.5,36936,18804,18132,103.7
'23003, 동부,'025005, 24세,2019,40432,20856,19576,106.5,38386,19618,18768,104.5
'23003, 동부,'030,25~29세,2019,213467,112752,100715,112,200549,104826,95723,109.5
'23003, 동부,'030001, 25세,2019,42259,22369,19890,112.5,40143,21063,19080,110.4
'23003, 동부,'030002, 26세,2019,43822,23207,20615,112.6,41469,21747,19722,110.3
'23003, 동부,'030003, 27세,2019,44713,23383,21330,109.6,42153,21771,20382,106.8
'23003, 동부,'030004, 28세,2019,42558,22539,20019,112.6,39758,20877,18881,110.6
'23003, 동부,'030005, 29세,2019,40115,21254,18861,112.7,37026,19368,17658,109.7
'23003, 동부,'035,30~34세,2019,192468,101312,91156,111.1,176634,91502,85132,107.5
'23003, 동부,'035001, 30세,2019,38717,20404,18313,111.4,35714,18554,17160,108.1
'23003, 동부,'035002, 31세,2019,37771,19822,17949,110.4,34463,17800,16663,106.8
'23003, 동부,'035003, 32세,2019,37756,19754,18002,109.7,34485,17708,16777,105.5
'23003, 동부,'035004, 33세,2019,38925,20575,18350,112.1,35701,18584,17117,108.6
'23003, 동부,'035005, 34세,2019,39299,20757,18542,111.9,36271,18856,17415,108.3
'23003, 동부,'040,35~39세,2019,235511,122316,113195,108.1,223103,114605,108498,105.6
'23003, 동부,'040001, 35세,2019,40824,21310,19514,109.2,38049,19608,18441,106.3
'23003, 동부,'040002, 36세,2019,45479,23495,21984,106.9,42803,21801,21002,103.8
'23003, 동부,'040003, 37세,2019,49427,25663,23764,108,46807,24027,22780,105.5
'23003, 동부,'040004, 38세,2019,49440,25891,23549,109.9,47181,24490,22691,107.9
'23003, 동부,'040005, 39세,2019,50341,25957,24384,106.5,48263,24679,23584,104.6
'23003, 동부,'045,40~44세,2019,223907,115510,108397,106.6,215441,110364,105077,105
'23003, 동부,'045001, 40세,2019,47726,24868,22858,108.8,45608,23560,22048,106.9
'23003, 동부,'045002, 41세,2019,43612,22374,21238,105.3,41767,21250,20517,103.6
'23003, 동부,'045003, 42세,2019,44250,22819,21431,106.5,42647,21831,20816,104.9
'23003, 동부,'045004, 43세,2019,42696,22056,20640,106.9,41220,21173,20047,105.6
'23003, 동부,'045005, 44세,2019,45623,23393,22230,105.2,44199,22550,21649,104.2
'23003, 동부,'050,45~49세,2019,253166,128130,125036,102.5,245383,123748,121635,101.7
'23003, 동부,'050001, 45세,2019,49144,25308,23836,106.2,47715,24456,23259,105.1
'23003, 동부,'050002, 46세,2019,49859,24949,24910,100.2,48280,24055,24225,99.3
'23003, 동부,'050003, 47세,2019,50066,25456,24610,103.4,48494,24587,23907,102.8
'23003, 동부,'050004, 48세,2019,52785,26641,26144,101.9,51172,25757,25415,101.3
'23003, 동부,'050005, 49세,2019,51312,25776,25536,100.9,49722,24893,24829,100.3
'23003, 동부,'055,50~54세,2019,249962,123049,126913,97,243130,119494,123636,96.6
'23003, 동부,'055001, 50세,2019,52332,25728,26604,96.7,50840,24952,25888,96.4
'23003, 동부,'055002, 51세,2019,52483,25572,26911,95,50966,24766,26200,94.5
'23003, 동부,'055003, 52세,2019,47677,23317,24360,95.7,46541,22710,23831,95.3
'23003, 동부,'055004, 53세,2019,47280,23625,23655,99.9,46026,22997,23029,99.9
'23003, 동부,'055005, 54세,2019,50190,24807,25383,97.7,48757,24069,24688,97.5
'23003, 동부,'060,55~59세,2019,250374,125717,124657,100.9,244114,122709,121405,101.1
'23003, 동부,'060001, 55세,2019,46766,23292,23474,99.2,45332,22590,22742,99.3
'23003, 동부,'060002, 56세,2019,49542,25035,24507,102.2,48009,24301,23708,102.5
'23003, 동부,'060003, 57세,2019,49706,24960,24746,100.9,48507,24366,24141,100.9
'23003, 동부,'060004, 58세,2019,52624,26514,26110,101.5,51765,26126,25639,101.9
'23003, 동부,'060005, 59세,2019,51736,25916,25820,100.4,50501,25326,25175,100.6
'23003, 동부,'065,60~64세,2019,199132,99139,99993,99.1,194400,96873,97527,99.3
'23003, 동부,'065001, 60세,2019,45232,22636,22596,100.2,44225,22132,22093,100.2
'23003, 동부,'065002, 61세,2019,42429,21328,21101,101.1,41366,20798,20568,101.1
'23003, 동부,'065003, 62세,2019,40117,20104,20013,100.5,39099,19614,19485,100.7
'23003, 동부,'065004, 63세,2019,35454,17534,17920,97.8,34617,17157,17460,98.3
'23003, 동부,'065005, 64세,2019,35900,17537,18363,95.5,35093,17172,17921,95.8
'23003, 동부,'070,65~69세,2019,119608,58391,61217,95.4,116969,57197,59772,95.7
'23003, 동부,'070001, 65세,2019,29171,14274,14897,95.8,28449,13946,14503,96.2
'23003, 동부,'070002, 66세,2019,24993,12158,12835,94.7,24378,11879,12499,95
'23003, 동부,'070003, 67세,2019,27044,13248,13796,96,26505,13004,13501,96.3
'23003, 동부,'070004, 68세,2019,18027,8768,9259,94.7,17620,8570,9050,94.7
'23003, 동부,'070005, 69세,2019,20373,9943,10430,95.3,20017,9798,10219,95.9
'23003, 동부,'075,70~74세,2019,89500,41985,47515,88.4,88517,41576,46941,88.6
'23003, 동부,'075001, 70세,2019,20710,9949,10761,92.5,20406,9824,10582,92.8
'23003, 동부,'075002, 71세,2019,19830,9552,10278,92.9,19612,9456,10156,93.1
'23003, 동부,'075003, 72세,2019,19820,9122,10698,85.3,19636,9042,10594,85.4
'23003, 동부,'075004, 73세,2019,15064,6963,8101,86,14916,6906,8010,86.2
'23003, 동부,'075005, 74세,2019,14076,6399,7677,83.4,13947,6348,7599,83.5
'23003, 동부,'080,75~79세,2019,67976,28732,39244,73.2,67496,28567,38929,73.4
'23003, 동부,'080001, 75세,2019,13948,6268,7680,81.6,13831,6232,7599,82
'23003, 동부,'080002, 76세,2019,14175,6145,8030,76.5,14096,6129,7967,76.9
'23003, 동부,'080003, 77세,2019,16036,6751,9285,72.7,15931,6701,9230,72.6
'23003, 동부,'080004, 78세,2019,12599,5163,7436,69.4,12509,5133,7376,69.6
'23003, 동부,'080005, 79세,2019,11218,4405,6813,64.7,11129,4372,6757,64.7
'23003, 동부,'085,80~84세,2019,44454,15869,28585,55.5,44138,15778,28360,55.6
'23003, 동부,'085001, 80세,2019,10974,4180,6794,61.5,10896,4164,6732,61.9
'23003, 동부,'085002, 81세,2019,9903,3676,6227,59,9833,3661,6172,59.3
'23003, 동부,'085003, 82세,2019,8455,2979,5476,54.4,8401,2955,5446,54.3
'23003, 동부,'085004, 83세,2019,7870,2641,5229,50.5,7801,2619,5182,50.5
'23003, 동부,'085005, 84세,2019,7252,2393,4859,49.2,7207,2379,4828,49.3
'23003, 동부,'086,85세이상,2019,31442,7907,23535,33.6,31264,7858,23406,33.6
'23003, 동부,'090,85~89세,2019,21473,5766,15707,36.7,21349,5741,15608,36.8
'23003, 동부,'090001, 85세,2019,5824,1764,4060,43.4,5788,1758,4030,43.6
'23003, 동부,'090002, 86세,2019,5020,1413,3607,39.2,4993,1410,3583,39.4
'23003, 동부,'090003, 87세,2019,4252,1130,3122,36.2,4231,1124,3107,36.2
'23003, 동부,'090004, 88세,2019,3319,816,2503,32.6,3300,812,2488,32.6
'23003, 동부,'090005, 89세,2019,3058,643,2415,26.6,3037,637,2400,26.5
'23003, 동부,'095,90~94세,2019,7921,1714,6207,27.6,7883,1702,6181,27.5
'23003, 동부,'095001, 90세,2019,2610,625,1985,31.5,2601,621,1980,31.4
'23003, 동부,'095002, 91세,2019,1946,425,1521,27.9,1939,423,1516,27.9
'23003, 동부,'095003, 92세,2019,1525,323,1202,26.9,1516,322,1194,27
'23003, 동부,'095004, 93세,2019,1014,202,812,24.9,1006,198,808,24.5
'23003, 동부,'095005, 94세,2019,826,139,687,20.2,821,138,683,20.2
'23003, 동부,'100,95~99세,2019,1805,382,1423,26.8,1793,374,1419,26.4
'23003, 동부,'100001, 95세,2019,567,119,448,26.6,563,117,446,26.2
'23003, 동부,'100002, 96세,2019,509,123,386,31.9,505,120,385,31.2
'23003, 동부,'100003, 97세,2019,344,63,281,22.4,341,61,280,21.8
'23003, 동부,'100004, 98세,2019,238,46,192,24,237,45,192,23.4
'23003, 동부,'100005, 99세,2019,147,31,116,26.7,147,31,116,26.7
'23003, 동부,'101,100세이상,2019,243,45,198,22.7,239,41,198,20.7
'23003, 동부,'102,15세미만,2019,368478,189201,179277,105.5,361060,185337,175723,105.5
'23003, 동부,'103,15~64세,2019,2146504,1098736,1047768,104.9,2059909,1048553,1011356,103.7
'23003, 동부,'104,65세이상,2019,352980,152884,200096,76.4,348384,150976,197408,76.5
'23003, 동부,'126,평균연령,2019,41.2,40.3,42.2,,41.4,40.4,42.3,
'23003, 동부,'127,중위연령,2019,42.1,41,43.3,,42.4,41.4,43.6,
'23010, 중구,'000,합계,2019,131863,68277,63586,107.4,126612,65455,61157,107
'23010, 중구,'005,0~4세,2019,5440,2850,2590,110,5329,2792,2537,110.1
'23010, 중구,'005001, 0세,2019,933,496,437,113.5,920,493,427,115.5
'23010, 중구,'005002, 1세,2019,970,521,449,116,952,511,441,115.9
'23010, 중구,'005003, 2세,2019,1065,551,514,107.2,1043,539,504,106.9
'23010, 중구,'005004, 3세,2019,1191,603,588,102.6,1158,583,575,101.4
'23010, 중구,'005005, 4세,2019,1281,679,602,112.8,1256,666,590,112.9
'23010, 중구,'010,5~9세,2019,6424,3280,3144,104.3,6328,3232,3096,104.4
'23010, 중구,'010001, 5세,2019,1227,610,617,98.9,1208,603,605,99.7
'23010, 중구,'010002, 6세,2019,1312,664,648,102.5,1284,652,632,103.2
'23010, 중구,'010003, 7세,2019,1343,663,680,97.5,1327,655,672,97.5
'23010, 중구,'010004, 8세,2019,1298,683,615,111.1,1282,674,608,110.9
'23010, 중구,'010005, 9세,2019,1244,660,584,113,1227,648,579,111.9
'23010, 중구,'015,10~14세,2019,5988,3083,2905,106.1,5904,3041,2863,106.2
'23010, 중구,'015001, 10세,2019,1151,587,564,104.1,1132,578,554,104.3
'23010, 중구,'015002, 11세,2019,1235,601,634,94.8,1223,597,626,95.4
'23010, 중구,'015003, 12세,2019,1333,713,620,115,1319,706,613,115.2
'23010, 중구,'015004, 13세,2019,1147,594,553,107.4,1125,583,542,107.6
'23010, 중구,'015005, 14세,2019,1122,588,534,110.1,1105,577,528,109.3
'23010, 중구,'020,15~19세,2019,6509,3528,2981,118.3,6389,3476,2913,119.3
'23010, 중구,'020001, 15세,2019,1306,678,628,108,1288,670,618,108.4
'23010, 중구,'020002, 16세,2019,1484,851,633,134.4,1458,841,617,136.3
'23010, 중구,'020003, 17세,2019,1365,781,584,133.7,1340,771,569,135.5
'23010, 중구,'020004, 18세,2019,1381,714,667,107,1358,708,650,108.9
'23010, 중구,'020005, 19세,2019,973,504,469,107.5,945,486,459,105.9
'23010, 중구,'025,20~24세,2019,6931,3322,3609,92,6623,3143,3480,90.3
'23010, 중구,'025001, 20세,2019,1031,551,480,114.8,992,531,461,115.2
'23010, 중구,'025002, 21세,2019,1252,638,614,103.9,1212,616,596,103.4
'23010, 중구,'025003, 22세,2019,1320,639,681,93.8,1258,599,659,90.9
'23010, 중구,'025004, 23세,2019,1580,711,869,81.8,1496,660,836,78.9
'23010, 중구,'025005, 24세,2019,1748,783,965,81.1,1665,737,928,79.4
'23010, 중구,'030,25~29세,2019,10633,5813,4820,120.6,10020,5472,4548,120.3
'23010, 중구,'030001, 25세,2019,2052,1074,978,109.8,1951,1013,938,108
'23010, 중구,'030002, 26세,2019,2251,1168,1083,107.8,2135,1109,1026,108.1
'23010, 중구,'030003, 27세,2019,2213,1204,1009,119.3,2088,1131,957,118.2
'23010, 중구,'030004, 28세,2019,2126,1191,935,127.4,2009,1127,882,127.8
'23010, 중구,'030005, 29세,2019,1991,1176,815,144.3,1837,1092,745,146.6
'23010, 중구,'035,30~34세,2019,9318,5069,4249,119.3,8620,4664,3956,117.9
'23010, 중구,'035001, 30세,2019,1861,1036,825,125.6,1723,956,767,124.6
'23010, 중구,'035002, 31세,2019,1799,997,802,124.3,1670,923,747,123.6
'23010, 중구,'035003, 32세,2019,1874,1041,833,125,1711,946,765,123.7
'23010, 중구,'035004, 33세,2019,1901,1001,900,111.2,1755,918,837,109.7
'23010, 중구,'035005, 34세,2019,1883,994,889,111.8,1761,921,840,109.6
'23010, 중구,'040,35~39세,2019,11636,6256,5380,116.3,10948,5866,5082,115.4
'23010, 중구,'040001, 35세,2019,1925,1037,888,116.8,1793,964,829,116.3
'23010, 중구,'040002, 36세,2019,2236,1217,1019,119.4,2094,1127,967,116.5
'23010, 중구,'040003, 37세,2019,2531,1329,1202,110.6,2373,1241,1132,109.6
'23010, 중구,'040004, 38세,2019,2453,1308,1145,114.2,2311,1239,1072,115.6
'23010, 중구,'040005, 39세,2019,2491,1365,1126,121.2,2377,1295,1082,119.7
'23010, 중구,'045,40~44세,2019,11307,6130,5177,118.4,10816,5838,4978,117.3
'23010, 중구,'045001, 40세,2019,2377,1287,1090,118.1,2260,1216,1044,116.5
'23010, 중구,'045002, 41세,2019,2333,1243,1090,114,2216,1172,1044,112.3
'23010, 중구,'045003, 42세,2019,2219,1211,1008,120.1,2118,1151,967,119
'23010, 중구,'045004, 43세,2019,2171,1180,991,119.1,2099,1141,958,119.1
'23010, 중구,'045005, 44세,2019,2207,1209,998,121.1,2123,1158,965,120
'23010, 중구,'050,45~49세,2019,11622,6491,5131,126.5,11137,6202,4935,125.7
'23010, 중구,'050001, 45세,2019,2347,1322,1025,129,2255,1262,993,127.1
'23010, 중구,'050002, 46세,2019,2369,1271,1098,115.8,2261,1209,1052,114.9
'23010, 중구,'050003, 47세,2019,2308,1279,1029,124.3,2213,1223,990,123.5
'23010, 중구,'050004, 48세,2019,2365,1357,1008,134.6,2277,1304,973,134
'23010, 중구,'050005, 49세,2019,2233,1262,971,130,2131,1204,927,129.9
'23010, 중구,'055,50~54세,2019,9792,5349,4443,120.4,9378,5149,4229,121.8
'23010, 중구,'055001, 50세,2019,2129,1161,968,119.9,2045,1122,923,121.6
'23010, 중구,'055002, 51세,2019,2164,1168,996,117.3,2069,1119,950,117.8
'23010, 중구,'055003, 52세,2019,1822,1035,787,131.5,1757,1000,757,132.1
'23010, 중구,'055004, 53세,2019,1770,952,818,116.4,1688,915,773,118.4
'23010, 중구,'055005, 54세,2019,1907,1033,874,118.2,1819,993,826,120.2
'23010, 중구,'060,55~59세,2019,9209,4776,4433,107.7,8807,4591,4216,108.9
'23010, 중구,'060001, 55세,2019,1717,928,789,117.6,1632,883,749,117.9
'23010, 중구,'060002, 56세,2019,1853,947,906,104.5,1760,903,857,105.4
'23010, 중구,'060003, 57세,2019,1799,944,855,110.4,1716,904,812,111.3
'23010, 중구,'060004, 58세,2019,1936,964,972,99.2,1869,941,928,101.4
'23010, 중구,'060005, 59세,2019,1904,993,911,109,1830,960,870,110.3
'23010, 중구,'065,60~64세,2019,8635,4263,4372,97.5,8316,4107,4209,97.6
'23010, 중구,'065001, 60세,2019,1805,894,911,98.1,1724,852,872,97.7
'23010, 중구,'065002, 61세,2019,1791,892,899,99.2,1729,862,867,99.4
'23010, 중구,'065003, 62세,2019,1716,860,856,100.5,1660,832,828,100.5
'23010, 중구,'065004, 63세,2019,1583,784,799,98.1,1523,754,769,98
'23010, 중구,'065005, 64세,2019,1740,833,907,91.8,1680,807,873,92.4
'23010, 중구,'070,65~69세,2019,5865,2828,3037,93.1,5637,2728,2909,93.8
'23010, 중구,'070001, 65세,2019,1467,705,762,92.5,1402,678,724,93.6
'23010, 중구,'070002, 66세,2019,1199,582,617,94.3,1150,566,584,96.9
'23010, 중구,'070003, 67세,2019,1303,630,673,93.6,1253,605,648,93.4
'23010, 중구,'070004, 68세,2019,832,389,443,87.8,796,369,427,86.4
'23010, 중구,'070005, 69세,2019,1064,522,542,96.3,1036,510,526,97
'23010, 중구,'075,70~74세,2019,4934,2273,2661,85.4,4832,2227,2605,85.5
'23010, 중구,'075001, 70세,2019,1132,490,642,76.3,1098,474,624,76
'23010, 중구,'075002, 71세,2019,1054,498,556,89.6,1032,487,545,89.4
'23010, 중구,'075003, 72세,2019,1125,528,597,88.4,1105,517,588,87.9
'23010, 중구,'075004, 73세,2019,835,380,455,83.5,825,376,449,83.7
'23010, 중구,'075005, 74세,2019,788,377,411,91.7,772,373,399,93.5
'23010, 중구,'080,75~79세,2019,3684,1652,2032,81.3,3632,1627,2005,81.1
'23010, 중구,'080001, 75세,2019,796,396,400,99,784,391,393,99.5
'23010, 중구,'080002, 76세,2019,756,358,398,89.9,748,353,395,89.4
'23010, 중구,'080003, 77세,2019,899,367,532,69,886,361,525,68.8
'23010, 중구,'080004, 78세,2019,666,294,372,79,655,290,365,79.5
'23010, 중구,'080005, 79세,2019,567,237,330,71.8,559,232,327,70.9
'23010, 중구,'085,80~84세,2019,2253,868,1385,62.7,2228,861,1367,63
'23010, 중구,'085001, 80세,2019,589,224,365,61.4,585,224,361,62
'23010, 중구,'085002, 81세,2019,504,202,302,66.9,500,200,300,66.7
'23010, 중구,'085003, 82세,2019,406,163,243,67.1,399,159,240,66.3
'23010, 중구,'085004, 83세,2019,380,157,223,70.4,374,156,218,71.6
'23010, 중구,'085005, 84세,2019,374,122,252,48.4,370,122,248,49.2
'23010, 중구,'086,85세이상,2019,1683,446,1237,36.1,1668,439,1229,35.7
'23010, 중구,'090,85~89세,2019,1105,302,803,37.6,1097,301,796,37.8
'23010, 중구,'090001, 85세,2019,293,84,209,40.2,290,84,206,40.8
'23010, 중구,'090002, 86세,2019,232,73,159,45.9,232,73,159,45.9
'23010, 중구,'090003, 87세,2019,249,62,187,33.2,247,62,185,33.5
'23010, 중구,'090004, 88세,2019,178,48,130,36.9,176,48,128,37.5
'23010, 중구,'090005, 89세,2019,153,35,118,29.7,152,34,118,28.8
'23010, 중구,'095,90~94세,2019,449,112,337,33.2,446,109,337,32.3
'23010, 중구,'095001, 90세,2019,141,34,107,31.8,140,33,107,30.8
'23010, 중구,'095002, 91세,2019,101,24,77,31.2,100,23,77,29.9
'23010, 중구,'095003, 92세,2019,94,25,69,36.2,94,25,69,36.2
'23010, 중구,'095004, 93세,2019,63,18,45,40,63,18,45,40
'23010, 중구,'095005, 94세,2019,50,11,39,28.2,49,10,39,25.6
'23010, 중구,'100,95~99세,2019,111,25,86,29.1,109,24,85,28.2
'23010, 중구,'100001, 95세,2019,37,9,28,32.1,36,8,28,28.6
'23010, 중구,'100002, 96세,2019,27,7,20,35,27,7,20,35
'23010, 중구,'100003, 97세,2019,26,X,22,18.2,25,X,21,19
'23010, 중구,'100004, 98세,2019,9,X,7,28.6,9,X,7,28.6
'23010, 중구,'100005, 99세,2019,12,X,9,33.3,12,X,9,33.3
'23010, 중구,'101,100세이상,2019,18,7,11,63.6,16,5,11,45.5
'23010, 중구,'102,15세미만,2019,17852,9213,8639,106.6,17561,9065,8496,106.7
'23010, 중구,'103,15~64세,2019,95592,50997,44595,114.4,91054,48508,42546,114
'23010, 중구,'104,65세이상,2019,18419,8067,10352,77.9,17997,7882,10115,77.9
'23010, 중구,'126,평균연령,2019,41.2,40.3,42.1,,41.2,40.3,42.1,
'23010, 중구,'127,중위연령,2019,41.3,40.7,41.9,,41.4,40.9,42,
'23020, 동구,'000,합계,2019,63003,31760,31243,101.7,61744,31053,30691,101.2
'23020, 동구,'005,0~4세,2019,1881,980,901,108.8,1862,975,887,109.9
'23020, 동구,'005001, 0세,2019,328,161,167,96.4,325,160,165,97
'23020, 동구,'005002, 1세,2019,309,167,142,117.6,306,166,140,118.6
'23020, 동구,'005003, 2세,2019,351,168,183,91.8,344,167,177,94.4
'23020, 동구,'005004, 3세,2019,428,231,197,117.3,424,229,195,117.4
'23020, 동구,'005005, 4세,2019,465,253,212,119.3,463,253,210,120.5
'23020, 동구,'010,5~9세,2019,2477,1281,1196,107.1,2456,1274,1182,107.8
'23020, 동구,'010001, 5세,2019,457,248,209,118.7,452,245,207,118.4
'23020, 동구,'010002, 6세,2019,477,241,236,102.1,471,239,232,103
'23020, 동구,'010003, 7세,2019,524,278,246,113,523,278,245,113.5
'23020, 동구,'010004, 8세,2019,496,257,239,107.5,494,255,239,106.7
'23020, 동구,'010005, 9세,2019,523,257,266,96.6,516,257,259,99.2
'23020, 동구,'015,10~14세,2019,2431,1251,1180,106,2418,1247,1171,106.5
'23020, 동구,'015001, 10세,2019,472,225,247,91.1,471,225,246,91.5
'23020, 동구,'015002, 11세,2019,480,255,225,113.3,478,254,224,113.4
'23020, 동구,'015003, 12세,2019,563,284,279,101.8,561,284,277,102.5
'23020, 동구,'015004, 13세,2019,445,241,204,118.1,441,240,201,119.4
'23020, 동구,'015005, 14세,2019,471,246,225,109.3,467,244,223,109.4
'23020, 동구,'020,15~19세,2019,2643,1378,1265,108.9,2622,1367,1255,108.9
'23020, 동구,'020001, 15세,2019,511,266,245,108.6,507,265,242,109.5
'23020, 동구,'020002, 16세,2019,495,250,245,102,495,250,245,102
'23020, 동구,'020003, 17세,2019,520,274,246,111.4,513,270,243,111.1
'23020, 동구,'020004, 18세,2019,533,279,254,109.8,530,277,253,109.5
'23020, 동구,'020005, 19세,2019,584,309,275,112.4,577,305,272,112.1
'23020, 동구,'025,20~24세,2019,3301,1785,1516,117.7,3210,1723,1487,115.9
'23020, 동구,'025001, 20세,2019,605,338,267,126.6,592,330,262,126
'23020, 동구,'025002, 21세,2019,651,344,307,112.1,636,335,301,111.3
'23020, 동구,'025003, 22세,2019,674,356,318,111.9,659,347,312,111.2
'23020, 동구,'025004, 23세,2019,683,375,308,121.8,663,361,302,119.5
'23020, 동구,'025005, 24세,2019,688,372,316,117.7,660,350,310,112.9
'23020, 동구,'030,25~29세,2019,3409,1894,1515,125,3249,1778,1471,120.9
'23020, 동구,'030001, 25세,2019,661,386,275,140.4,639,370,269,137.5
'23020, 동구,'030002, 26세,2019,698,389,309,125.9,661,361,300,120.3
'23020, 동구,'030003, 27세,2019,703,381,322,118.3,666,352,314,112.1
'23020, 동구,'030004, 28세,2019,701,387,314,123.2,665,365,300,121.7
'23020, 동구,'030005, 29세,2019,646,351,295,119,618,330,288,114.6
'23020, 동구,'035,30~34세,2019,3305,1801,1504,119.7,3118,1688,1430,118
'23020, 동구,'035001, 30세,2019,591,326,265,123,562,311,251,123.9
'23020, 동구,'035002, 31세,2019,616,326,290,112.4,576,302,274,110.2
'23020, 동구,'035003, 32세,2019,683,395,288,137.2,640,367,273,134.4
'23020, 동구,'035004, 33세,2019,675,359,316,113.6,642,341,301,113.3
'23020, 동구,'035005, 34세,2019,740,395,345,114.5,698,367,331,110.9
'23020, 동구,'040,35~39세,2019,4608,2441,2167,112.6,4463,2354,2109,111.6
'23020, 동구,'040001, 35세,2019,731,393,338,116.3,698,374,324,115.4
'23020, 동구,'040002, 36세,2019,861,452,409,110.5,832,436,396,110.1
'23020, 동구,'040003, 37세,2019,930,476,454,104.8,896,453,443,102.3
'23020, 동구,'040004, 38세,2019,1023,557,466,119.5,1001,544,457,119
'23020, 동구,'040005, 39세,2019,1063,563,500,112.6,1036,547,489,111.9
'23020, 동구,'045,40~44세,2019,4819,2646,2173,121.8,4697,2582,2115,122.1
'23020, 동구,'045001, 40세,2019,1049,580,469,123.7,1018,565,453,124.7
'23020, 동구,'045002, 41세,2019,932,497,435,114.3,909,486,423,114.9
'23020, 동구,'045003, 42세,2019,902,506,396,127.8,871,488,383,127.4
'23020, 동구,'045004, 43세,2019,921,506,415,121.9,899,494,405,122
'23020, 동구,'045005, 44세,2019,1015,557,458,121.6,1000,549,451,121.7
'23020, 동구,'050,45~49세,2019,5253,2808,2445,114.8,5144,2748,2396,114.7
'23020, 동구,'050001, 45세,2019,999,504,495,101.8,984,497,487,102.1
'23020, 동구,'050002, 46세,2019,1069,557,512,108.8,1053,547,506,108.1
'23020, 동구,'050003, 47세,2019,1093,590,503,117.3,1068,577,491,117.5
'23020, 동구,'050004, 48세,2019,1080,584,496,117.7,1058,572,486,117.7
'23020, 동구,'050005, 49세,2019,1012,573,439,130.5,981,555,426,130.3
'23020, 동구,'055,50~54세,2019,4903,2575,2328,110.6,4797,2524,2273,111
'23020, 동구,'055001, 50세,2019,1011,525,486,108,993,516,477,108.2
'23020, 동구,'055002, 51세,2019,1043,562,481,116.8,1010,547,463,118.1
'23020, 동구,'055003, 52세,2019,947,483,464,104.1,930,476,454,104.8
'23020, 동구,'055004, 53세,2019,897,478,419,114.1,879,469,410,114.4
'23020, 동구,'055005, 54세,2019,1005,527,478,110.3,985,516,469,110
'23020, 동구,'060,55~59세,2019,5294,2688,2606,103.1,5183,2628,2555,102.9
'23020, 동구,'060001, 55세,2019,908,478,430,111.2,891,470,421,111.6
'23020, 동구,'060002, 56세,2019,960,497,463,107.3,935,478,457,104.6
'23020, 동구,'060003, 57세,2019,1079,546,533,102.4,1052,534,518,103.1
'23020, 동구,'060004, 58세,2019,1124,567,557,101.8,1111,561,550,102
'23020, 동구,'060005, 59세,2019,1223,600,623,96.3,1194,585,609,96.1
'23020, 동구,'065,60~64세,2019,5447,2638,2809,93.9,5375,2609,2766,94.3
'23020, 동구,'065001, 60세,2019,1132,540,592,91.2,1118,533,585,91.1
'23020, 동구,'065002, 61세,2019,1112,552,560,98.6,1094,542,552,98.2
'23020, 동구,'065003, 62세,2019,1092,529,563,94,1076,524,552,94.9
'23020, 동구,'065004, 63세,2019,1020,498,522,95.4,1008,495,513,96.5
'23020, 동구,'065005, 64세,2019,1091,519,572,90.7,1079,515,564,91.3
'23020, 동구,'070,65~69세,2019,3976,1864,2112,88.3,3930,1842,2088,88.2
'23020, 동구,'070001, 65세,2019,898,451,447,100.9,885,442,443,99.8
'23020, 동구,'070002, 66세,2019,775,371,404,91.8,766,369,397,92.9
'23020, 동구,'070003, 67세,2019,920,430,490,87.8,906,422,484,87.2
'23020, 동구,'070004, 68세,2019,630,260,370,70.3,625,257,368,69.8
'23020, 동구,'070005, 69세,2019,753,352,401,87.8,748,352,396,88.9
'23020, 동구,'075,70~74세,2019,3498,1565,1933,81,3479,1556,1923,80.9
'23020, 동구,'075001, 70세,2019,751,332,419,79.2,744,328,416,78.8
'23020, 동구,'075002, 71세,2019,761,340,421,80.8,755,338,417,81.1
'23020, 동구,'075003, 72세,2019,763,335,428,78.3,760,333,427,78
'23020, 동구,'075004, 73세,2019,624,275,349,78.8,623,274,349,78.5
'23020, 동구,'075005, 74세,2019,599,283,316,89.6,597,283,314,90.1
'23020, 동구,'080,75~79세,2019,2821,1216,1605,75.8,2814,1213,1601,75.8
'23020, 동구,'080001, 75세,2019,575,242,333,72.7,573,241,332,72.6
'23020, 동구,'080002, 76세,2019,584,252,332,75.9,583,252,331,76.1
'23020, 동구,'080003, 77세,2019,691,305,386,79,691,305,386,79
'23020, 동구,'080004, 78세,2019,542,230,312,73.7,539,229,310,73.9
'23020, 동구,'080005, 79세,2019,429,187,242,77.3,428,186,242,76.9
'23020, 동구,'085,80~84세,2019,1772,646,1126,57.4,1770,644,1126,57.2
'23020, 동구,'085001, 80세,2019,462,176,286,61.5,462,176,286,61.5
'23020, 동구,'085002, 81세,2019,375,148,227,65.2,374,147,227,64.8
'23020, 동구,'085003, 82세,2019,336,125,211,59.2,335,124,211,58.8
'23020, 동구,'085004, 83세,2019,316,104,212,49.1,316,104,212,49.1
'23020, 동구,'085005, 84세,2019,283,93,190,48.9,283,93,190,48.9
'23020, 동구,'086,85세이상,2019,1165,303,862,35.2,1157,301,856,35.2
'23020, 동구,'090,85~89세,2019,819,223,596,37.4,814,221,593,37.3
'23020, 동구,'090001, 85세,2019,221,67,154,43.5,219,67,152,44.1
'23020, 동구,'090002, 86세,2019,186,45,141,31.9,185,44,141,31.2
'23020, 동구,'090003, 87세,2019,182,48,134,35.8,181,47,134,35.1
'23020, 동구,'090004, 88세,2019,129,37,92,40.2,129,37,92,40.2
'23020, 동구,'090005, 89세,2019,101,26,75,34.7,100,26,74,35.1
'23020, 동구,'095,90~94세,2019,279,62,217,28.6,276,62,214,29
'23020, 동구,'095001, 90세,2019,91,24,67,35.8,91,24,67,35.8
'23020, 동구,'095002, 91세,2019,76,16,60,26.7,74,16,58,27.6
'23020, 동구,'095003, 92세,2019,65,14,51,27.5,64,14,50,28
'23020, 동구,'095004, 93세,2019,26,7,19,36.8,26,7,19,36.8
'23020, 동구,'095005, 94세,2019,21,X,20,5,21,X,20,5
'23020, 동구,'100,95~99세,2019,59,16,43,37.2,59,16,43,37.2
'23020, 동구,'100001, 95세,2019,28,6,22,27.3,28,6,22,27.3
'23020, 동구,'100002, 96세,2019,13,5,8,62.5,13,5,8,62.5
'23020, 동구,'100003, 97세,2019,11,X,8,37.5,11,X,8,37.5
'23020, 동구,'100004, 98세,2019,6,X,X,50,6,X,X,50
'23020, 동구,'100005, 99세,2019,X,X,X,0,X,X,X,0
'23020, 동구,'101,100세이상,2019,8,X,6,33.3,8,X,6,33.3
'23020, 동구,'102,15세미만,2019,6789,3512,3277,107.2,6736,3496,3240,107.9
'23020, 동구,'103,15~64세,2019,42982,22654,20328,111.4,41858,22001,19857,110.8
'23020, 동구,'104,65세이상,2019,13232,5594,7638,73.2,13150,5556,7594,73.2
'23020, 동구,'126,평균연령,2019,46,44.4,47.6,,46.1,44.5,47.7,
'23020, 동구,'127,중위연령,2019,47.5,45.8,49.5,,47.7,46.1,49.6,
'23040, 연수구,'000,합계,2019,374413,186902,187511,99.7,355529,176863,178666,99
'23040, 연수구,'005,0~4세,2019,16914,8633,8281,104.3,15565,7884,7681,102.6
'23040, 연수구,'005001, 0세,2019,2826,1496,1330,112.5,2653,1390,1263,110.1
'23040, 연수구,'005002, 1세,2019,3079,1596,1483,107.6,2778,1414,1364,103.7
'23040, 연수구,'005003, 2세,2019,3333,1676,1657,101.1,3054,1528,1526,100.1
'23040, 연수구,'005004, 3세,2019,3693,1842,1851,99.5,3387,1675,1712,97.8
'23040, 연수구,'005005, 4세,2019,3983,2023,1960,103.2,3693,1877,1816,103.4
'23040, 연수구,'010,5~9세,2019,20536,10591,9945,106.5,19606,10114,9492,106.6
'23040, 연수구,'010001, 5세,2019,3992,2071,1921,107.8,3731,1938,1793,108.1
'23040, 연수구,'010002, 6세,2019,4048,2085,1963,106.2,3848,1984,1864,106.4
'23040, 연수구,'010003, 7세,2019,4268,2172,2096,103.6,4085,2073,2012,103
'23040, 연수구,'010004, 8세,2019,4252,2209,2043,108.1,4092,2128,1964,108.4
'23040, 연수구,'010005, 9세,2019,3976,2054,1922,106.9,3850,1991,1859,107.1
'23040, 연수구,'015,10~14세,2019,19990,10253,9737,105.3,19424,9930,9494,104.6
'23040, 연수구,'015001, 10세,2019,4072,2116,1956,108.2,3939,2047,1892,108.2
'23040, 연수구,'015002, 11세,2019,4127,2121,2006,105.7,3994,2037,1957,104.1
'23040, 연수구,'015003, 12세,2019,4289,2186,2103,103.9,4183,2124,2059,103.2
'23040, 연수구,'015004, 13세,2019,3831,1951,1880,103.8,3734,1898,1836,103.4
'23040, 연수구,'015005, 14세,2019,3671,1879,1792,104.9,3574,1824,1750,104.2
'23040, 연수구,'020,15~19세,2019,23720,11977,11743,102,22307,11324,10983,103.1
'23040, 연수구,'020001, 15세,2019,3959,2015,1944,103.7,3878,1981,1897,104.4
'23040, 연수구,'020002, 16세,2019,3679,1857,1822,101.9,3607,1819,1788,101.7
'23040, 연수구,'020003, 17세,2019,3752,1951,1801,108.3,3678,1910,1768,108
'23040, 연수구,'020004, 18세,2019,5130,2610,2520,103.6,4803,2483,2320,107
'23040, 연수구,'020005, 19세,2019,7200,3544,3656,96.9,6341,3131,3210,97.5
'23040, 연수구,'025,20~24세,2019,26458,13764,12694,108.4,24228,12543,11685,107.3
'23040, 연수구,'025001, 20세,2019,5629,2964,2665,111.2,5167,2722,2445,111.3
'23040, 연수구,'025002, 21세,2019,5199,2743,2456,111.7,4752,2485,2267,109.6
'23040, 연수구,'025003, 22세,2019,5182,2664,2518,105.8,4743,2406,2337,103
'23040, 연수구,'025004, 23세,2019,5251,2716,2535,107.1,4819,2481,2338,106.1
'23040, 연수구,'025005, 24세,2019,5197,2677,2520,106.2,4747,2449,2298,106.6
'23040, 연수구,'030,25~29세,2019,26827,13980,12847,108.8,24507,12727,11780,108
'23040, 연수구,'030001, 25세,2019,5284,2800,2484,112.7,4829,2554,2275,112.3
'23040, 연수구,'030002, 26세,2019,5449,2926,2523,116,5004,2666,2338,114
'23040, 연수구,'030003, 27세,2019,5589,2850,2739,104.1,5157,2626,2531,103.8
'23040, 연수구,'030004, 28세,2019,5335,2748,2587,106.2,4852,2507,2345,106.9
'23040, 연수구,'030005, 29세,2019,5170,2656,2514,105.6,4665,2374,2291,103.6
'23040, 연수구,'035,30~34세,2019,25428,12844,12584,102.1,22812,11397,11415,99.8
'23040, 연수구,'035001, 30세,2019,5060,2549,2511,101.5,4532,2271,2261,100.4
'23040, 연수구,'035002, 31세,2019,4956,2546,2410,105.6,4413,2256,2157,104.6
'23040, 연수구,'035003, 32세,2019,4926,2434,2492,97.7,4424,2137,2287,93.4
'23040, 연수구,'035004, 33세,2019,5236,2632,2604,101.1,4680,2324,2356,98.6
'23040, 연수구,'035005, 34세,2019,5250,2683,2567,104.5,4763,2409,2354,102.3
'23040, 연수구,'040,35~39세,2019,31549,15564,15985,97.4,29346,14334,15012,95.5
'23040, 연수구,'040001, 35세,2019,5457,2739,2718,100.8,4992,2482,2510,98.9
'23040, 연수구,'040002, 36세,2019,6013,2915,3098,94.1,5529,2637,2892,91.2
'23040, 연수구,'040003, 37세,2019,6623,3301,3322,99.4,6163,3048,3115,97.8
'23040, 연수구,'040004, 38세,2019,6703,3274,3429,95.5,6302,3044,3258,93.4
'23040, 연수구,'040005, 39세,2019,6753,3335,3418,97.6,6360,3123,3237,96.5
'23040, 연수구,'045,40~44세,2019,30778,15265,15513,98.4,29148,14354,14794,97
'23040, 연수구,'045001, 40세,2019,6465,3199,3266,97.9,6057,2982,3075,97
'23040, 연수구,'045002, 41세,2019,5992,2986,3006,99.3,5643,2785,2858,97.4
'23040, 연수구,'045003, 42세,2019,6010,2976,3034,98.1,5711,2804,2907,96.5
'23040, 연수구,'045004, 43세,2019,5918,2970,2948,100.7,5631,2806,2825,99.3
'23040, 연수구,'045005, 44세,2019,6393,3134,3259,96.2,6106,2977,3129,95.1
'23040, 연수구,'050,45~49세,2019,34594,16980,17614,96.4,33327,16312,17015,95.9
'23040, 연수구,'050001, 45세,2019,6814,3362,3452,97.4,6570,3224,3346,96.4
'23040, 연수구,'050002, 46세,2019,6829,3221,3608,89.3,6544,3092,3452,89.6
'23040, 연수구,'050003, 47세,2019,6860,3411,3449,98.9,6605,3267,3338,97.9
'23040, 연수구,'050004, 48세,2019,7218,3605,3613,99.8,6969,3471,3498,99.2
'23040, 연수구,'050005, 49세,2019,6873,3381,3492,96.8,6639,3258,3381,96.4
'23040, 연수구,'055,50~54세,2019,31682,15473,16209,95.5,30785,14996,15789,95
'23040, 연수구,'055001, 50세,2019,6872,3336,3536,94.3,6678,3229,3449,93.6
'23040, 연수구,'055002, 51세,2019,6644,3220,3424,94,6407,3097,3310,93.6
'23040, 연수구,'055003, 52세,2019,6047,2968,3079,96.4,5911,2893,3018,95.9
'23040, 연수구,'055004, 53세,2019,5919,2900,3019,96.1,5763,2819,2944,95.8
'23040, 연수구,'055005, 54세,2019,6200,3049,3151,96.8,6026,2958,3068,96.4
'23040, 연수구,'060,55~59세,2019,30579,15556,15023,103.5,29918,15233,14685,103.7
'23040, 연수구,'060001, 55세,2019,5822,2907,2915,99.7,5681,2835,2846,99.6
'23040, 연수구,'060002, 56세,2019,6260,3169,3091,102.5,6089,3084,3005,102.6
'23040, 연수구,'060003, 57세,2019,6124,3069,3055,100.5,5999,3013,2986,100.9
'23040, 연수구,'060004, 58세,2019,6341,3286,3055,107.6,6239,3238,3001,107.9
'23040, 연수구,'060005, 59세,2019,6032,3125,2907,107.5,5910,3063,2847,107.6
'23040, 연수구,'065,60~64세,2019,21680,11247,10433,107.8,21227,11064,10163,108.9
'23040, 연수구,'065001, 60세,2019,5148,2675,2473,108.2,5057,2637,2420,109
'23040, 연수구,'065002, 61세,2019,4725,2517,2208,114,4607,2465,2142,115.1
'23040, 연수구,'065003, 62세,2019,4335,2259,2076,108.8,4252,2218,2034,109
'23040, 연수구,'065004, 63세,2019,3776,1926,1850,104.1,3698,1906,1792,106.4
'23040, 연수구,'065005, 64세,2019,3696,1870,1826,102.4,3613,1838,1775,103.5
'23040, 연수구,'070,65~69세,2019,11541,5884,5657,104,11354,5815,5539,105
'23040, 연수구,'070001, 65세,2019,2971,1588,1383,114.8,2918,1564,1354,115.5
'23040, 연수구,'070002, 66세,2019,2459,1208,1251,96.6,2416,1196,1220,98
'23040, 연수구,'070003, 67세,2019,2644,1366,1278,106.9,2605,1353,1252,108.1
'23040, 연수구,'070004, 68세,2019,1633,814,819,99.4,1602,801,801,100
'23040, 연수구,'070005, 69세,2019,1834,908,926,98.1,1813,901,912,98.8
'23040, 연수구,'075,70~74세,2019,8238,3880,4358,89,8136,3839,4297,89.3
'23040, 연수구,'075001, 70세,2019,1919,939,980,95.8,1899,931,968,96.2
'23040, 연수구,'075002, 71세,2019,1841,867,974,89,1816,856,960,89.2
'23040, 연수구,'075003, 72세,2019,1821,807,1014,79.6,1802,801,1001,80
'23040, 연수구,'075004, 73세,2019,1411,678,733,92.5,1387,670,717,93.4
'23040, 연수구,'075005, 74세,2019,1246,589,657,89.6,1232,581,651,89.2
'23040, 연수구,'080,75~79세,2019,6339,2683,3656,73.4,6307,2673,3634,73.6
'23040, 연수구,'080001, 75세,2019,1266,584,682,85.6,1258,581,677,85.8
'23040, 연수구,'080002, 76세,2019,1371,591,780,75.8,1364,591,773,76.5
'23040, 연수구,'080003, 77세,2019,1445,584,861,67.8,1440,583,857,68
'23040, 연수구,'080004, 78세,2019,1198,509,689,73.9,1193,506,687,73.7
'23040, 연수구,'080005, 79세,2019,1059,415,644,64.4,1052,412,640,64.4
'23040, 연수구,'085,80~84세,2019,4310,1480,2830,52.3,4295,1479,2816,52.5
'23040, 연수구,'085001, 80세,2019,1064,385,679,56.7,1058,385,673,57.2
'23040, 연수구,'085002, 81세,2019,961,349,612,57,958,349,609,57.3
'23040, 연수구,'085003, 82세,2019,868,292,576,50.7,866,291,575,50.6
'23040, 연수구,'085004, 83세,2019,712,222,490,45.3,708,222,486,45.7
'23040, 연수구,'085005, 84세,2019,705,232,473,49,705,232,473,49
'23040, 연수구,'086,85세이상,2019,3250,848,2402,35.3,3237,845,2392,35.3
'23040, 연수구,'090,85~89세,2019,2236,600,1636,36.7,2226,598,1628,36.7
'23040, 연수구,'090001, 85세,2019,580,185,395,46.8,577,185,392,47.2
'23040, 연수구,'090002, 86세,2019,505,136,369,36.9,505,136,369,36.9
'23040, 연수구,'090003, 87세,2019,453,120,333,36,452,120,332,36.1
'23040, 연수구,'090004, 88세,2019,376,89,287,31,372,88,284,31
'23040, 연수구,'090005, 89세,2019,322,70,252,27.8,320,69,251,27.5
'23040, 연수구,'095,90~94세,2019,803,189,614,30.8,800,188,612,30.7
'23040, 연수구,'095001, 90세,2019,262,67,195,34.4,262,67,195,34.4
'23040, 연수구,'095002, 91세,2019,195,48,147,32.7,194,48,146,32.9
'23040, 연수구,'095003, 92세,2019,143,42,101,41.6,142,42,100,42
'23040, 연수구,'095004, 93세,2019,115,20,95,21.1,114,19,95,20
'23040, 연수구,'095005, 94세,2019,88,12,76,15.8,88,12,76,15.8
'23040, 연수구,'100,95~99세,2019,186,54,132,40.9,186,54,132,40.9
'23040, 연수구,'100001, 95세,2019,56,16,40,40,56,16,40,40
'23040, 연수구,'100002, 96세,2019,52,14,38,36.8,52,14,38,36.8
'23040, 연수구,'100003, 97세,2019,44,12,32,37.5,44,12,32,37.5
'23040, 연수구,'100004, 98세,2019,21,6,15,40,21,6,15,40
'23040, 연수구,'100005, 99세,2019,13,6,7,85.7,13,6,7,85.7
'23040, 연수구,'101,100세이상,2019,25,5,20,25,25,5,20,25
'23040, 연수구,'102,15세미만,2019,57440,29477,27963,105.4,54595,27928,26667,104.7
'23040, 연수구,'103,15~64세,2019,283295,142650,140645,101.4,267605,134284,133321,100.7
'23040, 연수구,'104,65세이상,2019,33678,14775,18903,78.2,33329,14651,18678,78.4
'23040, 연수구,'126,평균연령,2019,38.6,37.9,39.3,,39,38.3,39.6,
'23040, 연수구,'127,중위연령,2019,39.4,38.7,40,,40,39.4,40.6,
'23050, 남동구,'000,합계,2019,533119,267291,265828,100.6,515481,255756,259725,98.5
'23050, 남동구,'005,0~4세,2019,20252,10398,9854,105.5,19866,10199,9667,105.5
'23050, 남동구,'005001, 0세,2019,3309,1694,1615,104.9,3230,1654,1576,104.9
'23050, 남동구,'005002, 1세,2019,3535,1823,1712,106.5,3470,1793,1677,106.9
'23050, 남동구,'005003, 2세,2019,4004,2070,1934,107,3919,2023,1896,106.7
'23050, 남동구,'005004, 3세,2019,4519,2338,2181,107.2,4431,2292,2139,107.2
'23050, 남동구,'005005, 4세,2019,4885,2473,2412,102.5,4816,2437,2379,102.4
'23050, 남동구,'010,5~9세,2019,25507,13091,12416,105.4,25259,12956,12303,105.3
'23050, 남동구,'010001, 5세,2019,4846,2500,2346,106.6,4784,2469,2315,106.7
'23050, 남동구,'010002, 6세,2019,4901,2455,2446,100.4,4849,2430,2419,100.5
'23050, 남동구,'010003, 7세,2019,5370,2755,2615,105.4,5315,2727,2588,105.4
'23050, 남동구,'010004, 8세,2019,5300,2775,2525,109.9,5260,2747,2513,109.3
'23050, 남동구,'010005, 9세,2019,5090,2606,2484,104.9,5051,2583,2468,104.7
'23050, 남동구,'015,10~14세,2019,24326,12415,11911,104.2,24171,12343,11828,104.4
'23050, 남동구,'015001, 10세,2019,4917,2495,2422,103,4885,2483,2402,103.4
'23050, 남동구,'015002, 11세,2019,5101,2561,2540,100.8,5062,2538,2524,100.6
'23050, 남동구,'015003, 12세,2019,5097,2621,2476,105.9,5064,2612,2452,106.5
'23050, 남동구,'015004, 13세,2019,4666,2430,2236,108.7,4641,2415,2226,108.5
'23050, 남동구,'015005, 14세,2019,4545,2308,2237,103.2,4519,2295,2224,103.2
'23050, 남동구,'020,15~19세,2019,25655,13023,12632,103.1,25351,12870,12481,103.1
'23050, 남동구,'020001, 15세,2019,4721,2392,2329,102.7,4699,2381,2318,102.7
'23050, 남동구,'020002, 16세,2019,4977,2526,2451,103.1,4951,2514,2437,103.2
'23050, 남동구,'020003, 17세,2019,5103,2596,2507,103.6,5077,2584,2493,103.7
'23050, 남동구,'020004, 18세,2019,5598,2840,2758,103,5548,2815,2733,103
'23050, 남동구,'020005, 19세,2019,5256,2669,2587,103.2,5076,2576,2500,103
'23050, 남동구,'025,20~24세,2019,32019,16870,15149,111.4,30676,15943,14733,108.2
'23050, 남동구,'025001, 20세,2019,5421,3005,2416,124.4,5304,2934,2370,123.8
'23050, 남동구,'025002, 21세,2019,5984,3294,2690,122.5,5792,3178,2614,121.6
'23050, 남동구,'025003, 22세,2019,6353,3354,2999,111.8,6067,3148,2919,107.8
'23050, 남동구,'025004, 23세,2019,6881,3501,3380,103.6,6533,3247,3286,98.8
'23050, 남동구,'025005, 24세,2019,7380,3716,3664,101.4,6980,3436,3544,97
'23050, 남동구,'030,25~29세,2019,39396,20992,18404,114.1,36646,18963,17683,107.2
'23050, 남동구,'030001, 25세,2019,7660,4015,3645,110.2,7186,3667,3519,104.2
'23050, 남동구,'030002, 26세,2019,8144,4392,3752,117.1,7648,4026,3622,111.2
'23050, 남동구,'030003, 27세,2019,8327,4398,3929,111.9,7800,4004,3796,105.5
'23050, 남동구,'030004, 28세,2019,7788,4180,3608,115.9,7195,3754,3441,109.1
'23050, 남동구,'030005, 29세,2019,7477,4007,3470,115.5,6817,3512,3305,106.3
'23050, 남동구,'035,30~34세,2019,35446,18991,16455,115.4,32189,16647,15542,107.1
'23050, 남동구,'035001, 30세,2019,7082,3743,3339,112.1,6448,3293,3155,104.4
'23050, 남동구,'035002, 31세,2019,7075,3821,3254,117.4,6396,3328,3068,108.5
'23050, 남동구,'035003, 32세,2019,6938,3721,3217,115.7,6279,3252,3027,107.4
'23050, 남동구,'035004, 33세,2019,7089,3800,3289,115.5,6448,3347,3101,107.9
'23050, 남동구,'035005, 34세,2019,7262,3906,3356,116.4,6618,3427,3191,107.4
'23050, 남동구,'040,35~39세,2019,45259,23587,21672,108.8,42621,21689,20932,103.6
'23050, 남동구,'040001, 35세,2019,7661,4094,3567,114.8,7047,3658,3389,107.9
'23050, 남동구,'040002, 36세,2019,8741,4521,4220,107.1,8178,4104,4074,100.7
'23050, 남동구,'040003, 37세,2019,9481,4944,4537,109,8968,4570,4398,103.9
'23050, 남동구,'040004, 38세,2019,9527,5007,4520,110.8,9042,4663,4379,106.5
'23050, 남동구,'040005, 39세,2019,9849,5021,4828,104,9386,4694,4692,100
'23050, 남동구,'045,40~44세,2019,43306,22465,20841,107.8,41603,21251,20352,104.4
'23050, 남동구,'045001, 40세,2019,9357,4857,4500,107.9,8891,4519,4372,103.4
'23050, 남동구,'045002, 41세,2019,8487,4313,4174,103.3,8136,4058,4078,99.5
'23050, 남동구,'045003, 42세,2019,8614,4451,4163,106.9,8280,4223,4057,104.1
'23050, 남동구,'045004, 43세,2019,8200,4373,3827,114.3,7915,4171,3744,111.4
'23050, 남동구,'045005, 44세,2019,8648,4471,4177,107,8381,4280,4101,104.4
'23050, 남동구,'050,45~49세,2019,47084,23880,23204,102.9,45647,22993,22654,101.5
'23050, 남동구,'050001, 45세,2019,9255,4816,4439,108.5,8965,4617,4348,106.2
'23050, 남동구,'050002, 46세,2019,9302,4669,4633,100.8,9003,4484,4519,99.2
'23050, 남동구,'050003, 47세,2019,9239,4722,4517,104.5,8964,4567,4397,103.9
'23050, 남동구,'050004, 48세,2019,9780,4904,4876,100.6,9489,4731,4758,99.4
'23050, 남동구,'050005, 49세,2019,9508,4769,4739,100.6,9226,4594,4632,99.2
'23050, 남동구,'055,50~54세,2019,45633,22251,23382,95.2,44466,21602,22864,94.5
'23050, 남동구,'055001, 50세,2019,9599,4636,4963,93.4,9335,4498,4837,93
'23050, 남동구,'055002, 51세,2019,9660,4700,4960,94.8,9407,4551,4856,93.7
'23050, 남동구,'055003, 52세,2019,8667,4198,4469,93.9,8465,4085,4380,93.3
'23050, 남동구,'055004, 53세,2019,8527,4210,4317,97.5,8315,4092,4223,96.9
'23050, 남동구,'055005, 54세,2019,9180,4507,4673,96.4,8944,4376,4568,95.8
'23050, 남동구,'060,55~59세,2019,45916,22787,23129,98.5,44987,22335,22652,98.6
'23050, 남동구,'060001, 55세,2019,8434,4150,4284,96.9,8205,4043,4162,97.1
'23050, 남동구,'060002, 56세,2019,8922,4455,4467,99.7,8696,4349,4347,100
'23050, 남동구,'060003, 57세,2019,9122,4562,4560,100,8950,4477,4473,100.1
'23050, 남동구,'060004, 58세,2019,9835,4872,4963,98.2,9703,4809,4894,98.3
'23050, 남동구,'060005, 59세,2019,9603,4748,4855,97.8,9433,4657,4776,97.5
'23050, 남동구,'065,60~64세,2019,37105,18037,19068,94.6,36465,17719,18746,94.5
'23050, 남동구,'065001, 60세,2019,8384,4051,4333,93.5,8250,3979,4271,93.2
'23050, 남동구,'065002, 61세,2019,8017,3911,4106,95.3,7873,3840,4033,95.2
'23050, 남동구,'065003, 62세,2019,7443,3681,3762,97.8,7304,3612,3692,97.8
'23050, 남동구,'065004, 63세,2019,6476,3130,3346,93.5,6364,3075,3289,93.5
'23050, 남동구,'065005, 64세,2019,6785,3264,3521,92.7,6674,3213,3461,92.8
'23050, 남동구,'070,65~69세,2019,23060,11085,11975,92.6,22677,10926,11751,93
'23050, 남동구,'070001, 65세,2019,5614,2670,2944,90.7,5511,2628,2883,91.2
'23050, 남동구,'070002, 66세,2019,4852,2313,2539,91.1,4773,2282,2491,91.6
'23050, 남동구,'070003, 67세,2019,5227,2511,2716,92.5,5143,2477,2666,92.9
'23050, 남동구,'070004, 68세,2019,3433,1676,1757,95.4,3379,1651,1728,95.5
'23050, 남동구,'070005, 69세,2019,3934,1915,2019,94.8,3871,1888,1983,95.2
'23050, 남동구,'075,70~74세,2019,16867,7968,8899,89.5,16715,7914,8801,89.9
'23050, 남동구,'075001, 70세,2019,3917,1933,1984,97.4,3875,1918,1957,98
'23050, 남동구,'075002, 71세,2019,3749,1788,1961,91.2,3713,1774,1939,91.5
'23050, 남동구,'075003, 72세,2019,3723,1734,1989,87.2,3695,1724,1971,87.5
'23050, 남동구,'075004, 73세,2019,2876,1325,1551,85.4,2857,1316,1541,85.4
'23050, 남동구,'075005, 74세,2019,2602,1188,1414,84,2575,1182,1393,84.9
'23050, 남동구,'080,75~79세,2019,12525,5211,7314,71.2,12447,5183,7264,71.4
'23050, 남동구,'080001, 75세,2019,2679,1216,1463,83.1,2660,1207,1453,83.1
'23050, 남동구,'080002, 76세,2019,2545,1042,1503,69.3,2533,1040,1493,69.7
'23050, 남동구,'080003, 77세,2019,2990,1238,1752,70.7,2971,1230,1741,70.6
'23050, 남동구,'080004, 78세,2019,2257,905,1352,66.9,2240,898,1342,66.9
'23050, 남동구,'080005, 79세,2019,2054,810,1244,65.1,2043,808,1235,65.4
'23050, 남동구,'085,80~84세,2019,7927,2853,5074,56.2,7883,2843,5040,56.4
'23050, 남동구,'085001, 80세,2019,1945,745,1200,62.1,1941,745,1196,62.3
'23050, 남동구,'085002, 81세,2019,1727,647,1080,59.9,1717,646,1071,60.3
'23050, 남동구,'085003, 82세,2019,1557,577,980,58.9,1548,575,973,59.1
'23050, 남동구,'085004, 83세,2019,1418,462,956,48.3,1402,456,946,48.2
'23050, 남동구,'085005, 84세,2019,1280,422,858,49.2,1275,421,854,49.3
'23050, 남동구,'086,85세이상,2019,5836,1387,4449,31.2,5812,1380,4432,31.1
'23050, 남동구,'090,85~89세,2019,3898,1000,2898,34.5,3882,997,2885,34.6
'23050, 남동구,'090001, 85세,2019,1038,309,729,42.4,1034,308,726,42.4
'23050, 남동구,'090002, 86세,2019,913,269,644,41.8,910,269,641,42
'23050, 남동구,'090003, 87세,2019,756,184,572,32.2,754,183,571,32
'23050, 남동구,'090004, 88세,2019,612,123,489,25.2,608,123,485,25.4
'23050, 남동구,'090005, 89세,2019,579,115,464,24.8,576,114,462,24.7
'23050, 남동구,'095,90~94세,2019,1535,317,1218,26,1530,316,1214,26
'23050, 남동구,'095001, 90세,2019,529,124,405,30.6,528,124,404,30.7
'23050, 남동구,'095002, 91세,2019,372,82,290,28.3,371,82,289,28.4
'23050, 남동구,'095003, 92세,2019,282,54,228,23.7,281,54,227,23.8
'23050, 남동구,'095004, 93세,2019,191,34,157,21.7,190,33,157,21
'23050, 남동구,'095005, 94세,2019,161,23,138,16.7,160,23,137,16.8
'23050, 남동구,'100,95~99세,2019,355,63,292,21.6,352,60,292,20.5
'23050, 남동구,'100001, 95세,2019,112,20,92,21.7,111,19,92,20.7
'23050, 남동구,'100002, 96세,2019,99,22,77,28.6,97,20,77,26
'23050, 남동구,'100003, 97세,2019,66,10,56,17.9,66,10,56,17.9
'23050, 남동구,'100004, 98세,2019,45,7,38,18.4,45,7,38,18.4
'23050, 남동구,'100005, 99세,2019,33,X,29,13.8,33,X,29,13.8
'23050, 남동구,'101,100세이상,2019,48,7,41,17.1,48,7,41,17.1
'23050, 남동구,'102,15세미만,2019,70085,35904,34181,105,69296,35498,33798,105
'23050, 남동구,'103,15~64세,2019,396819,202883,193936,104.6,380651,192012,188639,101.8
'23050, 남동구,'104,65세이상,2019,66215,28504,37711,75.6,65534,28246,37288,75.8
'23050, 남동구,'126,평균연령,2019,41.3,40.2,42.3,,41.4,40.4,42.4,
'23050, 남동구,'127,중위연령,2019,42.1,40.9,43.4,,42.5,41.4,43.6,
'23060, 부평구,'000,합계,2019,514385,254711,259674,98.1,493540,244177,249363,97.9
'23060, 부평구,'005,0~4세,2019,17691,9025,8666,104.1,16708,8541,8167,104.6
'23060, 부평구,'005001, 0세,2019,3124,1604,1520,105.5,2897,1498,1399,107.1
'23060, 부평구,'005002, 1세,2019,3252,1638,1614,101.5,3048,1542,1506,102.4
'23060, 부평구,'005003, 2세,2019,3384,1792,1592,112.6,3189,1685,1504,112
'23060, 부평구,'005004, 3세,2019,3939,1985,1954,101.6,3729,1881,1848,101.8
'23060, 부평구,'005005, 4세,2019,3992,2006,1986,101,3845,1935,1910,101.3
'23060, 부평구,'010,5~9세,2019,20114,10306,9808,105.1,19634,10068,9566,105.2
'23060, 부평구,'010001, 5세,2019,3983,2032,1951,104.2,3849,1963,1886,104.1
'23060, 부평구,'010002, 6세,2019,3798,1915,1883,101.7,3710,1873,1837,102
'23060, 부평구,'010003, 7세,2019,4188,2119,2069,102.4,4076,2070,2006,103.2
'23060, 부평구,'010004, 8세,2019,4196,2168,2028,106.9,4114,2123,1991,106.6
'23060, 부평구,'010005, 9세,2019,3949,2072,1877,110.4,3885,2039,1846,110.5
'23060, 부평구,'015,10~14세,2019,20497,10593,9904,107,20275,10481,9794,107
'23060, 부평구,'015001, 10세,2019,4006,2019,1987,101.6,3955,1997,1958,102
'23060, 부평구,'015002, 11세,2019,4160,2163,1997,108.3,4109,2137,1972,108.4
'23060, 부평구,'015003, 12세,2019,4387,2276,2111,107.8,4348,2256,2092,107.8
'23060, 부평구,'015004, 13세,2019,3974,2088,1886,110.7,3939,2066,1873,110.3
'23060, 부평구,'015005, 14세,2019,3970,2047,1923,106.4,3924,2025,1899,106.6
'23060, 부평구,'020,15~19세,2019,24181,12478,11703,106.6,23952,12367,11585,106.8
'23060, 부평구,'020001, 15세,2019,4349,2269,2080,109.1,4317,2254,2063,109.3
'23060, 부평구,'020002, 16세,2019,4633,2408,2225,108.2,4610,2398,2212,108.4
'23060, 부평구,'020003, 17세,2019,4807,2471,2336,105.8,4782,2456,2326,105.6
'23060, 부평구,'020004, 18세,2019,5204,2698,2506,107.7,5157,2675,2482,107.8
'23060, 부평구,'020005, 19세,2019,5188,2632,2556,103,5086,2584,2502,103.3
'23060, 부평구,'025,20~24세,2019,31944,16668,15276,109.1,31202,16334,14868,109.9
'23060, 부평구,'025001, 20세,2019,5477,2983,2494,119.6,5378,2939,2439,120.5
'23060, 부평구,'025002, 21세,2019,5962,3222,2740,117.6,5847,3167,2680,118.2
'23060, 부평구,'025003, 22세,2019,6359,3267,3092,105.7,6224,3209,3015,106.4
'23060, 부평구,'025004, 23세,2019,6766,3392,3374,100.5,6579,3314,3265,101.5
'23060, 부평구,'025005, 24세,2019,7380,3804,3576,106.4,7174,3705,3469,106.8
'23060, 부평구,'030,25~29세,2019,39504,20101,19403,103.6,37619,19240,18379,104.7
'23060, 부평구,'030001, 25세,2019,7793,4007,3786,105.8,7572,3905,3667,106.5
'23060, 부평구,'030002, 26세,2019,8071,4085,3986,102.5,7776,3959,3817,103.7
'23060, 부평구,'030003, 27세,2019,8236,4161,4075,102.1,7883,3994,3889,102.7
'23060, 부평구,'030004, 28세,2019,7875,4029,3846,104.8,7452,3846,3606,106.7
'23060, 부평구,'030005, 29세,2019,7529,3819,3710,102.9,6936,3536,3400,104
'23060, 부평구,'035,30~34세,2019,35497,18398,17099,107.6,32332,16726,15606,107.2
'23060, 부평구,'035001, 30세,2019,7276,3812,3464,110,6720,3512,3208,109.5
'23060, 부평구,'035002, 31세,2019,7036,3546,3490,101.6,6369,3202,3167,101.1
'23060, 부평구,'035003, 32세,2019,7082,3683,3399,108.4,6412,3338,3074,108.6
'23060, 부평구,'035004, 33세,2019,7101,3695,3406,108.5,6440,3333,3107,107.3
'23060, 부평구,'035005, 34세,2019,7002,3662,3340,109.6,6391,3341,3050,109.5
'23060, 부평구,'040,35~39세,2019,40179,20803,19376,107.4,37947,19583,18364,106.6
'23060, 부평구,'040001, 35세,2019,7279,3784,3495,108.3,6740,3497,3243,107.8
'23060, 부평구,'040002, 36세,2019,7728,4023,3705,108.6,7232,3752,3480,107.8
'23060, 부평구,'040003, 37세,2019,8536,4341,4195,103.5,8046,4064,3982,102.1
'23060, 부평구,'040004, 38세,2019,8281,4339,3942,110.1,7896,4138,3758,110.1
'23060, 부평구,'040005, 39세,2019,8355,4316,4039,106.9,8033,4132,3901,105.9
'23060, 부평구,'045,40~44세,2019,37143,18973,18170,104.4,35607,18094,17513,103.3
'23060, 부평구,'045001, 40세,2019,7774,4079,3695,110.4,7418,3854,3564,108.1
'23060, 부평구,'045002, 41세,2019,7217,3687,3530,104.4,6870,3487,3383,103.1
'23060, 부평구,'045003, 42세,2019,7456,3812,3644,104.6,7198,3658,3540,103.3
'23060, 부평구,'045004, 43세,2019,7098,3651,3447,105.9,6805,3492,3313,105.4
'23060, 부평구,'045005, 44세,2019,7598,3744,3854,97.1,7316,3603,3713,97
'23060, 부평구,'050,45~49세,2019,44251,22003,22248,98.9,42469,21031,21438,98.1
'23060, 부평구,'050001, 45세,2019,8353,4233,4120,102.7,8082,4080,4002,101.9
'23060, 부평구,'050002, 46세,2019,8643,4360,4283,101.8,8298,4167,4131,100.9
'23060, 부평구,'050003, 47세,2019,8737,4334,4403,98.4,8376,4141,4235,97.8
'23060, 부평구,'050004, 48세,2019,9203,4515,4688,96.3,8806,4302,4504,95.5
'23060, 부평구,'050005, 49세,2019,9315,4561,4754,95.9,8907,4341,4566,95.1
'23060, 부평구,'055,50~54세,2019,46855,22478,24377,92.2,44884,21486,23398,91.8
'23060, 부평구,'055001, 50세,2019,9564,4556,5008,91,9161,4353,4808,90.5
'23060, 부평구,'055002, 51세,2019,9762,4542,5220,87,9342,4331,5011,86.4
'23060, 부평구,'055003, 52세,2019,8932,4285,4647,92.2,8599,4113,4486,91.7
'23060, 부평구,'055004, 53세,2019,9086,4482,4604,97.4,8702,4299,4403,97.6
'23060, 부평구,'055005, 54세,2019,9511,4613,4898,94.2,9080,4390,4690,93.6
'23060, 부평구,'060,55~59세,2019,48339,24032,24307,98.9,46138,22977,23161,99.2
'23060, 부평구,'060001, 55세,2019,9187,4554,4633,98.3,8661,4298,4363,98.5
'23060, 부평구,'060002, 56세,2019,9468,4735,4733,100,8943,4483,4460,100.5
'23060, 부평구,'060003, 57세,2019,9529,4704,4825,97.5,9119,4495,4624,97.2
'23060, 부평구,'060004, 58세,2019,10016,5051,4965,101.7,9734,4923,4811,102.3
'23060, 부평구,'060005, 59세,2019,10139,4988,5151,96.8,9681,4778,4903,97.5
'23060, 부평구,'065,60~64세,2019,39118,19178,19940,96.2,37285,18253,19032,95.9
'23060, 부평구,'065001, 60세,2019,8889,4412,4477,98.5,8492,4204,4288,98
'23060, 부평구,'065002, 61세,2019,8264,4087,4177,97.8,7841,3861,3980,97
'23060, 부평구,'065003, 62세,2019,8066,3948,4118,95.9,7668,3751,3917,95.8
'23060, 부평구,'065004, 63세,2019,6891,3359,3532,95.1,6586,3212,3374,95.2
'23060, 부평구,'065005, 64세,2019,7008,3372,3636,92.7,6698,3225,3473,92.9
'23060, 부평구,'070,65~69세,2019,23652,11423,12229,93.4,22673,10954,11719,93.5
'23060, 부평구,'070001, 65세,2019,5744,2696,3048,88.5,5467,2566,2901,88.5
'23060, 부평구,'070002, 66세,2019,4961,2425,2536,95.6,4728,2309,2419,95.5
'23060, 부평구,'070003, 67세,2019,5262,2563,2699,95,5070,2472,2598,95.2
'23060, 부평구,'070004, 68세,2019,3718,1815,1903,95.4,3561,1735,1826,95
'23060, 부평구,'070005, 69세,2019,3967,1924,2043,94.2,3847,1872,1975,94.8
'23060, 부평구,'075,70~74세,2019,17210,8025,9185,87.4,16936,7906,9030,87.6
'23060, 부평구,'075001, 70세,2019,3998,1901,2097,90.7,3902,1860,2042,91.1
'23060, 부평구,'075002, 71세,2019,3885,1888,1997,94.5,3824,1861,1963,94.8
'23060, 부평구,'075003, 72세,2019,3780,1722,2058,83.7,3729,1700,2029,83.8
'23060, 부평구,'075004, 73세,2019,2894,1338,1556,86,2858,1321,1537,85.9
'23060, 부평구,'075005, 74세,2019,2653,1176,1477,79.6,2623,1164,1459,79.8
'23060, 부평구,'080,75~79세,2019,13305,5596,7709,72.6,13145,5548,7597,73
'23060, 부평구,'080001, 75세,2019,2685,1204,1481,81.3,2650,1198,1452,82.5
'23060, 부평구,'080002, 76세,2019,2808,1209,1599,75.6,2784,1204,1580,76.2
'23060, 부평구,'080003, 77세,2019,3078,1309,1769,74,3048,1295,1753,73.9
'23060, 부평구,'080004, 78세,2019,2498,998,1500,66.5,2469,990,1479,66.9
'23060, 부평구,'080005, 79세,2019,2236,876,1360,64.4,2194,861,1333,64.6
'23060, 부평구,'085,80~84세,2019,8887,3077,5810,53,8773,3043,5730,53.1
'23060, 부평구,'085001, 80세,2019,2187,809,1378,58.7,2155,802,1353,59.3
'23060, 부평구,'085002, 81세,2019,1961,687,1274,53.9,1934,681,1253,54.3
'23060, 부평구,'085003, 82세,2019,1689,549,1140,48.2,1674,541,1133,47.7
'23060, 부평구,'085004, 83세,2019,1589,545,1044,52.2,1564,537,1027,52.3
'23060, 부평구,'085005, 84세,2019,1461,487,974,50,1446,482,964,50
'23060, 부평구,'086,85세이상,2019,6018,1554,4464,34.8,5961,1545,4416,35
'23060, 부평구,'090,85~89세,2019,4185,1176,3009,39.1,4139,1170,2969,39.4
'23060, 부평구,'090001, 85세,2019,1125,350,775,45.2,1113,349,764,45.7
'23060, 부평구,'090002, 86세,2019,1029,312,717,43.5,1012,311,701,44.4
'23060, 부평구,'090003, 87세,2019,830,225,605,37.2,822,224,598,37.5
'23060, 부평구,'090004, 88세,2019,626,173,453,38.2,622,171,451,37.9
'23060, 부평구,'090005, 89세,2019,575,116,459,25.3,570,115,455,25.3
'23060, 부평구,'095,90~94세,2019,1439,299,1140,26.2,1431,297,1134,26.2
'23060, 부평구,'095001, 90세,2019,474,114,360,31.7,471,113,358,31.6
'23060, 부평구,'095002, 91세,2019,363,78,285,27.4,363,78,285,27.4
'23060, 부평구,'095003, 92세,2019,276,53,223,23.8,275,52,223,23.3
'23060, 부평구,'095004, 93세,2019,191,34,157,21.7,190,34,156,21.8
'23060, 부평구,'095005, 94세,2019,135,20,115,17.4,132,20,112,17.9
'23060, 부평구,'100,95~99세,2019,349,72,277,26,346,71,275,25.8
'23060, 부평구,'100001, 95세,2019,103,19,84,22.6,101,19,82,23.2
'23060, 부평구,'100002, 96세,2019,96,23,73,31.5,96,23,73,31.5
'23060, 부평구,'100003, 97세,2019,70,17,53,32.1,69,16,53,30.2
'23060, 부평구,'100004, 98세,2019,52,9,43,20.9,52,9,43,20.9
'23060, 부평구,'100005, 99세,2019,28,X,24,16.7,28,X,24,16.7
'23060, 부평구,'101,100세이상,2019,45,7,38,18.4,45,7,38,18.4
'23060, 부평구,'102,15세미만,2019,58302,29924,28378,105.4,56617,29090,27527,105.7
'23060, 부평구,'103,15~64세,2019,387011,195112,191899,101.7,369435,186091,183344,101.5
'23060, 부평구,'104,65세이상,2019,69072,29675,39397,75.3,67488,28996,38492,75.3
'23060, 부평구,'126,평균연령,2019,42.5,41.4,43.5,,42.5,41.4,43.6,
'23060, 부평구,'127,중위연령,2019,43.7,42.3,45.1,,43.8,42.4,45.2,
'23070, 계양구,'000,합계,2019,298912,148434,150478,98.6,294175,146295,147880,98.9
'23070, 계양구,'005,0~4세,2019,8963,4546,4417,102.9,8862,4498,4364,103.1
'23070, 계양구,'005001, 0세,2019,1590,825,765,107.8,1565,811,754,107.6
'23070, 계양구,'005002, 1세,2019,1593,811,782,103.7,1576,796,780,102.1
'23070, 계양구,'005003, 2세,2019,1681,854,827,103.3,1662,848,814,104.2
'23070, 계양구,'005004, 3세,2019,1991,1002,989,101.3,1971,995,976,101.9
'23070, 계양구,'005005, 4세,2019,2108,1054,1054,100,2088,1048,1040,100.8
'23070, 계양구,'010,5~9세,2019,11580,5899,5681,103.8,11535,5879,5656,103.9
'23070, 계양구,'010001, 5세,2019,2183,1120,1063,105.4,2159,1108,1051,105.4
'23070, 계양구,'010002, 6세,2019,2184,1149,1035,111,2175,1147,1028,111.6
'23070, 계양구,'010003, 7세,2019,2354,1178,1176,100.2,2350,1175,1175,100
'23070, 계양구,'010004, 8세,2019,2463,1238,1225,101.1,2457,1236,1221,101.2
'23070, 계양구,'010005, 9세,2019,2396,1214,1182,102.7,2394,1213,1181,102.7
'23070, 계양구,'015,10~14세,2019,12366,6347,6019,105.4,12333,6327,6006,105.3
'23070, 계양구,'015001, 10세,2019,2386,1229,1157,106.2,2383,1227,1156,106.1
'23070, 계양구,'015002, 11세,2019,2546,1312,1234,106.3,2538,1308,1230,106.3
'23070, 계양구,'015003, 12세,2019,2693,1379,1314,104.9,2685,1374,1311,104.8
'23070, 계양구,'015004, 13세,2019,2421,1239,1182,104.8,2414,1234,1180,104.6
'23070, 계양구,'015005, 14세,2019,2320,1188,1132,104.9,2313,1184,1129,104.9
'23070, 계양구,'020,15~19세,2019,15306,7796,7510,103.8,15207,7759,7448,104.2
'23070, 계양구,'020001, 15세,2019,2691,1393,1298,107.3,2686,1392,1294,107.6
'23070, 계양구,'020002, 16세,2019,2726,1345,1381,97.4,2723,1344,1379,97.5
'23070, 계양구,'020003, 17세,2019,2886,1531,1355,113,2873,1527,1346,113.4
'23070, 계양구,'020004, 18세,2019,3356,1734,1622,106.9,3333,1726,1607,107.4
'23070, 계양구,'020005, 19세,2019,3647,1793,1854,96.7,3592,1770,1822,97.1
'23070, 계양구,'025,20~24세,2019,20753,10740,10013,107.3,20300,10540,9760,108
'23070, 계양구,'025001, 20세,2019,3918,2004,1914,104.7,3865,1982,1883,105.3
'23070, 계양구,'025002, 21세,2019,3810,2069,1741,118.8,3740,2035,1705,119.4
'23070, 계양구,'025003, 22세,2019,4136,2187,1949,112.2,4036,2143,1893,113.2
'23070, 계양구,'025004, 23세,2019,4379,2201,2178,101.1,4271,2157,2114,102
'23070, 계양구,'025005, 24세,2019,4510,2279,2231,102.2,4388,2223,2165,102.7
'23070, 계양구,'030,25~29세,2019,23599,12204,11395,107.1,22861,11839,11022,107.4
'23070, 계양구,'030001, 25세,2019,4887,2537,2350,108,4747,2466,2281,108.1
'23070, 계양구,'030002, 26세,2019,4961,2563,2398,106.9,4818,2492,2326,107.1
'23070, 계양구,'030003, 27세,2019,4970,2542,2428,104.7,4798,2450,2348,104.3
'23070, 계양구,'030004, 28세,2019,4571,2352,2219,106,4424,2279,2145,106.2
'23070, 계양구,'030005, 29세,2019,4210,2210,2000,110.5,4074,2152,1922,112
'23070, 계양구,'035,30~34세,2019,18593,9643,8950,107.7,17848,9301,8547,108.8
'23070, 계양구,'035001, 30세,2019,3953,2011,1942,103.6,3797,1944,1853,104.9
'23070, 계양구,'035002, 31세,2019,3696,1903,1793,106.1,3551,1846,1705,108.3
'23070, 계양구,'035003, 32세,2019,3588,1816,1772,102.5,3449,1750,1699,103
'23070, 계양구,'035004, 33세,2019,3693,2000,1693,118.1,3538,1914,1624,117.9
'23070, 계양구,'035005, 34세,2019,3663,1913,1750,109.3,3513,1847,1666,110.9
'23070, 계양구,'040,35~39세,2019,21266,10851,10415,104.2,20707,10604,10103,105
'23070, 계양구,'040001, 35세,2019,3642,1875,1767,106.1,3512,1823,1689,107.9
'23070, 계양구,'040002, 36세,2019,4220,2147,2073,103.6,4104,2098,2006,104.6
'23070, 계양구,'040003, 37세,2019,4382,2237,2145,104.3,4270,2188,2082,105.1
'23070, 계양구,'040004, 38세,2019,4435,2323,2112,110,4334,2270,2064,110
'23070, 계양구,'040005, 39세,2019,4587,2269,2318,97.9,4487,2225,2262,98.4
'23070, 계양구,'045,40~44세,2019,20851,10500,10351,101.4,20483,10339,10144,101.9
'23070, 계양구,'045001, 40세,2019,4299,2197,2102,104.5,4218,2163,2055,105.3
'23070, 계양구,'045002, 41세,2019,3903,1976,1927,102.5,3815,1934,1881,102.8
'23070, 계양구,'045003, 42세,2019,4160,2117,2043,103.6,4093,2088,2005,104.1
'23070, 계양구,'045004, 43세,2019,4064,2031,2033,99.9,3993,1997,1996,100.1
'23070, 계양구,'045005, 44세,2019,4425,2179,2246,97,4364,2157,2207,97.7
'23070, 계양구,'050,45~49세,2019,26640,13029,13611,95.7,26214,12832,13382,95.9
'23070, 계양구,'050001, 45세,2019,4927,2512,2415,104,4844,2470,2374,104
'23070, 계양구,'050002, 46세,2019,5169,2478,2691,92.1,5078,2429,2649,91.7
'23070, 계양구,'050003, 47세,2019,5142,2517,2625,95.9,5065,2484,2581,96.2
'23070, 계양구,'050004, 48세,2019,5698,2744,2954,92.9,5591,2698,2893,93.3
'23070, 계양구,'050005, 49세,2019,5704,2778,2926,94.9,5636,2751,2885,95.4
'23070, 계양구,'055,50~54세,2019,30065,14332,15733,91.1,29695,14177,15518,91.4
'23070, 계양구,'055001, 50세,2019,6019,2839,3180,89.3,5921,2797,3124,89.5
'23070, 계양구,'055002, 51세,2019,6242,2927,3315,88.3,6164,2891,3273,88.3
'23070, 계양구,'055003, 52세,2019,5796,2709,3087,87.8,5745,2693,3052,88.2
'23070, 계양구,'055004, 53세,2019,5834,2858,2976,96,5767,2828,2939,96.2
'23070, 계양구,'055005, 54세,2019,6174,2999,3175,94.5,6098,2968,3130,94.8
'23070, 계양구,'060,55~59세,2019,31612,15813,15799,100.1,31285,15664,15621,100.3
'23070, 계양구,'060001, 55세,2019,5775,2781,2994,92.9,5704,2749,2955,93
'23070, 계양구,'060002, 56세,2019,6324,3200,3124,102.4,6238,3160,3078,102.7
'23070, 계양구,'060003, 57세,2019,6433,3236,3197,101.2,6375,3210,3165,101.4
'23070, 계양구,'060004, 58세,2019,6704,3362,3342,100.6,6659,3339,3320,100.6
'23070, 계양구,'060005, 59세,2019,6376,3234,3142,102.9,6309,3206,3103,103.3
'23070, 계양구,'065,60~64세,2019,22401,11621,10780,107.8,22191,11530,10661,108.2
'23070, 계양구,'065001, 60세,2019,5347,2769,2578,107.4,5298,2744,2554,107.4
'23070, 계양구,'065002, 61세,2019,4884,2567,2317,110.8,4841,2548,2293,111.1
'23070, 계양구,'065003, 62세,2019,4467,2374,2093,113.4,4420,2354,2066,113.9
'23070, 계양구,'065004, 63세,2019,3862,1979,1883,105.1,3817,1960,1857,105.5
'23070, 계양구,'065005, 64세,2019,3841,1932,1909,101.2,3815,1924,1891,101.7
'23070, 계양구,'070,65~69세,2019,11866,6062,5804,104.4,11725,5998,5727,104.7
'23070, 계양구,'070001, 65세,2019,2979,1586,1393,113.9,2948,1565,1383,113.2
'23070, 계양구,'070002, 66세,2019,2514,1271,1243,102.3,2478,1260,1218,103.4
'23070, 계양구,'070003, 67세,2019,2726,1365,1361,100.3,2694,1350,1344,100.4
'23070, 계양구,'070004, 68세,2019,1738,884,854,103.5,1719,877,842,104.2
'23070, 계양구,'070005, 69세,2019,1909,956,953,100.3,1886,946,940,100.6
'23070, 계양구,'075,70~74세,2019,8373,3969,4404,90.1,8312,3946,4366,90.4
'23070, 계양구,'075001, 70세,2019,1945,964,981,98.3,1927,960,967,99.3
'23070, 계양구,'075002, 71세,2019,1868,949,919,103.3,1857,945,912,103.6
'23070, 계양구,'075003, 72세,2019,1840,842,998,84.4,1828,838,990,84.6
'23070, 계양구,'075004, 73세,2019,1387,633,754,84,1370,625,745,83.9
'23070, 계양구,'075005, 74세,2019,1333,581,752,77.3,1330,578,752,76.9
'23070, 계양구,'080,75~79세,2019,6650,2679,3971,67.5,6621,2667,3954,67.5
'23070, 계양구,'080001, 75세,2019,1295,557,738,75.5,1285,552,733,75.3
'23070, 계양구,'080002, 76세,2019,1324,558,766,72.8,1317,556,761,73.1
'23070, 계양구,'080003, 77세,2019,1566,635,931,68.2,1558,631,927,68.1
'23070, 계양구,'080004, 78세,2019,1305,503,802,62.7,1303,503,800,62.9
'23070, 계양구,'080005, 79세,2019,1160,426,734,58,1158,425,733,58
'23070, 계양구,'085,80~84세,2019,4646,1576,3070,51.3,4625,1570,3055,51.4
'23070, 계양구,'085001, 80세,2019,1105,405,700,57.9,1095,403,692,58.2
'23070, 계양구,'085002, 81세,2019,1032,358,674,53.1,1028,358,670,53.4
'23070, 계양구,'085003, 82세,2019,874,305,569,53.6,869,303,566,53.5
'23070, 계양구,'085004, 83세,2019,856,251,605,41.5,856,251,605,41.5
'23070, 계양구,'085005, 84세,2019,779,257,522,49.2,777,255,522,48.9
'23070, 계양구,'086,85세이상,2019,3382,827,2555,32.4,3371,825,2546,32.4
'23070, 계양구,'090,85~89세,2019,2324,594,1730,34.3,2317,593,1724,34.4
'23070, 계양구,'090001, 85세,2019,639,186,453,41.1,637,185,452,40.9
'23070, 계양구,'090002, 86세,2019,559,142,417,34.1,556,142,414,34.3
'23070, 계양구,'090003, 87세,2019,437,116,321,36.1,437,116,321,36.1
'23070, 계양구,'090004, 88세,2019,357,81,276,29.3,356,81,275,29.5
'23070, 계양구,'090005, 89세,2019,332,69,263,26.2,331,69,262,26.3
'23070, 계양구,'095,90~94세,2019,858,191,667,28.6,855,190,665,28.6
'23070, 계양구,'095001, 90세,2019,263,59,204,28.9,263,59,204,28.9
'23070, 계양구,'095002, 91세,2019,223,48,175,27.4,222,48,174,27.6
'23070, 계양구,'095003, 92세,2019,161,35,126,27.8,160,35,125,28
'23070, 계양구,'095004, 93세,2019,115,29,86,33.7,114,28,86,32.6
'23070, 계양구,'095005, 94세,2019,96,20,76,26.3,96,20,76,26.3
'23070, 계양구,'100,95~99세,2019,178,41,137,29.9,177,41,136,30.1
'23070, 계양구,'100001, 95세,2019,51,13,38,34.2,51,13,38,34.2
'23070, 계양구,'100002, 96세,2019,60,16,44,36.4,59,16,43,37.2
'23070, 계양구,'100003, 97세,2019,31,X,27,14.8,31,X,27,14.8
'23070, 계양구,'100004, 98세,2019,25,6,19,31.6,25,6,19,31.6
'23070, 계양구,'100005, 99세,2019,11,X,9,22.2,11,X,9,22.2
'23070, 계양구,'101,100세이상,2019,22,X,21,4.8,22,X,21,4.8
'23070, 계양구,'102,15세미만,2019,32909,16792,16117,104.2,32730,16704,16026,104.2
'23070, 계양구,'103,15~64세,2019,231086,116529,114557,101.7,226791,114585,112206,102.1
'23070, 계양구,'104,65세이상,2019,34917,15113,19804,76.3,34654,15006,19648,76.4
'23070, 계양구,'126,평균연령,2019,42.2,41.3,43,,42.2,41.3,43.1,
'23070, 계양구,'127,중위연령,2019,44.1,43,45.2,,44.3,43.1,45.4,
'23080, 서구,'000,합계,2019,540655,275606,265049,104,523012,263711,259301,101.7
'23080, 서구,'005,0~4세,2019,24302,12553,11749,106.8,23925,12367,11558,107
'23080, 서구,'005001, 0세,2019,4120,2113,2007,105.3,4057,2090,1967,106.3
'23080, 서구,'005002, 1세,2019,4223,2184,2039,107.1,4139,2142,1997,107.3
'23080, 서구,'005003, 2세,2019,4772,2465,2307,106.8,4699,2427,2272,106.8
'23080, 서구,'005004, 3세,2019,5448,2821,2627,107.4,5369,2780,2589,107.4
'23080, 서구,'005005, 4세,2019,5739,2970,2769,107.3,5661,2928,2733,107.1
'23080, 서구,'010,5~9세,2019,29043,14994,14049,106.7,28765,14850,13915,106.7
'23080, 서구,'010001, 5세,2019,5545,2864,2681,106.8,5472,2829,2643,107
'23080, 서구,'010002, 6세,2019,5580,2848,2732,104.2,5525,2823,2702,104.5
'23080, 서구,'010003, 7세,2019,6105,3218,2887,111.5,6056,3195,2861,111.7
'23080, 서구,'010004, 8세,2019,6102,3155,2947,107.1,6045,3118,2927,106.5
'23080, 서구,'010005, 9세,2019,5711,2909,2802,103.8,5667,2885,2782,103.7
'23080, 서구,'015,10~14세,2019,27335,14010,13325,105.1,27186,13934,13252,105.1
'23080, 서구,'015001, 10세,2019,5370,2778,2592,107.2,5335,2760,2575,107.2
'23080, 서구,'015002, 11세,2019,5667,2862,2805,102,5627,2839,2788,101.8
'23080, 서구,'015003, 12세,2019,5819,2933,2886,101.6,5789,2916,2873,101.5
'23080, 서구,'015004, 13세,2019,5345,2763,2582,107,5323,2753,2570,107.1
'23080, 서구,'015005, 14세,2019,5134,2674,2460,108.7,5112,2666,2446,109
'23080, 서구,'020,15~19세,2019,27369,14097,13272,106.2,27203,14002,13201,106.1
'23080, 서구,'020001, 15세,2019,5429,2749,2680,102.6,5406,2741,2665,102.9
'23080, 서구,'020002, 16세,2019,5284,2694,2590,104,5264,2680,2584,103.7
'23080, 서구,'020003, 17세,2019,5462,2822,2640,106.9,5430,2798,2632,106.3
'23080, 서구,'020004, 18세,2019,5774,2982,2792,106.8,5738,2961,2777,106.6
'23080, 서구,'020005, 19세,2019,5420,2850,2570,110.9,5365,2822,2543,111
'23080, 서구,'025,20~24세,2019,32318,17175,15143,113.4,30969,16169,14800,109.3
'23080, 서구,'025001, 20세,2019,5606,3084,2522,122.3,5508,3018,2490,121.2
'23080, 서구,'025002, 21세,2019,6181,3421,2760,123.9,6007,3300,2707,121.9
'23080, 서구,'025003, 22세,2019,6502,3404,3098,109.9,6241,3211,3030,106
'23080, 서구,'025004, 23세,2019,6832,3519,3313,106.2,6463,3236,3227,100.3
'23080, 서구,'025005, 24세,2019,7197,3747,3450,108.6,6750,3404,3346,101.7
'23080, 서구,'030,25~29세,2019,38887,20848,18039,115.6,35862,18569,17293,107.4
'23080, 서구,'030001, 25세,2019,7520,4041,3479,116.2,7071,3690,3381,109.1
'23080, 서구,'030002, 26세,2019,7865,4220,3645,115.8,7291,3794,3497,108.5
'23080, 서구,'030003, 27세,2019,8181,4369,3812,114.6,7546,3877,3669,105.7
'23080, 서구,'030004, 28세,2019,8003,4318,3685,117.2,7303,3802,3501,108.6
'23080, 서구,'030005, 29세,2019,7318,3900,3418,114.1,6651,3406,3245,105
'23080, 서구,'035,30~34세,2019,37917,20029,17888,112,34398,17394,17004,102.3
'23080, 서구,'035001, 30세,2019,7289,3892,3397,114.6,6635,3401,3234,105.2
'23080, 서구,'035002, 31세,2019,7333,3864,3469,111.4,6564,3289,3275,100.4
'23080, 서구,'035003, 32세,2019,7384,3828,3556,107.6,6635,3266,3369,96.9
'23080, 서구,'035004, 33세,2019,7849,4174,3675,113.6,7141,3647,3494,104.4
'23080, 서구,'035005, 34세,2019,8062,4271,3791,112.7,7423,3791,3632,104.4
'23080, 서구,'040,35~39세,2019,48764,25547,23217,110,46127,23623,22504,105
'23080, 서구,'040001, 35세,2019,8503,4403,4100,107.4,7892,3958,3934,100.6
'23080, 서구,'040002, 36세,2019,9390,4929,4461,110.5,8853,4524,4329,104.5
'23080, 서구,'040003, 37세,2019,10218,5393,4825,111.8,9672,4992,4680,106.7
'23080, 서구,'040004, 38세,2019,10206,5400,4806,112.4,9719,5040,4679,107.7
'23080, 서구,'040005, 39세,2019,10447,5422,5025,107.9,9991,5109,4882,104.6
'23080, 서구,'045,40~44세,2019,46024,23745,22279,106.6,44322,22600,21722,104
'23080, 서구,'045001, 40세,2019,9874,5115,4759,107.5,9431,4815,4616,104.3
'23080, 서구,'045002, 41세,2019,8919,4609,4310,106.9,8550,4356,4194,103.9
'23080, 서구,'045003, 42세,2019,9156,4695,4461,105.2,8825,4469,4356,102.6
'23080, 서구,'045004, 43세,2019,8784,4488,4296,104.5,8495,4299,4196,102.5
'23080, 서구,'045005, 44세,2019,9291,4838,4453,108.6,9021,4661,4360,106.9
'23080, 서구,'050,45~49세,2019,49879,25391,24488,103.7,48507,24557,23950,102.5
'23080, 서구,'050001, 45세,2019,9984,5126,4858,105.5,9708,4957,4751,104.3
'23080, 서구,'050002, 46세,2019,9757,4907,4850,101.2,9496,4737,4759,99.5
'23080, 서구,'050003, 47세,2019,9858,5019,4839,103.7,9550,4836,4714,102.6
'23080, 서구,'050004, 48세,2019,10447,5360,5087,105.4,10194,5212,4982,104.6
'23080, 서구,'050005, 49세,2019,9833,4979,4854,102.6,9559,4815,4744,101.5
'23080, 서구,'055,50~54세,2019,47860,24005,23855,100.6,46781,23376,23405,99.9
'23080, 서구,'055001, 50세,2019,10087,5038,5049,99.8,9842,4890,4952,98.7
'23080, 서구,'055002, 51세,2019,10062,5009,5053,99.1,9846,4879,4967,98.2
'23080, 서구,'055003, 52세,2019,9176,4539,4637,97.9,8979,4419,4560,96.9
'23080, 서구,'055004, 53세,2019,9063,4636,4427,104.7,8874,4531,4343,104.3
'23080, 서구,'055005, 54세,2019,9472,4783,4689,102,9240,4657,4583,101.6
'23080, 서구,'060,55~59세,2019,44611,22959,21652,106,43790,22554,21236,106.2
'23080, 서구,'060001, 55세,2019,8666,4394,4272,102.9,8475,4296,4179,102.8
'23080, 서구,'060002, 56세,2019,8895,4562,4333,105.3,8691,4465,4226,105.7
'23080, 서구,'060003, 57세,2019,8713,4509,4204,107.3,8565,4428,4137,107
'23080, 서구,'060004, 58세,2019,9277,4844,4433,109.3,9155,4790,4365,109.7
'23080, 서구,'060005, 59세,2019,9060,4650,4410,105.4,8904,4575,4329,105.7
'23080, 서구,'065,60~64세,2019,33179,16945,16234,104.4,32612,16664,15948,104.5
'23080, 서구,'065001, 60세,2019,7639,3921,3718,105.5,7524,3868,3656,105.8
'23080, 서구,'065002, 61세,2019,7132,3692,3440,107.3,7012,3632,3380,107.5
'23080, 서구,'065003, 62세,2019,6667,3373,3294,102.4,6528,3305,3223,102.5
'23080, 서구,'065004, 63세,2019,5931,3036,2895,104.9,5829,2989,2840,105.2
'23080, 서구,'065005, 64세,2019,5810,2923,2887,101.2,5719,2870,2849,100.7
'23080, 서구,'070,65~69세,2019,18982,9497,9485,100.1,18633,9337,9296,100.4
'23080, 서구,'070001, 65세,2019,4658,2331,2327,100.2,4570,2293,2277,100.7
'23080, 서구,'070002, 66세,2019,4005,1978,2027,97.6,3921,1938,1983,97.7
'23080, 서구,'070003, 67세,2019,4247,2153,2094,102.8,4184,2119,2065,102.6
'23080, 서구,'070004, 68세,2019,2883,1435,1448,99.1,2827,1408,1419,99.2
'23080, 서구,'070005, 69세,2019,3189,1600,1589,100.7,3131,1579,1552,101.7
'23080, 서구,'075,70~74세,2019,13357,6387,6970,91.6,13226,6330,6896,91.8
'23080, 서구,'075001, 70세,2019,3175,1582,1593,99.3,3136,1568,1568,100
'23080, 서구,'075002, 71세,2019,2990,1485,1505,98.7,2960,1470,1490,98.7
'23080, 서구,'075003, 72세,2019,2975,1382,1593,86.8,2951,1369,1582,86.5
'23080, 서구,'075004, 73세,2019,2134,993,1141,87,2119,989,1130,87.5
'23080, 서구,'075005, 74세,2019,2083,945,1138,83,2060,934,1126,82.9
'23080, 서구,'080,75~79세,2019,9610,4066,5544,73.3,9553,4047,5506,73.5
'23080, 서구,'080001, 75세,2019,1979,901,1078,83.6,1966,898,1068,84.1
'23080, 서구,'080002, 76세,2019,2055,915,1140,80.3,2044,913,1131,80.7
'23080, 서구,'080003, 77세,2019,2282,973,1309,74.3,2265,963,1302,74
'23080, 서구,'080004, 78세,2019,1722,691,1031,67,1712,689,1023,67.4
'23080, 서구,'080005, 79세,2019,1572,586,986,59.4,1566,584,982,59.5
'23080, 서구,'085,80~84세,2019,6493,2240,4253,52.7,6448,2227,4221,52.8
'23080, 서구,'085001, 80세,2019,1554,601,953,63.1,1545,597,948,63
'23080, 서구,'085002, 81세,2019,1459,532,927,57.4,1445,529,916,57.8
'23080, 서구,'085003, 82세,2019,1195,390,805,48.4,1187,388,799,48.6
'23080, 서구,'085004, 83세,2019,1213,384,829,46.3,1203,381,822,46.4
'23080, 서구,'085005, 84세,2019,1072,333,739,45.1,1068,332,736,45.1
'23080, 서구,'086,85세이상,2019,4725,1118,3607,31,4705,1111,3594,30.9
'23080, 서구,'090,85~89세,2019,3206,832,2374,35,3195,829,2366,35
'23080, 서구,'090001, 85세,2019,874,263,611,43,871,263,608,43.3
'23080, 서구,'090002, 86세,2019,755,205,550,37.3,754,204,550,37.1
'23080, 서구,'090003, 87세,2019,628,166,462,35.9,624,164,460,35.7
'23080, 서구,'090004, 88세,2019,486,111,375,29.6,485,111,374,29.7
'23080, 서구,'090005, 89세,2019,463,87,376,23.1,461,87,374,23.3
'23080, 서구,'095,90~94세,2019,1210,236,974,24.2,1203,234,969,24.1
'23080, 서구,'095001, 90세,2019,393,79,314,25.2,391,78,313,24.9
'23080, 서구,'095002, 91세,2019,301,66,235,28.1,301,66,235,28.1
'23080, 서구,'095003, 92세,2019,246,41,205,20,243,41,202,20.3
'23080, 서구,'095004, 93세,2019,146,26,120,21.7,144,25,119,21
'23080, 서구,'095005, 94세,2019,124,24,100,24,124,24,100,24
'23080, 서구,'100,95~99세,2019,275,46,229,20.1,274,45,229,19.7
'23080, 서구,'100001, 95세,2019,82,12,70,17.1,82,12,70,17.1
'23080, 서구,'100002, 96세,2019,77,16,61,26.2,76,15,61,24.6
'23080, 서구,'100003, 97세,2019,49,5,44,11.4,49,5,44,11.4
'23080, 서구,'100004, 98세,2019,38,X,35,8.6,38,X,35,8.6
'23080, 서구,'100005, 99세,2019,29,10,19,52.6,29,10,19,52.6
'23080, 서구,'101,100세이상,2019,34,X,30,13.3,33,X,30,10
'23080, 서구,'102,15세미만,2019,80680,41557,39123,106.2,79876,41151,38725,106.3
'23080, 서구,'103,15~64세,2019,406808,210741,196067,107.5,390571,199508,191063,104.4
'23080, 서구,'104,65세이상,2019,53167,23308,29859,78.1,52565,23052,29513,78.1
'23080, 서구,'126,평균연령,2019,39.6,38.8,40.3,,39.6,38.9,40.4,
'23080, 서구,'127,중위연령,2019,40.4,39.7,41.3,,40.7,40.2,41.4,
'23090, 미추홀구,'000,합계,2019,411612,207840,203772,102,399260,201556,197704,101.9
'23090, 미추홀구,'005,0~4세,2019,14009,7151,6858,104.3,13611,6947,6664,104.2
'23090, 미추홀구,'005001, 0세,2019,2398,1216,1182,102.9,2314,1178,1136,103.7
'23090, 미추홀구,'005002, 1세,2019,2517,1296,1221,106.1,2421,1244,1177,105.7
'23090, 미추홀구,'005003, 2세,2019,2806,1435,1371,104.7,2723,1389,1334,104.1
'23090, 미추홀구,'005004, 3세,2019,3061,1536,1525,100.7,2974,1495,1479,101.1
'23090, 미추홀구,'005005, 4세,2019,3227,1668,1559,107,3179,1641,1538,106.7
'23090, 미추홀구,'010,5~9세,2019,15658,8008,7650,104.7,15427,7883,7544,104.5
'23090, 미추홀구,'010001, 5세,2019,3016,1496,1520,98.4,2959,1461,1498,97.5
'23090, 미추홀구,'010002, 6세,2019,3034,1566,1468,106.7,2984,1541,1443,106.8
'23090, 미추홀구,'010003, 7세,2019,3305,1705,1600,106.6,3255,1679,1576,106.5
'23090, 미추홀구,'010004, 8세,2019,3255,1691,1564,108.1,3216,1670,1546,108
'23090, 미추홀구,'010005, 9세,2019,3048,1550,1498,103.5,3013,1532,1481,103.4
'23090, 미추홀구,'015,10~14세,2019,14754,7663,7091,108.1,14611,7575,7036,107.7
'23090, 미추홀구,'015001, 10세,2019,2935,1520,1415,107.4,2908,1502,1406,106.8
'23090, 미추홀구,'015002, 11세,2019,3084,1582,1502,105.3,3058,1567,1491,105.1
'23090, 미추홀구,'015003, 12세,2019,3103,1662,1441,115.3,3072,1644,1428,115.1
'23090, 미추홀구,'015004, 13세,2019,2801,1450,1351,107.3,2772,1428,1344,106.3
'23090, 미추홀구,'015005, 14세,2019,2831,1449,1382,104.8,2801,1434,1367,104.9
'23090, 미추홀구,'020,15~19세,2019,19465,10177,9288,109.6,18755,9801,8954,109.5
'23090, 미추홀구,'020001, 15세,2019,3061,1599,1462,109.4,3045,1590,1455,109.3
'23090, 미추홀구,'020002, 16세,2019,3293,1728,1565,110.4,3280,1722,1558,110.5
'23090, 미추홀구,'020003, 17세,2019,3343,1747,1596,109.5,3307,1726,1581,109.2
'23090, 미추홀구,'020004, 18세,2019,4188,2159,2029,106.4,4002,2045,1957,104.5
'23090, 미추홀구,'020005, 19세,2019,5580,2944,2636,111.7,5121,2718,2403,113.1
'23090, 미추홀구,'025,20~24세,2019,29945,16033,13912,115.2,28161,15071,13090,115.1
'23090, 미추홀구,'025001, 20세,2019,5393,2721,2672,101.8,4985,2498,2487,100.4
'23090, 미추홀구,'025002, 21세,2019,5544,2922,2622,111.4,5165,2706,2459,110
'23090, 미추홀구,'025003, 22세,2019,6234,3400,2834,120,5877,3205,2672,119.9
'23090, 미추홀구,'025004, 23세,2019,6442,3512,2930,119.9,6112,3348,2764,121.1
'23090, 미추홀구,'025005, 24세,2019,6332,3478,2854,121.9,6022,3314,2708,122.4
'23090, 미추홀구,'030,25~29세,2019,31212,16920,14292,118.4,29785,16238,13547,119.9
'23090, 미추홀구,'030001, 25세,2019,6402,3509,2893,121.3,6148,3398,2750,123.6
'23090, 미추홀구,'030002, 26세,2019,6383,3464,2919,118.7,6136,3340,2796,119.5
'23090, 미추홀구,'030003, 27세,2019,6494,3478,3016,115.3,6215,3337,2878,115.9
'23090, 미추홀구,'030004, 28세,2019,6159,3334,2825,118,5858,3197,2661,120.1
'23090, 미추홀구,'030005, 29세,2019,5774,3135,2639,118.8,5428,2966,2462,120.5
'23090, 미추홀구,'035,30~34세,2019,26964,14537,12427,117,25317,13685,11632,117.6
'23090, 미추홀구,'035001, 30세,2019,5605,3035,2570,118.1,5297,2866,2431,117.9
'23090, 미추홀구,'035002, 31세,2019,5260,2819,2441,115.5,4924,2654,2270,116.9
'23090, 미추홀구,'035003, 32세,2019,5281,2836,2445,116,4935,2652,2283,116.2
'23090, 미추홀구,'035004, 33세,2019,5381,2914,2467,118.1,5057,2760,2297,120.2
'23090, 미추홀구,'035005, 34세,2019,5437,2933,2504,117.1,5104,2753,2351,117.1
'23090, 미추홀구,'040,35~39세,2019,32250,17267,14983,115.2,30944,16552,14392,115
'23090, 미추홀구,'040001, 35세,2019,5626,2985,2641,113,5375,2852,2523,113
'23090, 미추홀구,'040002, 36세,2019,6290,3291,2999,109.7,5981,3123,2858,109.3
'23090, 미추홀구,'040003, 37세,2019,6726,3642,3084,118.1,6419,3471,2948,117.7
'23090, 미추홀구,'040004, 38세,2019,6812,3683,3129,117.7,6576,3552,3024,117.5
'23090, 미추홀구,'040005, 39세,2019,6796,3666,3130,117.1,6593,3554,3039,116.9
'23090, 미추홀구,'045,40~44세,2019,29679,15786,13893,113.6,28765,15306,13459,113.7
'23090, 미추홀구,'045001, 40세,2019,6531,3554,2977,119.4,6315,3446,2869,120.1
'23090, 미추홀구,'045002, 41세,2019,5829,3063,2766,110.7,5628,2972,2656,111.9
'23090, 미추홀구,'045003, 42세,2019,5733,3051,2682,113.8,5551,2950,2601,113.4
'23090, 미추홀구,'045004, 43세,2019,5540,2857,2683,106.5,5383,2773,2610,106.2
'23090, 미추홀구,'045005, 44세,2019,6046,3261,2785,117.1,5888,3165,2723,116.2
'23090, 미추홀구,'050,45~49세,2019,33843,17548,16295,107.7,32938,17073,15865,107.6
'23090, 미추홀구,'050001, 45세,2019,6465,3433,3032,113.2,6307,3349,2958,113.2
'23090, 미추홀구,'050002, 46세,2019,6721,3486,3235,107.8,6547,3390,3157,107.4
'23090, 미추홀구,'050003, 47세,2019,6829,3584,3245,110.4,6653,3492,3161,110.5
'23090, 미추홀구,'050004, 48세,2019,6994,3572,3422,104.4,6788,3467,3321,104.4
'23090, 미추홀구,'050005, 49세,2019,6834,3473,3361,103.3,6643,3375,3268,103.3
'23090, 미추홀구,'055,50~54세,2019,33172,16586,16586,100,32344,16184,16160,100.1
'23090, 미추홀구,'055001, 50세,2019,7051,3637,3414,106.5,6865,3547,3318,106.9
'23090, 미추홀구,'055002, 51세,2019,6906,3444,3462,99.5,6721,3351,3370,99.4
'23090, 미추홀구,'055003, 52세,2019,6290,3100,3190,97.2,6155,3031,3124,97
'23090, 미추홀구,'055004, 53세,2019,6184,3109,3075,101.1,6038,3044,2994,101.7
'23090, 미추홀구,'055005, 54세,2019,6741,3296,3445,95.7,6565,3211,3354,95.7
'23090, 미추홀구,'060,55~59세,2019,34814,17106,17708,96.6,34006,16727,17279,96.8
'23090, 미추홀구,'060001, 55세,2019,6257,3100,3157,98.2,6083,3016,3067,98.3
'23090, 미추홀구,'060002, 56세,2019,6860,3470,3390,102.4,6657,3379,3278,103.1
'23090, 미추홀구,'060003, 57세,2019,6907,3390,3517,96.4,6731,3305,3426,96.5
'23090, 미추홀구,'060004, 58세,2019,7391,3568,3823,93.3,7295,3525,3770,93.5
'23090, 미추홀구,'060005, 59세,2019,7399,3578,3821,93.6,7240,3502,3738,93.7
'23090, 미추홀구,'065,60~64세,2019,31567,15210,16357,93,30929,14927,16002,93.3
'23090, 미추홀구,'065001, 60세,2019,6888,3374,3514,96,6762,3315,3447,96.2
'23090, 미추홀구,'065002, 61세,2019,6504,3110,3394,91.6,6369,3048,3321,91.8
'23090, 미추홀구,'065003, 62세,2019,6331,3080,3251,94.7,6191,3018,3173,95.1
'23090, 미추홀구,'065004, 63세,2019,5915,2822,3093,91.2,5792,2766,3026,91.4
'23090, 미추홀구,'065005, 64세,2019,5929,2824,3105,91,5815,2780,3035,91.6
'23090, 미추홀구,'070,65~69세,2019,20666,9748,10918,89.3,20340,9597,10743,89.3
'23090, 미추홀구,'070001, 65세,2019,4840,2247,2593,86.7,4748,2210,2538,87.1
'23090, 미추홀구,'070002, 66세,2019,4228,2010,2218,90.6,4146,1959,2187,89.6
'23090, 미추홀구,'070003, 67세,2019,4715,2230,2485,89.7,4650,2206,2444,90.3
'23090, 미추홀구,'070004, 68세,2019,3160,1495,1665,89.8,3111,1472,1639,89.8
'23090, 미추홀구,'070005, 69세,2019,3723,1766,1957,90.2,3685,1750,1935,90.4
'23090, 미추홀구,'075,70~74세,2019,17023,7918,9105,87,16881,7858,9023,87.1
'23090, 미추홀구,'075001, 70세,2019,3873,1808,2065,87.6,3825,1785,2040,87.5
'23090, 미추홀구,'075002, 71세,2019,3682,1737,1945,89.3,3655,1725,1930,89.4
'23090, 미추홀구,'075003, 72세,2019,3793,1772,2021,87.7,3766,1760,2006,87.7
'23090, 미추홀구,'075004, 73세,2019,2903,1341,1562,85.9,2877,1335,1542,86.6
'23090, 미추홀구,'075005, 74세,2019,2772,1260,1512,83.3,2758,1253,1505,83.3
'23090, 미추홀구,'080,75~79세,2019,13042,5629,7413,75.9,12977,5609,7368,76.1
'23090, 미추홀구,'080001, 75세,2019,2673,1168,1505,77.6,2655,1164,1491,78.1
'23090, 미추홀구,'080002, 76세,2019,2732,1220,1512,80.7,2723,1220,1503,81.2
'23090, 미추홀구,'080003, 77세,2019,3085,1340,1745,76.8,3072,1333,1739,76.7
'23090, 미추홀구,'080004, 78세,2019,2411,1033,1378,75,2398,1028,1370,75
'23090, 미추홀구,'080005, 79세,2019,2141,868,1273,68.2,2129,864,1265,68.3
'23090, 미추홀구,'085,80~84세,2019,8166,3129,5037,62.1,8116,3111,5005,62.2
'23090, 미추홀구,'085001, 80세,2019,2068,835,1233,67.7,2055,832,1223,68
'23090, 미추홀구,'085002, 81세,2019,1884,753,1131,66.6,1877,751,1126,66.7
'23090, 미추홀구,'085003, 82세,2019,1530,578,952,60.7,1523,574,949,60.5
'23090, 미추홀구,'085004, 83세,2019,1386,516,870,59.3,1378,512,866,59.1
'23090, 미추홀구,'085005, 84세,2019,1298,447,851,52.5,1283,442,841,52.6
'23090, 미추홀구,'086,85세이상,2019,5383,1424,3959,36,5353,1412,3941,35.8
'23090, 미추홀구,'090,85~89세,2019,3700,1039,2661,39,3679,1032,2647,39
'23090, 미추홀구,'090001, 85세,2019,1054,320,734,43.6,1047,317,730,43.4
'23090, 미추홀구,'090002, 86세,2019,841,231,610,37.9,839,231,608,38
'23090, 미추홀구,'090003, 87세,2019,717,209,508,41.1,714,208,506,41.1
'23090, 미추홀구,'090004, 88세,2019,555,154,401,38.4,552,153,399,38.3
'23090, 미추홀구,'090005, 89세,2019,533,125,408,30.6,527,123,404,30.4
'23090, 미추홀구,'095,90~94세,2019,1348,308,1040,29.6,1342,306,1036,29.5
'23090, 미추홀구,'095001, 90세,2019,457,124,333,37.2,455,123,332,37
'23090, 미추홀구,'095002, 91세,2019,315,63,252,25,314,62,252,24.6
'23090, 미추홀구,'095003, 92세,2019,258,59,199,29.6,257,59,198,29.8
'23090, 미추홀구,'095004, 93세,2019,167,34,133,25.6,165,34,131,26
'23090, 미추홀구,'095005, 94세,2019,151,28,123,22.8,151,28,123,22.8
'23090, 미추홀구,'100,95~99세,2019,292,65,227,28.6,290,63,227,27.8
'23090, 미추홀구,'100001, 95세,2019,98,24,74,32.4,98,24,74,32.4
'23090, 미추홀구,'100002, 96세,2019,85,20,65,30.8,85,20,65,30.8
'23090, 미추홀구,'100003, 97세,2019,47,8,39,20.5,46,7,39,17.9
'23090, 미추홀구,'100004, 98세,2019,42,11,31,35.5,41,10,31,32.3
'23090, 미추홀구,'100005, 99세,2019,20,X,18,11.1,20,X,18,11.1
'23090, 미추홀구,'101,100세이상,2019,43,12,31,38.7,42,11,31,35.5
'23090, 미추홀구,'102,15세미만,2019,44421,22822,21599,105.7,43649,22405,21244,105.5
'23090, 미추홀구,'103,15~64세,2019,302911,157170,145741,107.8,291944,151564,140380,108
'23090, 미추홀구,'104,65세이상,2019,64280,27848,36432,76.4,63667,27587,36080,76.5
'23090, 미추홀구,'126,평균연령,2019,42.9,41.7,44.2,,43.1,41.8,44.4,
'23090, 미추홀구,'127,중위연령,2019,43.6,41.9,45.5,,44,42.2,45.9,
'23310, 강화군,'000,합계,2019,65235,32781,32454,101,64004,31985,32019,99.9
'23310, 강화군,'005,0~4세,2019,1379,704,675,104.3,1374,699,675,103.6
'23310, 강화군,'005001, 0세,2019,289,146,143,102.1,288,145,143,101.4
'23310, 강화군,'005002, 1세,2019,259,134,125,107.2,256,131,125,104.8
'23310, 강화군,'005003, 2세,2019,239,124,115,107.8,239,124,115,107.8
'23310, 강화군,'005004, 3세,2019,281,146,135,108.1,281,146,135,108.1
'23310, 강화군,'005005, 4세,2019,311,154,157,98.1,310,153,157,97.5
'23310, 강화군,'010,5~9세,2019,1795,927,868,106.8,1787,922,865,106.6
'23310, 강화군,'010001, 5세,2019,318,161,157,102.5,314,158,156,101.3
'23310, 강화군,'010002, 6세,2019,323,158,165,95.8,322,157,165,95.2
'23310, 강화군,'010003, 7세,2019,368,195,173,112.7,367,195,172,113.4
'23310, 강화군,'010004, 8세,2019,404,208,196,106.1,403,207,196,105.6
'23310, 강화군,'010005, 9세,2019,382,205,177,115.8,381,205,176,116.5
'23310, 강화군,'015,10~14세,2019,2059,1058,1001,105.7,2054,1054,1000,105.4
'23310, 강화군,'015001, 10세,2019,405,222,183,121.3,403,221,182,121.4
'23310, 강화군,'015002, 11세,2019,431,197,234,84.2,430,196,234,83.8
'23310, 강화군,'015003, 12세,2019,398,215,183,117.5,398,215,183,117.5
'23310, 강화군,'015004, 13세,2019,421,218,203,107.4,420,217,203,106.9
'23310, 강화군,'015005, 14세,2019,404,206,198,104,403,205,198,103.5
'23310, 강화군,'020,15~19세,2019,2658,1366,1292,105.7,2648,1360,1288,105.6
'23310, 강화군,'020001, 15세,2019,472,241,231,104.3,468,239,229,104.4
'23310, 강화군,'020002, 16세,2019,680,379,301,125.9,680,379,301,125.9
'23310, 강화군,'020003, 17세,2019,579,287,292,98.3,577,286,291,98.3
'23310, 강화군,'020004, 18세,2019,552,256,296,86.5,552,256,296,86.5
'23310, 강화군,'020005, 19세,2019,375,203,172,118,371,200,171,117
'23310, 강화군,'025,20~24세,2019,2368,1403,965,145.4,2241,1319,922,143.1
'23310, 강화군,'025001, 20세,2019,424,256,168,152.4,412,248,164,151.2
'23310, 강화군,'025002, 21세,2019,487,299,188,159,468,286,182,157.1
'23310, 강화군,'025003, 22세,2019,442,260,182,142.9,426,249,177,140.7
'23310, 강화군,'025004, 23세,2019,472,264,208,126.9,430,237,193,122.8
'23310, 강화군,'025005, 24세,2019,543,324,219,147.9,505,299,206,145.1
'23310, 강화군,'030,25~29세,2019,2741,1649,1092,151,2483,1458,1025,142.2
'23310, 강화군,'030001, 25세,2019,588,366,222,164.9,540,330,210,157.1
'23310, 강화군,'030002, 26세,2019,530,310,220,140.9,474,268,206,130.1
'23310, 강화군,'030003, 27세,2019,549,328,221,148.4,494,290,204,142.2
'23310, 강화군,'030004, 28세,2019,563,326,237,137.6,517,292,225,129.8
'23310, 강화군,'030005, 29세,2019,511,319,192,166.1,458,278,180,154.4
'23310, 강화군,'035,30~34세,2019,2337,1300,1037,125.4,2111,1134,977,116.1
'23310, 강화군,'035001, 30세,2019,498,291,207,140.6,444,248,196,126.5
'23310, 강화군,'035002, 31세,2019,465,255,210,121.4,414,216,198,109.1
'23310, 강화군,'035003, 32세,2019,454,256,198,129.3,417,230,187,123
'23310, 강화군,'035004, 33세,2019,443,249,194,128.4,396,215,181,118.8
'23310, 강화군,'035005, 34세,2019,477,249,228,109.2,440,225,215,104.7
'23310, 강화군,'040,35~39세,2019,2970,1583,1387,114.1,2813,1483,1330,111.5
'23310, 강화군,'040001, 35세,2019,520,266,254,104.7,481,242,239,101.3
'23310, 강화군,'040002, 36세,2019,587,320,267,119.9,546,296,250,118.4
'23310, 강화군,'040003, 37세,2019,628,330,298,110.7,596,309,287,107.7
'23310, 강화군,'040004, 38세,2019,622,334,288,116,600,319,281,113.5
'23310, 강화군,'040005, 39세,2019,613,333,280,118.9,590,317,273,116.1
'23310, 강화군,'045,40~44세,2019,3175,1689,1486,113.7,3081,1630,1451,112.3
'23310, 강화군,'045001, 40세,2019,582,300,282,106.4,560,285,275,103.6
'23310, 강화군,'045002, 41세,2019,597,319,278,114.7,575,308,267,115.4
'23310, 강화군,'045003, 42세,2019,658,362,296,122.3,649,355,294,120.7
'23310, 강화군,'045004, 43세,2019,643,328,315,104.1,626,317,309,102.6
'23310, 강화군,'045005, 44세,2019,695,380,315,120.6,671,365,306,119.3
'23310, 강화군,'050,45~49세,2019,4246,2345,1901,123.4,4156,2292,1864,123
'23310, 강화군,'050001, 45세,2019,777,443,334,132.6,755,432,323,133.7
'23310, 강화군,'050002, 46세,2019,843,470,373,126,832,462,370,124.9
'23310, 강화군,'050003, 47세,2019,811,435,376,115.7,792,425,367,115.8
'23310, 강화군,'050004, 48세,2019,916,497,419,118.6,897,485,412,117.7
'23310, 강화군,'050005, 49세,2019,899,500,399,125.3,880,488,392,124.5
'23310, 강화군,'055,50~54세,2019,5028,2564,2464,104.1,4945,2521,2424,104
'23310, 강화군,'055001, 50세,2019,972,501,471,106.4,956,495,461,107.4
'23310, 강화군,'055002, 51세,2019,990,499,491,101.6,973,490,483,101.4
'23310, 강화군,'055003, 52세,2019,938,479,459,104.4,918,469,449,104.5
'23310, 강화군,'055004, 53세,2019,1005,523,482,108.5,992,515,477,108
'23310, 강화군,'055005, 54세,2019,1123,562,561,100.2,1106,552,554,99.6
'23310, 강화군,'060,55~59세,2019,6637,3291,3346,98.4,6570,3256,3314,98.2
'23310, 강화군,'060001, 55세,2019,1069,546,523,104.4,1046,537,509,105.5
'23310, 강화군,'060002, 56세,2019,1163,583,580,100.5,1148,576,572,100.7
'23310, 강화군,'060003, 57세,2019,1365,675,690,97.8,1353,668,685,97.5
'23310, 강화군,'060004, 58세,2019,1483,729,754,96.7,1478,725,753,96.3
'23310, 강화군,'060005, 59세,2019,1557,758,799,94.9,1545,750,795,94.3
'23310, 강화군,'065,60~64세,2019,7193,3570,3623,98.5,7144,3552,3592,98.9
'23310, 강화군,'065001, 60세,2019,1551,760,791,96.1,1538,755,783,96.4
'23310, 강화군,'065002, 61세,2019,1453,706,747,94.5,1443,705,738,95.5
'23310, 강화군,'065003, 62세,2019,1418,728,690,105.5,1414,726,688,105.5
'23310, 강화군,'065004, 63세,2019,1362,670,692,96.8,1353,666,687,96.9
'23310, 강화군,'065005, 64세,2019,1409,706,703,100.4,1396,700,696,100.6
'23310, 강화군,'070,65~69세,2019,5299,2626,2673,98.2,5279,2615,2664,98.2
'23310, 강화군,'070001, 65세,2019,1168,579,589,98.3,1161,576,585,98.5
'23310, 강화군,'070002, 66세,2019,1156,584,572,102.1,1154,583,571,102.1
'23310, 강화군,'070003, 67세,2019,1204,587,617,95.1,1198,583,615,94.8
'23310, 강화군,'070004, 68세,2019,783,387,396,97.7,779,385,394,97.7
'23310, 강화군,'070005, 69세,2019,988,489,499,98,987,488,499,97.8
'23310, 강화군,'075,70~74세,2019,4922,2421,2501,96.8,4907,2412,2495,96.7
'23310, 강화군,'075001, 70세,2019,1026,519,507,102.4,1020,514,506,101.6
'23310, 강화군,'075002, 71세,2019,1035,526,509,103.3,1033,526,507,103.7
'23310, 강화군,'075003, 72세,2019,1160,564,596,94.6,1157,562,595,94.5
'23310, 강화군,'075004, 73세,2019,884,422,462,91.3,882,421,461,91.3
'23310, 강화군,'075005, 74세,2019,817,390,427,91.3,815,389,426,91.3
'23310, 강화군,'080,75~79세,2019,4407,2029,2378,85.3,4401,2027,2374,85.4
'23310, 강화군,'080001, 75세,2019,861,388,473,82,861,388,473,82
'23310, 강화군,'080002, 76세,2019,949,462,487,94.9,948,462,486,95.1
'23310, 강화군,'080003, 77세,2019,970,444,526,84.4,969,444,525,84.6
'23310, 강화군,'080004, 78세,2019,878,401,477,84.1,877,400,477,83.9
'23310, 강화군,'080005, 79세,2019,749,334,415,80.5,746,333,413,80.6
'23310, 강화군,'085,80~84세,2019,3420,1466,1954,75,3413,1463,1950,75
'23310, 강화군,'085001, 80세,2019,769,338,431,78.4,768,338,430,78.6
'23310, 강화군,'085002, 81세,2019,725,342,383,89.3,724,341,383,89
'23310, 강화군,'085003, 82세,2019,632,269,363,74.1,630,268,362,74
'23310, 강화군,'085004, 83세,2019,675,272,403,67.5,674,272,402,67.7
'23310, 강화군,'085005, 84세,2019,619,245,374,65.5,617,244,373,65.4
'23310, 강화군,'086,85세이상,2019,2601,790,1811,43.6,2597,788,1809,43.6
'23310, 강화군,'090,85~89세,2019,1826,597,1229,48.6,1825,596,1229,48.5
'23310, 강화군,'090001, 85세,2019,492,180,312,57.7,492,180,312,57.7
'23310, 강화군,'090002, 86세,2019,432,153,279,54.8,432,153,279,54.8
'23310, 강화군,'090003, 87세,2019,392,113,279,40.5,392,113,279,40.5
'23310, 강화군,'090004, 88세,2019,275,85,190,44.7,274,84,190,44.2
'23310, 강화군,'090005, 89세,2019,235,66,169,39.1,235,66,169,39.1
'23310, 강화군,'095,90~94세,2019,605,140,465,30.1,602,139,463,30
'23310, 강화군,'095001, 90세,2019,191,48,143,33.6,190,48,142,33.8
'23310, 강화군,'095002, 91세,2019,154,37,117,31.6,154,37,117,31.6
'23310, 강화군,'095003, 92세,2019,105,23,82,28,104,22,82,26.8
'23310, 강화군,'095004, 93세,2019,83,16,67,23.9,82,16,66,24.2
'23310, 강화군,'095005, 94세,2019,72,16,56,28.6,72,16,56,28.6
'23310, 강화군,'100,95~99세,2019,145,46,99,46.5,145,46,99,46.5
'23310, 강화군,'100001, 95세,2019,57,15,42,35.7,57,15,42,35.7
'23310, 강화군,'100002, 96세,2019,37,15,22,68.2,37,15,22,68.2
'23310, 강화군,'100003, 97세,2019,22,6,16,37.5,22,6,16,37.5
'23310, 강화군,'100004, 98세,2019,21,8,13,61.5,21,8,13,61.5
'23310, 강화군,'100005, 99세,2019,8,X,6,33.3,8,X,6,33.3
'23310, 강화군,'101,100세이상,2019,25,7,18,38.9,25,7,18,38.9
'23310, 강화군,'102,15세미만,2019,5233,2689,2544,105.7,5215,2675,2540,105.3
'23310, 강화군,'103,15~64세,2019,39353,20760,18593,111.7,38192,20005,18187,110
'23310, 강화군,'104,65세이상,2019,20649,9332,11317,82.5,20597,9305,11292,82.4
'23310, 강화군,'126,평균연령,2019,52.2,50.5,54,,52.5,50.8,54.1,
'23310, 강화군,'127,중위연령,2019,56.7,54.6,58.4,,57.1,55.2,58.6,
'23320, 옹진군,'000,합계,2019,19040,10926,8114,134.7,18706,10687,8019,133.3
'23320, 옹진군,'005,0~4세,2019,489,261,228,114.5,489,261,228,114.5
'23320, 옹진군,'005001, 0세,2019,93,55,38,144.7,93,55,38,144.7
'23320, 옹진군,'005002, 1세,2019,82,50,32,156.3,82,50,32,156.3
'23320, 옹진군,'005003, 2세,2019,94,46,48,95.8,94,46,48,95.8
'23320, 옹진군,'005004, 3세,2019,111,51,60,85,111,51,60,85
'23320, 옹진군,'005005, 4세,2019,109,59,50,118,109,59,50,118
'23320, 옹진군,'010,5~9세,2019,552,268,284,94.4,551,268,283,94.7
'23320, 옹진군,'010001, 5세,2019,99,39,60,65,99,39,60,65
'23320, 옹진군,'010002, 6세,2019,124,64,60,106.7,124,64,60,106.7
'23320, 옹진군,'010003, 7세,2019,108,50,58,86.2,108,50,58,86.2
'23320, 옹진군,'010004, 8세,2019,113,65,48,135.4,112,65,47,138.3
'23320, 옹진군,'010005, 9세,2019,108,50,58,86.2,108,50,58,86.2
'23320, 옹진군,'015,10~14세,2019,472,243,229,106.1,472,243,229,106.1
'23320, 옹진군,'015001, 10세,2019,100,56,44,127.3,100,56,44,127.3
'23320, 옹진군,'015002, 11세,2019,96,52,44,118.2,96,52,44,118.2
'23320, 옹진군,'015003, 12세,2019,106,47,59,79.7,106,47,59,79.7
'23320, 옹진군,'015004, 13세,2019,88,43,45,95.6,88,43,45,95.6
'23320, 옹진군,'015005, 14세,2019,82,45,37,121.6,82,45,37,121.6
'23320, 옹진군,'020,15~19세,2019,498,289,209,138.3,497,288,209,137.8
'23320, 옹진군,'020001, 15세,2019,109,53,56,94.6,109,53,56,94.6
'23320, 옹진군,'020002, 16세,2019,98,49,49,100,98,49,49,100
'23320, 옹진군,'020003, 17세,2019,99,57,42,135.7,99,57,42,135.7
'23320, 옹진군,'020004, 18세,2019,103,63,40,157.5,102,62,40,155
'23320, 옹진군,'020005, 19세,2019,89,67,22,304.5,89,67,22,304.5
'23320, 옹진군,'025,20~24세,2019,1154,955,199,479.9,1103,911,192,474.5
'23320, 옹진군,'025001, 20세,2019,147,120,27,444.4,141,115,26,442.3
'23320, 옹진군,'025002, 21세,2019,233,202,31,651.6,223,193,30,643.3
'23320, 옹진군,'025003, 22세,2019,237,204,33,618.2,225,193,32,603.1
'23320, 옹진군,'025004, 23세,2019,262,210,52,403.8,252,202,50,404
'23320, 옹진군,'025005, 24세,2019,275,219,56,391.1,262,208,54,385.2
'23320, 옹진군,'030,25~29세,2019,1316,922,394,234,1244,868,376,230.9
'23320, 옹진군,'030001, 25세,2019,289,219,70,312.9,280,211,69,305.8
'23320, 옹진군,'030002, 26세,2019,286,202,84,240.5,264,184,80,230
'23320, 옹진군,'030003, 27세,2019,272,193,79,244.3,253,179,74,241.9
'23320, 옹진군,'030004, 28세,2019,244,156,88,177.3,236,152,84,181
'23320, 옹진군,'030005, 29세,2019,225,152,73,208.2,211,142,69,205.8
'23320, 옹진군,'035,30~34세,2019,969,649,320,202.8,909,603,306,197.1
'23320, 옹진군,'035001, 30세,2019,216,159,57,278.9,203,151,52,290.4
'23320, 옹진군,'035002, 31세,2019,197,138,59,233.9,182,125,57,219.3
'23320, 옹진군,'035003, 32세,2019,203,135,68,198.5,191,127,64,198.4
'23320, 옹진군,'035004, 33세,2019,179,109,70,155.7,168,100,68,147.1
'23320, 옹진군,'035005, 34세,2019,174,108,66,163.6,165,100,65,153.8
'23320, 옹진군,'040,35~39세,2019,1074,652,422,154.5,1027,618,409,151.1
'23320, 옹진군,'040001, 35세,2019,182,111,71,156.3,170,105,65,161.5
'23320, 옹진군,'040002, 36세,2019,209,124,85,145.9,197,114,83,137.3
'23320, 옹진군,'040003, 37세,2019,241,155,86,180.2,228,146,82,178
'23320, 옹진군,'040004, 38세,2019,205,123,82,150,198,117,81,144.4
'23320, 옹진군,'040005, 39세,2019,237,139,98,141.8,234,136,98,138.8
'23320, 옹진군,'045,40~44세,2019,1101,694,407,170.5,1075,677,398,170.1
'23320, 옹진군,'045001, 40세,2019,233,136,97,140.2,227,131,96,136.5
'23320, 옹진군,'045002, 41세,2019,214,133,81,164.2,211,131,80,163.8
'23320, 옹진군,'045003, 42세,2019,213,132,81,163,205,128,77,166.2
'23320, 옹진군,'045004, 43세,2019,210,136,74,183.8,202,131,71,184.5
'23320, 옹진군,'045005, 44세,2019,231,157,74,212.2,230,156,74,210.8
'23320, 옹진군,'050,45~49세,2019,1265,815,450,181.1,1239,798,441,181
'23320, 옹진군,'050001, 45세,2019,230,148,82,180.5,224,144,80,180
'23320, 옹진군,'050002, 46세,2019,239,160,79,202.5,234,157,77,203.9
'23320, 옹진군,'050003, 47세,2019,253,165,88,187.5,249,163,86,189.5
'23320, 옹진군,'050004, 48세,2019,278,171,107,159.8,274,168,106,158.5
'23320, 옹진군,'050005, 49세,2019,265,171,94,181.9,258,166,92,180.4
'23320, 옹진군,'055,50~54세,2019,1431,833,598,139.3,1418,826,592,139.5
'23320, 옹진군,'055001, 50세,2019,241,152,89,170.8,240,151,89,169.7
'23320, 옹진군,'055002, 51세,2019,262,152,110,138.2,260,151,109,138.5
'23320, 옹진군,'055003, 52세,2019,301,182,119,152.9,297,179,118,151.7
'23320, 옹진군,'055004, 53세,2019,286,171,115,148.7,284,170,114,149.1
'23320, 옹진군,'055005, 54세,2019,341,176,165,106.7,337,175,162,108
'23320, 옹진군,'060,55~59세,2019,1985,1120,865,129.5,1974,1116,858,130.1
'23320, 옹진군,'060001, 55세,2019,296,167,129,129.5,294,167,127,131.5
'23320, 옹진군,'060002, 56세,2019,365,205,160,128.1,361,203,158,128.5
'23320, 옹진군,'060003, 57세,2019,410,237,173,137,408,236,172,137.2
'23320, 옹진군,'060004, 58세,2019,471,261,210,124.3,471,261,210,124.3
'23320, 옹진군,'060005, 59세,2019,443,250,193,129.5,440,249,191,130.4
'23320, 옹진군,'065,60~64세,2019,2033,1073,960,111.8,2020,1064,956,111.3
'23320, 옹진군,'065001, 60세,2019,430,224,206,108.7,427,222,205,108.3
'23320, 옹진군,'065002, 61세,2019,392,216,176,122.7,391,215,176,122.2
'23320, 옹진군,'065003, 62세,2019,395,212,183,115.8,394,211,183,115.3
'23320, 옹진군,'065004, 63세,2019,397,200,197,101.5,393,197,196,100.5
'23320, 옹진군,'065005, 64세,2019,419,221,198,111.6,415,219,196,111.7
'23320, 옹진군,'070,65~69세,2019,1379,728,651,111.8,1374,727,647,112.4
'23320, 옹진군,'070001, 65세,2019,306,156,150,104,306,156,150,104
'23320, 옹진군,'070002, 66세,2019,289,162,127,127.6,289,162,127,127.6
'23320, 옹진군,'070003, 67세,2019,327,164,163,100.6,326,164,162,101.2
'23320, 옹진군,'070004, 68세,2019,181,86,95,90.5,179,85,94,90.4
'23320, 옹진군,'070005, 69세,2019,276,160,116,137.9,274,160,114,140.4
'23320, 옹진군,'075,70~74세,2019,1224,605,619,97.7,1217,601,616,97.6
'23320, 옹진군,'075001, 70세,2019,265,146,119,122.7,263,145,118,122.9
'23320, 옹진군,'075002, 71세,2019,217,104,113,92,214,103,111,92.8
'23320, 옹진군,'075003, 72세,2019,302,139,163,85.3,301,138,163,84.7
'23320, 옹진군,'075004, 73세,2019,229,111,118,94.1,229,111,118,94.1
'23320, 옹진군,'075005, 74세,2019,211,105,106,99.1,210,104,106,98.1
'23320, 옹진군,'080,75~79세,2019,883,418,465,89.9,882,417,465,89.7
'23320, 옹진군,'080001, 75세,2019,167,84,83,101.2,167,84,83,101.2
'23320, 옹진군,'080002, 76세,2019,197,92,105,87.6,196,91,105,86.7
'23320, 옹진군,'080003, 77세,2019,214,95,119,79.8,214,95,119,79.8
'23320, 옹진군,'080004, 78세,2019,165,76,89,85.4,165,76,89,85.4
'23320, 옹진군,'080005, 79세,2019,140,71,69,102.9,140,71,69,102.9
'23320, 옹진군,'085,80~84세,2019,654,245,409,59.9,654,245,409,59.9
'23320, 옹진군,'085001, 80세,2019,138,48,90,53.3,138,48,90,53.3
'23320, 옹진군,'085002, 81세,2019,139,57,82,69.5,139,57,82,69.5
'23320, 옹진군,'085003, 82세,2019,139,57,82,69.5,139,57,82,69.5
'23320, 옹진군,'085004, 83세,2019,135,46,89,51.7,135,46,89,51.7
'23320, 옹진군,'085005, 84세,2019,103,37,66,56.1,103,37,66,56.1
'23320, 옹진군,'086,85세이상,2019,561,156,405,38.5,561,156,405,38.5
'23320, 옹진군,'090,85~89세,2019,360,106,254,41.7,360,106,254,41.7
'23320, 옹진군,'090001, 85세,2019,98,33,65,50.8,98,33,65,50.8
'23320, 옹진군,'090002, 86세,2019,80,32,48,66.7,80,32,48,66.7
'23320, 옹진군,'090003, 87세,2019,67,17,50,34,67,17,50,34
'23320, 옹진군,'090004, 88세,2019,66,15,51,29.4,66,15,51,29.4
'23320, 옹진군,'090005, 89세,2019,49,9,40,22.5,49,9,40,22.5
'23320, 옹진군,'095,90~94세,2019,153,35,118,29.7,153,35,118,29.7
'23320, 옹진군,'095001, 90세,2019,43,14,29,48.3,43,14,29,48.3
'23320, 옹진군,'095002, 91세,2019,33,6,27,22.2,33,6,27,22.2
'23320, 옹진군,'095003, 92세,2019,34,7,27,25.9,34,7,27,25.9
'23320, 옹진군,'095004, 93세,2019,19,X,16,18.8,19,X,16,18.8
'23320, 옹진군,'095005, 94세,2019,24,5,19,26.3,24,5,19,26.3
'23320, 옹진군,'100,95~99세,2019,43,13,30,43.3,43,13,30,43.3
'23320, 옹진군,'100001, 95세,2019,15,X,12,25,15,X,12,25
'23320, 옹진군,'100002, 96세,2019,10,X,7,42.9,10,X,7,42.9
'23320, 옹진군,'100003, 97세,2019,10,X,8,25,10,X,8,25
'23320, 옹진군,'100004, 98세,2019,X,X,X,100,X,X,X,100
'23320, 옹진군,'100005, 99세,2019,6,X,X,200,6,X,X,200
'23320, 옹진군,'101,100세이상,2019,5,X,X,66.7,5,X,X,66.7
'23320, 옹진군,'102,15세미만,2019,1513,772,741,104.2,1512,772,740,104.3
'23320, 옹진군,'103,15~64세,2019,12826,8002,4824,165.9,12506,7769,4737,164
'23320, 옹진군,'104,65세이상,2019,4701,2152,2549,84.4,4688,2146,2542,84.4
'23320, 옹진군,'126,평균연령,2019,48.9,46.3,52.5,,49.2,46.6,52.6,
'23320, 옹진군,'127,중위연령,2019,52.4,48.3,57.2,,52.8,48.8,57.4,
'24,광주광역시,'000,합계,2019,1489730,741287,748443,99,1456444,722939,733505,98.6
'24,광주광역시,'005,0~4세,2019,55212,28386,26826,105.8,54510,28041,26469,105.9
'24,광주광역시,'005001, 0세,2019,8652,4357,4295,101.4,8550,4309,4241,101.6
'24,광주광역시,'005002, 1세,2019,9756,5063,4693,107.9,9616,4984,4632,107.6
'24,광주광역시,'005003, 2세,2019,10950,5676,5274,107.6,10779,5598,5181,108
'24,광주광역시,'005004, 3세,2019,12541,6380,6161,103.6,12393,6309,6084,103.7
'24,광주광역시,'005005, 4세,2019,13313,6910,6403,107.9,13172,6841,6331,108.1
'24,광주광역시,'010,5~9세,2019,71975,37069,34906,106.2,71430,36809,34621,106.3
'24,광주광역시,'010001, 5세,2019,13547,6883,6664,103.3,13407,6815,6592,103.4
'24,광주광역시,'010002, 6세,2019,13798,7133,6665,107,13678,7084,6594,107.4
'24,광주광역시,'010003, 7세,2019,15234,7912,7322,108.1,15124,7862,7262,108.3
'24,광주광역시,'010004, 8세,2019,14902,7680,7222,106.3,14816,7632,7184,106.2
'24,광주광역시,'010005, 9세,2019,14494,7461,7033,106.1,14405,7416,6989,106.1
'24,광주광역시,'015,10~14세,2019,73432,38032,35400,107.4,73128,37887,35241,107.5
'24,광주광역시,'015001, 10세,2019,14155,7295,6860,106.3,14101,7271,6830,106.5
'24,광주광역시,'015002, 11세,2019,14874,7726,7148,108.1,14806,7692,7114,108.1
'24,광주광역시,'015003, 12세,2019,15718,8164,7554,108.1,15664,8143,7521,108.3
'24,광주광역시,'015004, 13세,2019,14457,7512,6945,108.2,14380,7475,6905,108.3
'24,광주광역시,'015005, 14세,2019,14228,7335,6893,106.4,14177,7306,6871,106.3
'24,광주광역시,'020,15~19세,2019,90702,46731,43971,106.3,89293,46023,43270,106.4
'24,광주광역시,'020001, 15세,2019,15444,8027,7417,108.2,15388,7994,7394,108.1
'24,광주광역시,'020002, 16세,2019,15949,8423,7526,111.9,15886,8396,7490,112.1
'24,광주광역시,'020003, 17세,2019,16448,8531,7917,107.8,16368,8485,7883,107.6
'24,광주광역시,'020004, 18세,2019,19735,10144,9591,105.8,19400,9981,9419,106
'24,광주광역시,'020005, 19세,2019,23126,11606,11520,100.7,22251,11167,11084,100.7
'24,광주광역시,'025,20~24세,2019,117694,60731,56963,106.6,111384,57139,54245,105.3
'24,광주광역시,'025001, 20세,2019,22517,11522,10995,104.8,21435,10930,10505,104
'24,광주광역시,'025002, 21세,2019,23728,12082,11646,103.7,22459,11354,11105,102.2
'24,광주광역시,'025003, 22세,2019,24141,12355,11786,104.8,22753,11551,11202,103.1
'24,광주광역시,'025004, 23세,2019,23826,12482,11344,110,22530,11741,10789,108.8
'24,광주광역시,'025005, 24세,2019,23482,12290,11192,109.8,22207,11563,10644,108.6
'24,광주광역시,'030,25~29세,2019,104600,55536,49064,113.2,98608,52051,46557,111.8
'24,광주광역시,'030001, 25세,2019,23010,12403,10607,116.9,21695,11636,10059,115.7
'24,광주광역시,'030002, 26세,2019,22072,11867,10205,116.3,20802,11114,9688,114.7
'24,광주광역시,'030003, 27세,2019,21687,11399,10288,110.8,20489,10684,9805,109
'24,광주광역시,'030004, 28세,2019,19569,10213,9356,109.2,18506,9629,8877,108.5
'24,광주광역시,'030005, 29세,2019,18262,9654,8608,112.2,17116,8988,8128,110.6
'24,광주광역시,'035,30~34세,2019,87174,45097,42077,107.2,82165,42265,39900,105.9
'24,광주광역시,'035001, 30세,2019,17552,9205,8347,110.3,16425,8563,7862,108.9
'24,광주광역시,'035002, 31세,2019,16847,8780,8067,108.8,15813,8188,7625,107.4
'24,광주광역시,'035003, 32세,2019,17255,8889,8366,106.3,16197,8277,7920,104.5
'24,광주광역시,'035004, 33세,2019,17617,8991,8626,104.2,16721,8497,8224,103.3
'24,광주광역시,'035005, 34세,2019,17903,9232,8671,106.5,17009,8740,8269,105.7
'24,광주광역시,'040,35~39세,2019,113361,57516,55845,103,109729,55438,54291,102.1
'24,광주광역시,'040001, 35세,2019,19597,10104,9493,106.4,18811,9671,9140,105.8
'24,광주광역시,'040002, 36세,2019,21861,11214,10647,105.3,21082,10746,10336,104
'24,광주광역시,'040003, 37세,2019,24234,12284,11950,102.8,23452,11840,11612,102
'24,광주광역시,'040004, 38세,2019,23342,11794,11548,102.1,22683,11421,11262,101.4
'24,광주광역시,'040005, 39세,2019,24327,12120,12207,99.3,23701,11760,11941,98.5
'24,광주광역시,'045,40~44세,2019,114858,57481,57377,100.2,112199,55999,56200,99.6
'24,광주광역시,'045001, 40세,2019,23928,11833,12095,97.8,23363,11518,11845,97.2
'24,광주광역시,'045002, 41세,2019,21899,10999,10900,100.9,21314,10660,10654,100.1
'24,광주광역시,'045003, 42세,2019,22953,11452,11501,99.6,22442,11164,11278,99
'24,광주광역시,'045004, 43세,2019,22764,11545,11219,102.9,22261,11263,10998,102.4
'24,광주광역시,'045005, 44세,2019,23314,11652,11662,99.9,22819,11394,11425,99.7
'24,광주광역시,'050,45~49세,2019,133073,66538,66535,100,130788,65303,65485,99.7
'24,광주광역시,'050001, 45세,2019,26391,13336,13055,102.2,25923,13082,12841,101.9
'24,광주광역시,'050002, 46세,2019,25994,12812,13182,97.2,25545,12567,12978,96.8
'24,광주광역시,'050003, 47세,2019,26378,13225,13153,100.5,25868,12959,12909,100.4
'24,광주광역시,'050004, 48세,2019,27733,13837,13896,99.6,27292,13585,13707,99.1
'24,광주광역시,'050005, 49세,2019,26577,13328,13249,100.6,26160,13110,13050,100.5
'24,광주광역시,'055,50~54세,2019,124598,62354,62244,100.2,122797,61422,61375,100.1
'24,광주광역시,'055001, 50세,2019,26000,13067,12933,101,25603,12846,12757,100.7
'24,광주광역시,'055002, 51세,2019,26838,13329,13509,98.7,26451,13134,13317,98.6
'24,광주광역시,'055003, 52세,2019,24175,12044,12131,99.3,23831,11871,11960,99.3
'24,광주광역시,'055004, 53세,2019,24117,12266,11851,103.5,23770,12099,11671,103.7
'24,광주광역시,'055005, 54세,2019,23468,11648,11820,98.5,23142,11472,11670,98.3
'24,광주광역시,'060,55~59세,2019,114111,56861,57250,99.3,112832,56240,56592,99.4
'24,광주광역시,'060001, 55세,2019,21592,10887,10705,101.7,21274,10733,10541,101.8
'24,광주광역시,'060002, 56세,2019,23023,11592,11431,101.4,22718,11465,11253,101.9
'24,광주광역시,'060003, 57세,2019,21759,10933,10826,101,21517,10805,10712,100.9
'24,광주광역시,'060004, 58세,2019,23325,11530,11795,97.8,23133,11434,11699,97.7
'24,광주광역시,'060005, 59세,2019,24412,11919,12493,95.4,24190,11803,12387,95.3
'24,광주광역시,'065,60~64세,2019,92620,45158,47462,95.1,91893,44794,47099,95.1
'24,광주광역시,'065001, 60세,2019,21575,10553,11022,95.7,21390,10456,10934,95.6
'24,광주광역시,'065002, 61세,2019,19275,9390,9885,95,19114,9306,9808,94.9
'24,광주광역시,'065003, 62세,2019,18775,9205,9570,96.2,18632,9134,9498,96.2
'24,광주광역시,'065004, 63세,2019,16002,7884,8118,97.1,15885,7834,8051,97.3
'24,광주광역시,'065005, 64세,2019,16993,8126,8867,91.6,16872,8064,8808,91.6
'24,광주광역시,'070,65~69세,2019,61784,29249,32535,89.9,61437,29100,32337,90
'24,광주광역시,'070001, 65세,2019,13682,6576,7106,92.5,13580,6529,7051,92.6
'24,광주광역시,'070002, 66세,2019,12241,5768,6473,89.1,12173,5734,6439,89.1
'24,광주광역시,'070003, 67세,2019,13378,6343,7035,90.2,13299,6309,6990,90.3
'24,광주광역시,'070004, 68세,2019,11042,5190,5852,88.7,10990,5172,5818,88.9
'24,광주광역시,'070005, 69세,2019,11441,5372,6069,88.5,11395,5356,6039,88.7
'24,광주광역시,'075,70~74세,2019,51048,23388,27660,84.6,50895,23316,27579,84.5
'24,광주광역시,'075001, 70세,2019,11942,5523,6419,86,11900,5500,6400,85.9
'24,광주광역시,'075002, 71세,2019,10896,5039,5857,86,10866,5025,5841,86
'24,광주광역시,'075003, 72세,2019,11304,5112,6192,82.6,11270,5099,6171,82.6
'24,광주광역시,'075004, 73세,2019,8635,4010,4625,86.7,8613,3998,4615,86.6
'24,광주광역시,'075005, 74세,2019,8271,3704,4567,81.1,8246,3694,4552,81.2
'24,광주광역시,'080,75~79세,2019,39989,17076,22913,74.5,39917,17051,22866,74.6
'24,광주광역시,'080001, 75세,2019,7855,3501,4354,80.4,7833,3494,4339,80.5
'24,광주광역시,'080002, 76세,2019,7814,3430,4384,78.2,7802,3425,4377,78.2
'24,광주광역시,'080003, 77세,2019,10112,4422,5690,77.7,10095,4417,5678,77.8
'24,광주광역시,'080004, 78세,2019,7554,3106,4448,69.8,7543,3103,4440,69.9
'24,광주광역시,'080005, 79세,2019,6654,2617,4037,64.8,6644,2612,4032,64.8
'24,광주광역시,'085,80~84세,2019,25592,9477,16115,58.8,25559,9466,16093,58.8
'24,광주광역시,'085001, 80세,2019,6328,2549,3779,67.5,6321,2545,3776,67.4
'24,광주광역시,'085002, 81세,2019,5689,2188,3501,62.5,5679,2185,3494,62.5
'24,광주광역시,'085003, 82세,2019,5133,1875,3258,57.6,5129,1874,3255,57.6
'24,광주광역시,'085004, 83세,2019,4311,1496,2815,53.1,4305,1495,2810,53.2
'24,광주광역시,'085005, 84세,2019,4131,1369,2762,49.6,4125,1367,2758,49.6
'24,광주광역시,'086,85세이상,2019,17907,4607,13300,34.6,17880,4595,13285,34.6
'24,광주광역시,'090,85~89세,2019,12598,3509,9089,38.6,12582,3501,9081,38.6
'24,광주광역시,'090001, 85세,2019,3630,1124,2506,44.9,3627,1123,2504,44.8
'24,광주광역시,'090002, 86세,2019,2800,825,1975,41.8,2795,823,1972,41.7
'24,광주광역시,'090003, 87세,2019,2399,685,1714,40,2395,682,1713,39.8
'24,광주광역시,'090004, 88세,2019,1894,472,1422,33.2,1892,471,1421,33.1
'24,광주광역시,'090005, 89세,2019,1875,403,1472,27.4,1873,402,1471,27.3
'24,광주광역시,'095,90~94세,2019,4267,947,3320,28.5,4258,944,3314,28.5
'24,광주광역시,'095001, 90세,2019,1391,363,1028,35.3,1389,363,1026,35.4
'24,광주광역시,'095002, 91세,2019,1079,233,846,27.5,1078,232,846,27.4
'24,광주광역시,'095003, 92세,2019,784,159,625,25.4,780,157,623,25.2
'24,광주광역시,'095004, 93세,2019,575,116,459,25.3,574,116,458,25.3
'24,광주광역시,'095005, 94세,2019,438,76,362,21,437,76,361,21.1
'24,광주광역시,'100,95~99세,2019,917,141,776,18.2,915,140,775,18.1
'24,광주광역시,'100001, 95세,2019,240,53,187,28.3,239,52,187,27.8
'24,광주광역시,'100002, 96세,2019,312,43,269,16,311,43,268,16
'24,광주광역시,'100003, 97세,2019,184,21,163,12.9,184,21,163,12.9
'24,광주광역시,'100004, 98세,2019,112,16,96,16.7,112,16,96,16.7
'24,광주광역시,'100005, 99세,2019,69,8,61,13.1,69,8,61,13.1
'24,광주광역시,'101,100세이상,2019,125,10,115,8.7,125,10,115,8.7
'24,광주광역시,'102,15세미만,2019,200619,103487,97132,106.5,199068,102737,96331,106.6
'24,광주광역시,'103,15~64세,2019,1092791,554003,538788,102.8,1061688,536674,525014,102.2
'24,광주광역시,'104,65세이상,2019,196320,83797,112523,74.5,195688,83528,112160,74.5
'24,광주광역시,'126,평균연령,2019,40.7,39.5,41.8,,40.8,39.7,41.9,
'24,광주광역시,'127,중위연령,2019,41.3,40.1,42.5,,41.7,40.5,42.9,
'24010, 동구,'000,합계,2019,103754,51747,52007,99.5,101181,50421,50760,99.3
'24010, 동구,'005,0~4세,2019,3186,1655,1531,108.1,3153,1642,1511,108.7
'24010, 동구,'005001, 0세,2019,527,262,265,98.9,524,260,264,98.5
'24010, 동구,'005002, 1세,2019,583,313,270,115.9,575,309,266,116.2
'24010, 동구,'005003, 2세,2019,638,346,292,118.5,628,342,286,119.6
'24010, 동구,'005004, 3세,2019,675,350,325,107.7,669,347,322,107.8
'24010, 동구,'005005, 4세,2019,763,384,379,101.3,757,384,373,102.9
'24010, 동구,'010,5~9세,2019,3408,1741,1667,104.4,3381,1730,1651,104.8
'24010, 동구,'010001, 5세,2019,712,380,332,114.5,706,377,329,114.6
'24010, 동구,'010002, 6세,2019,687,343,344,99.7,679,339,340,99.7
'24010, 동구,'010003, 7세,2019,679,341,338,100.9,671,339,332,102.1
'24010, 동구,'010004, 8세,2019,706,351,355,98.9,704,350,354,98.9
'24010, 동구,'010005, 9세,2019,624,326,298,109.4,621,325,296,109.8
'24010, 동구,'015,10~14세,2019,2974,1551,1423,109,2968,1548,1420,109
'24010, 동구,'015001, 10세,2019,534,288,246,117.1,534,288,246,117.1
'24010, 동구,'015002, 11세,2019,616,312,304,102.6,615,311,304,102.3
'24010, 동구,'015003, 12세,2019,645,331,314,105.4,644,331,313,105.8
'24010, 동구,'015004, 13세,2019,613,320,293,109.2,611,319,292,109.2
'24010, 동구,'015005, 14세,2019,566,300,266,112.8,564,299,265,112.8
'24010, 동구,'020,15~19세,2019,5451,2878,2573,111.9,5147,2729,2418,112.9
'24010, 동구,'020001, 15세,2019,689,347,342,101.5,688,347,341,101.8
'24010, 동구,'020002, 16세,2019,748,434,314,138.2,747,434,313,138.7
'24010, 동구,'020003, 17세,2019,802,431,371,116.2,798,427,371,115.1
'24010, 동구,'020004, 18세,2019,1200,644,556,115.8,1126,611,515,118.6
'24010, 동구,'020005, 19세,2019,2012,1022,990,103.2,1788,910,878,103.6
'24010, 동구,'025,20~24세,2019,9836,5138,4698,109.4,9101,4750,4351,109.2
'24010, 동구,'025001, 20세,2019,1941,934,1007,92.8,1765,843,922,91.4
'24010, 동구,'025002, 21세,2019,1825,886,939,94.4,1691,817,874,93.5
'24010, 동구,'025003, 22세,2019,2060,1128,932,121,1901,1024,877,116.8
'24010, 동구,'025004, 23세,2019,1994,1091,903,120.8,1863,1028,835,123.1
'24010, 동구,'025005, 24세,2019,2016,1099,917,119.8,1881,1038,843,123.1
'24010, 동구,'030,25~29세,2019,7695,4086,3609,113.2,7279,3884,3395,114.4
'24010, 동구,'030001, 25세,2019,1807,982,825,119,1700,935,765,122.2
'24010, 동구,'030002, 26세,2019,1644,868,776,111.9,1551,821,730,112.5
'24010, 동구,'030003, 27세,2019,1589,853,736,115.9,1497,803,694,115.7
'24010, 동구,'030004, 28세,2019,1396,721,675,106.8,1332,692,640,108.1
'24010, 동구,'030005, 29세,2019,1259,662,597,110.9,1199,633,566,111.8
'24010, 동구,'035,30~34세,2019,6204,3258,2946,110.6,5895,3106,2789,111.4
'24010, 동구,'035001, 30세,2019,1308,699,609,114.8,1223,656,567,115.7
'24010, 동구,'035002, 31세,2019,1183,635,548,115.9,1125,602,523,115.1
'24010, 동구,'035003, 32세,2019,1238,630,608,103.6,1176,596,580,102.8
'24010, 동구,'035004, 33세,2019,1248,656,592,110.8,1191,631,560,112.7
'24010, 동구,'035005, 34세,2019,1227,638,589,108.3,1180,621,559,111.1
'24010, 동구,'040,35~39세,2019,6784,3605,3179,113.4,6587,3489,3098,112.6
'24010, 동구,'040001, 35세,2019,1277,677,600,112.8,1229,656,573,114.5
'24010, 동구,'040002, 36세,2019,1308,691,617,112,1269,666,603,110.4
'24010, 동구,'040003, 37세,2019,1504,801,703,113.9,1462,774,688,112.5
'24010, 동구,'040004, 38세,2019,1371,730,641,113.9,1337,712,625,113.9
'24010, 동구,'040005, 39세,2019,1324,706,618,114.2,1290,681,609,111.8
'24010, 동구,'045,40~44세,2019,6135,3316,2819,117.6,6005,3248,2757,117.8
'24010, 동구,'045001, 40세,2019,1314,701,613,114.4,1292,690,602,114.6
'24010, 동구,'045002, 41세,2019,1224,680,544,125,1190,663,527,125.8
'24010, 동구,'045003, 42세,2019,1246,665,581,114.5,1222,649,573,113.3
'24010, 동구,'045004, 43세,2019,1181,649,532,122,1160,642,518,123.9
'24010, 동구,'045005, 44세,2019,1170,621,549,113.1,1141,604,537,112.5
'24010, 동구,'050,45~49세,2019,7209,3727,3482,107,7080,3639,3441,105.8
'24010, 동구,'050001, 45세,2019,1302,702,600,117,1278,685,593,115.5
'24010, 동구,'050002, 46세,2019,1423,731,692,105.6,1395,711,684,103.9
'24010, 동구,'050003, 47세,2019,1433,753,680,110.7,1398,731,667,109.6
'24010, 동구,'050004, 48세,2019,1534,770,764,100.8,1507,755,752,100.4
'24010, 동구,'050005, 49세,2019,1517,771,746,103.4,1502,757,745,101.6
'24010, 동구,'055,50~54세,2019,7437,3729,3708,100.6,7327,3673,3654,100.5
'24010, 동구,'055001, 50세,2019,1478,741,737,100.5,1460,731,729,100.3
'24010, 동구,'055002, 51세,2019,1581,787,794,99.1,1557,772,785,98.3
'24010, 동구,'055003, 52세,2019,1395,716,679,105.4,1361,701,660,106.2
'24010, 동구,'055004, 53세,2019,1484,746,738,101.1,1469,738,731,101
'24010, 동구,'055005, 54세,2019,1499,739,760,97.2,1480,731,749,97.6
'24010, 동구,'060,55~59세,2019,8146,3918,4228,92.7,8068,3887,4181,93
'24010, 동구,'060001, 55세,2019,1403,685,718,95.4,1388,678,710,95.5
'24010, 동구,'060002, 56세,2019,1607,790,817,96.7,1584,780,804,97
'24010, 동구,'060003, 57세,2019,1529,750,779,96.3,1516,744,772,96.4
'24010, 동구,'060004, 58세,2019,1722,811,911,89,1708,806,902,89.4
'24010, 동구,'060005, 59세,2019,1885,882,1003,87.9,1872,879,993,88.5
'24010, 동구,'065,60~64세,2019,7934,3828,4106,93.2,7884,3803,4081,93.2
'24010, 동구,'065001, 60세,2019,1688,825,863,95.6,1671,813,858,94.8
'24010, 동구,'065002, 61세,2019,1656,811,845,96,1640,805,835,96.4
'24010, 동구,'065003, 62세,2019,1597,793,804,98.6,1591,790,801,98.6
'24010, 동구,'065004, 63세,2019,1432,676,756,89.4,1426,674,752,89.6
'24010, 동구,'065005, 64세,2019,1561,723,838,86.3,1556,721,835,86.3
'24010, 동구,'070,65~69세,2019,6080,2833,3247,87.2,6059,2823,3236,87.2
'24010, 동구,'070001, 65세,2019,1341,639,702,91,1335,636,699,91
'24010, 동구,'070002, 66세,2019,1194,550,644,85.4,1191,549,642,85.5
'24010, 동구,'070003, 67세,2019,1314,614,700,87.7,1307,610,697,87.5
'24010, 동구,'070004, 68세,2019,1093,506,587,86.2,1091,506,585,86.5
'24010, 동구,'070005, 69세,2019,1138,524,614,85.3,1135,522,613,85.2
'24010, 동구,'075,70~74세,2019,5492,2441,3051,80,5475,2432,3043,79.9
'24010, 동구,'075001, 70세,2019,1269,570,699,81.5,1266,568,698,81.4
'24010, 동구,'075002, 71세,2019,1129,515,614,83.9,1126,513,613,83.7
'24010, 동구,'075003, 72세,2019,1241,548,693,79.1,1238,547,691,79.2
'24010, 동구,'075004, 73세,2019,926,401,525,76.4,922,399,523,76.3
'24010, 동구,'075005, 74세,2019,927,407,520,78.3,923,405,518,78.2
'24010, 동구,'080,75~79세,2019,4688,2123,2565,82.8,4683,2122,2561,82.9
'24010, 동구,'080001, 75세,2019,910,451,459,98.3,908,451,457,98.7
'24010, 동구,'080002, 76세,2019,861,379,482,78.6,861,379,482,78.6
'24010, 동구,'080003, 77세,2019,1187,532,655,81.2,1185,532,653,81.5
'24010, 동구,'080004, 78세,2019,916,408,508,80.3,916,408,508,80.3
'24010, 동구,'080005, 79세,2019,814,353,461,76.6,813,352,461,76.4
'24010, 동구,'085,80~84세,2019,3009,1283,1726,74.3,3007,1282,1725,74.3
'24010, 동구,'085001, 80세,2019,735,311,424,73.3,734,310,424,73.1
'24010, 동구,'085002, 81세,2019,677,315,362,87,677,315,362,87
'24010, 동구,'085003, 82세,2019,599,249,350,71.1,599,249,350,71.1
'24010, 동구,'085004, 83세,2019,544,228,316,72.2,543,228,315,72.4
'24010, 동구,'085005, 84세,2019,454,180,274,65.7,454,180,274,65.7
'24010, 동구,'086,85세이상,2019,2086,637,1449,44,2082,634,1448,43.8
'24010, 동구,'090,85~89세,2019,1449,488,961,50.8,1447,486,961,50.6
'24010, 동구,'090001, 85세,2019,418,157,261,60.2,418,157,261,60.2
'24010, 동구,'090002, 86세,2019,326,119,207,57.5,326,119,207,57.5
'24010, 동구,'090003, 87세,2019,275,84,191,44,275,84,191,44
'24010, 동구,'090004, 88세,2019,215,73,142,51.4,214,72,142,50.7
'24010, 동구,'090005, 89세,2019,215,55,160,34.4,214,54,160,33.8
'24010, 동구,'095,90~94세,2019,500,124,376,33,499,124,375,33.1
'24010, 동구,'095001, 90세,2019,160,45,115,39.1,159,45,114,39.5
'24010, 동구,'095002, 91세,2019,131,39,92,42.4,131,39,92,42.4
'24010, 동구,'095003, 92세,2019,84,14,70,20,84,14,70,20
'24010, 동구,'095004, 93세,2019,75,14,61,23,75,14,61,23
'24010, 동구,'095005, 94세,2019,50,12,38,31.6,50,12,38,31.6
'24010, 동구,'100,95~99세,2019,125,24,101,23.8,124,23,101,22.8
'24010, 동구,'100001, 95세,2019,40,8,32,25,39,7,32,21.9
'24010, 동구,'100002, 96세,2019,38,6,32,18.8,38,6,32,18.8
'24010, 동구,'100003, 97세,2019,20,X,17,17.6,20,X,17,17.6
'24010, 동구,'100004, 98세,2019,17,X,14,21.4,17,X,14,21.4
'24010, 동구,'100005, 99세,2019,10,X,6,66.7,10,X,6,66.7
'24010, 동구,'101,100세이상,2019,12,X,11,9.1,12,X,11,9.1
'24010, 동구,'102,15세미만,2019,9568,4947,4621,107.1,9502,4920,4582,107.4
'24010, 동구,'103,15~64세,2019,72831,37483,35348,106,70373,36208,34165,106
'24010, 동구,'104,65세이상,2019,21355,9317,12038,77.4,21306,9293,12013,77.4
'24010, 동구,'126,평균연령,2019,44.5,43.1,46,,44.9,43.4,46.3,
'24010, 동구,'127,중위연령,2019,45.2,42.9,47.4,,45.8,43.5,48.1,
'24020, 서구,'000,합계,2019,298033,147067,150966,97.4,295601,145929,149672,97.5
'24020, 서구,'005,0~4세,2019,9964,5204,4760,109.3,9906,5171,4735,109.2
'24020, 서구,'005001, 0세,2019,1600,844,756,111.6,1594,841,753,111.7
'24020, 서구,'005002, 1세,2019,1761,905,856,105.7,1750,895,855,104.7
'24020, 서구,'005003, 2세,2019,1998,1056,942,112.1,1986,1052,934,112.6
'24020, 서구,'005004, 3세,2019,2256,1153,1103,104.5,2241,1144,1097,104.3
'24020, 서구,'005005, 4세,2019,2349,1246,1103,113,2335,1239,1096,113
'24020, 서구,'010,5~9세,2019,13425,7009,6416,109.2,13387,6988,6399,109.2
'24020, 서구,'010001, 5세,2019,2468,1239,1229,100.8,2459,1234,1225,100.7
'24020, 서구,'010002, 6세,2019,2582,1362,1220,111.6,2575,1360,1215,111.9
'24020, 서구,'010003, 7세,2019,2800,1477,1323,111.6,2789,1471,1318,111.6
'24020, 서구,'010004, 8세,2019,2870,1493,1377,108.4,2866,1490,1376,108.3
'24020, 서구,'010005, 9세,2019,2705,1438,1267,113.5,2698,1433,1265,113.3
'24020, 서구,'015,10~14세,2019,14515,7538,6977,108,14497,7532,6965,108.1
'24020, 서구,'015001, 10세,2019,2727,1397,1330,105,2724,1397,1327,105.3
'24020, 서구,'015002, 11세,2019,2909,1501,1408,106.6,2904,1498,1406,106.5
'24020, 서구,'015003, 12세,2019,3102,1600,1502,106.5,3099,1600,1499,106.7
'24020, 서구,'015004, 13세,2019,2891,1566,1325,118.2,2888,1564,1324,118.1
'24020, 서구,'015005, 14세,2019,2886,1474,1412,104.4,2882,1473,1409,104.5
'24020, 서구,'020,15~19세,2019,17204,9004,8200,109.8,17163,8988,8175,109.9
'24020, 서구,'020001, 15세,2019,3179,1686,1493,112.9,3178,1685,1493,112.9
'24020, 서구,'020002, 16세,2019,3160,1658,1502,110.4,3156,1656,1500,110.4
'24020, 서구,'020003, 17세,2019,3482,1872,1610,116.3,3478,1872,1606,116.6
'24020, 서구,'020004, 18세,2019,3792,1908,1884,101.3,3781,1904,1877,101.4
'24020, 서구,'020005, 19세,2019,3591,1880,1711,109.9,3570,1871,1699,110.1
'24020, 서구,'025,20~24세,2019,21161,10960,10201,107.4,20897,10833,10064,107.6
'24020, 서구,'025001, 20세,2019,3797,2126,1671,127.2,3764,2108,1656,127.3
'24020, 서구,'025002, 21세,2019,4059,2205,1854,118.9,4032,2194,1838,119.4
'24020, 서구,'025003, 22세,2019,4279,2164,2115,102.3,4229,2139,2090,102.3
'24020, 서구,'025004, 23세,2019,4402,2206,2196,100.5,4331,2169,2162,100.3
'24020, 서구,'025005, 24세,2019,4624,2259,2365,95.5,4541,2223,2318,95.9
'24020, 서구,'030,25~29세,2019,21377,10905,10472,104.1,20969,10723,10246,104.7
'24020, 서구,'030001, 25세,2019,4643,2346,2297,102.1,4558,2307,2251,102.5
'24020, 서구,'030002, 26세,2019,4483,2323,2160,107.5,4393,2277,2116,107.6
'24020, 서구,'030003, 27세,2019,4483,2210,2273,97.2,4403,2178,2225,97.9
'24020, 서구,'030004, 28세,2019,4024,2039,1985,102.7,3948,2014,1934,104.1
'24020, 서구,'030005, 29세,2019,3744,1987,1757,113.1,3667,1947,1720,113.2
'24020, 서구,'035,30~34세,2019,17319,8884,8435,105.3,16941,8706,8235,105.7
'24020, 서구,'035001, 30세,2019,3668,1919,1749,109.7,3583,1880,1703,110.4
'24020, 서구,'035002, 31세,2019,3400,1780,1620,109.9,3318,1745,1573,110.9
'24020, 서구,'035003, 32세,2019,3324,1675,1649,101.6,3240,1636,1604,102
'24020, 서구,'035004, 33세,2019,3476,1781,1695,105.1,3405,1740,1665,104.5
'24020, 서구,'035005, 34세,2019,3451,1729,1722,100.4,3395,1705,1690,100.9
'24020, 서구,'040,35~39세,2019,21977,10960,11017,99.5,21697,10818,10879,99.4
'24020, 서구,'040001, 35세,2019,3769,1913,1856,103.1,3715,1891,1824,103.7
'24020, 서구,'040002, 36세,2019,4250,2138,2112,101.2,4192,2100,2092,100.4
'24020, 서구,'040003, 37세,2019,4648,2332,2316,100.7,4582,2297,2285,100.5
'24020, 서구,'040004, 38세,2019,4537,2292,2245,102.1,4488,2272,2216,102.5
'24020, 서구,'040005, 39세,2019,4773,2285,2488,91.8,4720,2258,2462,91.7
'24020, 서구,'045,40~44세,2019,22873,11120,11753,94.6,22655,11016,11639,94.6
'24020, 서구,'045001, 40세,2019,4655,2219,2436,91.1,4603,2194,2409,91.1
'24020, 서구,'045002, 41세,2019,4295,2089,2206,94.7,4249,2065,2184,94.6
'24020, 서구,'045003, 42세,2019,4569,2239,2330,96.1,4528,2219,2309,96.1
'24020, 서구,'045004, 43세,2019,4582,2253,2329,96.7,4549,2238,2311,96.8
'24020, 서구,'045005, 44세,2019,4772,2320,2452,94.6,4726,2300,2426,94.8
'24020, 서구,'050,45~49세,2019,28108,13651,14457,94.4,27881,13556,14325,94.6
'24020, 서구,'050001, 45세,2019,5528,2724,2804,97.1,5499,2713,2786,97.4
'24020, 서구,'050002, 46세,2019,5362,2572,2790,92.2,5318,2554,2764,92.4
'24020, 서구,'050003, 47세,2019,5600,2645,2955,89.5,5546,2620,2926,89.5
'24020, 서구,'050004, 48세,2019,5927,2868,3059,93.8,5870,2843,3027,93.9
'24020, 서구,'050005, 49세,2019,5691,2842,2849,99.8,5648,2826,2822,100.1
'24020, 서구,'055,50~54세,2019,26662,13346,13316,100.2,26467,13247,13220,100.2
'24020, 서구,'055001, 50세,2019,5730,2841,2889,98.3,5691,2819,2872,98.2
'24020, 서구,'055002, 51세,2019,5779,2892,2887,100.2,5733,2870,2863,100.2
'24020, 서구,'055003, 52세,2019,5196,2600,2596,100.2,5158,2580,2578,100.1
'24020, 서구,'055004, 53세,2019,5014,2535,2479,102.3,4980,2518,2462,102.3
'24020, 서구,'055005, 54세,2019,4943,2478,2465,100.5,4905,2460,2445,100.6
'24020, 서구,'060,55~59세,2019,24028,11785,12243,96.3,23891,11722,12169,96.3
'24020, 서구,'060001, 55세,2019,4633,2319,2314,100.2,4603,2303,2300,100.1
'24020, 서구,'060002, 56세,2019,4875,2397,2478,96.7,4837,2381,2456,96.9
'24020, 서구,'060003, 57세,2019,4612,2252,2360,95.4,4590,2240,2350,95.3
'24020, 서구,'060004, 58세,2019,4823,2349,2474,94.9,4802,2344,2458,95.4
'24020, 서구,'060005, 59세,2019,5085,2468,2617,94.3,5059,2454,2605,94.2
'24020, 서구,'065,60~64세,2019,19590,9460,10130,93.4,19510,9423,10087,93.4
'24020, 서구,'065001, 60세,2019,4543,2181,2362,92.3,4524,2172,2352,92.3
'24020, 서구,'065002, 61세,2019,4061,1917,2144,89.4,4045,1907,2138,89.2
'24020, 서구,'065003, 62세,2019,4014,1989,2025,98.2,3996,1983,2013,98.5
'24020, 서구,'065004, 63세,2019,3339,1627,1712,95,3327,1622,1705,95.1
'24020, 서구,'065005, 64세,2019,3633,1746,1887,92.5,3618,1739,1879,92.5
'24020, 서구,'070,65~69세,2019,12946,6147,6799,90.4,12900,6131,6769,90.6
'24020, 서구,'070001, 65세,2019,2834,1366,1468,93.1,2824,1364,1460,93.4
'24020, 서구,'070002, 66세,2019,2615,1227,1388,88.4,2605,1222,1383,88.4
'24020, 서구,'070003, 67세,2019,2808,1336,1472,90.8,2797,1332,1465,90.9
'24020, 서구,'070004, 68세,2019,2283,1107,1176,94.1,2271,1103,1168,94.4
'24020, 서구,'070005, 69세,2019,2406,1111,1295,85.8,2403,1110,1293,85.8
'24020, 서구,'075,70~74세,2019,10523,4837,5686,85.1,10500,4824,5676,85
'24020, 서구,'075001, 70세,2019,2448,1146,1302,88,2440,1140,1300,87.7
'24020, 서구,'075002, 71세,2019,2207,1005,1202,83.6,2201,1002,1199,83.6
'24020, 서구,'075003, 72세,2019,2352,1059,1293,81.9,2347,1057,1290,81.9
'24020, 서구,'075004, 73세,2019,1770,820,950,86.3,1769,819,950,86.2
'24020, 서구,'075005, 74세,2019,1746,807,939,85.9,1743,806,937,86
'24020, 서구,'080,75~79세,2019,8014,3487,4527,77,8008,3485,4523,77.1
'24020, 서구,'080001, 75세,2019,1597,707,890,79.4,1595,706,889,79.4
'24020, 서구,'080002, 76세,2019,1614,732,882,83,1612,732,880,83.2
'24020, 서구,'080003, 77세,2019,2005,864,1141,75.7,2005,864,1141,75.7
'24020, 서구,'080004, 78세,2019,1490,646,844,76.5,1489,645,844,76.4
'24020, 서구,'080005, 79세,2019,1308,538,770,69.9,1307,538,769,70
'24020, 서구,'085,80~84세,2019,4977,1881,3096,60.8,4968,1878,3090,60.8
'24020, 서구,'085001, 80세,2019,1291,503,788,63.8,1287,501,786,63.7
'24020, 서구,'085002, 81세,2019,1114,418,696,60.1,1111,418,693,60.3
'24020, 서구,'085003, 82세,2019,949,360,589,61.1,949,360,589,61.1
'24020, 서구,'085004, 83세,2019,843,297,546,54.4,843,297,546,54.4
'24020, 서구,'085005, 84세,2019,780,303,477,63.5,778,302,476,63.4
'24020, 서구,'086,85세이상,2019,3370,889,2481,35.8,3364,888,2476,35.9
'24020, 서구,'090,85~89세,2019,2354,659,1695,38.9,2350,658,1692,38.9
'24020, 서구,'090001, 85세,2019,679,197,482,40.9,678,197,481,41
'24020, 서구,'090002, 86세,2019,559,167,392,42.6,557,167,390,42.8
'24020, 서구,'090003, 87세,2019,448,136,312,43.6,447,135,312,43.3
'24020, 서구,'090004, 88세,2019,345,92,253,36.4,345,92,253,36.4
'24020, 서구,'090005, 89세,2019,323,67,256,26.2,323,67,256,26.2
'24020, 서구,'095,90~94세,2019,811,204,607,33.6,810,204,606,33.7
'24020, 서구,'095001, 90세,2019,283,88,195,45.1,283,88,195,45.1
'24020, 서구,'095002, 91세,2019,207,48,159,30.2,207,48,159,30.2
'24020, 서구,'095003, 92세,2019,139,37,102,36.3,139,37,102,36.3
'24020, 서구,'095004, 93세,2019,108,18,90,20,108,18,90,20
'24020, 서구,'095005, 94세,2019,74,13,61,21.3,73,13,60,21.7
'24020, 서구,'100,95~99세,2019,178,23,155,14.8,177,23,154,14.9
'24020, 서구,'100001, 95세,2019,48,9,39,23.1,48,9,39,23.1
'24020, 서구,'100002, 96세,2019,65,9,56,16.1,64,9,55,16.4
'24020, 서구,'100003, 97세,2019,35,X,32,9.4,35,X,32,9.4
'24020, 서구,'100004, 98세,2019,16,X,15,6.7,16,X,15,6.7
'24020, 서구,'100005, 99세,2019,14,X,13,7.7,14,X,13,7.7
'24020, 서구,'101,100세이상,2019,27,X,24,12.5,27,X,24,12.5
'24020, 서구,'102,15세미만,2019,37904,19751,18153,108.8,37790,19691,18099,108.8
'24020, 서구,'103,15~64세,2019,220299,110075,110224,99.9,218071,109032,109039,100
'24020, 서구,'104,65세이상,2019,39830,17241,22589,76.3,39740,17206,22534,76.4
'24020, 서구,'126,평균연령,2019,41.4,40.3,42.5,,41.4,40.3,42.5,
'24020, 서구,'127,중위연령,2019,42.7,41.4,43.9,,42.8,41.5,44,
'24030, 남구,'000,합계,2019,217972,105267,112705,93.4,215820,104374,111446,93.7
'24030, 남구,'005,0~4세,2019,7442,3781,3661,103.3,7402,3762,3640,103.4
'24030, 남구,'005001, 0세,2019,1122,539,583,92.5,1117,536,581,92.3
'24030, 남구,'005002, 1세,2019,1272,665,607,109.6,1268,663,605,109.6
'24030, 남구,'005003, 2세,2019,1486,770,716,107.5,1473,765,708,108.1
'24030, 남구,'005004, 3세,2019,1661,826,835,98.9,1649,821,828,99.2
'24030, 남구,'005005, 4세,2019,1901,981,920,106.6,1895,977,918,106.4
'24030, 남구,'010,5~9세,2019,10517,5347,5170,103.4,10483,5336,5147,103.7
'24030, 남구,'010001, 5세,2019,1998,1023,975,104.9,1988,1019,969,105.2
'24030, 남구,'010002, 6세,2019,2001,1006,995,101.1,1990,1003,987,101.6
'24030, 남구,'010003, 7세,2019,2252,1164,1088,107,2243,1162,1081,107.5
'24030, 남구,'010004, 8세,2019,2139,1082,1057,102.4,2137,1081,1056,102.4
'24030, 남구,'010005, 9세,2019,2127,1072,1055,101.6,2125,1071,1054,101.6
'24030, 남구,'015,10~14세,2019,10582,5331,5251,101.5,10567,5323,5244,101.5
'24030, 남구,'015001, 10세,2019,2047,1034,1013,102.1,2044,1032,1012,102
'24030, 남구,'015002, 11세,2019,2128,1095,1033,106,2124,1093,1031,106
'24030, 남구,'015003, 12세,2019,2297,1148,1149,99.9,2296,1147,1149,99.8
'24030, 남구,'015004, 13세,2019,2094,1038,1056,98.3,2089,1036,1053,98.4
'24030, 남구,'015005, 14세,2019,2016,1016,1000,101.6,2014,1015,999,101.6
'24030, 남구,'020,15~19세,2019,12809,6509,6300,103.3,12642,6422,6220,103.2
'24030, 남구,'020001, 15세,2019,2193,1109,1084,102.3,2189,1108,1081,102.5
'24030, 남구,'020002, 16세,2019,2154,1102,1052,104.8,2148,1100,1048,105
'24030, 남구,'020003, 17세,2019,2390,1201,1189,101,2383,1198,1185,101.1
'24030, 남구,'020004, 18세,2019,2849,1440,1409,102.2,2809,1422,1387,102.5
'24030, 남구,'020005, 19세,2019,3223,1657,1566,105.8,3113,1594,1519,104.9
'24030, 남구,'025,20~24세,2019,15537,7834,7703,101.7,15105,7651,7454,102.6
'24030, 남구,'025001, 20세,2019,3060,1504,1556,96.7,2969,1464,1505,97.3
'24030, 남구,'025002, 21세,2019,3259,1669,1590,105,3163,1626,1537,105.8
'24030, 남구,'025003, 22세,2019,3075,1557,1518,102.6,2991,1524,1467,103.9
'24030, 남구,'025004, 23세,2019,3088,1565,1523,102.8,2992,1522,1470,103.5
'24030, 남구,'025005, 24세,2019,3055,1539,1516,101.5,2990,1515,1475,102.7
'24030, 남구,'030,25~29세,2019,13413,6900,6513,105.9,13080,6787,6293,107.8
'24030, 남구,'030001, 25세,2019,2970,1597,1373,116.3,2899,1576,1323,119.1
'24030, 남구,'030002, 26세,2019,2846,1495,1351,110.7,2772,1466,1306,112.3
'24030, 남구,'030003, 27세,2019,2713,1356,1357,99.9,2651,1339,1312,102.1
'24030, 남구,'030004, 28세,2019,2555,1277,1278,99.9,2499,1258,1241,101.4
'24030, 남구,'030005, 29세,2019,2329,1175,1154,101.8,2259,1148,1111,103.3
'24030, 남구,'035,30~34세,2019,11274,5626,5648,99.6,11025,5541,5484,101
'24030, 남구,'035001, 30세,2019,2193,1143,1050,108.9,2150,1122,1028,109.1
'24030, 남구,'035002, 31세,2019,2174,1112,1062,104.7,2117,1092,1025,106.5
'24030, 남구,'035003, 32세,2019,2182,1071,1111,96.4,2136,1059,1077,98.3
'24030, 남구,'035004, 33세,2019,2326,1138,1188,95.8,2276,1120,1156,96.9
'24030, 남구,'035005, 34세,2019,2399,1162,1237,93.9,2346,1148,1198,95.8
'24030, 남구,'040,35~39세,2019,15751,7736,8015,96.5,15571,7669,7902,97.1
'24030, 남구,'040001, 35세,2019,2660,1331,1329,100.2,2617,1314,1303,100.8
'24030, 남구,'040002, 36세,2019,3030,1490,1540,96.8,2990,1473,1517,97.1
'24030, 남구,'040003, 37세,2019,3356,1627,1729,94.1,3324,1621,1703,95.2
'24030, 남구,'040004, 38세,2019,3333,1616,1717,94.1,3301,1603,1698,94.4
'24030, 남구,'040005, 39세,2019,3372,1672,1700,98.4,3339,1658,1681,98.6
'24030, 남구,'045,40~44세,2019,15977,7895,8082,97.7,15829,7832,7997,97.9
'24030, 남구,'045001, 40세,2019,3340,1650,1690,97.6,3305,1634,1671,97.8
'24030, 남구,'045002, 41세,2019,3036,1499,1537,97.5,3004,1484,1520,97.6
'24030, 남구,'045003, 42세,2019,3246,1576,1670,94.4,3222,1567,1655,94.7
'24030, 남구,'045004, 43세,2019,3185,1599,1586,100.8,3153,1586,1567,101.2
'24030, 남구,'045005, 44세,2019,3170,1571,1599,98.2,3145,1561,1584,98.5
'24030, 남구,'050,45~49세,2019,18027,8845,9182,96.3,17864,8774,9090,96.5
'24030, 남구,'050001, 45세,2019,3542,1777,1765,100.7,3509,1761,1748,100.7
'24030, 남구,'050002, 46세,2019,3511,1695,1816,93.3,3480,1682,1798,93.5
'24030, 남구,'050003, 47세,2019,3637,1842,1795,102.6,3592,1821,1771,102.8
'24030, 남구,'050004, 48세,2019,3767,1845,1922,96,3741,1833,1908,96.1
'24030, 남구,'050005, 49세,2019,3570,1686,1884,89.5,3542,1677,1865,89.9
'24030, 남구,'055,50~54세,2019,17314,8367,8947,93.5,17157,8288,8869,93.4
'24030, 남구,'055001, 50세,2019,3511,1741,1770,98.4,3485,1727,1758,98.2
'24030, 남구,'055002, 51세,2019,3688,1752,1936,90.5,3656,1738,1918,90.6
'24030, 남구,'055003, 52세,2019,3355,1614,1741,92.7,3326,1601,1725,92.8
'24030, 남구,'055004, 53세,2019,3379,1647,1732,95.1,3339,1627,1712,95
'24030, 남구,'055005, 54세,2019,3381,1613,1768,91.2,3351,1595,1756,90.8
'24030, 남구,'060,55~59세,2019,17373,8142,9231,88.2,17256,8092,9164,88.3
'24030, 남구,'060001, 55세,2019,3140,1522,1618,94.1,3108,1506,1602,94
'24030, 남구,'060002, 56세,2019,3378,1636,1742,93.9,3343,1631,1712,95.3
'24030, 남구,'060003, 57세,2019,3373,1550,1823,85,3354,1537,1817,84.6
'24030, 남구,'060004, 58세,2019,3624,1660,1964,84.5,3612,1655,1957,84.6
'24030, 남구,'060005, 59세,2019,3858,1774,2084,85.1,3839,1763,2076,84.9
'24030, 남구,'065,60~64세,2019,15865,7460,8405,88.8,15805,7431,8374,88.7
'24030, 남구,'065001, 60세,2019,3483,1623,1860,87.3,3470,1615,1855,87.1
'24030, 남구,'065002, 61세,2019,3310,1566,1744,89.8,3298,1561,1737,89.9
'24030, 남구,'065003, 62세,2019,3296,1529,1767,86.5,3282,1523,1759,86.6
'24030, 남구,'065004, 63세,2019,2832,1387,1445,96,2822,1382,1440,96
'24030, 남구,'065005, 64세,2019,2944,1355,1589,85.3,2933,1350,1583,85.3
'24030, 남구,'070,65~69세,2019,11270,5225,6045,86.4,11237,5209,6028,86.4
'24030, 남구,'070001, 65세,2019,2389,1105,1284,86.1,2384,1103,1281,86.1
'24030, 남구,'070002, 66세,2019,2265,1051,1214,86.6,2255,1046,1209,86.5
'24030, 남구,'070003, 67세,2019,2489,1173,1316,89.1,2480,1168,1312,89
'24030, 남구,'070004, 68세,2019,2020,909,1111,81.8,2015,907,1108,81.9
'24030, 남구,'070005, 69세,2019,2107,987,1120,88.1,2103,985,1118,88.1
'24030, 남구,'075,70~74세,2019,9557,4358,5199,83.8,9546,4350,5196,83.7
'24030, 남구,'075001, 70세,2019,2272,1037,1235,84,2270,1035,1235,83.8
'24030, 남구,'075002, 71세,2019,2061,942,1119,84.2,2059,940,1119,84
'24030, 남구,'075003, 72세,2019,2114,944,1170,80.7,2112,943,1169,80.7
'24030, 남구,'075004, 73세,2019,1585,729,856,85.2,1582,727,855,85
'24030, 남구,'075005, 74세,2019,1525,706,819,86.2,1523,705,818,86.2
'24030, 남구,'080,75~79세,2019,7408,3259,4149,78.5,7400,3257,4143,78.6
'24030, 남구,'080001, 75세,2019,1496,673,823,81.8,1493,672,821,81.9
'24030, 남구,'080002, 76세,2019,1453,663,790,83.9,1453,663,790,83.9
'24030, 남구,'080003, 77세,2019,1833,840,993,84.6,1832,840,992,84.7
'24030, 남구,'080004, 78세,2019,1406,585,821,71.3,1405,585,820,71.3
'24030, 남구,'080005, 79세,2019,1220,498,722,69,1217,497,720,69
'24030, 남구,'085,80~84세,2019,4632,1770,2862,61.8,4629,1769,2860,61.9
'24030, 남구,'085001, 80세,2019,1158,511,647,79,1158,511,647,79
'24030, 남구,'085002, 81세,2019,1053,414,639,64.8,1052,414,638,64.9
'24030, 남구,'085003, 82세,2019,961,339,622,54.5,960,338,622,54.3
'24030, 남구,'085004, 83세,2019,745,281,464,60.6,745,281,464,60.6
'24030, 남구,'085005, 84세,2019,715,225,490,45.9,714,225,489,46
'24030, 남구,'086,85세이상,2019,3224,882,2342,37.7,3222,881,2341,37.6
'24030, 남구,'090,85~89세,2019,2269,680,1589,42.8,2268,679,1589,42.7
'24030, 남구,'090001, 85세,2019,667,212,455,46.6,667,212,455,46.6
'24030, 남구,'090002, 86세,2019,508,161,347,46.4,507,160,347,46.1
'24030, 남구,'090003, 87세,2019,436,135,301,44.9,436,135,301,44.9
'24030, 남구,'090004, 88세,2019,306,74,232,31.9,306,74,232,31.9
'24030, 남구,'090005, 89세,2019,352,98,254,38.6,352,98,254,38.6
'24030, 남구,'095,90~94세,2019,764,171,593,28.8,763,171,592,28.9
'24030, 남구,'095001, 90세,2019,240,66,174,37.9,240,66,174,37.9
'24030, 남구,'095002, 91세,2019,176,36,140,25.7,176,36,140,25.7
'24030, 남구,'095003, 92세,2019,156,29,127,22.8,155,29,126,23
'24030, 남구,'095004, 93세,2019,104,22,82,26.8,104,22,82,26.8
'24030, 남구,'095005, 94세,2019,88,18,70,25.7,88,18,70,25.7
'24030, 남구,'100,95~99세,2019,164,29,135,21.5,164,29,135,21.5
'24030, 남구,'100001, 95세,2019,49,12,37,32.4,49,12,37,32.4
'24030, 남구,'100002, 96세,2019,57,11,46,23.9,57,11,46,23.9
'24030, 남구,'100003, 97세,2019,30,X,27,11.1,30,X,27,11.1
'24030, 남구,'100004, 98세,2019,20,X,18,11.1,20,X,18,11.1
'24030, 남구,'100005, 99세,2019,8,X,7,14.3,8,X,7,14.3
'24030, 남구,'101,100세이상,2019,27,X,25,8,27,X,25,8
'24030, 남구,'102,15세미만,2019,28541,14459,14082,102.7,28452,14421,14031,102.8
'24030, 남구,'103,15~64세,2019,153340,75314,78026,96.5,151334,74487,76847,96.9
'24030, 남구,'104,65세이상,2019,36091,15494,20597,75.2,36034,15466,20568,75.2
'24030, 남구,'126,평균연령,2019,42.5,41.3,43.6,,42.6,41.3,43.7,
'24030, 남구,'127,중위연령,2019,43.6,42.3,45,,43.8,42.4,45.2,
'24040, 북구,'000,합계,2019,446661,222727,223934,99.5,439737,219360,220377,99.5
'24040, 북구,'005,0~4세,2019,16027,8182,7845,104.3,15873,8107,7766,104.4
'24040, 북구,'005001, 0세,2019,2617,1296,1321,98.1,2599,1287,1312,98.1
'24040, 북구,'005002, 1세,2019,2909,1509,1400,107.8,2884,1496,1388,107.8
'24040, 북구,'005003, 2세,2019,3137,1613,1524,105.8,3094,1593,1501,106.1
'24040, 북구,'005004, 3세,2019,3596,1797,1799,99.9,3566,1782,1784,99.9
'24040, 북구,'005005, 4세,2019,3768,1967,1801,109.2,3730,1949,1781,109.4
'24040, 북구,'010,5~9세,2019,19383,9947,9436,105.4,19295,9909,9386,105.6
'24040, 북구,'010001, 5세,2019,3738,1869,1869,100,3713,1858,1855,100.2
'24040, 북구,'010002, 6세,2019,3703,1956,1747,112,3688,1951,1737,112.3
'24040, 북구,'010003, 7세,2019,4113,2104,2009,104.7,4093,2095,1998,104.9
'24040, 북구,'010004, 8세,2019,3963,2029,1934,104.9,3945,2019,1926,104.8
'24040, 북구,'010005, 9세,2019,3866,1989,1877,106,3856,1986,1870,106.2
'24040, 북구,'015,10~14세,2019,19677,10444,9233,113.1,19653,10433,9220,113.2
'24040, 북구,'015001, 10세,2019,3823,2053,1770,116,3816,2051,1765,116.2
'24040, 북구,'015002, 11세,2019,3983,2110,1873,112.7,3973,2104,1869,112.6
'24040, 북구,'015003, 12세,2019,4157,2225,1932,115.2,4157,2225,1932,115.2
'24040, 북구,'015004, 13세,2019,3834,2008,1826,110,3830,2007,1823,110.1
'24040, 북구,'015005, 14세,2019,3880,2048,1832,111.8,3877,2046,1831,111.7
'24040, 북구,'020,15~19세,2019,26611,13989,12622,110.8,26400,13873,12527,110.7
'24040, 북구,'020001, 15세,2019,4239,2250,1989,113.1,4235,2248,1987,113.1
'24040, 북구,'020002, 16세,2019,4616,2473,2143,115.4,4614,2472,2142,115.4
'24040, 북구,'020003, 17세,2019,4654,2424,2230,108.7,4646,2420,2226,108.7
'24040, 북구,'020004, 18세,2019,5795,3086,2709,113.9,5728,3048,2680,113.7
'24040, 북구,'020005, 19세,2019,7307,3756,3551,105.8,7177,3685,3492,105.5
'24040, 북구,'025,20~24세,2019,37348,19286,18062,106.8,35821,18486,17335,106.6
'24040, 북구,'025001, 20세,2019,6976,3526,3450,102.2,6733,3394,3339,101.6
'24040, 북구,'025002, 21세,2019,7324,3611,3713,97.3,7037,3455,3582,96.5
'24040, 북구,'025003, 22세,2019,7775,4009,3766,106.5,7423,3828,3595,106.5
'24040, 북구,'025004, 23세,2019,7777,4181,3596,116.3,7431,3991,3440,116
'24040, 북구,'025005, 24세,2019,7496,3959,3537,111.9,7197,3818,3379,113
'24040, 북구,'030,25~29세,2019,32959,17757,15202,116.8,31582,17083,14499,117.8
'24040, 북구,'030001, 25세,2019,7301,4034,3267,123.5,6982,3874,3108,124.6
'24040, 북구,'030002, 26세,2019,6979,3808,3171,120.1,6687,3664,3023,121.2
'24040, 북구,'030003, 27세,2019,6867,3648,3219,113.3,6603,3512,3091,113.6
'24040, 북구,'030004, 28세,2019,6110,3260,2850,114.4,5863,3144,2719,115.6
'24040, 북구,'030005, 29세,2019,5702,3007,2695,111.6,5447,2889,2558,112.9
'24040, 북구,'035,30~34세,2019,26466,13704,12762,107.4,25457,13236,12221,108.3
'24040, 북구,'035001, 30세,2019,5440,2799,2641,106,5198,2694,2504,107.6
'24040, 북구,'035002, 31세,2019,5218,2699,2519,107.1,5021,2601,2420,107.5
'24040, 북구,'035003, 32세,2019,5238,2671,2567,104.1,5021,2568,2453,104.7
'24040, 북구,'035004, 33세,2019,5235,2695,2540,106.1,5053,2610,2443,106.8
'24040, 북구,'035005, 34세,2019,5335,2840,2495,113.8,5164,2763,2401,115.1
'24040, 북구,'040,35~39세,2019,32451,16765,15686,106.9,31804,16462,15342,107.3
'24040, 북구,'040001, 35세,2019,5824,3070,2754,111.5,5674,2999,2675,112.1
'24040, 북구,'040002, 36세,2019,6429,3362,3067,109.6,6285,3301,2984,110.6
'24040, 북구,'040003, 37세,2019,6879,3582,3297,108.6,6734,3510,3224,108.9
'24040, 북구,'040004, 38세,2019,6543,3300,3243,101.8,6431,3245,3186,101.9
'24040, 북구,'040005, 39세,2019,6776,3451,3325,103.8,6680,3407,3273,104.1
'24040, 북구,'045,40~44세,2019,31798,16116,15682,102.8,31332,15901,15431,103
'24040, 북구,'045001, 40세,2019,6717,3370,3347,100.7,6608,3319,3289,100.9
'24040, 북구,'045002, 41세,2019,6178,3148,3030,103.9,6089,3097,2992,103.5
'24040, 북구,'045003, 42세,2019,6170,3096,3074,100.7,6085,3058,3027,101
'24040, 북구,'045004, 43세,2019,6262,3216,3046,105.6,6175,3180,2995,106.2
'24040, 북구,'045005, 44세,2019,6471,3286,3185,103.2,6375,3247,3128,103.8
'24040, 북구,'050,45~49세,2019,37414,18532,18882,98.1,36991,18332,18659,98.2
'24040, 북구,'050001, 45세,2019,7474,3824,3650,104.8,7389,3785,3604,105
'24040, 북구,'050002, 46세,2019,7161,3527,3634,97.1,7075,3483,3592,97
'24040, 북구,'050003, 47세,2019,7359,3635,3724,97.6,7269,3597,3672,98
'24040, 북구,'050004, 48세,2019,7779,3821,3958,96.5,7694,3774,3920,96.3
'24040, 북구,'050005, 49세,2019,7641,3725,3916,95.1,7564,3693,3871,95.4
'24040, 북구,'055,50~54세,2019,37609,18578,19031,97.6,37212,18406,18806,97.9
'24040, 북구,'055001, 50세,2019,7547,3759,3788,99.2,7469,3723,3746,99.4
'24040, 북구,'055002, 51세,2019,7992,3945,4047,97.5,7902,3907,3995,97.8
'24040, 북구,'055003, 52세,2019,7408,3569,3839,93,7331,3535,3796,93.1
'24040, 북구,'055004, 53세,2019,7422,3768,3654,103.1,7346,3732,3614,103.3
'24040, 북구,'055005, 54세,2019,7240,3537,3703,95.5,7164,3509,3655,96
'24040, 북구,'060,55~59세,2019,36732,17986,18746,95.9,36440,17851,18589,96
'24040, 북구,'060001, 55세,2019,6804,3347,3457,96.8,6728,3313,3415,97
'24040, 북구,'060002, 56세,2019,7270,3546,3724,95.2,7206,3523,3683,95.7
'24040, 북구,'060003, 57세,2019,6934,3463,3471,99.8,6877,3430,3447,99.5
'24040, 북구,'060004, 58세,2019,7667,3743,3924,95.4,7621,3722,3899,95.5
'24040, 북구,'060005, 59세,2019,8057,3887,4170,93.2,8008,3863,4145,93.2
'24040, 북구,'065,60~64세,2019,30115,14632,15483,94.5,29967,14549,15418,94.4
'24040, 북구,'065001, 60세,2019,7143,3448,3695,93.3,7104,3426,3678,93.1
'24040, 북구,'065002, 61세,2019,6164,2977,3187,93.4,6129,2960,3169,93.4
'24040, 북구,'065003, 62세,2019,6030,2946,3084,95.5,6009,2929,3080,95.1
'24040, 북구,'065004, 63세,2019,5199,2577,2622,98.3,5176,2568,2608,98.5
'24040, 북구,'065005, 64세,2019,5579,2684,2895,92.7,5549,2666,2883,92.5
'24040, 북구,'070,65~69세,2019,20131,9673,10458,92.5,20041,9628,10413,92.5
'24040, 북구,'070001, 65세,2019,4535,2202,2333,94.4,4501,2183,2318,94.2
'24040, 북구,'070002, 66세,2019,3889,1858,2031,91.5,3876,1852,2024,91.5
'24040, 북구,'070003, 67세,2019,4381,2092,2289,91.4,4360,2082,2278,91.4
'24040, 북구,'070004, 68세,2019,3597,1725,1872,92.1,3585,1719,1866,92.1
'24040, 북구,'070005, 69세,2019,3729,1796,1933,92.9,3719,1792,1927,93
'24040, 북구,'075,70~74세,2019,16208,7529,8679,86.7,16173,7512,8661,86.7
'24040, 북구,'075001, 70세,2019,3827,1804,2023,89.2,3812,1797,2015,89.2
'24040, 북구,'075002, 71세,2019,3533,1668,1865,89.4,3529,1667,1862,89.5
'24040, 북구,'075003, 72세,2019,3529,1638,1891,86.6,3519,1632,1887,86.5
'24040, 북구,'075004, 73세,2019,2715,1279,1436,89.1,2711,1276,1435,88.9
'24040, 북구,'075005, 74세,2019,2604,1140,1464,77.9,2602,1140,1462,78
'24040, 북구,'080,75~79세,2019,12381,5302,7079,74.9,12360,5293,7067,74.9
'24040, 북구,'080001, 75세,2019,2437,1076,1361,79.1,2432,1075,1357,79.2
'24040, 북구,'080002, 76세,2019,2452,1064,1388,76.7,2449,1063,1386,76.7
'24040, 북구,'080003, 77세,2019,3172,1438,1734,82.9,3166,1434,1732,82.8
'24040, 북구,'080004, 78세,2019,2299,937,1362,68.8,2293,935,1358,68.9
'24040, 북구,'080005, 79세,2019,2021,787,1234,63.8,2020,786,1234,63.7
'24040, 북구,'085,80~84세,2019,7837,2911,4926,59.1,7827,2908,4919,59.1
'24040, 북구,'085001, 80세,2019,1933,804,1129,71.2,1932,804,1128,71.3
'24040, 북구,'085002, 81세,2019,1721,672,1049,64.1,1718,670,1048,63.9
'24040, 북구,'085003, 82세,2019,1561,585,976,59.9,1560,585,975,60
'24040, 북구,'085004, 83세,2019,1322,453,869,52.1,1320,453,867,52.2
'24040, 북구,'085005, 84세,2019,1300,397,903,44,1297,396,901,44
'24040, 북구,'086,85세이상,2019,5514,1394,4120,33.8,5509,1391,4118,33.8
'24040, 북구,'090,85~89세,2019,3934,1078,2856,37.7,3930,1075,2855,37.7
'24040, 북구,'090001, 85세,2019,1136,357,779,45.8,1136,357,779,45.8
'24040, 북구,'090002, 86세,2019,861,252,609,41.4,860,251,609,41.2
'24040, 북구,'090003, 87세,2019,737,205,532,38.5,735,203,532,38.2
'24040, 북구,'090004, 88세,2019,638,154,484,31.8,637,154,483,31.9
'24040, 북구,'090005, 89세,2019,562,110,452,24.3,562,110,452,24.3
'24040, 북구,'095,90~94세,2019,1281,277,1004,27.6,1280,277,1003,27.6
'24040, 북구,'095001, 90세,2019,404,105,299,35.1,404,105,299,35.1
'24040, 북구,'095002, 91세,2019,334,63,271,23.2,334,63,271,23.2
'24040, 북구,'095003, 92세,2019,245,44,201,21.9,244,44,200,22
'24040, 북구,'095004, 93세,2019,181,44,137,32.1,181,44,137,32.1
'24040, 북구,'095005, 94세,2019,117,21,96,21.9,117,21,96,21.9
'24040, 북구,'100,95~99세,2019,263,35,228,15.4,263,35,228,15.4
'24040, 북구,'100001, 95세,2019,58,12,46,26.1,58,12,46,26.1
'24040, 북구,'100002, 96세,2019,83,11,72,15.3,83,11,72,15.3
'24040, 북구,'100003, 97세,2019,58,6,52,11.5,58,6,52,11.5
'24040, 북구,'100004, 98세,2019,38,5,33,15.2,38,5,33,15.2
'24040, 북구,'100005, 99세,2019,26,X,25,4,26,X,25,4
'24040, 북구,'101,100세이상,2019,36,X,32,12.5,36,X,32,12.5
'24040, 북구,'102,15세미만,2019,55087,28573,26514,107.8,54821,28449,26372,107.9
'24040, 북구,'103,15~64세,2019,329503,167345,162158,103.2,323006,164179,158827,103.4
'24040, 북구,'104,65세이상,2019,62071,26809,35262,76,61910,26732,35178,76
'24040, 북구,'126,평균연령,2019,41.3,40.1,42.5,,41.4,40.2,42.7,
'24040, 북구,'127,중위연령,2019,41.9,40.4,43.5,,42.2,40.6,43.9,
'24050, 광산구,'000,합계,2019,423310,214479,208831,102.7,404105,202855,201250,100.8
'24050, 광산구,'005,0~4세,2019,18593,9564,9029,105.9,18176,9359,8817,106.1
'24050, 광산구,'005001, 0세,2019,2786,1416,1370,103.4,2716,1385,1331,104.1
'24050, 광산구,'005002, 1세,2019,3231,1671,1560,107.1,3139,1621,1518,106.8
'24050, 광산구,'005003, 2세,2019,3691,1891,1800,105.1,3598,1846,1752,105.4
'24050, 광산구,'005004, 3세,2019,4353,2254,2099,107.4,4268,2215,2053,107.9
'24050, 광산구,'005005, 4세,2019,4532,2332,2200,106,4455,2292,2163,106
'24050, 광산구,'010,5~9세,2019,25242,13025,12217,106.6,24884,12846,12038,106.7
'24050, 광산구,'010001, 5세,2019,4631,2372,2259,105,4541,2327,2214,105.1
'24050, 광산구,'010002, 6세,2019,4825,2466,2359,104.5,4746,2431,2315,105
'24050, 광산구,'010003, 7세,2019,5390,2826,2564,110.2,5328,2795,2533,110.3
'24050, 광산구,'010004, 8세,2019,5224,2725,2499,109,5164,2692,2472,108.9
'24050, 광산구,'010005, 9세,2019,5172,2636,2536,103.9,5105,2601,2504,103.9
'24050, 광산구,'015,10~14세,2019,25684,13168,12516,105.2,25443,13051,12392,105.3
'24050, 광산구,'015001, 10세,2019,5024,2523,2501,100.9,4983,2503,2480,100.9
'24050, 광산구,'015002, 11세,2019,5238,2708,2530,107,5190,2686,2504,107.3
'24050, 광산구,'015003, 12세,2019,5517,2860,2657,107.6,5468,2840,2628,108.1
'24050, 광산구,'015004, 13세,2019,5025,2580,2445,105.5,4962,2549,2413,105.6
'24050, 광산구,'015005, 14세,2019,4880,2497,2383,104.8,4840,2473,2367,104.5
'24050, 광산구,'020,15~19세,2019,28627,14351,14276,100.5,27941,14011,13930,100.6
'24050, 광산구,'020001, 15세,2019,5144,2635,2509,105,5098,2606,2492,104.6
'24050, 광산구,'020002, 16세,2019,5271,2756,2515,109.6,5221,2734,2487,109.9
'24050, 광산구,'020003, 17세,2019,5120,2603,2517,103.4,5063,2568,2495,102.9
'24050, 광산구,'020004, 18세,2019,6099,3066,3033,101.1,5956,2996,2960,101.2
'24050, 광산구,'020005, 19세,2019,6993,3291,3702,88.9,6603,3107,3496,88.9
'24050, 광산구,'025,20~24세,2019,33812,17513,16299,107.4,30460,15419,15041,102.5
'24050, 광산구,'025001, 20세,2019,6743,3432,3311,103.7,6204,3121,3083,101.2
'24050, 광산구,'025002, 21세,2019,7261,3711,3550,104.5,6536,3262,3274,99.6
'24050, 광산구,'025003, 22세,2019,6952,3497,3455,101.2,6209,3036,3173,95.7
'24050, 광산구,'025004, 23세,2019,6565,3439,3126,110,5913,3031,2882,105.2
'24050, 광산구,'025005, 24세,2019,6291,3434,2857,120.2,5598,2969,2629,112.9
'24050, 광산구,'030,25~29세,2019,29156,15888,13268,119.7,25698,13574,12124,112
'24050, 광산구,'030001, 25세,2019,6289,3444,2845,121.1,5556,2944,2612,112.7
'24050, 광산구,'030002, 26세,2019,6120,3373,2747,122.8,5399,2886,2513,114.8
'24050, 광산구,'030003, 27세,2019,6035,3332,2703,123.3,5335,2852,2483,114.9
'24050, 광산구,'030004, 28세,2019,5484,2916,2568,113.6,4864,2521,2343,107.6
'24050, 광산구,'030005, 29세,2019,5228,2823,2405,117.4,4544,2371,2173,109.1
'24050, 광산구,'035,30~34세,2019,25911,13625,12286,110.9,22847,11676,11171,104.5
'24050, 광산구,'035001, 30세,2019,4943,2645,2298,115.1,4271,2211,2060,107.3
'24050, 광산구,'035002, 31세,2019,4872,2554,2318,110.2,4232,2148,2084,103.1
'24050, 광산구,'035003, 32세,2019,5273,2842,2431,116.9,4624,2418,2206,109.6
'24050, 광산구,'035004, 33세,2019,5332,2721,2611,104.2,4796,2396,2400,99.8
'24050, 광산구,'035005, 34세,2019,5491,2863,2628,108.9,4924,2503,2421,103.4
'24050, 광산구,'040,35~39세,2019,36398,18450,17948,102.8,34070,17000,17070,99.6
'24050, 광산구,'040001, 35세,2019,6067,3113,2954,105.4,5576,2811,2765,101.7
'24050, 광산구,'040002, 36세,2019,6844,3533,3311,106.7,6346,3206,3140,102.1
'24050, 광산구,'040003, 37세,2019,7847,3942,3905,100.9,7350,3638,3712,98
'24050, 광산구,'040004, 38세,2019,7558,3856,3702,104.2,7126,3589,3537,101.5
'24050, 광산구,'040005, 39세,2019,8082,4006,4076,98.3,7672,3756,3916,95.9
'24050, 광산구,'045,40~44세,2019,38075,19034,19041,100,36378,18002,18376,98
'24050, 광산구,'045001, 40세,2019,7902,3893,4009,97.1,7555,3681,3874,95
'24050, 광산구,'045002, 41세,2019,7166,3583,3583,100,6782,3351,3431,97.7
'24050, 광산구,'045003, 42세,2019,7722,3876,3846,100.8,7385,3671,3714,98.8
'24050, 광산구,'045004, 43세,2019,7554,3828,3726,102.7,7224,3617,3607,100.3
'24050, 광산구,'045005, 44세,2019,7731,3854,3877,99.4,7432,3682,3750,98.2
'24050, 광산구,'050,45~49세,2019,42315,21783,20532,106.1,40972,21002,19970,105.2
'24050, 광산구,'050001, 45세,2019,8545,4309,4236,101.7,8248,4138,4110,100.7
'24050, 광산구,'050002, 46세,2019,8537,4287,4250,100.9,8277,4137,4140,99.9
'24050, 광산구,'050003, 47세,2019,8349,4350,3999,108.8,8063,4190,3873,108.2
'24050, 광산구,'050004, 48세,2019,8726,4533,4193,108.1,8480,4380,4100,106.8
'24050, 광산구,'050005, 49세,2019,8158,4304,3854,111.7,7904,4157,3747,110.9
'24050, 광산구,'055,50~54세,2019,35576,18334,17242,106.3,34634,17808,16826,105.8
'24050, 광산구,'055001, 50세,2019,7734,3985,3749,106.3,7498,3846,3652,105.3
'24050, 광산구,'055002, 51세,2019,7798,3953,3845,102.8,7603,3847,3756,102.4
'24050, 광산구,'055003, 52세,2019,6821,3545,3276,108.2,6655,3454,3201,107.9
'24050, 광산구,'055004, 53세,2019,6818,3570,3248,109.9,6636,3484,3152,110.5
'24050, 광산구,'055005, 54세,2019,6405,3281,3124,105,6242,3177,3065,103.7
'24050, 광산구,'060,55~59세,2019,27832,15030,12802,117.4,27177,14688,12489,117.6
'24050, 광산구,'060001, 55세,2019,5612,3014,2598,116,5447,2933,2514,116.7
'24050, 광산구,'060002, 56세,2019,5893,3223,2670,120.7,5748,3150,2598,121.2
'24050, 광산구,'060003, 57세,2019,5311,2918,2393,121.9,5180,2854,2326,122.7
'24050, 광산구,'060004, 58세,2019,5489,2967,2522,117.6,5390,2907,2483,117.1
'24050, 광산구,'060005, 59세,2019,5527,2908,2619,111,5412,2844,2568,110.7
'24050, 광산구,'065,60~64세,2019,19116,9778,9338,104.7,18727,9588,9139,104.9
'24050, 광산구,'065001, 60세,2019,4718,2476,2242,110.4,4621,2430,2191,110.9
'24050, 광산구,'065002, 61세,2019,4084,2119,1965,107.8,4002,2073,1929,107.5
'24050, 광산구,'065003, 62세,2019,3838,1948,1890,103.1,3754,1909,1845,103.5
'24050, 광산구,'065004, 63세,2019,3200,1617,1583,102.1,3134,1588,1546,102.7
'24050, 광산구,'065005, 64세,2019,3276,1618,1658,97.6,3216,1588,1628,97.5
'24050, 광산구,'070,65~69세,2019,11357,5371,5986,89.7,11200,5309,5891,90.1
'24050, 광산구,'070001, 65세,2019,2583,1264,1319,95.8,2536,1243,1293,96.1
'24050, 광산구,'070002, 66세,2019,2278,1082,1196,90.5,2246,1065,1181,90.2
'24050, 광산구,'070003, 67세,2019,2386,1128,1258,89.7,2355,1117,1238,90.2
'24050, 광산구,'070004, 68세,2019,2049,943,1106,85.3,2028,937,1091,85.9
'24050, 광산구,'070005, 69세,2019,2061,954,1107,86.2,2035,947,1088,87
'24050, 광산구,'075,70~74세,2019,9268,4223,5045,83.7,9201,4198,5003,83.9
'24050, 광산구,'075001, 70세,2019,2126,966,1160,83.3,2112,960,1152,83.3
'24050, 광산구,'075002, 71세,2019,1966,909,1057,86,1951,903,1048,86.2
'24050, 광산구,'075003, 72세,2019,2068,923,1145,80.6,2054,920,1134,81.1
'24050, 광산구,'075004, 73세,2019,1639,781,858,91,1629,777,852,91.2
'24050, 광산구,'075005, 74세,2019,1469,644,825,78.1,1455,638,817,78.1
'24050, 광산구,'080,75~79세,2019,7498,2905,4593,63.2,7466,2894,4572,63.3
'24050, 광산구,'080001, 75세,2019,1415,594,821,72.4,1405,590,815,72.4
'24050, 광산구,'080002, 76세,2019,1434,592,842,70.3,1427,588,839,70.1
'24050, 광산구,'080003, 77세,2019,1915,748,1167,64.1,1907,747,1160,64.4
'24050, 광산구,'080004, 78세,2019,1443,530,913,58.1,1440,530,910,58.2
'24050, 광산구,'080005, 79세,2019,1291,441,850,51.9,1287,439,848,51.8
'24050, 광산구,'085,80~84세,2019,5137,1632,3505,46.6,5128,1629,3499,46.6
'24050, 광산구,'085001, 80세,2019,1211,420,791,53.1,1210,419,791,53
'24050, 광산구,'085002, 81세,2019,1124,369,755,48.9,1121,368,753,48.9
'24050, 광산구,'085003, 82세,2019,1063,342,721,47.4,1061,342,719,47.6
'24050, 광산구,'085004, 83세,2019,857,237,620,38.2,854,236,618,38.2
'24050, 광산구,'085005, 84세,2019,882,264,618,42.7,882,264,618,42.7
'24050, 광산구,'086,85세이상,2019,3713,805,2908,27.7,3703,801,2902,27.6
'24050, 광산구,'090,85~89세,2019,2592,604,1988,30.4,2587,603,1984,30.4
'24050, 광산구,'090001, 85세,2019,730,201,529,38,728,200,528,37.9
'24050, 광산구,'090002, 86세,2019,546,126,420,30,545,126,419,30.1
'24050, 광산구,'090003, 87세,2019,503,125,378,33.1,502,125,377,33.2
'24050, 광산구,'090004, 88세,2019,390,79,311,25.4,390,79,311,25.4
'24050, 광산구,'090005, 89세,2019,423,73,350,20.9,422,73,349,20.9
'24050, 광산구,'095,90~94세,2019,911,171,740,23.1,906,168,738,22.8
'24050, 광산구,'095001, 90세,2019,304,59,245,24.1,303,59,244,24.2
'24050, 광산구,'095002, 91세,2019,231,47,184,25.5,230,46,184,25
'24050, 광산구,'095003, 92세,2019,160,35,125,28,158,33,125,26.4
'24050, 광산구,'095004, 93세,2019,107,18,89,20.2,106,18,88,20.5
'24050, 광산구,'095005, 94세,2019,109,12,97,12.4,109,12,97,12.4
'24050, 광산구,'100,95~99세,2019,187,30,157,19.1,187,30,157,19.1
'24050, 광산구,'100001, 95세,2019,45,12,33,36.4,45,12,33,36.4
'24050, 광산구,'100002, 96세,2019,69,6,63,9.5,69,6,63,9.5
'24050, 광산구,'100003, 97세,2019,41,6,35,17.1,41,6,35,17.1
'24050, 광산구,'100004, 98세,2019,21,5,16,31.3,21,5,16,31.3
'24050, 광산구,'100005, 99세,2019,11,X,10,10,11,X,10,10
'24050, 광산구,'101,100세이상,2019,23,X,23,0,23,X,23,0
'24050, 광산구,'102,15세미만,2019,69519,35757,33762,105.9,68503,35256,33247,106
'24050, 광산구,'103,15~64세,2019,316818,163786,153032,107,298904,152768,146136,104.5
'24050, 광산구,'104,65세이상,2019,36973,14936,22037,67.8,36698,14831,21867,67.8
'24050, 광산구,'126,평균연령,2019,37.5,36.8,38.3,,37.7,37,38.5,
'24050, 광산구,'127,중위연령,2019,38.5,37.9,39.2,,39,38.5,39.5,
'25,대전광역시,'000,합계,2019,1498839,751585,747254,100.6,1473692,739521,734171,100.7
'25,대전광역시,'005,0~4세,2019,54516,28033,26483,105.9,53878,27703,26175,105.8
'25,대전광역시,'005001, 0세,2019,8706,4427,4279,103.5,8611,4380,4231,103.5
'25,대전광역시,'005002, 1세,2019,9534,4865,4669,104.2,9407,4793,4614,103.9
'25,대전광역시,'005003, 2세,2019,10926,5612,5314,105.6,10783,5547,5236,105.9
'25,대전광역시,'005004, 3세,2019,12284,6419,5865,109.4,12139,6338,5801,109.3
'25,대전광역시,'005005, 4세,2019,13066,6710,6356,105.6,12938,6645,6293,105.6
'25,대전광역시,'010,5~9세,2019,67447,34651,32796,105.7,67086,34473,32613,105.7
'25,대전광역시,'010001, 5세,2019,12725,6584,6141,107.2,12620,6526,6094,107.1
'25,대전광역시,'010002, 6세,2019,13289,6743,6546,103,13207,6699,6508,102.9
'25,대전광역시,'010003, 7세,2019,13881,7208,6673,108,13811,7175,6636,108.1
'25,대전광역시,'010004, 8세,2019,14112,7241,6871,105.4,14054,7213,6841,105.4
'25,대전광역시,'010005, 9세,2019,13440,6875,6565,104.7,13394,6860,6534,105
'25,대전광역시,'015,10~14세,2019,68743,35528,33215,107,68532,35414,33118,106.9
'25,대전광역시,'015001, 10세,2019,13154,6799,6355,107,13099,6771,6328,107
'25,대전광역시,'015002, 11세,2019,14048,7225,6823,105.9,14005,7198,6807,105.7
'25,대전광역시,'015003, 12세,2019,14723,7550,7173,105.3,14678,7528,7150,105.3
'25,대전광역시,'015004, 13세,2019,13449,6956,6493,107.1,13411,6937,6474,107.2
'25,대전광역시,'015005, 14세,2019,13369,6998,6371,109.8,13339,6980,6359,109.8
'25,대전광역시,'020,15~19세,2019,90628,47490,43138,110.1,89180,46773,42407,110.3
'25,대전광역시,'020001, 15세,2019,14921,7832,7089,110.5,14897,7817,7080,110.4
'25,대전광역시,'020002, 16세,2019,14967,7766,7201,107.8,14934,7751,7183,107.9
'25,대전광역시,'020003, 17세,2019,15497,8266,7231,114.3,15408,8214,7194,114.2
'25,대전광역시,'020004, 18세,2019,19607,10331,9276,111.4,19217,10138,9079,111.7
'25,대전광역시,'020005, 19세,2019,25636,13295,12341,107.7,24724,12853,11871,108.3
'25,대전광역시,'025,20~24세,2019,124362,65124,59238,109.9,118844,62522,56322,111
'25,대전광역시,'025001, 20세,2019,23810,11772,12038,97.8,22707,11284,11423,98.8
'25,대전광역시,'025002, 21세,2019,24147,12036,12111,99.4,22977,11495,11482,100.1
'25,대전광역시,'025003, 22세,2019,25593,13182,12411,106.2,24375,12602,11773,107
'25,대전광역시,'025004, 23세,2019,25682,14004,11678,119.9,24635,13473,11162,120.7
'25,대전광역시,'025005, 24세,2019,25130,14130,11000,128.5,24150,13668,10482,130.4
'25,대전광역시,'030,25~29세,2019,111165,60580,50585,119.8,107362,58810,48552,121.1
'25,대전광역시,'030001, 25세,2019,24323,13562,10761,126,23474,13150,10324,127.4
'25,대전광역시,'030002, 26세,2019,23138,12763,10375,123,22380,12424,9956,124.8
'25,대전광역시,'030003, 27세,2019,22880,12283,10597,115.9,22123,11950,10173,117.5
'25,대전광역시,'030004, 28세,2019,20926,11161,9765,114.3,20217,10825,9392,115.3
'25,대전광역시,'030005, 29세,2019,19898,10811,9087,119,19168,10461,8707,120.1
'25,대전광역시,'035,30~34세,2019,92983,49344,43639,113.1,89567,47691,41876,113.9
'25,대전광역시,'035001, 30세,2019,19022,10345,8677,119.2,18260,9970,8290,120.3
'25,대전광역시,'035002, 31세,2019,18528,9984,8544,116.9,17777,9626,8151,118.1
'25,대전광역시,'035003, 32세,2019,18295,9616,8679,110.8,17605,9265,8340,111.1
'25,대전광역시,'035004, 33세,2019,18544,9742,8802,110.7,17904,9431,8473,111.3
'25,대전광역시,'035005, 34세,2019,18594,9657,8937,108.1,18021,9399,8622,109
'25,대전광역시,'040,35~39세,2019,110133,55973,54160,103.3,107673,54797,52876,103.6
'25,대전광역시,'040001, 35세,2019,19062,9831,9231,106.5,18536,9576,8960,106.9
'25,대전광역시,'040002, 36세,2019,21206,10901,10305,105.8,20685,10648,10037,106.1
'25,대전광역시,'040003, 37세,2019,23022,11643,11379,102.3,22503,11409,11094,102.8
'25,대전광역시,'040004, 38세,2019,23302,11783,11519,102.3,22845,11559,11286,102.4
'25,대전광역시,'040005, 39세,2019,23541,11815,11726,100.8,23104,11605,11499,100.9
'25,대전광역시,'045,40~44세,2019,110297,54900,55397,99.1,108499,54028,54471,99.2
'25,대전광역시,'045001, 40세,2019,22446,11212,11234,99.8,22007,11008,10999,100.1
'25,대전광역시,'045002, 41세,2019,21288,10630,10658,99.7,20909,10432,10477,99.6
'25,대전광역시,'045003, 42세,2019,22054,10934,11120,98.3,21716,10772,10944,98.4
'25,대전광역시,'045004, 43세,2019,21627,10722,10905,98.3,21296,10569,10727,98.5
'25,대전광역시,'045005, 44세,2019,22882,11402,11480,99.3,22571,11247,11324,99.3
'25,대전광역시,'050,45~49세,2019,129472,64766,64706,100.1,127794,63914,63880,100.1
'25,대전광역시,'050001, 45세,2019,25263,12622,12641,99.8,24946,12460,12486,99.8
'25,대전광역시,'050002, 46세,2019,25731,12688,13043,97.3,25409,12509,12900,97
'25,대전광역시,'050003, 47세,2019,25051,12612,12439,101.4,24703,12435,12268,101.4
'25,대전광역시,'050004, 48세,2019,27436,13776,13660,100.8,27101,13610,13491,100.9
'25,대전광역시,'050005, 49세,2019,25991,13068,12923,101.1,25635,12900,12735,101.3
'25,대전광역시,'055,50~54세,2019,123737,61470,62267,98.7,122395,60798,61597,98.7
'25,대전광역시,'055001, 50세,2019,27288,13541,13747,98.5,26976,13380,13596,98.4
'25,대전광역시,'055002, 51세,2019,27003,13263,13740,96.5,26733,13122,13611,96.4
'25,대전광역시,'055003, 52세,2019,23780,11764,12016,97.9,23520,11638,11882,97.9
'25,대전광역시,'055004, 53세,2019,22250,11306,10944,103.3,21990,11182,10808,103.5
'25,대전광역시,'055005, 54세,2019,23416,11596,11820,98.1,23176,11476,11700,98.1
'25,대전광역시,'060,55~59세,2019,118422,58710,59712,98.3,117361,58220,59141,98.4
'25,대전광역시,'060001, 55세,2019,21428,10663,10765,99.1,21193,10555,10638,99.2
'25,대전광역시,'060002, 56세,2019,22129,11243,10886,103.3,21857,11105,10752,103.3
'25,대전광역시,'060003, 57세,2019,23722,11875,11847,100.2,23506,11776,11730,100.4
'25,대전광역시,'060004, 58세,2019,26076,12802,13274,96.4,25929,12741,13188,96.6
'25,대전광역시,'060005, 59세,2019,25067,12127,12940,93.7,24876,12043,12833,93.8
'25,대전광역시,'065,60~64세,2019,100048,49170,50878,96.6,99335,48832,50503,96.7
'25,대전광역시,'065001, 60세,2019,22045,10732,11313,94.9,21899,10666,11233,95
'25,대전광역시,'065002, 61세,2019,20249,10003,10246,97.6,20075,9913,10162,97.5
'25,대전광역시,'065003, 62세,2019,20227,10108,10119,99.9,20090,10048,10042,100.1
'25,대전광역시,'065004, 63세,2019,18717,9199,9518,96.6,18582,9135,9447,96.7
'25,대전광역시,'065005, 64세,2019,18810,9128,9682,94.3,18689,9070,9619,94.3
'25,대전광역시,'070,65~69세,2019,65580,31696,33884,93.5,65191,31528,33663,93.7
'25,대전광역시,'070001, 65세,2019,15766,7528,8238,91.4,15635,7469,8166,91.5
'25,대전광역시,'070002, 66세,2019,13154,6445,6709,96.1,13065,6405,6660,96.2
'25,대전광역시,'070003, 67세,2019,14258,6937,7321,94.8,14199,6915,7284,94.9
'25,대전광역시,'070004, 68세,2019,10536,5109,5427,94.1,10471,5082,5389,94.3
'25,대전광역시,'070005, 69세,2019,11866,5677,6189,91.7,11821,5657,6164,91.8
'25,대전광역시,'075,70~74세,2019,48045,22645,25400,89.2,47872,22570,25302,89.2
'25,대전광역시,'075001, 70세,2019,11400,5470,5930,92.2,11341,5445,5896,92.4
'25,대전광역시,'075002, 71세,2019,10839,5163,5676,91,10814,5151,5663,91
'25,대전광역시,'075003, 72세,2019,10150,4687,5463,85.8,10109,4670,5439,85.9
'25,대전광역시,'075004, 73세,2019,7868,3750,4118,91.1,7836,3739,4097,91.3
'25,대전광역시,'075005, 74세,2019,7788,3575,4213,84.9,7772,3565,4207,84.7
'25,대전광역시,'080,75~79세,2019,38878,16678,22200,75.1,38813,16650,22163,75.1
'25,대전광역시,'080001, 75세,2019,8050,3541,4509,78.5,8036,3535,4501,78.5
'25,대전광역시,'080002, 76세,2019,7953,3445,4508,76.4,7937,3437,4500,76.4
'25,대전광역시,'080003, 77세,2019,9596,4211,5385,78.2,9586,4207,5379,78.2
'25,대전광역시,'080004, 78세,2019,7121,2962,4159,71.2,7111,2960,4151,71.3
'25,대전광역시,'080005, 79세,2019,6158,2519,3639,69.2,6143,2511,3632,69.1
'25,대전광역시,'085,80~84세,2019,26176,9803,16373,59.9,26133,9789,16344,59.9
'25,대전광역시,'085001, 80세,2019,6444,2553,3891,65.6,6429,2548,3881,65.7
'25,대전광역시,'085002, 81세,2019,5829,2289,3540,64.7,5821,2286,3535,64.7
'25,대전광역시,'085003, 82세,2019,5085,1939,3146,61.6,5074,1936,3138,61.7
'25,대전광역시,'085004, 83세,2019,4630,1594,3036,52.5,4627,1593,3034,52.5
'25,대전광역시,'085005, 84세,2019,4188,1428,2760,51.7,4182,1426,2756,51.7
'25,대전광역시,'086,85세이상,2019,18207,5024,13183,38.1,18177,5009,13168,38
'25,대전광역시,'090,85~89세,2019,12719,3790,8929,42.4,12702,3782,8920,42.4
'25,대전광역시,'090001, 85세,2019,3577,1179,2398,49.2,3570,1175,2395,49.1
'25,대전광역시,'090002, 86세,2019,2948,917,2031,45.2,2943,914,2029,45
'25,대전광역시,'090003, 87세,2019,2599,770,1829,42.1,2597,769,1828,42.1
'25,대전광역시,'090004, 88세,2019,1910,511,1399,36.5,1909,511,1398,36.6
'25,대전광역시,'090005, 89세,2019,1685,413,1272,32.5,1683,413,1270,32.5
'25,대전광역시,'095,90~94세,2019,4378,1019,3359,30.3,4368,1013,3355,30.2
'25,대전광역시,'095001, 90세,2019,1359,314,1045,30,1355,310,1045,29.7
'25,대전광역시,'095002, 91세,2019,1151,267,884,30.2,1147,266,881,30.2
'25,대전광역시,'095003, 92세,2019,872,212,660,32.1,871,212,659,32.2
'25,대전광역시,'095004, 93세,2019,545,135,410,32.9,545,135,410,32.9
'25,대전광역시,'095005, 94세,2019,451,91,360,25.3,450,90,360,25
'25,대전광역시,'100,95~99세,2019,997,194,803,24.2,994,193,801,24.1
'25,대전광역시,'100001, 95세,2019,324,63,261,24.1,324,63,261,24.1
'25,대전광역시,'100002, 96세,2019,290,50,240,20.8,290,50,240,20.8
'25,대전광역시,'100003, 97세,2019,195,41,154,26.6,194,41,153,26.8
'25,대전광역시,'100004, 98세,2019,117,28,89,31.5,117,28,89,31.5
'25,대전광역시,'100005, 99세,2019,71,12,59,20.3,69,11,58,19
'25,대전광역시,'101,100세이상,2019,113,21,92,22.8,113,21,92,22.8
'25,대전광역시,'102,15세미만,2019,190706,98212,92494,106.2,189496,97590,91906,106.2
'25,대전광역시,'103,15~64세,2019,1111247,567527,543720,104.4,1088010,556385,531625,104.7
'25,대전광역시,'104,65세이상,2019,196886,85846,111040,77.3,196186,85546,110640,77.3
'25,대전광역시,'126,평균연령,2019,40.8,39.7,41.9,,41,39.8,42.1,
'25,대전광역시,'127,중위연령,2019,41.3,39.9,42.8,,41.6,40.1,43.1,
'25010, 동구,'000,합계,2019,237273,119605,117668,101.6,230735,116497,114238,102
'25010, 동구,'005,0~4세,2019,7196,3755,3441,109.1,7108,3705,3403,108.9
'25010, 동구,'005001, 0세,2019,1129,573,556,103.1,1119,569,550,103.5
'25010, 동구,'005002, 1세,2019,1256,659,597,110.4,1234,644,590,109.2
'25010, 동구,'005003, 2세,2019,1466,760,706,107.6,1446,751,695,108.1
'25010, 동구,'005004, 3세,2019,1605,865,740,116.9,1584,855,729,117.3
'25010, 동구,'005005, 4세,2019,1740,898,842,106.7,1725,886,839,105.6
'25010, 동구,'010,5~9세,2019,9121,4679,4442,105.3,9086,4660,4426,105.3
'25010, 동구,'010001, 5세,2019,1757,919,838,109.7,1746,912,834,109.4
'25010, 동구,'010002, 6세,2019,1777,882,895,98.5,1769,876,893,98.1
'25010, 동구,'010003, 7세,2019,1868,966,902,107.1,1861,962,899,107
'25010, 동구,'010004, 8세,2019,1900,958,942,101.7,1892,956,936,102.1
'25010, 동구,'010005, 9세,2019,1819,954,865,110.3,1818,954,864,110.4
'25010, 동구,'015,10~14세,2019,9334,4833,4501,107.4,9301,4810,4491,107.1
'25010, 동구,'015001, 10세,2019,1791,952,839,113.5,1780,944,836,112.9
'25010, 동구,'015002, 11세,2019,1975,991,984,100.7,1968,986,982,100.4
'25010, 동구,'015003, 12세,2019,1964,1008,956,105.4,1958,1005,953,105.5
'25010, 동구,'015004, 13세,2019,1813,921,892,103.3,1810,919,891,103.1
'25010, 동구,'015005, 14세,2019,1791,961,830,115.8,1785,956,829,115.3
'25010, 동구,'020,15~19세,2019,15249,7879,7370,106.9,14487,7530,6957,108.2
'25010, 동구,'020001, 15세,2019,2043,1046,997,104.9,2039,1044,995,104.9
'25010, 동구,'020002, 16세,2019,2116,1145,971,117.9,2109,1143,966,118.3
'25010, 동구,'020003, 17세,2019,2205,1245,960,129.7,2163,1223,940,130.1
'25010, 동구,'020004, 18세,2019,3311,1724,1587,108.6,3102,1636,1466,111.6
'25010, 동구,'020005, 19세,2019,5574,2719,2855,95.2,5074,2484,2590,95.9
'25010, 동구,'025,20~24세,2019,23372,12265,11107,110.4,21095,11173,9922,112.6
'25010, 동구,'025001, 20세,2019,4787,2093,2694,77.7,4197,1833,2364,77.5
'25010, 동구,'025002, 21세,2019,4821,2182,2639,82.7,4246,1920,2326,82.5
'25010, 동구,'025003, 22세,2019,4992,2680,2312,115.9,4473,2424,2049,118.3
'25010, 동구,'025004, 23세,2019,4563,2702,1861,145.2,4219,2518,1701,148
'25010, 동구,'025005, 24세,2019,4209,2608,1601,162.9,3960,2478,1482,167.2
'25010, 동구,'030,25~29세,2019,15608,8755,6853,127.8,14834,8398,6436,130.5
'25010, 동구,'030001, 25세,2019,3722,2166,1556,139.2,3522,2057,1465,140.4
'25010, 동구,'030002, 26세,2019,3241,1831,1410,129.9,3068,1755,1313,133.7
'25010, 동구,'030003, 27세,2019,3116,1679,1437,116.8,2979,1622,1357,119.5
'25010, 동구,'030004, 28세,2019,2921,1602,1319,121.5,2788,1549,1239,125
'25010, 동구,'030005, 29세,2019,2608,1477,1131,130.6,2477,1415,1062,133.2
'25010, 동구,'035,30~34세,2019,12201,6611,5590,118.3,11611,6342,5269,120.4
'25010, 동구,'035001, 30세,2019,2456,1345,1111,121.1,2321,1280,1041,123
'25010, 동구,'035002, 31세,2019,2460,1373,1087,126.3,2360,1328,1032,128.7
'25010, 동구,'035003, 32세,2019,2365,1287,1078,119.4,2236,1223,1013,120.7
'25010, 동구,'035004, 33세,2019,2458,1300,1158,112.3,2348,1254,1094,114.6
'25010, 동구,'035005, 34세,2019,2462,1306,1156,113,2346,1257,1089,115.4
'25010, 동구,'040,35~39세,2019,15765,8231,7534,109.3,15269,8032,7237,111
'25010, 동구,'040001, 35세,2019,2634,1377,1257,109.5,2530,1341,1189,112.8
'25010, 동구,'040002, 36세,2019,2990,1558,1432,108.8,2878,1511,1367,110.5
'25010, 동구,'040003, 37세,2019,3326,1731,1595,108.5,3207,1682,1525,110.3
'25010, 동구,'040004, 38세,2019,3406,1797,1609,111.7,3320,1761,1559,113
'25010, 동구,'040005, 39세,2019,3409,1768,1641,107.7,3334,1737,1597,108.8
'25010, 동구,'045,40~44세,2019,15888,8231,7657,107.5,15503,8045,7458,107.9
'25010, 동구,'045001, 40세,2019,3236,1647,1589,103.7,3142,1602,1540,104
'25010, 동구,'045002, 41세,2019,3097,1625,1472,110.4,3018,1588,1430,111
'25010, 동구,'045003, 42세,2019,3107,1589,1518,104.7,3033,1556,1477,105.3
'25010, 동구,'045004, 43세,2019,3114,1603,1511,106.1,3042,1564,1478,105.8
'25010, 동구,'045005, 44세,2019,3334,1767,1567,112.8,3268,1735,1533,113.2
'25010, 동구,'050,45~49세,2019,18451,9755,8696,112.2,18073,9556,8517,112.2
'25010, 동구,'050001, 45세,2019,3727,2024,1703,118.8,3664,1992,1672,119.1
'25010, 동구,'050002, 46세,2019,3775,1966,1809,108.7,3701,1921,1780,107.9
'25010, 동구,'050003, 47세,2019,3556,1873,1683,111.3,3477,1832,1645,111.4
'25010, 동구,'050004, 48세,2019,3817,2022,1795,112.6,3732,1976,1756,112.5
'25010, 동구,'050005, 49세,2019,3576,1870,1706,109.6,3499,1835,1664,110.3
'25010, 동구,'055,50~54세,2019,18192,9239,8953,103.2,17924,9095,8829,103
'25010, 동구,'055001, 50세,2019,3915,2018,1897,106.4,3856,1988,1868,106.4
'25010, 동구,'055002, 51세,2019,3879,1947,1932,100.8,3824,1913,1911,100.1
'25010, 동구,'055003, 52세,2019,3442,1726,1716,100.6,3389,1701,1688,100.8
'25010, 동구,'055004, 53세,2019,3359,1732,1627,106.5,3310,1704,1606,106.1
'25010, 동구,'055005, 54세,2019,3597,1816,1781,102,3545,1789,1756,101.9
'25010, 동구,'060,55~59세,2019,19064,9535,9529,100.1,18857,9438,9419,100.2
'25010, 동구,'060001, 55세,2019,3226,1648,1578,104.4,3180,1625,1555,104.5
'25010, 동구,'060002, 56세,2019,3446,1793,1653,108.5,3398,1770,1628,108.7
'25010, 동구,'060003, 57세,2019,3797,1927,1870,103,3752,1910,1842,103.7
'25010, 동구,'060004, 58세,2019,4287,2078,2209,94.1,4253,2061,2192,94
'25010, 동구,'060005, 59세,2019,4308,2089,2219,94.1,4274,2072,2202,94.1
'25010, 동구,'065,60~64세,2019,17549,8517,9032,94.3,17417,8451,8966,94.3
'25010, 동구,'065001, 60세,2019,3759,1780,1979,89.9,3729,1768,1961,90.2
'25010, 동구,'065002, 61세,2019,3438,1666,1772,94,3403,1645,1758,93.6
'25010, 동구,'065003, 62세,2019,3557,1780,1777,100.2,3537,1767,1770,99.8
'25010, 동구,'065004, 63세,2019,3431,1668,1763,94.6,3414,1663,1751,95
'25010, 동구,'065005, 64세,2019,3364,1623,1741,93.2,3334,1608,1726,93.2
'25010, 동구,'070,65~69세,2019,12655,6034,6621,91.1,12588,6003,6585,91.2
'25010, 동구,'070001, 65세,2019,2934,1430,1504,95.1,2915,1418,1497,94.7
'25010, 동구,'070002, 66세,2019,2440,1169,1271,92,2422,1165,1257,92.7
'25010, 동구,'070003, 67세,2019,2749,1311,1438,91.2,2737,1306,1431,91.3
'25010, 동구,'070004, 68세,2019,2099,1009,1090,92.6,2088,1002,1086,92.3
'25010, 동구,'070005, 69세,2019,2433,1115,1318,84.6,2426,1112,1314,84.6
'25010, 동구,'075,70~74세,2019,9837,4562,5275,86.5,9814,4547,5267,86.3
'25010, 동구,'075001, 70세,2019,2262,1039,1223,85,2254,1033,1221,84.6
'25010, 동구,'075002, 71세,2019,2183,1041,1142,91.2,2179,1037,1142,90.8
'25010, 동구,'075003, 72세,2019,2104,938,1166,80.4,2095,934,1161,80.4
'25010, 동구,'075004, 73세,2019,1621,767,854,89.8,1620,767,853,89.9
'25010, 동구,'075005, 74세,2019,1667,777,890,87.3,1666,776,890,87.2
'25010, 동구,'080,75~79세,2019,8518,3655,4863,75.2,8508,3649,4859,75.1
'25010, 동구,'080001, 75세,2019,1766,788,978,80.6,1762,785,977,80.3
'25010, 동구,'080002, 76세,2019,1781,789,992,79.5,1777,786,991,79.3
'25010, 동구,'080003, 77세,2019,2061,902,1159,77.8,2060,902,1158,77.9
'25010, 동구,'080004, 78세,2019,1558,655,903,72.5,1557,655,902,72.6
'25010, 동구,'080005, 79세,2019,1352,521,831,62.7,1352,521,831,62.7
'25010, 동구,'085,80~84세,2019,5461,2023,3438,58.8,5456,2021,3435,58.8
'25010, 동구,'085001, 80세,2019,1358,542,816,66.4,1356,541,815,66.4
'25010, 동구,'085002, 81세,2019,1210,453,757,59.8,1208,452,756,59.8
'25010, 동구,'085003, 82세,2019,1054,397,657,60.4,1053,397,656,60.5
'25010, 동구,'085004, 83세,2019,961,334,627,53.3,961,334,627,53.3
'25010, 동구,'085005, 84세,2019,878,297,581,51.1,878,297,581,51.1
'25010, 동구,'086,85세이상,2019,3812,1046,2766,37.8,3804,1042,2762,37.7
'25010, 동구,'090,85~89세,2019,2645,796,1849,43.1,2641,795,1846,43.1
'25010, 동구,'090001, 85세,2019,751,264,487,54.2,750,264,486,54.3
'25010, 동구,'090002, 86세,2019,600,170,430,39.5,598,169,429,39.4
'25010, 동구,'090003, 87세,2019,550,164,386,42.5,550,164,386,42.5
'25010, 동구,'090004, 88세,2019,397,116,281,41.3,397,116,281,41.3
'25010, 동구,'090005, 89세,2019,347,82,265,30.9,346,82,264,31.1
'25010, 동구,'095,90~94세,2019,941,206,735,28,938,204,734,27.8
'25010, 동구,'095001, 90세,2019,291,68,223,30.5,289,66,223,29.6
'25010, 동구,'095002, 91세,2019,248,56,192,29.2,247,56,191,29.3
'25010, 동구,'095003, 92세,2019,199,42,157,26.8,199,42,157,26.8
'25010, 동구,'095004, 93세,2019,107,24,83,28.9,107,24,83,28.9
'25010, 동구,'095005, 94세,2019,96,16,80,20,96,16,80,20
'25010, 동구,'100,95~99세,2019,203,40,163,24.5,202,39,163,23.9
'25010, 동구,'100001, 95세,2019,68,12,56,21.4,68,12,56,21.4
'25010, 동구,'100002, 96세,2019,57,8,49,16.3,57,8,49,16.3
'25010, 동구,'100003, 97세,2019,38,9,29,31,38,9,29,31
'25010, 동구,'100004, 98세,2019,28,6,22,27.3,28,6,22,27.3
'25010, 동구,'100005, 99세,2019,12,5,7,71.4,11,X,7,57.1
'25010, 동구,'101,100세이상,2019,23,X,19,21.1,23,X,19,21.1
'25010, 동구,'102,15세미만,2019,25651,13267,12384,107.1,25495,13175,12320,106.9
'25010, 동구,'103,15~64세,2019,171339,89018,82321,108.1,165070,86060,79010,108.9
'25010, 동구,'104,65세이상,2019,40283,17320,22963,75.4,40170,17262,22908,75.4
'25010, 동구,'126,평균연령,2019,42.7,41.3,44.1,,43,41.6,44.5,
'25010, 동구,'127,중위연령,2019,43.4,41.7,45.2,,44.1,42.3,45.9,
'25020, 중구,'000,합계,2019,234995,115835,119160,97.2,232914,115035,117879,97.6
'25020, 중구,'005,0~4세,2019,7087,3617,3470,104.2,7060,3602,3458,104.2
'25020, 중구,'005001, 0세,2019,1141,564,577,97.7,1138,563,575,97.9
'25020, 중구,'005002, 1세,2019,1203,602,601,100.2,1199,602,597,100.8
'25020, 중구,'005003, 2세,2019,1411,711,700,101.6,1406,708,698,101.4
'25020, 중구,'005004, 3세,2019,1575,805,770,104.5,1565,798,767,104
'25020, 중구,'005005, 4세,2019,1757,935,822,113.7,1752,931,821,113.4
'25020, 중구,'010,5~9세,2019,9501,4848,4653,104.2,9483,4833,4650,103.9
'25020, 중구,'010001, 5세,2019,1705,866,839,103.2,1700,861,839,102.6
'25020, 중구,'010002, 6세,2019,1858,961,897,107.1,1853,957,896,106.8
'25020, 중구,'010003, 7세,2019,1970,998,972,102.7,1968,996,972,102.5
'25020, 중구,'010004, 8세,2019,2004,1037,967,107.2,2002,1035,967,107
'25020, 중구,'010005, 9세,2019,1964,986,978,100.8,1960,984,976,100.8
'25020, 중구,'015,10~14세,2019,10151,5209,4942,105.4,10143,5205,4938,105.4
'25020, 중구,'015001, 10세,2019,1864,957,907,105.5,1862,956,906,105.5
'25020, 중구,'015002, 11세,2019,2137,1130,1007,112.2,2135,1129,1006,112.2
'25020, 중구,'015003, 12세,2019,2186,1144,1042,109.8,2185,1144,1041,109.9
'25020, 중구,'015004, 13세,2019,1955,971,984,98.7,1953,970,983,98.7
'25020, 중구,'015005, 14세,2019,2009,1007,1002,100.5,2008,1006,1002,100.4
'25020, 중구,'020,15~19세,2019,12509,6814,5695,119.6,12477,6802,5675,119.9
'25020, 중구,'020001, 15세,2019,2185,1160,1025,113.2,2185,1160,1025,113.2
'25020, 중구,'020002, 16세,2019,2477,1376,1101,125,2473,1374,1099,125
'25020, 중구,'020003, 17세,2019,2512,1405,1107,126.9,2512,1405,1107,126.9
'25020, 중구,'020004, 18세,2019,2753,1488,1265,117.6,2743,1485,1258,118
'25020, 중구,'020005, 19세,2019,2582,1385,1197,115.7,2564,1378,1186,116.2
'25020, 중구,'025,20~24세,2019,14774,7589,7185,105.6,14618,7544,7074,106.6
'25020, 중구,'025001, 20세,2019,2657,1438,1219,118,2639,1431,1208,118.5
'25020, 중구,'025002, 21세,2019,2740,1485,1255,118.3,2715,1476,1239,119.1
'25020, 중구,'025003, 22세,2019,2965,1525,1440,105.9,2934,1517,1417,107.1
'25020, 중구,'025004, 23세,2019,3234,1600,1634,97.9,3194,1589,1605,99
'25020, 중구,'025005, 24세,2019,3178,1541,1637,94.1,3136,1531,1605,95.4
'25020, 중구,'030,25~29세,2019,15160,7826,7334,106.7,14890,7748,7142,108.5
'25020, 중구,'030001, 25세,2019,3259,1657,1602,103.4,3213,1650,1563,105.6
'25020, 중구,'030002, 26세,2019,3166,1630,1536,106.1,3113,1609,1504,107
'25020, 중구,'030003, 27세,2019,3143,1616,1527,105.8,3077,1604,1473,108.9
'25020, 중구,'030004, 28세,2019,2905,1489,1416,105.2,2853,1470,1383,106.3
'25020, 중구,'030005, 29세,2019,2687,1434,1253,114.4,2634,1415,1219,116.1
'25020, 중구,'035,30~34세,2019,12221,6316,5905,107,11900,6211,5689,109.2
'25020, 중구,'035001, 30세,2019,2513,1331,1182,112.6,2436,1307,1129,115.8
'25020, 중구,'035002, 31세,2019,2434,1280,1154,110.9,2365,1259,1106,113.8
'25020, 중구,'035003, 32세,2019,2450,1235,1215,101.6,2388,1209,1179,102.5
'25020, 중구,'035004, 33세,2019,2414,1261,1153,109.4,2349,1238,1111,111.4
'25020, 중구,'035005, 34세,2019,2410,1209,1201,100.7,2362,1198,1164,102.9
'25020, 중구,'040,35~39세,2019,15512,7804,7708,101.2,15262,7717,7545,102.3
'25020, 중구,'040001, 35세,2019,2534,1288,1246,103.4,2491,1270,1221,104
'25020, 중구,'040002, 36세,2019,2918,1502,1416,106.1,2870,1488,1382,107.7
'25020, 중구,'040003, 37세,2019,3165,1559,1606,97.1,3111,1539,1572,97.9
'25020, 중구,'040004, 38세,2019,3361,1670,1691,98.8,3312,1652,1660,99.5
'25020, 중구,'040005, 39세,2019,3534,1785,1749,102.1,3478,1768,1710,103.4
'25020, 중구,'045,40~44세,2019,16843,8446,8397,100.6,16668,8374,8294,101
'25020, 중구,'045001, 40세,2019,3479,1742,1737,100.3,3450,1730,1720,100.6
'25020, 중구,'045002, 41세,2019,3128,1600,1528,104.7,3098,1589,1509,105.3
'25020, 중구,'045003, 42세,2019,3423,1684,1739,96.8,3381,1667,1714,97.3
'25020, 중구,'045004, 43세,2019,3297,1679,1618,103.8,3266,1666,1600,104.1
'25020, 중구,'045005, 44세,2019,3516,1741,1775,98.1,3473,1722,1751,98.3
'25020, 중구,'050,45~49세,2019,20249,10296,9953,103.4,20055,10217,9838,103.9
'25020, 중구,'050001, 45세,2019,3955,2014,1941,103.8,3919,2001,1918,104.3
'25020, 중구,'050002, 46세,2019,4019,2020,1999,101.1,3983,2001,1982,101
'25020, 중구,'050003, 47세,2019,3983,2029,1954,103.8,3937,2009,1928,104.2
'25020, 중구,'050004, 48세,2019,4250,2162,2088,103.5,4214,2149,2065,104.1
'25020, 중구,'050005, 49세,2019,4042,2071,1971,105.1,4002,2057,1945,105.8
'25020, 중구,'055,50~54세,2019,19908,9945,9963,99.8,19736,9856,9880,99.8
'25020, 중구,'055001, 50세,2019,4368,2220,2148,103.4,4321,2195,2126,103.2
'25020, 중구,'055002, 51세,2019,4214,2057,2157,95.4,4191,2045,2146,95.3
'25020, 중구,'055003, 52세,2019,3915,1941,1974,98.3,3874,1919,1955,98.2
'25020, 중구,'055004, 53세,2019,3635,1864,1771,105.3,3603,1849,1754,105.4
'25020, 중구,'055005, 54세,2019,3776,1863,1913,97.4,3747,1848,1899,97.3
'25020, 중구,'060,55~59세,2019,19701,9666,10035,96.3,19517,9588,9929,96.6
'25020, 중구,'060001, 55세,2019,3525,1803,1722,104.7,3490,1785,1705,104.7
'25020, 중구,'060002, 56세,2019,3605,1777,1828,97.2,3557,1754,1803,97.3
'25020, 중구,'060003, 57세,2019,4014,1995,2019,98.8,3976,1981,1995,99.3
'25020, 중구,'060004, 58세,2019,4301,2083,2218,93.9,4274,2076,2198,94.4
'25020, 중구,'060005, 59세,2019,4256,2008,2248,89.3,4220,1992,2228,89.4
'25020, 중구,'065,60~64세,2019,18325,8809,9516,92.6,18187,8747,9440,92.7
'25020, 중구,'065001, 60세,2019,3857,1844,2013,91.6,3835,1834,2001,91.7
'25020, 중구,'065002, 61세,2019,3620,1762,1858,94.8,3582,1746,1836,95.1
'25020, 중구,'065003, 62세,2019,3681,1829,1852,98.8,3660,1820,1840,98.9
'25020, 중구,'065004, 63세,2019,3529,1658,1871,88.6,3500,1642,1858,88.4
'25020, 중구,'065005, 64세,2019,3638,1716,1922,89.3,3610,1705,1905,89.5
'25020, 중구,'070,65~69세,2019,13399,6187,7212,85.8,13316,6150,7166,85.8
'25020, 중구,'070001, 65세,2019,3194,1422,1772,80.2,3157,1406,1751,80.3
'25020, 중구,'070002, 66세,2019,2627,1250,1377,90.8,2609,1241,1368,90.7
'25020, 중구,'070003, 67세,2019,2951,1386,1565,88.6,2940,1382,1558,88.7
'25020, 중구,'070004, 68세,2019,2134,1003,1131,88.7,2124,998,1126,88.6
'25020, 중구,'070005, 69세,2019,2493,1126,1367,82.4,2486,1123,1363,82.4
'25020, 중구,'075,70~74세,2019,10987,5112,5875,87,10956,5097,5859,87
'25020, 중구,'075001, 70세,2019,2597,1216,1381,88.1,2589,1212,1377,88
'25020, 중구,'075002, 71세,2019,2444,1165,1279,91.1,2440,1163,1277,91.1
'25020, 중구,'075003, 72세,2019,2278,1038,1240,83.7,2267,1033,1234,83.7
'25020, 중구,'075004, 73세,2019,1877,877,1000,87.7,1871,875,996,87.9
'25020, 중구,'075005, 74세,2019,1791,816,975,83.7,1789,814,975,83.5
'25020, 중구,'080,75~79세,2019,8850,3819,5031,75.9,8844,3818,5026,76
'25020, 중구,'080001, 75세,2019,1827,826,1001,82.5,1827,826,1001,82.5
'25020, 중구,'080002, 76세,2019,1776,759,1017,74.6,1774,759,1015,74.8
'25020, 중구,'080003, 77세,2019,2242,973,1269,76.7,2239,972,1267,76.7
'25020, 중구,'080004, 78세,2019,1596,664,932,71.2,1596,664,932,71.2
'25020, 중구,'080005, 79세,2019,1409,597,812,73.5,1408,597,811,73.6
'25020, 중구,'085,80~84세,2019,5960,2377,3583,66.3,5949,2374,3575,66.4
'25020, 중구,'085001, 80세,2019,1463,619,844,73.3,1461,618,843,73.3
'25020, 중구,'085002, 81세,2019,1392,584,808,72.3,1390,584,806,72.5
'25020, 중구,'085003, 82세,2019,1141,438,703,62.3,1138,437,701,62.3
'25020, 중구,'085004, 83세,2019,1066,403,663,60.8,1065,403,662,60.9
'25020, 중구,'085005, 84세,2019,898,333,565,58.9,895,332,563,59
'25020, 중구,'086,85세이상,2019,3858,1155,2703,42.7,3853,1152,2701,42.7
'25020, 중구,'090,85~89세,2019,2726,871,1855,47,2722,869,1853,46.9
'25020, 중구,'090001, 85세,2019,752,253,499,50.7,750,252,498,50.6
'25020, 중구,'090002, 86세,2019,630,212,418,50.7,630,212,418,50.7
'25020, 중구,'090003, 87세,2019,553,179,374,47.9,551,178,373,47.7
'25020, 중구,'090004, 88세,2019,430,131,299,43.8,430,131,299,43.8
'25020, 중구,'090005, 89세,2019,361,96,265,36.2,361,96,265,36.2
'25020, 중구,'095,90~94세,2019,907,231,676,34.2,906,230,676,34
'25020, 중구,'095001, 90세,2019,280,72,208,34.6,280,72,208,34.6
'25020, 중구,'095002, 91세,2019,229,59,170,34.7,228,58,170,34.1
'25020, 중구,'095003, 92세,2019,183,49,134,36.6,183,49,134,36.6
'25020, 중구,'095004, 93세,2019,113,24,89,27,113,24,89,27
'25020, 중구,'095005, 94세,2019,102,27,75,36,102,27,75,36
'25020, 중구,'100,95~99세,2019,206,51,155,32.9,206,51,155,32.9
'25020, 중구,'100001, 95세,2019,80,18,62,29,80,18,62,29
'25020, 중구,'100002, 96세,2019,53,12,41,29.3,53,12,41,29.3
'25020, 중구,'100003, 97세,2019,36,8,28,28.6,36,8,28,28.6
'25020, 중구,'100004, 98세,2019,25,9,16,56.3,25,9,16,56.3
'25020, 중구,'100005, 99세,2019,12,X,8,50,12,X,8,50
'25020, 중구,'101,100세이상,2019,19,X,17,11.8,19,X,17,11.8
'25020, 중구,'102,15세미만,2019,26739,13674,13065,104.7,26686,13640,13046,104.6
'25020, 중구,'103,15~64세,2019,165202,83511,81691,102.2,163310,82804,80506,102.9
'25020, 중구,'104,65세이상,2019,43054,18650,24404,76.4,42918,18591,24327,76.4
'25020, 중구,'126,평균연령,2019,44.2,42.9,45.4,,44.2,42.9,45.5,
'25020, 중구,'127,중위연령,2019,45.9,44.7,47.2,,46,44.7,47.3,
'25030, 서구,'000,합계,2019,480920,236242,244678,96.6,476257,234264,241993,96.8
'25030, 서구,'005,0~4세,2019,17893,9228,8665,106.5,17828,9194,8634,106.5
'25030, 서구,'005001, 0세,2019,2886,1496,1390,107.6,2874,1487,1387,107.2
'25030, 서구,'005002, 1세,2019,3147,1591,1556,102.2,3135,1584,1551,102.1
'25030, 서구,'005003, 2세,2019,3510,1813,1697,106.8,3498,1806,1692,106.7
'25030, 서구,'005004, 3세,2019,4093,2169,1924,112.7,4081,2164,1917,112.9
'25030, 서구,'005005, 4세,2019,4257,2159,2098,102.9,4240,2153,2087,103.2
'25030, 서구,'010,5~9세,2019,22170,11344,10826,104.8,22135,11327,10808,104.8
'25030, 서구,'010001, 5세,2019,4100,2103,1997,105.3,4094,2099,1995,105.2
'25030, 서구,'010002, 6세,2019,4402,2251,2151,104.6,4392,2245,2147,104.6
'25030, 서구,'010003, 7세,2019,4557,2385,2172,109.8,4550,2383,2167,110
'25030, 서구,'010004, 8세,2019,4680,2368,2312,102.4,4674,2366,2308,102.5
'25030, 서구,'010005, 9세,2019,4431,2237,2194,102,4425,2234,2191,102
'25030, 서구,'015,10~14세,2019,23130,11939,11191,106.7,23102,11926,11176,106.7
'25030, 서구,'015001, 10세,2019,4363,2283,2080,109.8,4354,2279,2075,109.8
'25030, 서구,'015002, 11세,2019,4625,2372,2253,105.3,4618,2368,2250,105.2
'25030, 서구,'015003, 12세,2019,4979,2546,2433,104.6,4976,2545,2431,104.7
'25030, 서구,'015004, 13세,2019,4580,2355,2225,105.8,4578,2354,2224,105.8
'25030, 서구,'015005, 14세,2019,4583,2383,2200,108.3,4576,2380,2196,108.4
'25030, 서구,'020,15~19세,2019,29561,14989,14572,102.9,29380,14898,14482,102.9
'25030, 서구,'020001, 15세,2019,5142,2657,2485,106.9,5136,2654,2482,106.9
'25030, 서구,'020002, 16세,2019,5105,2499,2606,95.9,5099,2495,2604,95.8
'25030, 서구,'020003, 17세,2019,5241,2700,2541,106.3,5230,2695,2535,106.3
'25030, 서구,'020004, 18세,2019,6260,3207,3053,105,6220,3187,3033,105.1
'25030, 서구,'020005, 19세,2019,7813,3926,3887,101,7695,3867,3828,101
'25030, 서구,'025,20~24세,2019,38481,19331,19150,100.9,37734,19067,18667,102.1
'25030, 서구,'025001, 20세,2019,7170,3489,3681,94.8,7059,3449,3610,95.5
'25030, 서구,'025002, 21세,2019,7405,3544,3861,91.8,7263,3495,3768,92.8
'25030, 서구,'025003, 22세,2019,7891,3790,4101,92.4,7725,3735,3990,93.6
'25030, 서구,'025004, 23세,2019,8014,4151,3863,107.5,7846,4083,3763,108.5
'25030, 서구,'025005, 24세,2019,8001,4357,3644,119.6,7841,4305,3536,121.7
'25030, 서구,'030,25~29세,2019,37232,19008,18224,104.3,36490,18740,17750,105.6
'25030, 서구,'030001, 25세,2019,7974,4173,3801,109.8,7803,4111,3692,111.3
'25030, 서구,'030002, 26세,2019,7709,3993,3716,107.5,7551,3943,3608,109.3
'25030, 서구,'030003, 27세,2019,7771,3926,3845,102.1,7626,3869,3757,103
'25030, 서구,'030004, 28세,2019,7005,3487,3518,99.1,6878,3440,3438,100.1
'25030, 서구,'030005, 29세,2019,6773,3429,3344,102.5,6632,3377,3255,103.7
'25030, 서구,'035,30~34세,2019,31315,16197,15118,107.1,30613,15894,14719,108
'25030, 서구,'035001, 30세,2019,6413,3377,3036,111.2,6270,3310,2960,111.8
'25030, 서구,'035002, 31세,2019,6222,3224,2998,107.5,6065,3160,2905,108.8
'25030, 서구,'035003, 32세,2019,6175,3147,3028,103.9,6023,3075,2948,104.3
'25030, 서구,'035004, 33세,2019,6185,3204,2981,107.5,6053,3154,2899,108.8
'25030, 서구,'035005, 34세,2019,6320,3245,3075,105.5,6202,3195,3007,106.3
'25030, 서구,'040,35~39세,2019,36275,18028,18247,98.8,35789,17818,17971,99.1
'25030, 서구,'040001, 35세,2019,6344,3165,3179,99.6,6247,3123,3124,100
'25030, 서구,'040002, 36세,2019,7043,3542,3501,101.2,6942,3502,3440,101.8
'25030, 서구,'040003, 37세,2019,7693,3837,3856,99.5,7584,3798,3786,100.3
'25030, 서구,'040004, 38세,2019,7456,3702,3754,98.6,7366,3655,3711,98.5
'25030, 서구,'040005, 39세,2019,7739,3782,3957,95.6,7650,3740,3910,95.7
'25030, 서구,'045,40~44세,2019,36031,17453,18578,93.9,35640,17280,18360,94.1
'25030, 서구,'045001, 40세,2019,7296,3611,3685,98,7212,3577,3635,98.4
'25030, 서구,'045002, 41세,2019,6934,3385,3549,95.4,6854,3341,3513,95.1
'25030, 서구,'045003, 42세,2019,7204,3470,3734,92.9,7131,3441,3690,93.3
'25030, 서구,'045004, 43세,2019,7063,3337,3726,89.6,6978,3304,3674,89.9
'25030, 서구,'045005, 44세,2019,7534,3650,3884,94,7465,3617,3848,94
'25030, 서구,'050,45~49세,2019,43006,20777,22229,93.5,42630,20588,22042,93.4
'25030, 서구,'050001, 45세,2019,8306,3910,4396,88.9,8237,3878,4359,89
'25030, 서구,'050002, 46세,2019,8428,4056,4372,92.8,8366,4023,4343,92.6
'25030, 서구,'050003, 47세,2019,8325,4045,4280,94.5,8237,4001,4236,94.5
'25030, 서구,'050004, 48세,2019,9305,4532,4773,95,9231,4494,4737,94.9
'25030, 서구,'050005, 49세,2019,8642,4234,4408,96.1,8559,4192,4367,96
'25030, 서구,'055,50~54세,2019,40428,19541,20887,93.6,40108,19394,20714,93.6
'25030, 서구,'055001, 50세,2019,9074,4367,4707,92.8,9011,4336,4675,92.7
'25030, 서구,'055002, 51세,2019,8974,4303,4671,92.1,8892,4261,4631,92
'25030, 서구,'055003, 52세,2019,7671,3665,4006,91.5,7620,3645,3975,91.7
'25030, 서구,'055004, 53세,2019,7127,3507,3620,96.9,7059,3478,3581,97.1
'25030, 서구,'055005, 54세,2019,7582,3699,3883,95.3,7526,3674,3852,95.4
'25030, 서구,'060,55~59세,2019,37777,18357,19420,94.5,37525,18236,19289,94.5
'25030, 서구,'060001, 55세,2019,6861,3288,3573,92,6807,3260,3547,91.9
'25030, 서구,'060002, 56세,2019,7141,3552,3589,99,7079,3524,3555,99.1
'25030, 서구,'060003, 57세,2019,7564,3735,3829,97.5,7513,3707,3806,97.4
'25030, 서구,'060004, 58세,2019,8326,4012,4314,93,8289,3996,4293,93.1
'25030, 서구,'060005, 59세,2019,7885,3770,4115,91.6,7837,3749,4088,91.7
'25030, 서구,'065,60~64세,2019,31069,15173,15896,95.5,30891,15084,15807,95.4
'25030, 서구,'065001, 60세,2019,6903,3352,3551,94.4,6878,3342,3536,94.5
'25030, 서구,'065002, 61세,2019,6368,3139,3229,97.2,6329,3114,3215,96.9
'25030, 서구,'065003, 62세,2019,6285,3071,3214,95.6,6247,3052,3195,95.5
'25030, 서구,'065004, 63세,2019,5743,2827,2916,96.9,5700,2809,2891,97.2
'25030, 서구,'065005, 64세,2019,5770,2784,2986,93.2,5737,2767,2970,93.2
'25030, 서구,'070,65~69세,2019,19738,9597,10141,94.6,19649,9558,10091,94.7
'25030, 서구,'070001, 65세,2019,4769,2293,2476,92.6,4741,2279,2462,92.6
'25030, 서구,'070002, 66세,2019,4017,1971,2046,96.3,3999,1964,2035,96.5
'25030, 서구,'070003, 67세,2019,4214,2073,2141,96.8,4199,2066,2133,96.9
'25030, 서구,'070004, 68세,2019,3192,1515,1677,90.3,3174,1509,1665,90.6
'25030, 서구,'070005, 69세,2019,3546,1745,1801,96.9,3536,1740,1796,96.9
'25030, 서구,'075,70~74세,2019,13753,6513,7240,90,13713,6505,7208,90.2
'25030, 서구,'075001, 70세,2019,3295,1629,1666,97.8,3279,1626,1653,98.4
'25030, 서구,'075002, 71세,2019,3127,1456,1671,87.1,3120,1455,1665,87.4
'25030, 서구,'075003, 72세,2019,2912,1380,1532,90.1,2908,1379,1529,90.2
'25030, 서구,'075004, 73세,2019,2275,1077,1198,89.9,2264,1075,1189,90.4
'25030, 서구,'075005, 74세,2019,2144,971,1173,82.8,2142,970,1172,82.8
'25030, 서구,'080,75~79세,2019,10653,4645,6008,77.3,10638,4640,5998,77.4
'25030, 서구,'080001, 75세,2019,2243,960,1283,74.8,2239,960,1279,75.1
'25030, 서구,'080002, 76세,2019,2157,959,1198,80.1,2155,957,1198,79.9
'25030, 서구,'080003, 77세,2019,2630,1180,1450,81.4,2629,1179,1450,81.3
'25030, 서구,'080004, 78세,2019,1965,842,1123,75,1961,842,1119,75.2
'25030, 서구,'080005, 79세,2019,1658,704,954,73.8,1654,702,952,73.7
'25030, 서구,'085,80~84세,2019,7264,2724,4540,60,7257,2721,4536,60
'25030, 서구,'085001, 80세,2019,1853,723,1130,64,1851,722,1129,64
'25030, 서구,'085002, 81세,2019,1575,611,964,63.4,1573,610,963,63.3
'25030, 서구,'085003, 82세,2019,1396,542,854,63.5,1393,541,852,63.5
'25030, 서구,'085004, 83세,2019,1252,420,832,50.5,1252,420,832,50.5
'25030, 서구,'085005, 84세,2019,1188,428,760,56.3,1188,428,760,56.3
'25030, 서구,'086,85세이상,2019,5144,1398,3746,37.3,5135,1394,3741,37.3
'25030, 서구,'090,85~89세,2019,3579,1043,2536,41.1,3574,1041,2533,41.1
'25030, 서구,'090001, 85세,2019,1032,337,695,48.5,1029,335,694,48.3
'25030, 서구,'090002, 86세,2019,821,259,562,46.1,820,259,561,46.2
'25030, 서구,'090003, 87세,2019,737,215,522,41.2,737,215,522,41.2
'25030, 서구,'090004, 88세,2019,509,124,385,32.2,508,124,384,32.3
'25030, 서구,'090005, 89세,2019,480,108,372,29,480,108,372,29
'25030, 서구,'095,90~94세,2019,1244,291,953,30.5,1241,289,952,30.4
'25030, 서구,'095001, 90세,2019,372,82,290,28.3,371,81,290,27.9
'25030, 서구,'095002, 91세,2019,332,75,257,29.2,332,75,257,29.2
'25030, 서구,'095003, 92세,2019,242,65,177,36.7,241,65,176,36.9
'25030, 서구,'095004, 93세,2019,163,47,116,40.5,163,47,116,40.5
'25030, 서구,'095005, 94세,2019,135,22,113,19.5,134,21,113,18.6
'25030, 서구,'100,95~99세,2019,277,53,224,23.7,276,53,223,23.8
'25030, 서구,'100001, 95세,2019,88,14,74,18.9,88,14,74,18.9
'25030, 서구,'100002, 96세,2019,87,16,71,22.5,87,16,71,22.5
'25030, 서구,'100003, 97세,2019,59,15,44,34.1,59,15,44,34.1
'25030, 서구,'100004, 98세,2019,21,7,14,50,21,7,14,50
'25030, 서구,'100005, 99세,2019,22,X,21,4.8,21,X,20,5
'25030, 서구,'101,100세이상,2019,44,11,33,33.3,44,11,33,33.3
'25030, 서구,'102,15세미만,2019,63193,32511,30682,106,63065,32447,30618,106
'25030, 서구,'103,15~64세,2019,361175,178854,182321,98.1,356800,176999,179801,98.4
'25030, 서구,'104,65세이상,2019,56552,24877,31675,78.5,56392,24818,31574,78.6
'25030, 서구,'126,평균연령,2019,40.2,39.2,41,,40.2,39.2,41.1,
'25030, 서구,'127,중위연령,2019,40.6,39.5,41.7,,40.7,39.5,41.9,
'25040, 유성구,'000,합계,2019,366544,189078,177466,106.5,357945,184541,173404,106.4
'25040, 유성구,'005,0~4세,2019,17212,8903,8309,107.1,16795,8689,8106,107.2
'25040, 유성구,'005001, 0세,2019,2716,1407,1309,107.5,2653,1377,1276,107.9
'25040, 유성구,'005002, 1세,2019,3025,1592,1433,111.1,2944,1545,1399,110.4
'25040, 유성구,'005003, 2세,2019,3496,1780,1716,103.7,3400,1738,1662,104.6
'25040, 유성구,'005004, 3세,2019,3873,2024,1849,109.5,3780,1969,1811,108.7
'25040, 유성구,'005005, 4세,2019,4102,2100,2002,104.9,4018,2060,1958,105.2
'25040, 유성구,'010,5~9세,2019,19813,10223,9590,106.6,19567,10113,9454,107
'25040, 유성구,'010001, 5세,2019,3898,2023,1875,107.9,3820,1983,1837,107.9
'25040, 유성구,'010002, 6세,2019,3949,2000,1949,102.6,3898,1976,1922,102.8
'25040, 유성구,'010003, 7세,2019,4100,2129,1971,108,4052,2108,1944,108.4
'25040, 유성구,'010004, 8세,2019,4064,2127,1937,109.8,4027,2109,1918,110
'25040, 유성구,'010005, 9세,2019,3802,1944,1858,104.6,3770,1937,1833,105.7
'25040, 유성구,'015,10~14세,2019,18517,9597,8920,107.6,18394,9534,8860,107.6
'25040, 유성구,'015001, 10세,2019,3652,1838,1814,101.3,3623,1825,1798,101.5
'25040, 유성구,'015002, 11세,2019,3818,1974,1844,107,3795,1960,1835,106.8
'25040, 유성구,'015003, 12세,2019,3951,1991,1960,101.6,3921,1976,1945,101.6
'25040, 유성구,'015004, 13세,2019,3612,1918,1694,113.2,3586,1906,1680,113.5
'25040, 유성구,'015005, 14세,2019,3484,1876,1608,116.7,3469,1867,1602,116.5
'25040, 유성구,'020,15~19세,2019,22988,12574,10414,120.7,22631,12362,10269,120.4
'25040, 유성구,'020001, 15세,2019,3815,2020,1795,112.5,3803,2011,1792,112.2
'25040, 유성구,'020002, 16세,2019,3556,1893,1663,113.8,3545,1888,1657,113.9
'25040, 유성구,'020003, 17세,2019,3749,2030,1719,118.1,3722,2010,1712,117.4
'25040, 유성구,'020004, 18세,2019,4946,2741,2205,124.3,4858,2681,2177,123.2
'25040, 유성구,'020005, 19세,2019,6922,3890,3032,128.3,6703,3772,2931,128.7
'25040, 유성구,'025,20~24세,2019,33040,18170,14870,122.2,31224,17234,13990,123.2
'25040, 유성구,'025001, 20세,2019,6353,3319,3034,109.4,6071,3175,2896,109.6
'25040, 유성구,'025002, 21세,2019,6267,3334,2933,113.7,5932,3158,2774,113.8
'25040, 유성구,'025003, 22세,2019,6673,3594,3079,116.7,6297,3404,2893,117.7
'25040, 유성구,'025004, 23세,2019,6971,3930,3041,129.2,6566,3709,2857,129.8
'25040, 유성구,'025005, 24세,2019,6776,3993,2783,143.5,6358,3788,2570,147.4
'25040, 유성구,'030,25~29세,2019,30783,17814,12969,137.4,29287,17040,12247,139.1
'25040, 유성구,'030001, 25세,2019,6586,3967,2619,151.5,6263,3800,2463,154.3
'25040, 유성구,'030002, 26세,2019,6392,3761,2631,142.9,6118,3625,2493,145.4
'25040, 유성구,'030003, 27세,2019,6297,3617,2680,135,5992,3468,2524,137.4
'25040, 유성구,'030004, 28세,2019,5845,3272,2573,127.2,5551,3110,2441,127.4
'25040, 유성구,'030005, 29세,2019,5663,3197,2466,129.6,5363,3037,2326,130.6
'25040, 유성구,'035,30~34세,2019,27679,14975,12704,117.9,26381,14247,12134,117.4
'25040, 유성구,'035001, 30세,2019,5662,3167,2495,126.9,5368,2999,2369,126.6
'25040, 유성구,'035002, 31세,2019,5470,3037,2433,124.8,5154,2863,2291,125
'25040, 유성구,'035003, 32세,2019,5452,2904,2548,114,5201,2767,2434,113.7
'25040, 유성구,'035004, 33세,2019,5571,2960,2611,113.4,5326,2817,2509,112.3
'25040, 유성구,'035005, 34세,2019,5524,2907,2617,111.1,5332,2801,2531,110.7
'25040, 유성구,'040,35~39세,2019,31261,15940,15321,104,30424,15473,14951,103.5
'25040, 유성구,'040001, 35세,2019,5601,2974,2627,113.2,5408,2862,2546,112.4
'25040, 유성구,'040002, 36세,2019,6117,3138,2979,105.3,5936,3033,2903,104.5
'25040, 유성구,'040003, 37세,2019,6532,3289,3243,101.4,6370,3208,3162,101.5
'25040, 유성구,'040004, 38세,2019,6587,3293,3294,100,6437,3210,3227,99.5
'25040, 유성구,'040005, 39세,2019,6424,3246,3178,102.1,6273,3160,3113,101.5
'25040, 유성구,'045,40~44세,2019,29192,14480,14712,98.4,28622,14171,14451,98.1
'25040, 유성구,'045001, 40세,2019,5962,2900,3062,94.7,5805,2821,2984,94.5
'25040, 유성구,'045002, 41세,2019,5814,2840,2974,95.5,5690,2768,2922,94.7
'25040, 유성구,'045003, 42세,2019,5868,2942,2926,100.5,5764,2882,2882,100
'25040, 유성구,'045004, 43세,2019,5671,2856,2815,101.5,5577,2812,2765,101.7
'25040, 유성구,'045005, 44세,2019,5877,2942,2935,100.2,5786,2888,2898,99.7
'25040, 유성구,'050,45~49세,2019,31737,15806,15931,99.2,31271,15554,15717,99
'25040, 유성구,'050001, 45세,2019,6271,3100,3171,97.8,6169,3044,3125,97.4
'25040, 유성구,'050002, 46세,2019,6405,3091,3314,93.3,6319,3042,3277,92.8
'25040, 유성구,'050003, 47세,2019,6197,3143,3054,102.9,6114,3095,3019,102.5
'25040, 유성구,'050004, 48세,2019,6576,3339,3237,103.2,6485,3291,3194,103
'25040, 유성구,'050005, 49세,2019,6288,3133,3155,99.3,6184,3082,3102,99.4
'25040, 유성구,'055,50~54세,2019,28204,14100,14104,100,27836,13909,13927,99.9
'25040, 유성구,'055001, 50세,2019,6251,3056,3195,95.6,6173,3016,3157,95.5
'25040, 유성구,'055002, 51세,2019,6207,3101,3106,99.8,6136,3062,3074,99.6
'25040, 유성구,'055003, 52세,2019,5507,2772,2735,101.4,5424,2733,2691,101.6
'25040, 유성구,'055004, 53세,2019,5046,2627,2419,108.6,4974,2590,2384,108.6
'25040, 유성구,'055005, 54세,2019,5193,2544,2649,96,5129,2508,2621,95.7
'25040, 유성구,'060,55~59세,2019,25407,12842,12565,102.2,25151,12719,12432,102.3
'25040, 유성구,'060001, 55세,2019,4812,2411,2401,100.4,4749,2384,2365,100.8
'25040, 유성구,'060002, 56세,2019,4983,2604,2379,109.5,4907,2558,2349,108.9
'25040, 유성구,'060003, 57세,2019,5045,2586,2459,105.2,4993,2561,2432,105.3
'25040, 유성구,'060004, 58세,2019,5468,2750,2718,101.2,5445,2741,2704,101.4
'25040, 유성구,'060005, 59세,2019,5099,2491,2608,95.5,5057,2475,2582,95.9
'25040, 유성구,'065,60~64세,2019,19412,9837,9575,102.7,19233,9760,9473,103
'25040, 유성구,'065001, 60세,2019,4522,2293,2229,102.9,4473,2273,2200,103.3
'25040, 유성구,'065002, 61세,2019,4028,2008,2020,99.4,3988,1992,1996,99.8
'25040, 유성구,'065003, 62세,2019,3898,2015,1883,107,3860,2003,1857,107.9
'25040, 유성구,'065004, 63세,2019,3472,1762,1710,103,3441,1744,1697,102.8
'25040, 유성구,'065005, 64세,2019,3492,1759,1733,101.5,3471,1748,1723,101.5
'25040, 유성구,'070,65~69세,2019,11114,5647,5467,103.3,11026,5607,5419,103.5
'25040, 유성구,'070001, 65세,2019,2805,1413,1392,101.5,2776,1399,1377,101.6
'25040, 유성구,'070002, 66세,2019,2355,1226,1129,108.6,2336,1215,1121,108.4
'25040, 유성구,'070003, 67세,2019,2413,1227,1186,103.5,2400,1223,1177,103.9
'25040, 유성구,'070004, 68세,2019,1676,847,829,102.2,1661,842,819,102.8
'25040, 유성구,'070005, 69세,2019,1865,934,931,100.3,1853,928,925,100.3
'25040, 유성구,'075,70~74세,2019,7185,3514,3671,95.7,7146,3493,3653,95.6
'25040, 유성구,'075001, 70세,2019,1741,894,847,105.5,1726,886,840,105.5
'25040, 유성구,'075002, 71세,2019,1671,828,843,98.2,1666,825,841,98.1
'25040, 유성구,'075003, 72세,2019,1478,710,768,92.4,1470,706,764,92.4
'25040, 유성구,'075004, 73세,2019,1121,542,579,93.6,1114,538,576,93.4
'25040, 유성구,'075005, 74세,2019,1174,540,634,85.2,1170,538,632,85.1
'25040, 유성구,'080,75~79세,2019,5649,2386,3263,73.1,5622,2374,3248,73.1
'25040, 유성구,'080001, 75세,2019,1190,519,671,77.3,1185,517,668,77.4
'25040, 유성구,'080002, 76세,2019,1113,464,649,71.5,1106,461,645,71.5
'25040, 유성구,'080003, 77세,2019,1371,610,761,80.2,1366,608,758,80.2
'25040, 유성구,'080004, 78세,2019,1046,411,635,64.7,1043,410,633,64.8
'25040, 유성구,'080005, 79세,2019,929,382,547,69.8,922,378,544,69.5
'25040, 유성구,'085,80~84세,2019,4075,1399,2676,52.3,4065,1395,2670,52.2
'25040, 유성구,'085001, 80세,2019,927,355,572,62.1,922,354,568,62.3
'25040, 유성구,'085002, 81세,2019,890,320,570,56.1,889,319,570,56
'25040, 유성구,'085003, 82세,2019,818,310,508,61,817,309,508,60.8
'25040, 유성구,'085004, 83세,2019,764,231,533,43.3,763,231,532,43.4
'25040, 유성구,'085005, 84세,2019,676,183,493,37.1,674,182,492,37
'25040, 유성구,'086,85세이상,2019,3276,871,2405,36.2,3270,867,2403,36.1
'25040, 유성구,'090,85~89세,2019,2229,627,1602,39.1,2226,624,1602,39
'25040, 유성구,'090001, 85세,2019,601,178,423,42.1,600,177,423,41.8
'25040, 유성구,'090002, 86세,2019,526,156,370,42.2,524,154,370,41.6
'25040, 유성구,'090003, 87세,2019,467,132,335,39.4,467,132,335,39.4
'25040, 유성구,'090004, 88세,2019,333,81,252,32.1,333,81,252,32.1
'25040, 유성구,'090005, 89세,2019,302,80,222,36,302,80,222,36
'25040, 유성구,'095,90~94세,2019,842,204,638,32,840,203,637,31.9
'25040, 유성구,'095001, 90세,2019,268,67,201,33.3,267,66,201,32.8
'25040, 유성구,'095002, 91세,2019,220,50,170,29.4,219,50,169,29.6
'25040, 유성구,'095003, 92세,2019,162,37,125,29.6,162,37,125,29.6
'25040, 유성구,'095004, 93세,2019,105,28,77,36.4,105,28,77,36.4
'25040, 유성구,'095005, 94세,2019,87,22,65,33.8,87,22,65,33.8
'25040, 유성구,'100,95~99세,2019,189,38,151,25.2,188,38,150,25.3
'25040, 유성구,'100001, 95세,2019,56,14,42,33.3,56,14,42,33.3
'25040, 유성구,'100002, 96세,2019,52,12,40,30,52,12,40,30
'25040, 유성구,'100003, 97세,2019,42,6,36,16.7,41,6,35,17.1
'25040, 유성구,'100004, 98세,2019,23,5,18,27.8,23,5,18,27.8
'25040, 유성구,'100005, 99세,2019,16,X,15,6.7,16,X,15,6.7
'25040, 유성구,'101,100세이상,2019,16,X,14,14.3,16,X,14,14.3
'25040, 유성구,'102,15세미만,2019,55542,28723,26819,107.1,54756,28336,26420,107.3
'25040, 유성구,'103,15~64세,2019,279703,146538,133165,110,272060,142469,129591,109.9
'25040, 유성구,'104,65세이상,2019,31299,13817,17482,79,31129,13736,17393,79
'25040, 유성구,'126,평균연령,2019,37.5,36.5,38.5,,37.6,36.6,38.7,
'25040, 유성구,'127,중위연령,2019,37.2,35.8,38.6,,37.5,36.1,38.9,
'25050, 대덕구,'000,합계,2019,179107,90825,88282,102.9,175841,89184,86657,102.9
'25050, 대덕구,'005,0~4세,2019,5128,2530,2598,97.4,5087,2513,2574,97.6
'25050, 대덕구,'005001, 0세,2019,834,387,447,86.6,827,384,443,86.7
'25050, 대덕구,'005002, 1세,2019,903,421,482,87.3,895,418,477,87.6
'25050, 대덕구,'005003, 2세,2019,1043,548,495,110.7,1033,544,489,111.2
'25050, 대덕구,'005004, 3세,2019,1138,556,582,95.5,1129,552,577,95.7
'25050, 대덕구,'005005, 4세,2019,1210,618,592,104.4,1203,615,588,104.6
'25050, 대덕구,'010,5~9세,2019,6842,3557,3285,108.3,6815,3540,3275,108.1
'25050, 대덕구,'010001, 5세,2019,1265,673,592,113.7,1260,671,589,113.9
'25050, 대덕구,'010002, 6세,2019,1303,649,654,99.2,1295,645,650,99.2
'25050, 대덕구,'010003, 7세,2019,1386,730,656,111.3,1380,726,654,111
'25050, 대덕구,'010004, 8세,2019,1464,751,713,105.3,1459,747,712,104.9
'25050, 대덕구,'010005, 9세,2019,1424,754,670,112.5,1421,751,670,112.1
'25050, 대덕구,'015,10~14세,2019,7611,3950,3661,107.9,7592,3939,3653,107.8
'25050, 대덕구,'015001, 10세,2019,1484,769,715,107.6,1480,767,713,107.6
'25050, 대덕구,'015002, 11세,2019,1493,758,735,103.1,1489,755,734,102.9
'25050, 대덕구,'015003, 12세,2019,1643,861,782,110.1,1638,858,780,110
'25050, 대덕구,'015004, 13세,2019,1489,791,698,113.3,1484,788,696,113.2
'25050, 대덕구,'015005, 14세,2019,1502,771,731,105.5,1501,771,730,105.6
'25050, 대덕구,'020,15~19세,2019,10321,5234,5087,102.9,10205,5181,5024,103.1
'25050, 대덕구,'020001, 15세,2019,1736,949,787,120.6,1734,948,786,120.6
'25050, 대덕구,'020002, 16세,2019,1713,853,860,99.2,1708,851,857,99.3
'25050, 대덕구,'020003, 17세,2019,1790,886,904,98,1781,881,900,97.9
'25050, 대덕구,'020004, 18세,2019,2337,1171,1166,100.4,2294,1149,1145,100.3
'25050, 대덕구,'020005, 19세,2019,2745,1375,1370,100.4,2688,1352,1336,101.2
'25050, 대덕구,'025,20~24세,2019,14695,7769,6926,112.2,14173,7504,6669,112.5
'25050, 대덕구,'025001, 20세,2019,2843,1433,1410,101.6,2741,1396,1345,103.8
'25050, 대덕구,'025002, 21세,2019,2914,1491,1423,104.8,2821,1446,1375,105.2
'25050, 대덕구,'025003, 22세,2019,3072,1593,1479,107.7,2946,1522,1424,106.9
'25050, 대덕구,'025004, 23세,2019,2900,1621,1279,126.7,2810,1574,1236,127.3
'25050, 대덕구,'025005, 24세,2019,2966,1631,1335,122.2,2855,1566,1289,121.5
'25050, 대덕구,'030,25~29세,2019,12382,7177,5205,137.9,11861,6884,4977,138.3
'25050, 대덕구,'030001, 25세,2019,2782,1599,1183,135.2,2673,1532,1141,134.3
'25050, 대덕구,'030002, 26세,2019,2630,1548,1082,143.1,2530,1492,1038,143.7
'25050, 대덕구,'030003, 27세,2019,2553,1445,1108,130.4,2449,1387,1062,130.6
'25050, 대덕구,'030004, 28세,2019,2250,1311,939,139.6,2147,1256,891,141
'25050, 대덕구,'030005, 29세,2019,2167,1274,893,142.7,2062,1217,845,144
'25050, 대덕구,'035,30~34세,2019,9567,5245,4322,121.4,9062,4997,4065,122.9
'25050, 대덕구,'035001, 30세,2019,1978,1125,853,131.9,1865,1074,791,135.8
'25050, 대덕구,'035002, 31세,2019,1942,1070,872,122.7,1833,1016,817,124.4
'25050, 대덕구,'035003, 32세,2019,1853,1043,810,128.8,1757,991,766,129.4
'25050, 대덕구,'035004, 33세,2019,1916,1017,899,113.1,1828,968,860,112.6
'25050, 대덕구,'035005, 34세,2019,1878,990,888,111.5,1779,948,831,114.1
'25050, 대덕구,'040,35~39세,2019,11320,5970,5350,111.6,10929,5757,5172,111.3
'25050, 대덕구,'040001, 35세,2019,1949,1027,922,111.4,1860,980,880,111.4
'25050, 대덕구,'040002, 36세,2019,2138,1161,977,118.8,2059,1114,945,117.9
'25050, 대덕구,'040003, 37세,2019,2306,1227,1079,113.7,2231,1182,1049,112.7
'25050, 대덕구,'040004, 38세,2019,2492,1321,1171,112.8,2410,1281,1129,113.5
'25050, 대덕구,'040005, 39세,2019,2435,1234,1201,102.7,2369,1200,1169,102.7
'25050, 대덕구,'045,40~44세,2019,12343,6290,6053,103.9,12066,6158,5908,104.2
'25050, 대덕구,'045001, 40세,2019,2473,1312,1161,113,2398,1278,1120,114.1
'25050, 대덕구,'045002, 41세,2019,2315,1180,1135,104,2249,1146,1103,103.9
'25050, 대덕구,'045003, 42세,2019,2452,1249,1203,103.8,2407,1226,1181,103.8
'25050, 대덕구,'045004, 43세,2019,2482,1247,1235,101,2433,1223,1210,101.1
'25050, 대덕구,'045005, 44세,2019,2621,1302,1319,98.7,2579,1285,1294,99.3
'25050, 대덕구,'050,45~49세,2019,16029,8132,7897,103,15765,7999,7766,103
'25050, 대덕구,'050001, 45세,2019,3004,1574,1430,110.1,2957,1545,1412,109.4
'25050, 대덕구,'050002, 46세,2019,3104,1555,1549,100.4,3040,1522,1518,100.3
'25050, 대덕구,'050003, 47세,2019,2990,1522,1468,103.7,2938,1498,1440,104
'25050, 대덕구,'050004, 48세,2019,3488,1721,1767,97.4,3439,1700,1739,97.8
'25050, 대덕구,'050005, 49세,2019,3443,1760,1683,104.6,3391,1734,1657,104.6
'25050, 대덕구,'055,50~54세,2019,17005,8645,8360,103.4,16791,8544,8247,103.6
'25050, 대덕구,'055001, 50세,2019,3680,1880,1800,104.4,3615,1845,1770,104.2
'25050, 대덕구,'055002, 51세,2019,3729,1855,1874,99,3690,1841,1849,99.6
'25050, 대덕구,'055003, 52세,2019,3245,1660,1585,104.7,3213,1640,1573,104.3
'25050, 대덕구,'055004, 53세,2019,3083,1576,1507,104.6,3044,1561,1483,105.3
'25050, 대덕구,'055005, 54세,2019,3268,1674,1594,105,3229,1657,1572,105.4
'25050, 대덕구,'060,55~59세,2019,16473,8310,8163,101.8,16311,8239,8072,102.1
'25050, 대덕구,'060001, 55세,2019,3004,1513,1491,101.5,2967,1501,1466,102.4
'25050, 대덕구,'060002, 56세,2019,2954,1517,1437,105.6,2916,1499,1417,105.8
'25050, 대덕구,'060003, 57세,2019,3302,1632,1670,97.7,3272,1617,1655,97.7
'25050, 대덕구,'060004, 58세,2019,3694,1879,1815,103.5,3668,1867,1801,103.7
'25050, 대덕구,'060005, 59세,2019,3519,1769,1750,101.1,3488,1755,1733,101.3
'25050, 대덕구,'065,60~64세,2019,13693,6834,6859,99.6,13607,6790,6817,99.6
'25050, 대덕구,'065001, 60세,2019,3004,1463,1541,94.9,2984,1449,1535,94.4
'25050, 대덕구,'065002, 61세,2019,2795,1428,1367,104.5,2773,1416,1357,104.3
'25050, 대덕구,'065003, 62세,2019,2806,1413,1393,101.4,2786,1406,1380,101.9
'25050, 대덕구,'065004, 63세,2019,2542,1284,1258,102.1,2527,1277,1250,102.2
'25050, 대덕구,'065005, 64세,2019,2546,1246,1300,95.8,2537,1242,1295,95.9
'25050, 대덕구,'070,65~69세,2019,8674,4231,4443,95.2,8612,4210,4402,95.6
'25050, 대덕구,'070001, 65세,2019,2064,970,1094,88.7,2046,967,1079,89.6
'25050, 대덕구,'070002, 66세,2019,1715,829,886,93.6,1699,820,879,93.3
'25050, 대덕구,'070003, 67세,2019,1931,940,991,94.9,1923,938,985,95.2
'25050, 대덕구,'070004, 68세,2019,1435,735,700,105,1424,731,693,105.5
'25050, 대덕구,'070005, 69세,2019,1529,757,772,98.1,1520,754,766,98.4
'25050, 대덕구,'075,70~74세,2019,6283,2944,3339,88.2,6243,2928,3315,88.3
'25050, 대덕구,'075001, 70세,2019,1505,692,813,85.1,1493,688,805,85.5
'25050, 대덕구,'075002, 71세,2019,1414,673,741,90.8,1409,671,738,90.9
'25050, 대덕구,'075003, 72세,2019,1378,621,757,82,1369,618,751,82.3
'25050, 대덕구,'075004, 73세,2019,974,487,487,100,967,484,483,100.2
'25050, 대덕구,'075005, 74세,2019,1012,471,541,87.1,1005,467,538,86.8
'25050, 대덕구,'080,75~79세,2019,5208,2173,3035,71.6,5201,2169,3032,71.5
'25050, 대덕구,'080001, 75세,2019,1024,448,576,77.8,1023,447,576,77.6
'25050, 대덕구,'080002, 76세,2019,1126,474,652,72.7,1125,474,651,72.8
'25050, 대덕구,'080003, 77세,2019,1292,546,746,73.2,1292,546,746,73.2
'25050, 대덕구,'080004, 78세,2019,956,390,566,68.9,954,389,565,68.8
'25050, 대덕구,'080005, 79세,2019,810,315,495,63.6,807,313,494,63.4
'25050, 대덕구,'085,80~84세,2019,3416,1280,2136,59.9,3406,1278,2128,60.1
'25050, 대덕구,'085001, 80세,2019,843,314,529,59.4,839,313,526,59.5
'25050, 대덕구,'085002, 81세,2019,762,321,441,72.8,761,321,440,73
'25050, 대덕구,'085003, 82세,2019,676,252,424,59.4,673,252,421,59.9
'25050, 대덕구,'085004, 83세,2019,587,206,381,54.1,586,205,381,53.8
'25050, 대덕구,'085005, 84세,2019,548,187,361,51.8,547,187,360,51.9
'25050, 대덕구,'086,85세이상,2019,2117,554,1563,35.4,2115,554,1561,35.5
'25050, 대덕구,'090,85~89세,2019,1540,453,1087,41.7,1539,453,1086,41.7
'25050, 대덕구,'090001, 85세,2019,441,147,294,50,441,147,294,50
'25050, 대덕구,'090002, 86세,2019,371,120,251,47.8,371,120,251,47.8
'25050, 대덕구,'090003, 87세,2019,292,80,212,37.7,292,80,212,37.7
'25050, 대덕구,'090004, 88세,2019,241,59,182,32.4,241,59,182,32.4
'25050, 대덕구,'090005, 89세,2019,195,47,148,31.8,194,47,147,32
'25050, 대덕구,'095,90~94세,2019,444,87,357,24.4,443,87,356,24.4
'25050, 대덕구,'095001, 90세,2019,148,25,123,20.3,148,25,123,20.3
'25050, 대덕구,'095002, 91세,2019,122,27,95,28.4,121,27,94,28.7
'25050, 대덕구,'095003, 92세,2019,86,19,67,28.4,86,19,67,28.4
'25050, 대덕구,'095004, 93세,2019,57,12,45,26.7,57,12,45,26.7
'25050, 대덕구,'095005, 94세,2019,31,X,27,14.8,31,X,27,14.8
'25050, 대덕구,'100,95~99세,2019,122,12,110,10.9,122,12,110,10.9
'25050, 대덕구,'100001, 95세,2019,32,5,27,18.5,32,5,27,18.5
'25050, 대덕구,'100002, 96세,2019,41,X,39,5.1,41,X,39,5.1
'25050, 대덕구,'100003, 97세,2019,20,X,17,17.6,20,X,17,17.6
'25050, 대덕구,'100004, 98세,2019,20,X,19,5.3,20,X,19,5.3
'25050, 대덕구,'100005, 99세,2019,9,X,8,12.5,9,X,8,12.5
'25050, 대덕구,'101,100세이상,2019,11,X,9,22.2,11,X,9,22.2
'25050, 대덕구,'102,15세미만,2019,19581,10037,9544,105.2,19494,9992,9502,105.2
'25050, 대덕구,'103,15~64세,2019,133828,69606,64222,108.4,130770,68053,62717,108.5
'25050, 대덕구,'104,65세이상,2019,25698,11182,14516,77,25577,11139,14438,77.2
'25050, 대덕구,'126,평균연령,2019,42.7,41.6,43.8,,42.8,41.7,43.9,
'25050, 대덕구,'127,중위연령,2019,44.7,43.2,46.1,,45,43.5,46.4,
'26,울산광역시,'000,합계,2019,1143692,591965,551727,107.3,1115088,574546,540542,106.3
'26,울산광역시,'005,0~4세,2019,47359,24435,22924,106.6,46838,24178,22660,106.7
'26,울산광역시,'005001, 0세,2019,7595,3908,3687,106,7496,3859,3637,106.1
'26,울산광역시,'005002, 1세,2019,8301,4230,4071,103.9,8206,4187,4019,104.2
'26,울산광역시,'005003, 2세,2019,9419,4883,4536,107.6,9297,4821,4476,107.7
'26,울산광역시,'005004, 3세,2019,10751,5545,5206,106.5,10645,5502,5143,107
'26,울산광역시,'005005, 4세,2019,11293,5869,5424,108.2,11194,5809,5385,107.9
'26,울산광역시,'010,5~9세,2019,57292,29532,27760,106.4,56923,29339,27584,106.4
'26,울산광역시,'010001, 5세,2019,11213,5718,5495,104.1,11107,5660,5447,103.9
'26,울산광역시,'010002, 6세,2019,11181,5695,5486,103.8,11104,5657,5447,103.9
'26,울산광역시,'010003, 7세,2019,11965,6172,5793,106.5,11892,6133,5759,106.5
'26,울산광역시,'010004, 8세,2019,11646,6021,5625,107,11594,5990,5604,106.9
'26,울산광역시,'010005, 9세,2019,11287,5926,5361,110.5,11226,5899,5327,110.7
'26,울산광역시,'015,10~14세,2019,54052,28178,25874,108.9,53836,28060,25776,108.9
'26,울산광역시,'015001, 10세,2019,10759,5596,5163,108.4,10709,5563,5146,108.1
'26,울산광역시,'015002, 11세,2019,11334,5833,5501,106,11284,5799,5485,105.7
'26,울산광역시,'015003, 12세,2019,11491,6030,5461,110.4,11450,6010,5440,110.5
'26,울산광역시,'015004, 13세,2019,10304,5345,4959,107.8,10274,5334,4940,108
'26,울산광역시,'015005, 14세,2019,10164,5374,4790,112.2,10119,5354,4765,112.4
'26,울산광역시,'020,15~19세,2019,58614,31852,26762,119,58110,31578,26532,119
'26,울산광역시,'020001, 15세,2019,10954,5798,5156,112.5,10921,5785,5136,112.6
'26,울산광역시,'020002, 16세,2019,11352,6016,5336,112.7,11322,6006,5316,113
'26,울산광역시,'020003, 17세,2019,11790,6188,5602,110.5,11729,6155,5574,110.4
'26,울산광역시,'020004, 18세,2019,12772,6994,5778,121,12646,6923,5723,121
'26,울산광역시,'020005, 19세,2019,11746,6856,4890,140.2,11492,6709,4783,140.3
'26,울산광역시,'025,20~24세,2019,70145,40951,29194,140.3,67440,39247,28193,139.2
'26,울산광역시,'025001, 20세,2019,12281,7624,4657,163.7,11916,7392,4524,163.4
'26,울산광역시,'025002, 21세,2019,13510,8084,5426,149,13090,7816,5274,148.2
'26,울산광역시,'025003, 22세,2019,14270,8167,6103,133.8,13734,7822,5912,132.3
'26,울산광역시,'025004, 23세,2019,14792,8407,6385,131.7,14163,8020,6143,130.6
'26,울산광역시,'025005, 24세,2019,15292,8669,6623,130.9,14537,8197,6340,129.3
'26,울산광역시,'030,25~29세,2019,76543,43548,32995,132,72073,40647,31426,129.3
'26,울산광역시,'030001, 25세,2019,15405,8936,6469,138.1,14632,8453,6179,136.8
'26,울산광역시,'030002, 26세,2019,15630,8996,6634,135.6,14845,8486,6359,133.4
'26,울산광역시,'030003, 27세,2019,15629,8904,6725,132.4,14779,8331,6448,129.2
'26,울산광역시,'030004, 28세,2019,15179,8399,6780,123.9,14164,7742,6422,120.6
'26,울산광역시,'030005, 29세,2019,14700,8313,6387,130.2,13653,7635,6018,126.9
'26,울산광역시,'035,30~34세,2019,72465,39810,32655,121.9,67734,36765,30969,118.7
'26,울산광역시,'035001, 30세,2019,14481,8159,6322,129.1,13558,7546,6012,125.5
'26,울산광역시,'035002, 31세,2019,14069,7919,6150,128.8,13033,7254,5779,125.5
'26,울산광역시,'035003, 32세,2019,14357,7806,6551,119.2,13410,7209,6201,116.3
'26,울산광역시,'035004, 33세,2019,14645,7931,6714,118.1,13681,7304,6377,114.5
'26,울산광역시,'035005, 34세,2019,14913,7995,6918,115.6,14052,7452,6600,112.9
'26,울산광역시,'040,35~39세,2019,93355,49032,44323,110.6,89874,46765,43109,108.5
'26,울산광역시,'040001, 35세,2019,16034,8534,7500,113.8,15246,8011,7235,110.7
'26,울산광역시,'040002, 36세,2019,17849,9345,8504,109.9,17070,8819,8251,106.9
'26,울산광역시,'040003, 37세,2019,19448,10092,9356,107.9,18765,9661,9104,106.1
'26,울산광역시,'040004, 38세,2019,19592,10397,9195,113.1,18957,9976,8981,111.1
'26,울산광역시,'040005, 39세,2019,20432,10664,9768,109.2,19836,10298,9538,108
'26,울산광역시,'045,40~44세,2019,88494,46001,42493,108.3,85918,44414,41504,107
'26,울산광역시,'045001, 40세,2019,18705,9796,8909,110,18140,9429,8711,108.2
'26,울산광역시,'045002, 41세,2019,17320,9108,8212,110.9,16757,8794,7963,110.4
'26,울산광역시,'045003, 42세,2019,17805,9263,8542,108.4,17310,8947,8363,107
'26,울산광역시,'045004, 43세,2019,16733,8726,8007,109,16263,8421,7842,107.4
'26,울산광역시,'045005, 44세,2019,17931,9108,8823,103.2,17448,8823,8625,102.3
'26,울산광역시,'050,45~49세,2019,102387,50955,51432,99.1,99756,49394,50362,98.1
'26,울산광역시,'050001, 45세,2019,19304,9649,9655,99.9,18820,9345,9475,98.6
'26,울산광역시,'050002, 46세,2019,19850,9864,9986,98.8,19367,9584,9783,98
'26,울산광역시,'050003, 47세,2019,20025,9994,10031,99.6,19515,9706,9809,98.9
'26,울산광역시,'050004, 48세,2019,21854,10913,10941,99.7,21249,10554,10695,98.7
'26,울산광역시,'050005, 49세,2019,21354,10535,10819,97.4,20805,10205,10600,96.3
'26,울산광역시,'055,50~54세,2019,108271,54637,53634,101.9,105774,53192,52582,101.2
'26,울산광역시,'055001, 50세,2019,22019,10916,11103,98.3,21477,10608,10869,97.6
'26,울산광역시,'055002, 51세,2019,22509,11115,11394,97.6,21963,10791,11172,96.6
'26,울산광역시,'055003, 52세,2019,21095,10364,10731,96.6,20673,10132,10541,96.1
'26,울산광역시,'055004, 53세,2019,21239,11143,10096,110.4,20740,10847,9893,109.6
'26,울산광역시,'055005, 54세,2019,21409,11099,10310,107.7,20921,10814,10107,107
'26,울산광역시,'060,55~59세,2019,103128,53237,49891,106.7,101210,52152,49058,106.3
'26,울산광역시,'060001, 55세,2019,19359,9995,9364,106.7,18873,9712,9161,106
'26,울산광역시,'060002, 56세,2019,20285,10633,9652,110.2,19781,10349,9432,109.7
'26,울산광역시,'060003, 57세,2019,20452,10713,9739,110,20103,10528,9575,110
'26,울산광역시,'060004, 58세,2019,22248,11383,10865,104.8,21997,11238,10759,104.5
'26,울산광역시,'060005, 59세,2019,20784,10513,10271,102.4,20456,10325,10131,101.9
'26,울산광역시,'065,60~64세,2019,81602,41273,40329,102.3,80550,40697,39853,102.1
'26,울산광역시,'065001, 60세,2019,18679,9559,9120,104.8,18433,9419,9014,104.5
'26,울산광역시,'065002, 61세,2019,17097,8723,8374,104.2,16861,8595,8266,104
'26,울산광역시,'065003, 62세,2019,16404,8313,8091,102.7,16176,8192,7984,102.6
'26,울산광역시,'065004, 63세,2019,14742,7384,7358,100.4,14554,7277,7277,100
'26,울산광역시,'065005, 64세,2019,14680,7294,7386,98.8,14526,7214,7312,98.7
'26,울산광역시,'070,65~69세,2019,50234,25279,24955,101.3,49725,25029,24696,101.3
'26,울산광역시,'070001, 65세,2019,11964,6073,5891,103.1,11805,5986,5819,102.9
'26,울산광역시,'070002, 66세,2019,10758,5366,5392,99.5,10651,5314,5337,99.6
'26,울산광역시,'070003, 67세,2019,10886,5495,5391,101.9,10787,5445,5342,101.9
'26,울산광역시,'070004, 68세,2019,8387,4222,4165,101.4,8314,4190,4124,101.6
'26,울산광역시,'070005, 69세,2019,8239,4123,4116,100.2,8168,4094,4074,100.5
'26,울산광역시,'075,70~74세,2019,32533,16105,16428,98,32332,16019,16313,98.2
'26,울산광역시,'075001, 70세,2019,8079,4075,4004,101.8,8016,4047,3969,102
'26,울산광역시,'075002, 71세,2019,7805,3893,3912,99.5,7765,3869,3896,99.3
'26,울산광역시,'075003, 72세,2019,7007,3462,3545,97.7,6967,3448,3519,98
'26,울산광역시,'075004, 73세,2019,4843,2382,2461,96.8,4813,2373,2440,97.3
'26,울산광역시,'075005, 74세,2019,4799,2293,2506,91.5,4771,2282,2489,91.7
'26,울산광역시,'080,75~79세,2019,23579,10146,13433,75.5,23467,10106,13361,75.6
'26,울산광역시,'080001, 75세,2019,4897,2185,2712,80.6,4875,2177,2698,80.7
'26,울산광역시,'080002, 76세,2019,5163,2308,2855,80.8,5142,2299,2843,80.9
'26,울산광역시,'080003, 77세,2019,5545,2415,3130,77.2,5517,2406,3111,77.3
'26,울산광역시,'080004, 78세,2019,4096,1706,2390,71.4,4074,1697,2377,71.4
'26,울산광역시,'080005, 79세,2019,3878,1532,2346,65.3,3859,1527,2332,65.5
'26,울산광역시,'085,80~84세,2019,14188,4853,9335,52,14119,4834,9285,52.1
'26,울산광역시,'085001, 80세,2019,3657,1441,2216,65,3638,1435,2203,65.1
'26,울산광역시,'085002, 81세,2019,3123,1092,2031,53.8,3110,1088,2022,53.8
'26,울산광역시,'085003, 82세,2019,2747,906,1841,49.2,2724,901,1823,49.4
'26,울산광역시,'085004, 83세,2019,2435,744,1691,44,2428,741,1687,43.9
'26,울산광역시,'085005, 84세,2019,2226,670,1556,43.1,2219,669,1550,43.2
'26,울산광역시,'086,85세이상,2019,9451,2141,7310,29.3,9409,2130,7279,29.3
'26,울산광역시,'090,85~89세,2019,6712,1717,4995,34.4,6682,1710,4972,34.4
'26,울산광역시,'090001, 85세,2019,1929,573,1356,42.3,1922,571,1351,42.3
'26,울산광역시,'090002, 86세,2019,1618,441,1177,37.5,1613,440,1173,37.5
'26,울산광역시,'090003, 87세,2019,1314,324,990,32.7,1311,323,988,32.7
'26,울산광역시,'090004, 88세,2019,1023,217,806,26.9,1016,215,801,26.8
'26,울산광역시,'090005, 89세,2019,828,162,666,24.3,820,161,659,24.4
'26,울산광역시,'095,90~94세,2019,2247,364,1883,19.3,2236,360,1876,19.2
'26,울산광역시,'095001, 90세,2019,712,150,562,26.7,708,149,559,26.7
'26,울산광역시,'095002, 91세,2019,565,85,480,17.7,563,84,479,17.5
'26,울산광역시,'095003, 92세,2019,447,68,379,17.9,445,67,378,17.7
'26,울산광역시,'095004, 93세,2019,286,36,250,14.4,284,35,249,14.1
'26,울산광역시,'095005, 94세,2019,237,25,212,11.8,236,25,211,11.8
'26,울산광역시,'100,95~99세,2019,450,58,392,14.8,449,58,391,14.8
'26,울산광역시,'100001, 95세,2019,153,18,135,13.3,153,18,135,13.3
'26,울산광역시,'100002, 96세,2019,136,26,110,23.6,136,26,110,23.6
'26,울산광역시,'100003, 97세,2019,81,5,76,6.6,80,5,75,6.7
'26,울산광역시,'100004, 98세,2019,47,X,43,9.3,47,X,43,9.3
'26,울산광역시,'100005, 99세,2019,33,5,28,17.9,33,5,28,17.9
'26,울산광역시,'101,100세이상,2019,42,X,40,5,42,X,40,5
'26,울산광역시,'102,15세미만,2019,158703,82145,76558,107.3,157597,81577,76020,107.3
'26,울산광역시,'103,15~64세,2019,855004,451296,403708,111.8,828439,434851,393588,110.5
'26,울산광역시,'104,65세이상,2019,129985,58524,71461,81.9,129052,58118,70934,81.9
'26,울산광역시,'126,평균연령,2019,40.8,39.8,41.9,,40.9,39.9,42,
'26,울산광역시,'127,중위연령,2019,42.3,40.9,44,,42.6,41.1,44.1,
'26004, 읍부,'000,합계,2019,171448,89957,81491,110.4,164125,85278,78847,108.2
'26004, 읍부,'005,0~4세,2019,7107,3696,3411,108.4,6925,3601,3324,108.3
'26004, 읍부,'005001, 0세,2019,1187,614,573,107.2,1145,593,552,107.4
'26004, 읍부,'005002, 1세,2019,1282,658,624,105.4,1256,646,610,105.9
'26004, 읍부,'005003, 2세,2019,1399,746,653,114.2,1352,719,633,113.6
'26004, 읍부,'005004, 3세,2019,1522,771,751,102.7,1490,758,732,103.6
'26004, 읍부,'005005, 4세,2019,1717,907,810,112,1682,885,797,111
'26004, 읍부,'010,5~9세,2019,9227,4677,4550,102.8,9105,4615,4490,102.8
'26004, 읍부,'010001, 5세,2019,1707,879,828,106.2,1669,862,807,106.8
'26004, 읍부,'010002, 6세,2019,1761,878,883,99.4,1739,867,872,99.4
'26004, 읍부,'010003, 7세,2019,1984,989,995,99.4,1958,975,983,99.2
'26004, 읍부,'010004, 8세,2019,1901,972,929,104.6,1882,960,922,104.1
'26004, 읍부,'010005, 9세,2019,1874,959,915,104.8,1857,951,906,105
'26004, 읍부,'015,10~14세,2019,9312,4827,4485,107.6,9240,4787,4453,107.5
'26004, 읍부,'015001, 10세,2019,1771,892,879,101.5,1754,879,875,100.5
'26004, 읍부,'015002, 11세,2019,1947,1001,946,105.8,1926,986,940,104.9
'26004, 읍부,'015003, 12세,2019,1981,1045,936,111.6,1972,1040,932,111.6
'26004, 읍부,'015004, 13세,2019,1773,943,830,113.6,1763,940,823,114.2
'26004, 읍부,'015005, 14세,2019,1840,946,894,105.8,1825,942,883,106.7
'26004, 읍부,'020,15~19세,2019,9839,5370,4469,120.2,9712,5293,4419,119.8
'26004, 읍부,'020001, 15세,2019,1907,980,927,105.7,1898,975,923,105.6
'26004, 읍부,'020002, 16세,2019,1860,938,922,101.7,1847,934,913,102.3
'26004, 읍부,'020003, 17세,2019,1913,983,930,105.7,1896,973,923,105.4
'26004, 읍부,'020004, 18세,2019,2107,1142,965,118.3,2074,1121,953,117.6
'26004, 읍부,'020005, 19세,2019,2052,1327,725,183,1997,1290,707,182.5
'26004, 읍부,'025,20~24세,2019,11103,6672,4431,150.6,10577,6319,4258,148.4
'26004, 읍부,'025001, 20세,2019,2082,1357,725,187.2,2017,1312,705,186.1
'26004, 읍부,'025002, 21세,2019,2058,1277,781,163.5,1972,1223,749,163.3
'26004, 읍부,'025003, 22세,2019,2229,1278,951,134.4,2118,1205,913,132
'26004, 읍부,'025004, 23세,2019,2283,1328,955,139.1,2166,1249,917,136.2
'26004, 읍부,'025005, 24세,2019,2451,1432,1019,140.5,2304,1330,974,136.6
'26004, 읍부,'030,25~29세,2019,11098,6539,4559,143.4,10122,5882,4240,138.7
'26004, 읍부,'030001, 25세,2019,2421,1472,949,155.1,2256,1352,904,149.6
'26004, 읍부,'030002, 26세,2019,2259,1380,879,157,2091,1265,826,153.1
'26004, 읍부,'030003, 27세,2019,2249,1311,938,139.8,2063,1189,874,136
'26004, 읍부,'030004, 28세,2019,2169,1232,937,131.5,1949,1083,866,125.1
'26004, 읍부,'030005, 29세,2019,2000,1144,856,133.6,1763,993,770,129
'26004, 읍부,'035,30~34세,2019,9846,5449,4397,123.9,8699,4672,4027,116
'26004, 읍부,'035001, 30세,2019,1963,1131,832,135.9,1752,987,765,129
'26004, 읍부,'035002, 31세,2019,1817,1003,814,123.2,1568,842,726,116
'26004, 읍부,'035003, 32세,2019,1981,1093,888,123.1,1760,935,825,113.3
'26004, 읍부,'035004, 33세,2019,2009,1101,908,121.3,1777,944,833,113.3
'26004, 읍부,'035005, 34세,2019,2076,1121,955,117.4,1842,964,878,109.8
'26004, 읍부,'040,35~39세,2019,13219,6941,6278,110.6,12414,6368,6046,105.3
'26004, 읍부,'040001, 35세,2019,2251,1198,1053,113.8,2099,1086,1013,107.2
'26004, 읍부,'040002, 36세,2019,2413,1283,1130,113.5,2218,1137,1081,105.2
'26004, 읍부,'040003, 37세,2019,2736,1428,1308,109.2,2580,1319,1261,104.6
'26004, 읍부,'040004, 38세,2019,2837,1532,1305,117.4,2672,1420,1252,113.4
'26004, 읍부,'040005, 39세,2019,2982,1500,1482,101.2,2845,1406,1439,97.7
'26004, 읍부,'045,40~44세,2019,14339,7288,7051,103.4,13638,6822,6816,100.1
'26004, 읍부,'045001, 40세,2019,2839,1453,1386,104.8,2689,1349,1340,100.7
'26004, 읍부,'045002, 41세,2019,2641,1357,1284,105.7,2480,1256,1224,102.6
'26004, 읍부,'045003, 42세,2019,2912,1472,1440,102.2,2809,1404,1405,99.9
'26004, 읍부,'045004, 43세,2019,2877,1475,1402,105.2,2734,1373,1361,100.9
'26004, 읍부,'045005, 44세,2019,3070,1531,1539,99.5,2926,1440,1486,96.9
'26004, 읍부,'050,45~49세,2019,17589,8940,8649,103.4,16806,8458,8348,101.3
'26004, 읍부,'050001, 45세,2019,3379,1721,1658,103.8,3237,1622,1615,100.4
'26004, 읍부,'050002, 46세,2019,3404,1698,1706,99.5,3269,1609,1660,96.9
'26004, 읍부,'050003, 47세,2019,3456,1750,1706,102.6,3302,1663,1639,101.5
'26004, 읍부,'050004, 48세,2019,3821,1977,1844,107.2,3641,1866,1775,105.1
'26004, 읍부,'050005, 49세,2019,3529,1794,1735,103.4,3357,1698,1659,102.4
'26004, 읍부,'055,50~54세,2019,16655,8857,7798,113.6,15865,8377,7488,111.9
'26004, 읍부,'055001, 50세,2019,3551,1865,1686,110.6,3388,1771,1617,109.5
'26004, 읍부,'055002, 51세,2019,3504,1866,1638,113.9,3343,1765,1578,111.9
'26004, 읍부,'055003, 52세,2019,3297,1715,1582,108.4,3152,1634,1518,107.6
'26004, 읍부,'055004, 53세,2019,3168,1697,1471,115.4,3009,1600,1409,113.6
'26004, 읍부,'055005, 54세,2019,3135,1714,1421,120.6,2973,1607,1366,117.6
'26004, 읍부,'060,55~59세,2019,14002,7589,6413,118.3,13420,7229,6191,116.8
'26004, 읍부,'060001, 55세,2019,2744,1501,1243,120.8,2584,1395,1189,117.3
'26004, 읍부,'060002, 56세,2019,2859,1586,1273,124.6,2688,1486,1202,123.6
'26004, 읍부,'060003, 57세,2019,2701,1455,1246,116.8,2602,1396,1206,115.8
'26004, 읍부,'060004, 58세,2019,3001,1581,1420,111.3,2933,1535,1398,109.8
'26004, 읍부,'060005, 59세,2019,2697,1466,1231,119.1,2613,1417,1196,118.5
'26004, 읍부,'065,60~64세,2019,10632,5495,5137,107,10338,5329,5009,106.4
'26004, 읍부,'065001, 60세,2019,2441,1291,1150,112.3,2359,1246,1113,111.9
'26004, 읍부,'065002, 61세,2019,2226,1138,1088,104.6,2166,1100,1066,103.2
'26004, 읍부,'065003, 62세,2019,2125,1111,1014,109.6,2062,1079,983,109.8
'26004, 읍부,'065004, 63세,2019,1910,980,930,105.4,1853,946,907,104.3
'26004, 읍부,'065005, 64세,2019,1930,975,955,102.1,1898,958,940,101.9
'26004, 읍부,'070,65~69세,2019,6241,3172,3069,103.4,6129,3117,3012,103.5
'26004, 읍부,'070001, 65세,2019,1499,788,711,110.8,1463,767,696,110.2
'26004, 읍부,'070002, 66세,2019,1318,672,646,104,1295,659,636,103.6
'26004, 읍부,'070003, 67세,2019,1367,696,671,103.7,1344,685,659,103.9
'26004, 읍부,'070004, 68세,2019,1042,517,525,98.5,1032,514,518,99.2
'26004, 읍부,'070005, 69세,2019,1015,499,516,96.7,995,492,503,97.8
'26004, 읍부,'075,70~74세,2019,4139,2035,2104,96.7,4093,2016,2077,97.1
'26004, 읍부,'075001, 70세,2019,1021,491,530,92.6,1010,487,523,93.1
'26004, 읍부,'075002, 71세,2019,980,502,478,105,967,495,472,104.9
'26004, 읍부,'075003, 72세,2019,933,476,457,104.2,921,472,449,105.1
'26004, 읍부,'075004, 73세,2019,600,283,317,89.3,596,282,314,89.8
'26004, 읍부,'075005, 74세,2019,605,283,322,87.9,599,280,319,87.8
'26004, 읍부,'080,75~79세,2019,3384,1355,2029,66.8,3350,1345,2005,67.1
'26004, 읍부,'080001, 75세,2019,668,268,400,67,661,264,397,66.5
'26004, 읍부,'080002, 76세,2019,732,326,406,80.3,726,325,401,81
'26004, 읍부,'080003, 77세,2019,797,326,471,69.2,788,324,464,69.8
'26004, 읍부,'080004, 78세,2019,614,232,382,60.7,610,231,379,60.9
'26004, 읍부,'080005, 79세,2019,573,203,370,54.9,565,201,364,55.2
'26004, 읍부,'085,80~84세,2019,2207,739,1468,50.3,2191,735,1456,50.5
'26004, 읍부,'085001, 80세,2019,584,203,381,53.3,579,201,378,53.2
'26004, 읍부,'085002, 81세,2019,509,195,314,62.1,504,195,309,63.1
'26004, 읍부,'085003, 82세,2019,405,124,281,44.1,400,123,277,44.4
'26004, 읍부,'085004, 83세,2019,349,110,239,46,348,109,239,45.6
'26004, 읍부,'085005, 84세,2019,360,107,253,42.3,360,107,253,42.3
'26004, 읍부,'086,85세이상,2019,1509,316,1193,26.5,1501,313,1188,26.3
'26004, 읍부,'090,85~89세,2019,1067,252,815,30.9,1061,250,811,30.8
'26004, 읍부,'090001, 85세,2019,307,78,229,34.1,305,77,228,33.8
'26004, 읍부,'090002, 86세,2019,227,69,158,43.7,226,69,157,43.9
'26004, 읍부,'090003, 87세,2019,206,44,162,27.2,205,44,161,27.3
'26004, 읍부,'090004, 88세,2019,181,34,147,23.1,180,33,147,22.4
'26004, 읍부,'090005, 89세,2019,146,27,119,22.7,145,27,118,22.9
'26004, 읍부,'095,90~94세,2019,372,55,317,17.4,370,54,316,17.1
'26004, 읍부,'095001, 90세,2019,125,23,102,22.5,125,23,102,22.5
'26004, 읍부,'095002, 91세,2019,91,17,74,23,90,16,74,21.6
'26004, 읍부,'095003, 92세,2019,74,7,67,10.4,73,7,66,10.6
'26004, 읍부,'095004, 93세,2019,45,X,41,9.8,45,X,41,9.8
'26004, 읍부,'095005, 94세,2019,37,X,33,12.1,37,X,33,12.1
'26004, 읍부,'100,95~99세,2019,62,9,53,17,62,9,53,17
'26004, 읍부,'100001, 95세,2019,22,X,18,22.2,22,X,18,22.2
'26004, 읍부,'100002, 96세,2019,21,X,18,16.7,21,X,18,16.7
'26004, 읍부,'100003, 97세,2019,13,X,12,8.3,13,X,12,8.3
'26004, 읍부,'100004, 98세,2019,X,X,X,0,X,X,X,0
'26004, 읍부,'100005, 99세,2019,5,X,X,25,5,X,X,25
'26004, 읍부,'101,100세이상,2019,8,X,8,0,8,X,8,0
'26004, 읍부,'102,15세미만,2019,25646,13200,12446,106.1,25270,13003,12267,106
'26004, 읍부,'103,15~64세,2019,128322,69140,59182,116.8,121591,64749,56842,113.9
'26004, 읍부,'104,65세이상,2019,17480,7617,9863,77.2,17264,7526,9738,77.3
'26004, 읍부,'126,평균연령,2019,39.9,38.9,40.9,,39.9,38.9,41,
'26004, 읍부,'127,중위연령,2019,41.8,40.6,43,,42,40.8,43.1,
'26005, 면부,'000,합계,2019,55053,29048,26005,111.7,51900,26482,25418,104.2
'26005, 면부,'005,0~4세,2019,1450,763,687,111.1,1441,761,680,111.9
'26005, 면부,'005001, 0세,2019,269,139,130,106.9,264,138,126,109.5
'26005, 면부,'005002, 1세,2019,298,164,134,122.4,297,164,133,123.3
'26005, 면부,'005003, 2세,2019,279,147,132,111.4,276,146,130,112.3
'26005, 면부,'005004, 3세,2019,315,161,154,104.5,315,161,154,104.5
'26005, 면부,'005005, 4세,2019,289,152,137,110.9,289,152,137,110.9
'26005, 면부,'010,5~9세,2019,1402,731,671,108.9,1394,727,667,109
'26005, 면부,'010001, 5세,2019,309,173,136,127.2,307,172,135,127.4
'26005, 면부,'010002, 6세,2019,265,121,144,84,264,121,143,84.6
'26005, 면부,'010003, 7세,2019,264,135,129,104.7,262,134,128,104.7
'26005, 면부,'010004, 8세,2019,296,159,137,116.1,295,158,137,115.3
'26005, 면부,'010005, 9세,2019,268,143,125,114.4,266,142,124,114.5
'26005, 면부,'015,10~14세,2019,1508,793,715,110.9,1502,789,713,110.7
'26005, 면부,'015001, 10세,2019,277,140,137,102.2,276,140,136,102.9
'26005, 면부,'015002, 11세,2019,298,158,140,112.9,298,158,140,112.9
'26005, 면부,'015003, 12세,2019,315,166,149,111.4,315,166,149,111.4
'26005, 면부,'015004, 13세,2019,310,161,149,108.1,309,161,148,108.8
'26005, 면부,'015005, 14세,2019,308,168,140,120,304,164,140,117.1
'26005, 면부,'020,15~19세,2019,2051,1058,993,106.5,2023,1039,984,105.6
'26005, 면부,'020001, 15세,2019,331,175,156,112.2,331,175,156,112.2
'26005, 면부,'020002, 16세,2019,354,187,167,112,352,186,166,112
'26005, 면부,'020003, 17세,2019,379,193,186,103.8,377,193,184,104.9
'26005, 면부,'020004, 18세,2019,405,224,181,123.8,395,217,178,121.9
'26005, 면부,'020005, 19세,2019,582,279,303,92.1,568,268,300,89.3
'26005, 면부,'025,20~24세,2019,3014,1845,1169,157.8,2624,1498,1126,133
'26005, 면부,'025001, 20세,2019,543,339,204,166.2,502,301,201,149.8
'26005, 면부,'025002, 21세,2019,591,341,250,136.4,541,294,247,119
'26005, 면부,'025003, 22세,2019,581,342,239,143.1,511,276,235,117.4
'26005, 면부,'025004, 23세,2019,600,384,216,177.8,492,293,199,147.2
'26005, 면부,'025005, 24세,2019,699,439,260,168.8,578,334,244,136.9
'26005, 면부,'030,25~29세,2019,3533,2324,1209,192.2,2754,1644,1110,148.1
'26005, 면부,'030001, 25세,2019,677,440,237,185.7,551,329,222,148.2
'26005, 면부,'030002, 26세,2019,709,483,226,213.7,575,362,213,170
'26005, 면부,'030003, 27세,2019,728,475,253,187.7,580,339,241,140.7
'26005, 면부,'030004, 28세,2019,724,470,254,185,545,320,225,142.2
'26005, 면부,'030005, 29세,2019,695,456,239,190.8,503,294,209,140.7
'26005, 면부,'035,30~34세,2019,3302,2101,1201,174.9,2600,1496,1104,135.5
'26005, 면부,'035001, 30세,2019,692,447,245,182.4,540,317,223,142.2
'26005, 면부,'035002, 31세,2019,662,446,216,206.5,507,308,199,154.8
'26005, 면부,'035003, 32세,2019,654,391,263,148.7,514,274,240,114.2
'26005, 면부,'035004, 33세,2019,661,414,247,167.6,525,299,226,132.3
'26005, 면부,'035005, 34세,2019,633,403,230,175.2,514,298,216,138
'26005, 면부,'040,35~39세,2019,3476,2067,1409,146.7,2965,1649,1316,125.3
'26005, 면부,'040001, 35세,2019,625,390,235,166,494,275,219,125.6
'26005, 면부,'040002, 36세,2019,673,404,269,150.2,553,306,247,123.9
'26005, 면부,'040003, 37세,2019,743,424,319,132.9,649,349,300,116.3
'26005, 면부,'040004, 38세,2019,737,427,310,137.7,645,353,292,120.9
'26005, 면부,'040005, 39세,2019,698,422,276,152.9,624,366,258,141.9
'26005, 면부,'045,40~44세,2019,3089,1785,1304,136.9,2829,1588,1241,128
'26005, 면부,'045001, 40세,2019,617,367,250,146.8,560,324,236,137.3
'26005, 면부,'045002, 41세,2019,595,363,232,156.5,532,315,217,145.2
'26005, 면부,'045003, 42세,2019,612,369,243,151.9,559,327,232,140.9
'26005, 면부,'045004, 43세,2019,576,331,245,135.1,532,298,234,127.4
'26005, 면부,'045005, 44세,2019,689,355,334,106.3,646,324,322,100.6
'26005, 면부,'050,45~49세,2019,3898,2082,1816,114.6,3739,1965,1774,110.8
'26005, 면부,'050001, 45세,2019,661,346,315,109.8,637,329,308,106.8
'26005, 면부,'050002, 46세,2019,751,397,354,112.1,720,372,348,106.9
'26005, 면부,'050003, 47세,2019,749,417,332,125.6,714,393,321,122.4
'26005, 면부,'050004, 48세,2019,878,457,421,108.6,835,428,407,105.2
'26005, 면부,'050005, 49세,2019,859,465,394,118,833,443,390,113.6
'26005, 면부,'055,50~54세,2019,4848,2470,2378,103.9,4718,2395,2323,103.1
'26005, 면부,'055001, 50세,2019,912,444,468,94.9,883,431,452,95.4
'26005, 면부,'055002, 51세,2019,1021,493,528,93.4,996,478,518,92.3
'26005, 면부,'055003, 52세,2019,910,449,461,97.4,886,435,451,96.5
'26005, 면부,'055004, 53세,2019,984,534,450,118.7,954,514,440,116.8
'26005, 면부,'055005, 54세,2019,1021,550,471,116.8,999,537,462,116.2
'26005, 면부,'060,55~59세,2019,5702,2923,2779,105.2,5615,2869,2746,104.5
'26005, 면부,'060001, 55세,2019,1032,509,523,97.3,1011,496,515,96.3
'26005, 면부,'060002, 56세,2019,1062,559,503,111.1,1040,548,492,111.4
'26005, 면부,'060003, 57세,2019,1148,608,540,112.6,1129,597,532,112.2
'26005, 면부,'060004, 58세,2019,1254,637,617,103.2,1243,628,615,102.1
'26005, 면부,'060005, 59세,2019,1206,610,596,102.3,1192,600,592,101.4
'26005, 면부,'065,60~64세,2019,5505,2802,2703,103.7,5463,2784,2679,103.9
'26005, 면부,'065001, 60세,2019,1147,578,569,101.6,1138,572,566,101.1
'26005, 면부,'065002, 61세,2019,1132,569,563,101.1,1124,566,558,101.4
'26005, 면부,'065003, 62세,2019,1149,588,561,104.8,1141,584,557,104.8
'26005, 면부,'065004, 63세,2019,1045,555,490,113.3,1036,552,484,114
'26005, 면부,'065005, 64세,2019,1032,512,520,98.5,1024,510,514,99.2
'26005, 면부,'070,65~69세,2019,3898,1938,1960,98.9,3874,1921,1953,98.4
'26005, 면부,'070001, 65세,2019,881,461,420,109.8,872,454,418,108.6
'26005, 면부,'070002, 66세,2019,823,390,433,90.1,818,386,432,89.4
'26005, 면부,'070003, 67세,2019,831,383,448,85.5,825,379,446,85
'26005, 면부,'070004, 68세,2019,662,338,324,104.3,659,336,323,104
'26005, 면부,'070005, 69세,2019,701,366,335,109.3,700,366,334,109.6
'26005, 면부,'075,70~74세,2019,2883,1439,1444,99.7,2878,1438,1440,99.9
'26005, 면부,'075001, 70세,2019,672,344,328,104.9,671,344,327,105.2
'26005, 면부,'075002, 71세,2019,657,336,321,104.7,657,336,321,104.7
'26005, 면부,'075003, 72세,2019,617,316,301,105,617,316,301,105
'26005, 면부,'075004, 73세,2019,445,213,232,91.8,444,213,231,92.2
'26005, 면부,'075005, 74세,2019,492,230,262,87.8,489,229,260,88.1
'26005, 면부,'080,75~79세,2019,2430,996,1434,69.5,2422,993,1429,69.5
'26005, 면부,'080001, 75세,2019,458,193,265,72.8,457,193,264,73.1
'26005, 면부,'080002, 76세,2019,509,219,290,75.5,508,218,290,75.2
'26005, 면부,'080003, 77세,2019,565,226,339,66.7,562,225,337,66.8
'26005, 면부,'080004, 78세,2019,448,180,268,67.2,445,179,266,67.3
'26005, 면부,'080005, 79세,2019,450,178,272,65.4,450,178,272,65.4
'26005, 면부,'085,80~84세,2019,1697,581,1116,52.1,1692,576,1116,51.6
'26005, 면부,'085001, 80세,2019,409,149,260,57.3,408,148,260,56.9
'26005, 면부,'085002, 81세,2019,380,126,254,49.6,378,124,254,48.8
'26005, 면부,'085003, 82세,2019,333,119,214,55.6,332,118,214,55.1
'26005, 면부,'085004, 83세,2019,291,99,192,51.6,291,99,192,51.6
'26005, 면부,'085005, 84세,2019,284,88,196,44.9,283,87,196,44.4
'26005, 면부,'086,85세이상,2019,1367,350,1017,34.4,1367,350,1017,34.4
'26005, 면부,'090,85~89세,2019,947,263,684,38.5,947,263,684,38.5
'26005, 면부,'090001, 85세,2019,272,84,188,44.7,272,84,188,44.7
'26005, 면부,'090002, 86세,2019,224,55,169,32.5,224,55,169,32.5
'26005, 면부,'090003, 87세,2019,197,59,138,42.8,197,59,138,42.8
'26005, 면부,'090004, 88세,2019,146,41,105,39,146,41,105,39
'26005, 면부,'090005, 89세,2019,108,24,84,28.6,108,24,84,28.6
'26005, 면부,'095,90~94세,2019,354,79,275,28.7,354,79,275,28.7
'26005, 면부,'095001, 90세,2019,99,26,73,35.6,99,26,73,35.6
'26005, 면부,'095002, 91세,2019,98,20,78,25.6,98,20,78,25.6
'26005, 면부,'095003, 92세,2019,70,19,51,37.3,70,19,51,37.3
'26005, 면부,'095004, 93세,2019,51,10,41,24.4,51,10,41,24.4
'26005, 면부,'095005, 94세,2019,36,X,32,12.5,36,X,32,12.5
'26005, 면부,'100,95~99세,2019,59,8,51,15.7,59,8,51,15.7
'26005, 면부,'100001, 95세,2019,24,X,23,4.3,24,X,23,4.3
'26005, 면부,'100002, 96세,2019,18,6,12,50,18,6,12,50
'26005, 면부,'100003, 97세,2019,9,X,8,12.5,9,X,8,12.5
'26005, 면부,'100004, 98세,2019,8,X,8,0,8,X,8,0
'26005, 면부,'100005, 99세,2019,X,X,X,,X,X,X,
'26005, 면부,'101,100세이상,2019,7,X,7,0,7,X,7,0
'26005, 면부,'102,15세미만,2019,4360,2287,2073,110.3,4337,2277,2060,110.5
'26005, 면부,'103,15~64세,2019,38418,21457,16961,126.5,35330,18927,16403,115.4
'26005, 면부,'104,65세이상,2019,12275,5304,6971,76.1,12233,5278,6955,75.9
'26005, 면부,'126,평균연령,2019,47.9,45.7,50.4,,48.7,46.8,50.7,
'26005, 면부,'127,중위연령,2019,50.9,47.8,53.8,,52.2,50.2,54.3,
'26003, 동부,'000,합계,2019,917191,472960,444231,106.5,899063,462786,436277,106.1
'26003, 동부,'005,0~4세,2019,38802,19976,18826,106.1,38472,19816,18656,106.2
'26003, 동부,'005001, 0세,2019,6139,3155,2984,105.7,6087,3128,2959,105.7
'26003, 동부,'005002, 1세,2019,6721,3408,3313,102.9,6653,3377,3276,103.1
'26003, 동부,'005003, 2세,2019,7741,3990,3751,106.4,7669,3956,3713,106.5
'26003, 동부,'005004, 3세,2019,8914,4613,4301,107.3,8840,4583,4257,107.7
'26003, 동부,'005005, 4세,2019,9287,4810,4477,107.4,9223,4772,4451,107.2
'26003, 동부,'010,5~9세,2019,46663,24124,22539,107,46424,23997,22427,107
'26003, 동부,'010001, 5세,2019,9197,4666,4531,103,9131,4626,4505,102.7
'26003, 동부,'010002, 6세,2019,9155,4696,4459,105.3,9101,4669,4432,105.3
'26003, 동부,'010003, 7세,2019,9717,5048,4669,108.1,9672,5024,4648,108.1
'26003, 동부,'010004, 8세,2019,9449,4890,4559,107.3,9417,4872,4545,107.2
'26003, 동부,'010005, 9세,2019,9145,4824,4321,111.6,9103,4806,4297,111.8
'26003, 동부,'015,10~14세,2019,43232,22558,20674,109.1,43094,22484,20610,109.1
'26003, 동부,'015001, 10세,2019,8711,4564,4147,110.1,8679,4544,4135,109.9
'26003, 동부,'015002, 11세,2019,9089,4674,4415,105.9,9060,4655,4405,105.7
'26003, 동부,'015003, 12세,2019,9195,4819,4376,110.1,9163,4804,4359,110.2
'26003, 동부,'015004, 13세,2019,8221,4241,3980,106.6,8202,4233,3969,106.7
'26003, 동부,'015005, 14세,2019,8016,4260,3756,113.4,7990,4248,3742,113.5
'26003, 동부,'020,15~19세,2019,46724,25424,21300,119.4,46375,25246,21129,119.5
'26003, 동부,'020001, 15세,2019,8716,4643,4073,114,8692,4635,4057,114.2
'26003, 동부,'020002, 16세,2019,9138,4891,4247,115.2,9123,4886,4237,115.3
'26003, 동부,'020003, 17세,2019,9498,5012,4486,111.7,9456,4989,4467,111.7
'26003, 동부,'020004, 18세,2019,10260,5628,4632,121.5,10177,5585,4592,121.6
'26003, 동부,'020005, 19세,2019,9112,5250,3862,135.9,8927,5151,3776,136.4
'26003, 동부,'025,20~24세,2019,56028,32434,23594,137.5,54239,31430,22809,137.8
'26003, 동부,'025001, 20세,2019,9656,5928,3728,159,9397,5779,3618,159.7
'26003, 동부,'025002, 21세,2019,10861,6466,4395,147.1,10577,6299,4278,147.2
'26003, 동부,'025003, 22세,2019,11460,6547,4913,133.3,11105,6341,4764,133.1
'26003, 동부,'025004, 23세,2019,11909,6695,5214,128.4,11505,6478,5027,128.9
'26003, 동부,'025005, 24세,2019,12142,6798,5344,127.2,11655,6533,5122,127.5
'26003, 동부,'030,25~29세,2019,61912,34685,27227,127.4,59197,33121,26076,127
'26003, 동부,'030001, 25세,2019,12307,7024,5283,133,11825,6772,5053,134
'26003, 동부,'030002, 26세,2019,12662,7133,5529,129,12179,6859,5320,128.9
'26003, 동부,'030003, 27세,2019,12652,7118,5534,128.6,12136,6803,5333,127.6
'26003, 동부,'030004, 28세,2019,12286,6697,5589,119.8,11670,6339,5331,118.9
'26003, 동부,'030005, 29세,2019,12005,6713,5292,126.9,11387,6348,5039,126
'26003, 동부,'035,30~34세,2019,59317,32260,27057,119.2,56435,30597,25838,118.4
'26003, 동부,'035001, 30세,2019,11826,6581,5245,125.5,11266,6242,5024,124.2
'26003, 동부,'035002, 31세,2019,11590,6470,5120,126.4,10958,6104,4854,125.8
'26003, 동부,'035003, 32세,2019,11722,6322,5400,117.1,11136,6000,5136,116.8
'26003, 동부,'035004, 33세,2019,11975,6416,5559,115.4,11379,6061,5318,114
'26003, 동부,'035005, 34세,2019,12204,6471,5733,112.9,11696,6190,5506,112.4
'26003, 동부,'040,35~39세,2019,76660,40024,36636,109.2,74495,38748,35747,108.4
'26003, 동부,'040001, 35세,2019,13158,6946,6212,111.8,12653,6650,6003,110.8
'26003, 동부,'040002, 36세,2019,14763,7658,7105,107.8,14299,7376,6923,106.5
'26003, 동부,'040003, 37세,2019,15969,8240,7729,106.6,15536,7993,7543,106
'26003, 동부,'040004, 38세,2019,16018,8438,7580,111.3,15640,8203,7437,110.3
'26003, 동부,'040005, 39세,2019,16752,8742,8010,109.1,16367,8526,7841,108.7
'26003, 동부,'045,40~44세,2019,71066,36928,34138,108.2,69451,36004,33447,107.6
'26003, 동부,'045001, 40세,2019,15249,7976,7273,109.7,14891,7756,7135,108.7
'26003, 동부,'045002, 41세,2019,14084,7388,6696,110.3,13745,7223,6522,110.7
'26003, 동부,'045003, 42세,2019,14281,7422,6859,108.2,13942,7216,6726,107.3
'26003, 동부,'045004, 43세,2019,13280,6920,6360,108.8,12997,6750,6247,108.1
'26003, 동부,'045005, 44세,2019,14172,7222,6950,103.9,13876,7059,6817,103.5
'26003, 동부,'050,45~49세,2019,80900,39933,40967,97.5,79211,38971,40240,96.8
'26003, 동부,'050001, 45세,2019,15264,7582,7682,98.7,14946,7394,7552,97.9
'26003, 동부,'050002, 46세,2019,15695,7769,7926,98,15378,7603,7775,97.8
'26003, 동부,'050003, 47세,2019,15820,7827,7993,97.9,15499,7650,7849,97.5
'26003, 동부,'050004, 48세,2019,17155,8479,8676,97.7,16773,8260,8513,97
'26003, 동부,'050005, 49세,2019,16966,8276,8690,95.2,16615,8064,8551,94.3
'26003, 동부,'055,50~54세,2019,86768,43310,43458,99.7,85191,42420,42771,99.2
'26003, 동부,'055001, 50세,2019,17556,8607,8949,96.2,17206,8406,8800,95.5
'26003, 동부,'055002, 51세,2019,17984,8756,9228,94.9,17624,8548,9076,94.2
'26003, 동부,'055003, 52세,2019,16888,8200,8688,94.4,16635,8063,8572,94.1
'26003, 동부,'055004, 53세,2019,17087,8912,8175,109,16777,8733,8044,108.6
'26003, 동부,'055005, 54세,2019,17253,8835,8418,105,16949,8670,8279,104.7
'26003, 동부,'060,55~59세,2019,83424,42725,40699,105,82175,42054,40121,104.8
'26003, 동부,'060001, 55세,2019,15583,7985,7598,105.1,15278,7821,7457,104.9
'26003, 동부,'060002, 56세,2019,16364,8488,7876,107.8,16053,8315,7738,107.5
'26003, 동부,'060003, 57세,2019,16603,8650,7953,108.8,16372,8535,7837,108.9
'26003, 동부,'060004, 58세,2019,17993,9165,8828,103.8,17821,9075,8746,103.8
'26003, 동부,'060005, 59세,2019,16881,8437,8444,99.9,16651,8308,8343,99.6
'26003, 동부,'065,60~64세,2019,65465,32976,32489,101.5,64749,32584,32165,101.3
'26003, 동부,'065001, 60세,2019,15091,7690,7401,103.9,14936,7601,7335,103.6
'26003, 동부,'065002, 61세,2019,13739,7016,6723,104.4,13571,6929,6642,104.3
'26003, 동부,'065003, 62세,2019,13130,6614,6516,101.5,12973,6529,6444,101.3
'26003, 동부,'065004, 63세,2019,11787,5849,5938,98.5,11665,5779,5886,98.2
'26003, 동부,'065005, 64세,2019,11718,5807,5911,98.2,11604,5746,5858,98.1
'26003, 동부,'070,65~69세,2019,40095,20169,19926,101.2,39722,19991,19731,101.3
'26003, 동부,'070001, 65세,2019,9584,4824,4760,101.3,9470,4765,4705,101.3
'26003, 동부,'070002, 66세,2019,8617,4304,4313,99.8,8538,4269,4269,100
'26003, 동부,'070003, 67세,2019,8688,4416,4272,103.4,8618,4381,4237,103.4
'26003, 동부,'070004, 68세,2019,6683,3367,3316,101.5,6623,3340,3283,101.7
'26003, 동부,'070005, 69세,2019,6523,3258,3265,99.8,6473,3236,3237,100
'26003, 동부,'075,70~74세,2019,25511,12631,12880,98.1,25361,12565,12796,98.2
'26003, 동부,'075001, 70세,2019,6386,3240,3146,103,6335,3216,3119,103.1
'26003, 동부,'075002, 71세,2019,6168,3055,3113,98.1,6141,3038,3103,97.9
'26003, 동부,'075003, 72세,2019,5457,2670,2787,95.8,5429,2660,2769,96.1
'26003, 동부,'075004, 73세,2019,3798,1886,1912,98.6,3773,1878,1895,99.1
'26003, 동부,'075005, 74세,2019,3702,1780,1922,92.6,3683,1773,1910,92.8
'26003, 동부,'080,75~79세,2019,17765,7795,9970,78.2,17695,7768,9927,78.3
'26003, 동부,'080001, 75세,2019,3771,1724,2047,84.2,3757,1720,2037,84.4
'26003, 동부,'080002, 76세,2019,3922,1763,2159,81.7,3908,1756,2152,81.6
'26003, 동부,'080003, 77세,2019,4183,1863,2320,80.3,4167,1857,2310,80.4
'26003, 동부,'080004, 78세,2019,3034,1294,1740,74.4,3019,1287,1732,74.3
'26003, 동부,'080005, 79세,2019,2855,1151,1704,67.5,2844,1148,1696,67.7
'26003, 동부,'085,80~84세,2019,10284,3533,6751,52.3,10236,3523,6713,52.5
'26003, 동부,'085001, 80세,2019,2664,1089,1575,69.1,2651,1086,1565,69.4
'26003, 동부,'085002, 81세,2019,2234,771,1463,52.7,2228,769,1459,52.7
'26003, 동부,'085003, 82세,2019,2009,663,1346,49.3,1992,660,1332,49.5
'26003, 동부,'085004, 83세,2019,1795,535,1260,42.5,1789,533,1256,42.4
'26003, 동부,'085005, 84세,2019,1582,475,1107,42.9,1576,475,1101,43.1
'26003, 동부,'086,85세이상,2019,6575,1475,5100,28.9,6541,1467,5074,28.9
'26003, 동부,'090,85~89세,2019,4698,1202,3496,34.4,4674,1197,3477,34.4
'26003, 동부,'090001, 85세,2019,1350,411,939,43.8,1345,410,935,43.9
'26003, 동부,'090002, 86세,2019,1167,317,850,37.3,1163,316,847,37.3
'26003, 동부,'090003, 87세,2019,911,221,690,32,909,220,689,31.9
'26003, 동부,'090004, 88세,2019,696,142,554,25.6,690,141,549,25.7
'26003, 동부,'090005, 89세,2019,574,111,463,24,567,110,457,24.1
'26003, 동부,'095,90~94세,2019,1521,230,1291,17.8,1512,227,1285,17.7
'26003, 동부,'095001, 90세,2019,488,101,387,26.1,484,100,384,26
'26003, 동부,'095002, 91세,2019,376,48,328,14.6,375,48,327,14.7
'26003, 동부,'095003, 92세,2019,303,42,261,16.1,302,41,261,15.7
'26003, 동부,'095004, 93세,2019,190,22,168,13.1,188,21,167,12.6
'26003, 동부,'095005, 94세,2019,164,17,147,11.6,163,17,146,11.6
'26003, 동부,'100,95~99세,2019,329,41,288,14.2,328,41,287,14.3
'26003, 동부,'100001, 95세,2019,107,13,94,13.8,107,13,94,13.8
'26003, 동부,'100002, 96세,2019,97,17,80,21.3,97,17,80,21.3
'26003, 동부,'100003, 97세,2019,59,X,56,5.4,58,X,55,5.5
'26003, 동부,'100004, 98세,2019,38,X,34,11.8,38,X,34,11.8
'26003, 동부,'100005, 99세,2019,28,X,24,16.7,28,X,24,16.7
'26003, 동부,'101,100세이상,2019,27,X,25,8,27,X,25,8
'26003, 동부,'102,15세미만,2019,128697,66658,62039,107.4,127990,66297,61693,107.5
'26003, 동부,'103,15~64세,2019,688264,360699,327565,110.1,671518,351175,320343,109.6
'26003, 동부,'104,65세이상,2019,100230,45603,54627,83.5,99555,45314,54241,83.5
'26003, 동부,'126,평균연령,2019,40.6,39.6,41.6,,40.6,39.7,41.7,
'26003, 동부,'127,중위연령,2019,42,40.6,43.5,,42.2,40.8,43.7,
'26010, 중구,'000,합계,2019,219428,111433,107995,103.2,216449,110164,106285,103.6
'26010, 중구,'005,0~4세,2019,7873,4088,3785,108,7814,4059,3755,108.1
'26010, 중구,'005001, 0세,2019,1168,621,547,113.5,1162,618,544,113.6
'26010, 중구,'005002, 1세,2019,1368,709,659,107.6,1355,702,653,107.5
'26010, 중구,'005003, 2세,2019,1605,831,774,107.4,1595,828,767,108
'26010, 중구,'005004, 3세,2019,1828,946,882,107.3,1813,941,872,107.9
'26010, 중구,'005005, 4세,2019,1904,981,923,106.3,1889,970,919,105.5
'26010, 중구,'010,5~9세,2019,10253,5351,4902,109.2,10203,5324,4879,109.1
'26010, 중구,'010001, 5세,2019,1959,995,964,103.2,1944,985,959,102.7
'26010, 중구,'010002, 6세,2019,1988,1035,953,108.6,1975,1029,946,108.8
'26010, 중구,'010003, 7세,2019,2133,1150,983,117,2122,1144,978,117
'26010, 중구,'010004, 8세,2019,2151,1107,1044,106,2147,1104,1043,105.8
'26010, 중구,'010005, 9세,2019,2022,1064,958,111.1,2015,1062,953,111.4
'26010, 중구,'015,10~14세,2019,9551,5078,4473,113.5,9530,5068,4462,113.6
'26010, 중구,'015001, 10세,2019,1918,1031,887,116.2,1911,1028,883,116.4
'26010, 중구,'015002, 11세,2019,1994,1037,957,108.4,1992,1036,956,108.4
'26010, 중구,'015003, 12세,2019,2036,1093,943,115.9,2031,1089,942,115.6
'26010, 중구,'015004, 13세,2019,1806,947,859,110.2,1805,947,858,110.4
'26010, 중구,'015005, 14세,2019,1797,970,827,117.3,1791,968,823,117.6
'26010, 중구,'020,15~19세,2019,10681,5784,4897,118.1,10640,5771,4869,118.5
'26010, 중구,'020001, 15세,2019,1985,1071,914,117.2,1980,1069,911,117.3
'26010, 중구,'020002, 16세,2019,2169,1143,1026,111.4,2166,1142,1024,111.5
'26010, 중구,'020003, 17세,2019,2128,1075,1053,102.1,2118,1070,1048,102.1
'26010, 중구,'020004, 18세,2019,2368,1295,1073,120.7,2358,1293,1065,121.4
'26010, 중구,'020005, 19세,2019,2031,1200,831,144.4,2018,1197,821,145.8
'26010, 중구,'025,20~24세,2019,12620,7338,5282,138.9,12429,7290,5139,141.9
'26010, 중구,'025001, 20세,2019,2110,1337,773,173,2082,1328,754,176.1
'26010, 중구,'025002, 21세,2019,2475,1516,959,158.1,2447,1510,937,161.2
'26010, 중구,'025003, 22세,2019,2573,1464,1109,132,2530,1454,1076,135.1
'26010, 중구,'025004, 23세,2019,2663,1512,1151,131.4,2635,1506,1129,133.4
'26010, 중구,'025005, 24세,2019,2799,1509,1290,117,2735,1492,1243,120
'26010, 중구,'030,25~29세,2019,14159,7802,6357,122.7,13836,7708,6128,125.8
'26010, 중구,'030001, 25세,2019,2962,1660,1302,127.5,2895,1647,1248,132
'26010, 중구,'030002, 26세,2019,2963,1649,1314,125.5,2901,1630,1271,128.2
'26010, 중구,'030003, 27세,2019,2776,1524,1252,121.7,2729,1511,1218,124.1
'26010, 중구,'030004, 28세,2019,2802,1506,1296,116.2,2729,1480,1249,118.5
'26010, 중구,'030005, 29세,2019,2656,1463,1193,122.6,2582,1440,1142,126.1
'26010, 중구,'035,30~34세,2019,12420,6530,5890,110.9,12024,6382,5642,113.1
'26010, 중구,'035001, 30세,2019,2572,1405,1167,120.4,2498,1384,1114,124.2
'26010, 중구,'035002, 31세,2019,2461,1306,1155,113.1,2376,1275,1101,115.8
'26010, 중구,'035003, 32세,2019,2376,1250,1126,111,2286,1216,1070,113.6
'26010, 중구,'035004, 33세,2019,2491,1319,1172,112.5,2409,1279,1130,113.2
'26010, 중구,'035005, 34세,2019,2520,1250,1270,98.4,2455,1228,1227,100.1
'26010, 중구,'040,35~39세,2019,16310,8370,7940,105.4,16000,8246,7754,106.3
'26010, 중구,'040001, 35세,2019,2790,1447,1343,107.7,2709,1416,1293,109.5
'26010, 중구,'040002, 36세,2019,3103,1613,1490,108.3,3048,1589,1459,108.9
'26010, 중구,'040003, 37세,2019,3373,1685,1688,99.8,3313,1664,1649,100.9
'26010, 중구,'040004, 38세,2019,3392,1736,1656,104.8,3333,1709,1624,105.2
'26010, 중구,'040005, 39세,2019,3652,1889,1763,107.1,3597,1868,1729,108
'26010, 중구,'045,40~44세,2019,15941,8231,7710,106.8,15670,8116,7554,107.4
'26010, 중구,'045001, 40세,2019,3441,1786,1655,107.9,3375,1748,1627,107.4
'26010, 중구,'045002, 41세,2019,3140,1648,1492,110.5,3069,1627,1442,112.8
'26010, 중구,'045003, 42세,2019,3192,1656,1536,107.8,3146,1637,1509,108.5
'26010, 중구,'045004, 43세,2019,2939,1493,1446,103.3,2898,1476,1422,103.8
'26010, 중구,'045005, 44세,2019,3229,1648,1581,104.2,3182,1628,1554,104.8
'26010, 중구,'050,45~49세,2019,19247,9456,9791,96.6,18931,9307,9624,96.7
'26010, 중구,'050001, 45세,2019,3563,1791,1772,101.1,3507,1763,1744,101.1
'26010, 중구,'050002, 46세,2019,3766,1860,1906,97.6,3717,1844,1873,98.5
'26010, 중구,'050003, 47세,2019,3813,1873,1940,96.5,3754,1847,1907,96.9
'26010, 중구,'050004, 48세,2019,4109,2020,2089,96.7,4029,1982,2047,96.8
'26010, 중구,'050005, 49세,2019,3996,1912,2084,91.7,3924,1871,2053,91.1
'26010, 중구,'055,50~54세,2019,21160,10419,10741,97,20826,10242,10584,96.8
'26010, 중구,'055001, 50세,2019,4177,1992,2185,91.2,4114,1964,2150,91.3
'26010, 중구,'055002, 51세,2019,4366,2106,2260,93.2,4293,2065,2228,92.7
'26010, 중구,'055003, 52세,2019,4125,2019,2106,95.9,4076,1991,2085,95.5
'26010, 중구,'055004, 53세,2019,4123,2109,2014,104.7,4053,2072,1981,104.6
'26010, 중구,'055005, 54세,2019,4369,2193,2176,100.8,4290,2150,2140,100.5
'26010, 중구,'060,55~59세,2019,21202,10689,10513,101.7,20898,10537,10361,101.7
'26010, 중구,'060001, 55세,2019,3982,2026,1956,103.6,3904,1991,1913,104.1
'26010, 중구,'060002, 56세,2019,3997,1991,2006,99.3,3921,1957,1964,99.6
'26010, 중구,'060003, 57세,2019,4229,2210,2019,109.5,4172,2174,1998,108.8
'26010, 중구,'060004, 58세,2019,4724,2381,2343,101.6,4682,2362,2320,101.8
'26010, 중구,'060005, 59세,2019,4270,2081,2189,95.1,4219,2053,2166,94.8
'26010, 중구,'065,60~64세,2019,17801,8703,9098,95.7,17612,8602,9010,95.5
'26010, 중구,'065001, 60세,2019,3969,1976,1993,99.1,3933,1954,1979,98.7
'26010, 중구,'065002, 61세,2019,3656,1831,1825,100.3,3608,1810,1798,100.7
'26010, 중구,'065003, 62세,2019,3588,1790,1798,99.6,3551,1773,1778,99.7
'26010, 중구,'065004, 63세,2019,3329,1593,1736,91.8,3289,1570,1719,91.3
'26010, 중구,'065005, 64세,2019,3259,1513,1746,86.7,3231,1495,1736,86.1
'26010, 중구,'070,65~69세,2019,11714,5765,5949,96.9,11604,5709,5895,96.8
'26010, 중구,'070001, 65세,2019,2740,1363,1377,99,2712,1350,1362,99.1
'26010, 중구,'070002, 66세,2019,2506,1215,1291,94.1,2485,1203,1282,93.8
'26010, 중구,'070003, 67세,2019,2548,1253,1295,96.8,2519,1236,1283,96.3
'26010, 중구,'070004, 68세,2019,2019,1006,1013,99.3,2002,999,1003,99.6
'26010, 중구,'070005, 69세,2019,1901,928,973,95.4,1886,921,965,95.4
'26010, 중구,'075,70~74세,2019,7759,3737,4022,92.9,7726,3720,4006,92.9
'26010, 중구,'075001, 70세,2019,1995,1013,982,103.2,1977,1005,972,103.4
'26010, 중구,'075002, 71세,2019,1801,834,967,86.2,1795,830,965,86
'26010, 중구,'075003, 72세,2019,1664,776,888,87.4,1656,772,884,87.3
'26010, 중구,'075004, 73세,2019,1105,545,560,97.3,1104,544,560,97.1
'26010, 중구,'075005, 74세,2019,1194,569,625,91,1194,569,625,91
'26010, 중구,'080,75~79세,2019,5718,2452,3266,75.1,5706,2446,3260,75
'26010, 중구,'080001, 75세,2019,1241,515,726,70.9,1237,513,724,70.9
'26010, 중구,'080002, 76세,2019,1237,563,674,83.5,1234,562,672,83.6
'26010, 중구,'080003, 77세,2019,1326,575,751,76.6,1324,575,749,76.8
'26010, 중구,'080004, 78세,2019,985,421,564,74.6,982,418,564,74.1
'26010, 중구,'080005, 79세,2019,929,378,551,68.6,929,378,551,68.6
'26010, 중구,'085,80~84세,2019,3207,1183,2024,58.4,3199,1182,2017,58.6
'26010, 중구,'085001, 80세,2019,848,349,499,69.9,845,349,496,70.4
'26010, 중구,'085002, 81세,2019,699,262,437,60,698,262,436,60.1
'26010, 중구,'085003, 82세,2019,604,217,387,56.1,604,217,387,56.1
'26010, 중구,'085004, 83세,2019,585,197,388,50.8,583,196,387,50.6
'26010, 중구,'085005, 84세,2019,471,158,313,50.5,469,158,311,50.8
'26010, 중구,'086,85세이상,2019,1812,457,1355,33.7,1801,455,1346,33.8
'26010, 중구,'090,85~89세,2019,1324,380,944,40.3,1317,379,938,40.4
'26010, 중구,'090001, 85세,2019,347,120,227,52.9,346,120,226,53.1
'26010, 중구,'090002, 86세,2019,349,100,249,40.2,347,100,247,40.5
'26010, 중구,'090003, 87세,2019,270,73,197,37.1,268,72,196,36.7
'26010, 중구,'090004, 88세,2019,219,53,166,31.9,217,53,164,32.3
'26010, 중구,'090005, 89세,2019,139,34,105,32.4,139,34,105,32.4
'26010, 중구,'095,90~94세,2019,413,69,344,20.1,410,68,342,19.9
'26010, 중구,'095001, 90세,2019,139,32,107,29.9,137,31,106,29.2
'26010, 중구,'095002, 91세,2019,108,14,94,14.9,108,14,94,14.9
'26010, 중구,'095003, 92세,2019,81,12,69,17.4,81,12,69,17.4
'26010, 중구,'095004, 93세,2019,46,7,39,17.9,45,7,38,18.4
'26010, 중구,'095005, 94세,2019,39,X,35,11.4,39,X,35,11.4
'26010, 중구,'100,95~99세,2019,65,7,58,12.1,64,7,57,12.3
'26010, 중구,'100001, 95세,2019,22,X,21,4.8,22,X,21,4.8
'26010, 중구,'100002, 96세,2019,21,X,17,23.5,21,X,17,23.5
'26010, 중구,'100003, 97세,2019,13,X,13,0,12,X,12,0
'26010, 중구,'100004, 98세,2019,5,X,X,25,5,X,X,25
'26010, 중구,'100005, 99세,2019,X,X,X,33.3,X,X,X,33.3
'26010, 중구,'101,100세이상,2019,10,X,9,11.1,10,X,9,11.1
'26010, 중구,'102,15세미만,2019,27677,14517,13160,110.3,27547,14451,13096,110.3
'26010, 중구,'103,15~64세,2019,161541,83322,78219,106.5,158866,82201,76665,107.2
'26010, 중구,'104,65세이상,2019,30210,13594,16616,81.8,30036,13512,16524,81.8
'26010, 중구,'126,평균연령,2019,42.6,41.4,43.8,,42.6,41.4,43.9,
'26010, 중구,'127,중위연령,2019,45,43.2,46.5,,45,43.2,46.6,
'26020, 남구,'000,합계,2019,322135,164591,157544,104.5,315224,160907,154317,104.3
'26020, 남구,'005,0~4세,2019,11188,5733,5455,105.1,11043,5661,5382,105.2
'26020, 남구,'005001, 0세,2019,1867,942,925,101.8,1840,927,913,101.5
'26020, 남구,'005002, 1세,2019,1891,933,958,97.4,1864,919,945,97.2
'26020, 남구,'005003, 2세,2019,2203,1120,1083,103.4,2168,1103,1065,103.6
'26020, 남구,'005004, 3세,2019,2522,1330,1192,111.6,2489,1316,1173,112.2
'26020, 남구,'005005, 4세,2019,2705,1408,1297,108.6,2682,1396,1286,108.6
'26020, 남구,'010,5~9세,2019,13540,7008,6532,107.3,13460,6968,6492,107.3
'26020, 남구,'010001, 5세,2019,2598,1326,1272,104.2,2574,1312,1262,104
'26020, 남구,'010002, 6세,2019,2670,1334,1336,99.9,2651,1326,1325,100.1
'26020, 남구,'010003, 7세,2019,2811,1450,1361,106.5,2804,1448,1356,106.8
'26020, 남구,'010004, 8세,2019,2793,1483,1310,113.2,2779,1475,1304,113.1
'26020, 남구,'010005, 9세,2019,2668,1415,1253,112.9,2652,1407,1245,113
'26020, 남구,'015,10~14세,2019,13992,7289,6703,108.7,13927,7254,6673,108.7
'26020, 남구,'015001, 10세,2019,2726,1407,1319,106.7,2711,1395,1316,106
'26020, 남구,'015002, 11세,2019,2897,1483,1414,104.9,2883,1473,1410,104.5
'26020, 남구,'015003, 12세,2019,2915,1558,1357,114.8,2901,1553,1348,115.2
'26020, 남구,'015004, 13세,2019,2718,1374,1344,102.2,2710,1371,1339,102.4
'26020, 남구,'015005, 14세,2019,2736,1467,1269,115.6,2722,1462,1260,116
'26020, 남구,'020,15~19세,2019,16929,9203,7726,119.1,16747,9101,7646,119
'26020, 남구,'020001, 15세,2019,3130,1662,1468,113.2,3124,1661,1463,113.5
'26020, 남구,'020002, 16세,2019,2951,1583,1368,115.7,2944,1581,1363,116
'26020, 남구,'020003, 17세,2019,3164,1670,1494,111.8,3139,1654,1485,111.4
'26020, 남구,'020004, 18세,2019,3780,2079,1701,122.2,3730,2051,1679,122.2
'26020, 남구,'020005, 19세,2019,3904,2209,1695,130.3,3810,2154,1656,130.1
'26020, 남구,'025,20~24세,2019,23047,13180,9867,133.6,22214,12704,9510,133.6
'26020, 남구,'025001, 20세,2019,4079,2358,1721,137,3950,2281,1669,136.7
'26020, 남구,'025002, 21세,2019,4394,2498,1896,131.8,4264,2427,1837,132.1
'26020, 남구,'025003, 22세,2019,4772,2769,2003,138.2,4593,2652,1941,136.6
'26020, 남구,'025004, 23세,2019,4882,2733,2149,127.2,4693,2630,2063,127.5
'26020, 남구,'025005, 24세,2019,4920,2822,2098,134.5,4714,2714,2000,135.7
'26020, 남구,'030,25~29세,2019,23603,13264,10339,128.3,22642,12777,9865,129.5
'26020, 남구,'030001, 25세,2019,4839,2798,2041,137.1,4651,2708,1943,139.4
'26020, 남구,'030002, 26세,2019,4990,2788,2202,126.6,4815,2695,2120,127.1
'26020, 남구,'030003, 27세,2019,4927,2786,2141,130.1,4760,2708,2052,132
'26020, 남구,'030004, 28세,2019,4519,2501,2018,123.9,4309,2391,1918,124.7
'26020, 남구,'030005, 29세,2019,4328,2391,1937,123.4,4107,2275,1832,124.2
'26020, 남구,'035,30~34세,2019,19984,10784,9200,117.2,19047,10308,8739,118
'26020, 남구,'035001, 30세,2019,4180,2258,1922,117.5,3982,2148,1834,117.1
'26020, 남구,'035002, 31세,2019,4009,2238,1771,126.4,3785,2122,1663,127.6
'26020, 남구,'035003, 32세,2019,3930,2109,1821,115.8,3760,2023,1737,116.5
'26020, 남구,'035004, 33세,2019,3901,2068,1833,112.8,3715,1972,1743,113.1
'26020, 남구,'035005, 34세,2019,3964,2111,1853,113.9,3805,2043,1762,115.9
'26020, 남구,'040,35~39세,2019,23721,12218,11503,106.2,23040,11859,11181,106.1
'26020, 남구,'040001, 35세,2019,4100,2132,1968,108.3,3957,2051,1906,107.6
'26020, 남구,'040002, 36세,2019,4456,2323,2133,108.9,4303,2242,2061,108.8
'26020, 남구,'040003, 37세,2019,4982,2530,2452,103.2,4844,2463,2381,103.4
'26020, 남구,'040004, 38세,2019,5027,2623,2404,109.1,4904,2561,2343,109.3
'26020, 남구,'040005, 39세,2019,5156,2610,2546,102.5,5032,2542,2490,102.1
'26020, 남구,'045,40~44세,2019,22964,11355,11609,97.8,22419,11065,11354,97.5
'26020, 남구,'045001, 40세,2019,4728,2357,2371,99.4,4604,2290,2314,99
'26020, 남구,'045002, 41세,2019,4457,2285,2172,105.2,4348,2231,2117,105.4
'26020, 남구,'045003, 42세,2019,4581,2292,2289,100.1,4463,2223,2240,99.2
'26020, 남구,'045004, 43세,2019,4412,2143,2269,94.4,4312,2088,2224,93.9
'26020, 남구,'045005, 44세,2019,4786,2278,2508,90.8,4692,2233,2459,90.8
'26020, 남구,'050,45~49세,2019,30201,14408,15793,91.2,29555,14046,15509,90.6
'26020, 남구,'050001, 45세,2019,5433,2538,2895,87.7,5317,2470,2847,86.8
'26020, 남구,'050002, 46세,2019,5754,2723,3031,89.8,5627,2656,2971,89.4
'26020, 남구,'050003, 47세,2019,5858,2787,3071,90.8,5742,2726,3016,90.4
'26020, 남구,'050004, 48세,2019,6564,3148,3416,92.2,6413,3064,3349,91.5
'26020, 남구,'050005, 49세,2019,6592,3212,3380,95,6456,3130,3326,94.1
'26020, 남구,'055,50~54세,2019,32482,16240,16242,100,31805,15864,15941,99.5
'26020, 남구,'055001, 50세,2019,6653,3248,3405,95.4,6498,3160,3338,94.7
'26020, 남구,'055002, 51세,2019,6787,3316,3471,95.5,6639,3231,3408,94.8
'26020, 남구,'055003, 52세,2019,6303,3022,3281,92.1,6201,2972,3229,92
'26020, 남구,'055004, 53세,2019,6346,3323,3023,109.9,6203,3241,2962,109.4
'26020, 남구,'055005, 54세,2019,6393,3331,3062,108.8,6264,3260,3004,108.5
'26020, 남구,'060,55~59세,2019,30314,15457,14857,104,29767,15152,14615,103.7
'26020, 남구,'060001, 55세,2019,5684,2887,2797,103.2,5557,2815,2742,102.7
'26020, 남구,'060002, 56세,2019,6070,3133,2937,106.7,5927,3052,2875,106.2
'26020, 남구,'060003, 57세,2019,6023,3083,2940,104.9,5918,3031,2887,105
'26020, 남구,'060004, 58세,2019,6434,3325,3109,106.9,6363,3284,3079,106.7
'26020, 남구,'060005, 59세,2019,6103,3029,3074,98.5,6002,2970,3032,98
'26020, 남구,'065,60~64세,2019,23776,11928,11848,100.7,23452,11743,11709,100.3
'26020, 남구,'065001, 60세,2019,5438,2703,2735,98.8,5355,2653,2702,98.2
'26020, 남구,'065002, 61세,2019,4938,2463,2475,99.5,4869,2427,2442,99.4
'26020, 남구,'065003, 62세,2019,4785,2430,2355,103.2,4708,2385,2323,102.7
'26020, 남구,'065004, 63세,2019,4270,2126,2144,99.2,4224,2101,2123,99
'26020, 남구,'065005, 64세,2019,4345,2206,2139,103.1,4296,2177,2119,102.7
'26020, 남구,'070,65~69세,2019,14650,7316,7334,99.8,14496,7243,7253,99.9
'26020, 남구,'070001, 65세,2019,3563,1803,1760,102.4,3506,1770,1736,102
'26020, 남구,'070002, 66세,2019,3176,1576,1600,98.5,3142,1563,1579,99
'26020, 남구,'070003, 67세,2019,3102,1557,1545,100.8,3080,1550,1530,101.3
'26020, 남구,'070004, 68세,2019,2407,1187,1220,97.3,2379,1173,1206,97.3
'26020, 남구,'070005, 69세,2019,2402,1193,1209,98.7,2389,1187,1202,98.8
'26020, 남구,'075,70~74세,2019,9216,4557,4659,97.8,9155,4532,4623,98
'26020, 남구,'075001, 70세,2019,2252,1130,1122,100.7,2233,1122,1111,101
'26020, 남구,'075002, 71세,2019,2337,1184,1153,102.7,2326,1177,1149,102.4
'26020, 남구,'075003, 72세,2019,1919,957,962,99.5,1910,953,957,99.6
'26020, 남구,'075004, 73세,2019,1401,664,737,90.1,1389,659,730,90.3
'26020, 남구,'075005, 74세,2019,1307,622,685,90.8,1297,621,676,91.9
'26020, 남구,'080,75~79세,2019,6368,2834,3534,80.2,6334,2821,3513,80.3
'26020, 남구,'080001, 75세,2019,1359,626,733,85.4,1353,626,727,86.1
'26020, 남구,'080002, 76세,2019,1380,619,761,81.3,1374,615,759,81
'26020, 남구,'080003, 77세,2019,1496,685,811,84.5,1488,680,808,84.2
'26020, 남구,'080004, 78세,2019,1099,487,612,79.6,1091,484,607,79.7
'26020, 남구,'080005, 79세,2019,1034,417,617,67.6,1028,416,612,68
'26020, 남구,'085,80~84세,2019,3710,1271,2439,52.1,3686,1266,2420,52.3
'26020, 남구,'085001, 80세,2019,974,398,576,69.1,967,397,570,69.6
'26020, 남구,'085002, 81세,2019,780,262,518,50.6,779,261,518,50.4
'26020, 남구,'085003, 82세,2019,744,252,492,51.2,732,250,482,51.9
'26020, 남구,'085004, 83세,2019,624,180,444,40.5,623,179,444,40.3
'26020, 남구,'085005, 84세,2019,588,179,409,43.8,585,179,406,44.1
'26020, 남구,'086,85세이상,2019,2450,546,1904,28.7,2435,543,1892,28.7
'26020, 남구,'090,85~89세,2019,1736,442,1294,34.2,1727,441,1286,34.3
'26020, 남구,'090001, 85세,2019,533,163,370,44.1,531,163,368,44.3
'26020, 남구,'090002, 86세,2019,423,103,320,32.2,423,103,320,32.2
'26020, 남구,'090003, 87세,2019,313,84,229,36.7,313,84,229,36.7
'26020, 남구,'090004, 88세,2019,254,49,205,23.9,253,49,204,24
'26020, 남구,'090005, 89세,2019,213,43,170,25.3,207,42,165,25.5
'26020, 남구,'095,90~94세,2019,578,86,492,17.5,572,84,488,17.2
'26020, 남구,'095001, 90세,2019,181,38,143,26.6,179,38,141,27
'26020, 남구,'095002, 91세,2019,142,17,125,13.6,141,17,124,13.7
'26020, 남구,'095003, 92세,2019,111,16,95,16.8,110,15,95,15.8
'26020, 남구,'095004, 93세,2019,79,10,69,14.5,78,9,69,13
'26020, 남구,'095005, 94세,2019,65,5,60,8.3,64,5,59,8.5
'26020, 남구,'100,95~99세,2019,127,17,110,15.5,127,17,110,15.5
'26020, 남구,'100001, 95세,2019,46,7,39,17.9,46,7,39,17.9
'26020, 남구,'100002, 96세,2019,40,8,32,25,40,8,32,25
'26020, 남구,'100003, 97세,2019,18,X,17,5.9,18,X,17,5.9
'26020, 남구,'100004, 98세,2019,14,X,13,7.7,14,X,13,7.7
'26020, 남구,'100005, 99세,2019,9,X,9,0,9,X,9,0
'26020, 남구,'101,100세이상,2019,9,X,8,12.5,9,X,8,12.5
'26020, 남구,'102,15세미만,2019,38720,20030,18690,107.2,38430,19883,18547,107.2
'26020, 남구,'103,15~64세,2019,247021,128037,118984,107.6,240688,124619,116069,107.4
'26020, 남구,'104,65세이상,2019,36394,16524,19870,83.2,36106,16405,19701,83.3
'26020, 남구,'126,평균연령,2019,41.4,40.3,42.4,,41.4,40.4,42.5,
'26020, 남구,'127,중위연령,2019,43.3,41.6,44.9,,43.5,41.7,45.1,
'26030, 동구,'000,합계,2019,162104,86075,76029,113.2,157271,82900,74371,111.5
'26030, 동구,'005,0~4세,2019,7363,3785,3578,105.8,7276,3747,3529,106.2
'26030, 동구,'005001, 0세,2019,1093,551,542,101.7,1082,547,535,102.2
'26030, 동구,'005002, 1세,2019,1240,629,611,102.9,1222,624,598,104.3
'26030, 동구,'005003, 2세,2019,1524,801,723,110.8,1507,794,713,111.4
'26030, 동구,'005004, 3세,2019,1755,899,856,105,1735,890,845,105.3
'26030, 동구,'005005, 4세,2019,1751,905,846,107,1730,892,838,106.4
'26030, 동구,'010,5~9세,2019,9091,4697,4394,106.9,9007,4647,4360,106.6
'26030, 동구,'010001, 5세,2019,1849,911,938,97.1,1829,900,929,96.9
'26030, 동구,'010002, 6세,2019,1739,903,836,108,1722,892,830,107.5
'26030, 동구,'010003, 7세,2019,1915,984,931,105.7,1891,968,923,104.9
'26030, 동구,'010004, 8세,2019,1785,937,848,110.5,1775,930,845,110.1
'26030, 동구,'010005, 9세,2019,1803,962,841,114.4,1790,957,833,114.9
'26030, 동구,'015,10~14세,2019,7722,4054,3668,110.5,7683,4032,3651,110.4
'26030, 동구,'015001, 10세,2019,1596,818,778,105.1,1588,814,774,105.2
'26030, 동구,'015002, 11세,2019,1601,853,748,114,1591,847,744,113.8
'26030, 동구,'015003, 12세,2019,1681,852,829,102.8,1672,847,825,102.7
'26030, 동구,'015004, 13세,2019,1484,811,673,120.5,1475,806,669,120.5
'26030, 동구,'015005, 14세,2019,1360,720,640,112.5,1357,718,639,112.4
'26030, 동구,'020,15~19세,2019,7835,4169,3666,113.7,7751,4127,3624,113.9
'26030, 동구,'020001, 15세,2019,1436,773,663,116.6,1428,769,659,116.7
'26030, 동구,'020002, 16세,2019,1627,867,760,114.1,1625,866,759,114.1
'26030, 동구,'020003, 17세,2019,1644,858,786,109.2,1640,857,783,109.5
'26030, 동구,'020004, 18세,2019,1724,917,807,113.6,1707,909,798,113.9
'26030, 동구,'020005, 19세,2019,1404,754,650,116,1351,726,625,116.2
'26030, 동구,'025,20~24세,2019,8517,4963,3554,139.6,8057,4661,3396,137.2
'26030, 동구,'025001, 20세,2019,1464,905,559,161.9,1380,852,528,161.4
'26030, 동구,'025002, 21세,2019,1647,1002,645,155.3,1567,943,624,151.1
'26030, 동구,'025003, 22세,2019,1710,947,763,124.1,1640,903,737,122.5
'26030, 동구,'025004, 23세,2019,1856,1047,809,129.4,1743,979,764,128.1
'26030, 동구,'025005, 24세,2019,1840,1062,778,136.5,1727,984,743,132.4
'26030, 동구,'030,25~29세,2019,10061,5797,4264,136,9287,5252,4035,130.2
'26030, 동구,'030001, 25세,2019,1856,1069,787,135.8,1733,988,745,132.6
'26030, 동구,'030002, 26세,2019,1947,1114,833,133.7,1812,1023,789,129.7
'26030, 동구,'030003, 27세,2019,2083,1204,879,137,1913,1075,838,128.3
'26030, 동구,'030004, 28세,2019,2089,1177,912,129.1,1911,1051,860,122.2
'26030, 동구,'030005, 29세,2019,2086,1233,853,144.5,1918,1115,803,138.9
'26030, 동구,'035,30~34세,2019,11692,6818,4874,139.9,10816,6197,4619,134.2
'26030, 동구,'035001, 30세,2019,2147,1294,853,151.7,1981,1172,809,144.9
'26030, 동구,'035002, 31세,2019,2198,1343,855,157.1,2019,1219,800,152.4
'26030, 동구,'035003, 32세,2019,2361,1365,996,137,2187,1248,939,132.9
'26030, 동구,'035004, 33세,2019,2481,1385,1096,126.4,2286,1243,1043,119.2
'26030, 동구,'035005, 34세,2019,2505,1431,1074,133.2,2343,1315,1028,127.9
'26030, 동구,'040,35~39세,2019,15758,8853,6905,128.2,15059,8363,6696,124.9
'26030, 동구,'040001, 35세,2019,2723,1537,1186,129.6,2555,1421,1134,125.3
'26030, 동구,'040002, 36세,2019,3172,1745,1427,122.3,3022,1642,1380,119
'26030, 동구,'040003, 37세,2019,3293,1847,1446,127.7,3143,1743,1400,124.5
'26030, 동구,'040004, 38세,2019,3198,1820,1378,132.1,3082,1732,1350,128.3
'26030, 동구,'040005, 39세,2019,3372,1904,1468,129.7,3257,1825,1432,127.4
'26030, 동구,'045,40~44세,2019,13350,7412,5938,124.8,12883,7094,5789,122.5
'26030, 동구,'045001, 40세,2019,2913,1650,1263,130.6,2820,1582,1238,127.8
'26030, 동구,'045002, 41세,2019,2766,1495,1271,117.6,2672,1443,1229,117.4
'26030, 동구,'045003, 42세,2019,2652,1436,1216,118.1,2543,1357,1186,114.4
'26030, 동구,'045004, 43세,2019,2457,1409,1048,134.4,2377,1348,1029,131
'26030, 동구,'045005, 44세,2019,2562,1422,1140,124.7,2471,1364,1107,123.2
'26030, 동구,'050,45~49세,2019,12873,6985,5888,118.6,12427,6691,5736,116.6
'26030, 동구,'050001, 45세,2019,2601,1447,1154,125.4,2504,1388,1116,124.4
'26030, 동구,'050002, 46세,2019,2604,1405,1199,117.2,2519,1351,1168,115.7
'26030, 동구,'050003, 47세,2019,2447,1383,1064,130,2364,1325,1039,127.5
'26030, 동구,'050004, 48세,2019,2683,1447,1236,117.1,2588,1382,1206,114.6
'26030, 동구,'050005, 49세,2019,2538,1303,1235,105.5,2452,1245,1207,103.1
'26030, 동구,'055,50~54세,2019,12835,6472,6363,101.7,12510,6278,6232,100.7
'26030, 동구,'055001, 50세,2019,2603,1379,1224,112.7,2534,1334,1200,111.2
'26030, 동구,'055002, 51세,2019,2633,1312,1321,99.3,2545,1259,1286,97.9
'26030, 동구,'055003, 52세,2019,2448,1178,1270,92.8,2398,1151,1247,92.3
'26030, 동구,'055004, 53세,2019,2545,1331,1214,109.6,2488,1298,1190,109.1
'26030, 동구,'055005, 54세,2019,2606,1272,1334,95.4,2545,1236,1309,94.4
'26030, 동구,'060,55~59세,2019,14376,6977,7399,94.3,14126,6838,7288,93.8
'26030, 동구,'060001, 55세,2019,2377,1178,1199,98.2,2313,1143,1170,97.7
'26030, 동구,'060002, 56세,2019,2703,1345,1358,99,2639,1305,1334,97.8
'26030, 동구,'060003, 57세,2019,2797,1383,1414,97.8,2755,1365,1390,98.2
'26030, 동구,'060004, 58세,2019,3216,1497,1719,87.1,3180,1480,1700,87.1
'26030, 동구,'060005, 59세,2019,3283,1574,1709,92.1,3239,1545,1694,91.2
'26030, 동구,'065,60~64세,2019,12928,6608,6320,104.6,12822,6544,6278,104.2
'26030, 동구,'065001, 60세,2019,3006,1559,1447,107.7,2985,1550,1435,108
'26030, 동구,'065002, 61세,2019,2810,1492,1318,113.2,2781,1473,1308,112.6
'26030, 동구,'065003, 62세,2019,2580,1261,1319,95.6,2561,1248,1313,95
'26030, 동구,'065004, 63세,2019,2289,1167,1122,104,2267,1153,1114,103.5
'26030, 동구,'065005, 64세,2019,2243,1129,1114,101.3,2228,1120,1108,101.1
'26030, 동구,'070,65~69세,2019,7696,3998,3698,108.1,7629,3968,3661,108.4
'26030, 동구,'070001, 65세,2019,1781,895,886,101,1766,888,878,101.1
'26030, 동구,'070002, 66세,2019,1659,841,818,102.8,1645,836,809,103.3
'26030, 동구,'070003, 67세,2019,1729,935,794,117.8,1716,928,788,117.8
'26030, 동구,'070004, 68세,2019,1281,677,604,112.1,1274,674,600,112.3
'26030, 동구,'070005, 69세,2019,1246,650,596,109.1,1228,642,586,109.6
'26030, 동구,'075,70~74세,2019,4647,2479,2168,114.3,4605,2461,2144,114.8
'26030, 동구,'075001, 70세,2019,1187,625,562,111.2,1177,619,558,110.9
'26030, 동구,'075002, 71세,2019,1128,615,513,119.9,1122,611,511,119.6
'26030, 동구,'075003, 72세,2019,979,524,455,115.2,971,522,449,116.3
'26030, 동구,'075004, 73세,2019,723,393,330,119.1,713,392,321,122.1
'26030, 동구,'075005, 74세,2019,630,322,308,104.5,622,317,305,103.9
'26030, 동구,'080,75~79세,2019,2793,1290,1503,85.8,2782,1286,1496,86
'26030, 동구,'080001, 75세,2019,568,285,283,100.7,567,284,283,100.4
'26030, 동구,'080002, 76세,2019,668,321,347,92.5,667,321,346,92.8
'26030, 동구,'080003, 77세,2019,660,295,365,80.8,657,294,363,81
'26030, 동구,'080004, 78세,2019,466,204,262,77.9,463,203,260,78.1
'26030, 동구,'080005, 79세,2019,431,185,246,75.2,428,184,244,75.4
'26030, 동구,'085,80~84세,2019,1535,516,1019,50.6,1525,515,1010,51
'26030, 동구,'085001, 80세,2019,407,178,229,77.7,405,177,228,77.6
'26030, 동구,'085002, 81세,2019,351,113,238,47.5,349,113,236,47.9
'26030, 동구,'085003, 82세,2019,274,87,187,46.5,272,87,185,47
'26030, 동구,'085004, 83세,2019,262,69,193,35.8,259,69,190,36.3
'26030, 동구,'085005, 84세,2019,241,69,172,40.1,240,69,171,40.4
'26030, 동구,'086,85세이상,2019,1032,202,830,24.3,1026,199,827,24.1
'26030, 동구,'090,85~89세,2019,726,165,561,29.4,720,162,558,29
'26030, 동구,'090001, 85세,2019,203,54,149,36.2,202,53,149,35.6
'26030, 동구,'090002, 86세,2019,168,51,117,43.6,166,50,116,43.1
'26030, 동구,'090003, 87세,2019,146,24,122,19.7,146,24,122,19.7
'26030, 동구,'090004, 88세,2019,111,21,90,23.3,108,20,88,22.7
'26030, 동구,'090005, 89세,2019,98,15,83,18.1,98,15,83,18.1
'26030, 동구,'095,90~94세,2019,243,31,212,14.6,243,31,212,14.6
'26030, 동구,'095001, 90세,2019,70,15,55,27.3,70,15,55,27.3
'26030, 동구,'095002, 91세,2019,53,5,48,10.4,53,5,48,10.4
'26030, 동구,'095003, 92세,2019,54,6,48,12.5,54,6,48,12.5
'26030, 동구,'095004, 93세,2019,26,X,25,4,26,X,25,4
'26030, 동구,'095005, 94세,2019,40,X,36,11.1,40,X,36,11.1
'26030, 동구,'100,95~99세,2019,60,6,54,11.1,60,6,54,11.1
'26030, 동구,'100001, 95세,2019,17,X,16,6.3,17,X,16,6.3
'26030, 동구,'100002, 96세,2019,16,X,13,23.1,16,X,13,23.1
'26030, 동구,'100003, 97세,2019,12,X,12,0,12,X,12,0
'26030, 동구,'100004, 98세,2019,7,X,7,0,7,X,7,0
'26030, 동구,'100005, 99세,2019,8,X,6,33.3,8,X,6,33.3
'26030, 동구,'101,100세이상,2019,X,X,X,0,X,X,X,0
'26030, 동구,'102,15세미만,2019,24176,12536,11640,107.7,23966,12426,11540,107.7
'26030, 동구,'103,15~64세,2019,120225,65054,55171,117.9,115738,62045,53693,115.6
'26030, 동구,'104,65세이상,2019,17703,8485,9218,92,17567,8429,9138,92.2
'26030, 동구,'126,평균연령,2019,40.3,39.5,41.2,,40.4,39.7,41.3,
'26030, 동구,'127,중위연령,2019,41,39.9,42.5,,41.3,40.3,42.7,
'26040, 북구,'000,합계,2019,213524,110861,102663,108,210119,108815,101304,107.4
'26040, 북구,'005,0~4세,2019,12378,6370,6008,106,12339,6349,5990,106
'26040, 북구,'005001, 0세,2019,2011,1041,970,107.3,2003,1036,967,107.1
'26040, 북구,'005002, 1세,2019,2222,1137,1085,104.8,2212,1132,1080,104.8
'26040, 북구,'005003, 2세,2019,2409,1238,1171,105.7,2399,1231,1168,105.4
'26040, 북구,'005004, 3세,2019,2809,1438,1371,104.9,2803,1436,1367,105
'26040, 북구,'005005, 4세,2019,2927,1516,1411,107.4,2922,1514,1408,107.5
'26040, 북구,'010,5~9세,2019,13779,7068,6711,105.3,13754,7058,6696,105.4
'26040, 북구,'010001, 5세,2019,2791,1434,1357,105.7,2784,1429,1355,105.5
'26040, 북구,'010002, 6세,2019,2758,1424,1334,106.7,2753,1422,1331,106.8
'26040, 북구,'010003, 7세,2019,2858,1464,1394,105,2855,1464,1391,105.2
'26040, 북구,'010004, 8세,2019,2720,1363,1357,100.4,2716,1363,1353,100.7
'26040, 북구,'010005, 9세,2019,2652,1383,1269,109,2646,1380,1266,109
'26040, 북구,'015,10~14세,2019,11967,6137,5830,105.3,11954,6130,5824,105.3
'26040, 북구,'015001, 10세,2019,2471,1308,1163,112.5,2469,1307,1162,112.5
'26040, 북구,'015002, 11세,2019,2597,1301,1296,100.4,2594,1299,1295,100.3
'26040, 북구,'015003, 12세,2019,2563,1316,1247,105.5,2559,1315,1244,105.7
'26040, 북구,'015004, 13세,2019,2213,1109,1104,100.5,2212,1109,1103,100.5
'26040, 북구,'015005, 14세,2019,2123,1103,1020,108.1,2120,1100,1020,107.8
'26040, 북구,'020,15~19세,2019,11279,6268,5011,125.1,11237,6247,4990,125.2
'26040, 북구,'020001, 15세,2019,2165,1137,1028,110.6,2160,1136,1024,110.9
'26040, 북구,'020002, 16세,2019,2391,1298,1093,118.8,2388,1297,1091,118.9
'26040, 북구,'020003, 17세,2019,2562,1409,1153,122.2,2559,1408,1151,122.3
'26040, 북구,'020004, 18세,2019,2388,1337,1051,127.2,2382,1332,1050,126.9
'26040, 북구,'020005, 19세,2019,1773,1087,686,158.5,1748,1074,674,159.3
'26040, 북구,'025,20~24세,2019,11844,6953,4891,142.2,11539,6775,4764,142.2
'26040, 북구,'025001, 20세,2019,2003,1328,675,196.7,1985,1318,667,197.6
'26040, 북구,'025002, 21세,2019,2345,1450,895,162,2299,1419,880,161.3
'26040, 북구,'025003, 22세,2019,2405,1367,1038,131.7,2342,1332,1010,131.9
'26040, 북구,'025004, 23세,2019,2508,1403,1105,127,2434,1363,1071,127.3
'26040, 북구,'025005, 24세,2019,2583,1405,1178,119.3,2479,1343,1136,118.2
'26040, 북구,'030,25~29세,2019,14089,7822,6267,124.8,13432,7384,6048,122.1
'26040, 북구,'030001, 25세,2019,2650,1497,1153,129.8,2546,1429,1117,127.9
'26040, 북구,'030002, 26세,2019,2762,1582,1180,134.1,2651,1511,1140,132.5
'26040, 북구,'030003, 27세,2019,2866,1604,1262,127.1,2734,1509,1225,123.2
'26040, 북구,'030004, 28세,2019,2876,1513,1363,111,2721,1417,1304,108.7
'26040, 북구,'030005, 29세,2019,2935,1626,1309,124.2,2780,1518,1262,120.3
'26040, 북구,'035,30~34세,2019,15221,8128,7093,114.6,14548,7710,6838,112.8
'26040, 북구,'035001, 30세,2019,2927,1624,1303,124.6,2805,1538,1267,121.4
'26040, 북구,'035002, 31세,2019,2922,1583,1339,118.2,2778,1488,1290,115.3
'26040, 북구,'035003, 32세,2019,3055,1598,1457,109.7,2903,1513,1390,108.8
'26040, 북구,'035004, 33세,2019,3102,1644,1458,112.8,2969,1567,1402,111.8
'26040, 북구,'035005, 34세,2019,3215,1679,1536,109.3,3093,1604,1489,107.7
'26040, 북구,'040,35~39세,2019,20871,10583,10288,102.9,20396,10280,10116,101.6
'26040, 북구,'040001, 35세,2019,3545,1830,1715,106.7,3432,1762,1670,105.5
'26040, 북구,'040002, 36세,2019,4032,1977,2055,96.2,3926,1903,2023,94.1
'26040, 북구,'040003, 37세,2019,4321,2178,2143,101.6,4236,2123,2113,100.5
'26040, 북구,'040004, 38세,2019,4401,2259,2142,105.5,4321,2201,2120,103.8
'26040, 북구,'040005, 39세,2019,4572,2339,2233,104.7,4481,2291,2190,104.6
'26040, 북구,'045,40~44세,2019,18811,9930,8881,111.8,18479,9729,8750,111.2
'26040, 북구,'045001, 40세,2019,4167,2183,1984,110,4092,2136,1956,109.2
'26040, 북구,'045002, 41세,2019,3721,1960,1761,111.3,3656,1922,1734,110.8
'26040, 북구,'045003, 42세,2019,3856,2038,1818,112.1,3790,1999,1791,111.6
'26040, 북구,'045004, 43세,2019,3472,1875,1597,117.4,3410,1838,1572,116.9
'26040, 북구,'045005, 44세,2019,3595,1874,1721,108.9,3531,1834,1697,108.1
'26040, 북구,'050,45~49세,2019,18579,9084,9495,95.7,18298,8927,9371,95.3
'26040, 북구,'050001, 45세,2019,3667,1806,1861,97,3618,1773,1845,96.1
'26040, 북구,'050002, 46세,2019,3571,1781,1790,99.5,3515,1752,1763,99.4
'26040, 북구,'050003, 47세,2019,3702,1784,1918,93,3639,1752,1887,92.8
'26040, 북구,'050004, 48세,2019,3799,1864,1935,96.3,3743,1832,1911,95.9
'26040, 북구,'050005, 49세,2019,3840,1849,1991,92.9,3783,1818,1965,92.5
'26040, 북구,'055,50~54세,2019,20291,10179,10112,100.7,20050,10036,10014,100.2
'26040, 북구,'055001, 50세,2019,4123,1988,2135,93.1,4060,1948,2112,92.2
'26040, 북구,'055002, 51세,2019,4198,2022,2176,92.9,4147,1993,2154,92.5
'26040, 북구,'055003, 52세,2019,4012,1981,2031,97.5,3960,1949,2011,96.9
'26040, 북구,'055004, 53세,2019,4073,2149,1924,111.7,4033,2122,1911,111
'26040, 북구,'055005, 54세,2019,3885,2039,1846,110.5,3850,2024,1826,110.8
'26040, 북구,'060,55~59세,2019,17532,9602,7930,121.1,17384,9527,7857,121.3
'26040, 북구,'060001, 55세,2019,3540,1894,1646,115.1,3504,1872,1632,114.7
'26040, 북구,'060002, 56세,2019,3594,2019,1575,128.2,3566,2001,1565,127.9
'26040, 북구,'060003, 57세,2019,3554,1974,1580,124.9,3527,1965,1562,125.8
'26040, 북구,'060004, 58세,2019,3619,1962,1657,118.4,3596,1949,1647,118.3
'26040, 북구,'060005, 59세,2019,3225,1753,1472,119.1,3191,1740,1451,119.9
'26040, 북구,'065,60~64세,2019,10960,5737,5223,109.8,10863,5695,5168,110.2
'26040, 북구,'065001, 60세,2019,2678,1452,1226,118.4,2663,1444,1219,118.5
'26040, 북구,'065002, 61세,2019,2335,1230,1105,111.3,2313,1219,1094,111.4
'26040, 북구,'065003, 62세,2019,2177,1133,1044,108.5,2153,1123,1030,109
'26040, 북구,'065004, 63세,2019,1899,963,936,102.9,1885,955,930,102.7
'26040, 북구,'065005, 64세,2019,1871,959,912,105.2,1849,954,895,106.6
'26040, 북구,'070,65~69세,2019,6035,3090,2945,104.9,5993,3071,2922,105.1
'26040, 북구,'070001, 65세,2019,1500,763,737,103.5,1486,757,729,103.8
'26040, 북구,'070002, 66세,2019,1276,672,604,111.3,1266,667,599,111.4
'26040, 북구,'070003, 67세,2019,1309,671,638,105.2,1303,667,636,104.9
'26040, 북구,'070004, 68세,2019,976,497,479,103.8,968,494,474,104.2
'26040, 북구,'070005, 69세,2019,974,487,487,100,970,486,484,100.4
'26040, 북구,'075,70~74세,2019,3889,1858,2031,91.5,3875,1852,2023,91.5
'26040, 북구,'075001, 70세,2019,952,472,480,98.3,948,470,478,98.3
'26040, 북구,'075002, 71세,2019,902,422,480,87.9,898,420,478,87.9
'26040, 북구,'075003, 72세,2019,895,413,482,85.7,892,413,479,86.2
'26040, 북구,'075004, 73세,2019,569,284,285,99.6,567,283,284,99.6
'26040, 북구,'075005, 74세,2019,571,267,304,87.8,570,266,304,87.5
'26040, 북구,'080,75~79세,2019,2886,1219,1667,73.1,2873,1215,1658,73.3
'26040, 북구,'080001, 75세,2019,603,298,305,97.7,600,297,303,98
'26040, 북구,'080002, 76세,2019,637,260,377,69,633,258,375,68.8
'26040, 북구,'080003, 77세,2019,701,308,393,78.4,698,308,390,79
'26040, 북구,'080004, 78세,2019,484,182,302,60.3,483,182,301,60.5
'26040, 북구,'080005, 79세,2019,461,171,290,59,459,170,289,58.8
'26040, 북구,'085,80~84세,2019,1832,563,1269,44.4,1826,560,1266,44.2
'26040, 북구,'085001, 80세,2019,435,164,271,60.5,434,163,271,60.1
'26040, 북구,'085002, 81세,2019,404,134,270,49.6,402,133,269,49.4
'26040, 북구,'085003, 82세,2019,387,107,280,38.2,384,106,278,38.1
'26040, 북구,'085004, 83세,2019,324,89,235,37.9,324,89,235,37.9
'26040, 북구,'085005, 84세,2019,282,69,213,32.4,282,69,213,32.4
'26040, 북구,'086,85세이상,2019,1281,270,1011,26.7,1279,270,1009,26.8
'26040, 북구,'090,85~89세,2019,912,215,697,30.8,910,215,695,30.9
'26040, 북구,'090001, 85세,2019,267,74,193,38.3,266,74,192,38.5
'26040, 북구,'090002, 86세,2019,227,63,164,38.4,227,63,164,38.4
'26040, 북구,'090003, 87세,2019,182,40,142,28.2,182,40,142,28.2
'26040, 북구,'090004, 88세,2019,112,19,93,20.4,112,19,93,20.4
'26040, 북구,'090005, 89세,2019,124,19,105,18.1,123,19,104,18.3
'26040, 북구,'095,90~94세,2019,287,44,243,18.1,287,44,243,18.1
'26040, 북구,'095001, 90세,2019,98,16,82,19.5,98,16,82,19.5
'26040, 북구,'095002, 91세,2019,73,12,61,19.7,73,12,61,19.7
'26040, 북구,'095003, 92세,2019,57,8,49,16.3,57,8,49,16.3
'26040, 북구,'095004, 93세,2019,39,X,35,11.4,39,X,35,11.4
'26040, 북구,'095005, 94세,2019,20,X,16,25,20,X,16,25
'26040, 북구,'100,95~99세,2019,77,11,66,16.7,77,11,66,16.7
'26040, 북구,'100001, 95세,2019,22,X,18,22.2,22,X,18,22.2
'26040, 북구,'100002, 96세,2019,20,X,18,11.1,20,X,18,11.1
'26040, 북구,'100003, 97세,2019,16,X,14,14.3,16,X,14,14.3
'26040, 북구,'100004, 98세,2019,12,X,10,20,12,X,10,20
'26040, 북구,'100005, 99세,2019,7,X,6,16.7,7,X,6,16.7
'26040, 북구,'101,100세이상,2019,5,X,5,0,5,X,5,0
'26040, 북구,'102,15세미만,2019,38124,19575,18549,105.5,38047,19537,18510,105.5
'26040, 북구,'103,15~64세,2019,159477,84286,75191,112.1,156226,82310,73916,111.4
'26040, 북구,'104,65세이상,2019,15923,7000,8923,78.4,15846,6968,8878,78.5
'26040, 북구,'126,평균연령,2019,37.6,36.9,38.3,,37.6,36.9,38.3,
'26040, 북구,'127,중위연령,2019,39,38.3,39.7,,39.1,38.4,39.7,
'26310, 울주군,'000,합계,2019,226501,119005,107496,110.7,216025,111760,104265,107.2
'26310, 울주군,'005,0~4세,2019,8557,4459,4098,108.8,8366,4362,4004,108.9
'26310, 울주군,'005001, 0세,2019,1456,753,703,107.1,1409,731,678,107.8
'26310, 울주군,'005002, 1세,2019,1580,822,758,108.4,1553,810,743,109
'26310, 울주군,'005003, 2세,2019,1678,893,785,113.8,1628,865,763,113.4
'26310, 울주군,'005004, 3세,2019,1837,932,905,103,1805,919,886,103.7
'26310, 울주군,'005005, 4세,2019,2006,1059,947,111.8,1971,1037,934,111
'26310, 울주군,'010,5~9세,2019,10629,5408,5221,103.6,10499,5342,5157,103.6
'26310, 울주군,'010001, 5세,2019,2016,1052,964,109.1,1976,1034,942,109.8
'26310, 울주군,'010002, 6세,2019,2026,999,1027,97.3,2003,988,1015,97.3
'26310, 울주군,'010003, 7세,2019,2248,1124,1124,100,2220,1109,1111,99.8
'26310, 울주군,'010004, 8세,2019,2197,1131,1066,106.1,2177,1118,1059,105.6
'26310, 울주군,'010005, 9세,2019,2142,1102,1040,106,2123,1093,1030,106.1
'26310, 울주군,'015,10~14세,2019,10820,5620,5200,108.1,10742,5576,5166,107.9
'26310, 울주군,'015001, 10세,2019,2048,1032,1016,101.6,2030,1019,1011,100.8
'26310, 울주군,'015002, 11세,2019,2245,1159,1086,106.7,2224,1144,1080,105.9
'26310, 울주군,'015003, 12세,2019,2296,1211,1085,111.6,2287,1206,1081,111.6
'26310, 울주군,'015004, 13세,2019,2083,1104,979,112.8,2072,1101,971,113.4
'26310, 울주군,'015005, 14세,2019,2148,1114,1034,107.7,2129,1106,1023,108.1
'26310, 울주군,'020,15~19세,2019,11890,6428,5462,117.7,11735,6332,5403,117.2
'26310, 울주군,'020001, 15세,2019,2238,1155,1083,106.6,2229,1150,1079,106.6
'26310, 울주군,'020002, 16세,2019,2214,1125,1089,103.3,2199,1120,1079,103.8
'26310, 울주군,'020003, 17세,2019,2292,1176,1116,105.4,2273,1166,1107,105.3
'26310, 울주군,'020004, 18세,2019,2512,1366,1146,119.2,2469,1338,1131,118.3
'26310, 울주군,'020005, 19세,2019,2634,1606,1028,156.2,2565,1558,1007,154.7
'26310, 울주군,'025,20~24세,2019,14117,8517,5600,152.1,13201,7817,5384,145.2
'26310, 울주군,'025001, 20세,2019,2625,1696,929,182.6,2519,1613,906,178
'26310, 울주군,'025002, 21세,2019,2649,1618,1031,156.9,2513,1517,996,152.3
'26310, 울주군,'025003, 22세,2019,2810,1620,1190,136.1,2629,1481,1148,129
'26310, 울주군,'025004, 23세,2019,2883,1712,1171,146.2,2658,1542,1116,138.2
'26310, 울주군,'025005, 24세,2019,3150,1871,1279,146.3,2882,1664,1218,136.6
'26310, 울주군,'030,25~29세,2019,14631,8863,5768,153.7,12876,7526,5350,140.7
'26310, 울주군,'030001, 25세,2019,3098,1912,1186,161.2,2807,1681,1126,149.3
'26310, 울주군,'030002, 26세,2019,2968,1863,1105,168.6,2666,1627,1039,156.6
'26310, 울주군,'030003, 27세,2019,2977,1786,1191,150,2643,1528,1115,137
'26310, 울주군,'030004, 28세,2019,2893,1702,1191,142.9,2494,1403,1091,128.6
'26310, 울주군,'030005, 29세,2019,2695,1600,1095,146.1,2266,1287,979,131.5
'26310, 울주군,'035,30~34세,2019,13148,7550,5598,134.9,11299,6168,5131,120.2
'26310, 울주군,'035001, 30세,2019,2655,1578,1077,146.5,2292,1304,988,132
'26310, 울주군,'035002, 31세,2019,2479,1449,1030,140.7,2075,1150,925,124.3
'26310, 울주군,'035003, 32세,2019,2635,1484,1151,128.9,2274,1209,1065,113.5
'26310, 울주군,'035004, 33세,2019,2670,1515,1155,131.2,2302,1243,1059,117.4
'26310, 울주군,'035005, 34세,2019,2709,1524,1185,128.6,2356,1262,1094,115.4
'26310, 울주군,'040,35~39세,2019,16695,9008,7687,117.2,15379,8017,7362,108.9
'26310, 울주군,'040001, 35세,2019,2876,1588,1288,123.3,2593,1361,1232,110.5
'26310, 울주군,'040002, 36세,2019,3086,1687,1399,120.6,2771,1443,1328,108.7
'26310, 울주군,'040003, 37세,2019,3479,1852,1627,113.8,3229,1668,1561,106.9
'26310, 울주군,'040004, 38세,2019,3574,1959,1615,121.3,3317,1773,1544,114.8
'26310, 울주군,'040005, 39세,2019,3680,1922,1758,109.3,3469,1772,1697,104.4
'26310, 울주군,'045,40~44세,2019,17428,9073,8355,108.6,16467,8410,8057,104.4
'26310, 울주군,'045001, 40세,2019,3456,1820,1636,111.2,3249,1673,1576,106.2
'26310, 울주군,'045002, 41세,2019,3236,1720,1516,113.5,3012,1571,1441,109
'26310, 울주군,'045003, 42세,2019,3524,1841,1683,109.4,3368,1731,1637,105.7
'26310, 울주군,'045004, 43세,2019,3453,1806,1647,109.7,3266,1671,1595,104.8
'26310, 울주군,'045005, 44세,2019,3759,1886,1873,100.7,3572,1764,1808,97.6
'26310, 울주군,'050,45~49세,2019,21487,11022,10465,105.3,20545,10423,10122,103
'26310, 울주군,'050001, 45세,2019,4040,2067,1973,104.8,3874,1951,1923,101.5
'26310, 울주군,'050002, 46세,2019,4155,2095,2060,101.7,3989,1981,2008,98.7
'26310, 울주군,'050003, 47세,2019,4205,2167,2038,106.3,4016,2056,1960,104.9
'26310, 울주군,'050004, 48세,2019,4699,2434,2265,107.5,4476,2294,2182,105.1
'26310, 울주군,'050005, 49세,2019,4388,2259,2129,106.1,4190,2141,2049,104.5
'26310, 울주군,'055,50~54세,2019,21503,11327,10176,111.3,20583,10772,9811,109.8
'26310, 울주군,'055001, 50세,2019,4463,2309,2154,107.2,4271,2202,2069,106.4
'26310, 울주군,'055002, 51세,2019,4525,2359,2166,108.9,4339,2243,2096,107
'26310, 울주군,'055003, 52세,2019,4207,2164,2043,105.9,4038,2069,1969,105.1
'26310, 울주군,'055004, 53세,2019,4152,2231,1921,116.1,3963,2114,1849,114.3
'26310, 울주군,'055005, 54세,2019,4156,2264,1892,119.7,3972,2144,1828,117.3
'26310, 울주군,'060,55~59세,2019,19704,10512,9192,114.4,19035,10098,8937,113
'26310, 울주군,'060001, 55세,2019,3776,2010,1766,113.8,3595,1891,1704,111
'26310, 울주군,'060002, 56세,2019,3921,2145,1776,120.8,3728,2034,1694,120.1
'26310, 울주군,'060003, 57세,2019,3849,2063,1786,115.5,3731,1993,1738,114.7
'26310, 울주군,'060004, 58세,2019,4255,2218,2037,108.9,4176,2163,2013,107.5
'26310, 울주군,'060005, 59세,2019,3903,2076,1827,113.6,3805,2017,1788,112.8
'26310, 울주군,'065,60~64세,2019,16137,8297,7840,105.8,15801,8113,7688,105.5
'26310, 울주군,'065001, 60세,2019,3588,1869,1719,108.7,3497,1818,1679,108.3
'26310, 울주군,'065002, 61세,2019,3358,1707,1651,103.4,3290,1666,1624,102.6
'26310, 울주군,'065003, 62세,2019,3274,1699,1575,107.9,3203,1663,1540,108
'26310, 울주군,'065004, 63세,2019,2955,1535,1420,108.1,2889,1498,1391,107.7
'26310, 울주군,'065005, 64세,2019,2962,1487,1475,100.8,2922,1468,1454,101
'26310, 울주군,'070,65~69세,2019,10139,5110,5029,101.6,10003,5038,4965,101.5
'26310, 울주군,'070001, 65세,2019,2380,1249,1131,110.4,2335,1221,1114,109.6
'26310, 울주군,'070002, 66세,2019,2141,1062,1079,98.4,2113,1045,1068,97.8
'26310, 울주군,'070003, 67세,2019,2198,1079,1119,96.4,2169,1064,1105,96.3
'26310, 울주군,'070004, 68세,2019,1704,855,849,100.7,1691,850,841,101.1
'26310, 울주군,'070005, 69세,2019,1716,865,851,101.6,1695,858,837,102.5
'26310, 울주군,'075,70~74세,2019,7022,3474,3548,97.9,6971,3454,3517,98.2
'26310, 울주군,'075001, 70세,2019,1693,835,858,97.3,1681,831,850,97.8
'26310, 울주군,'075002, 71세,2019,1637,838,799,104.9,1624,831,793,104.8
'26310, 울주군,'075003, 72세,2019,1550,792,758,104.5,1538,788,750,105.1
'26310, 울주군,'075004, 73세,2019,1045,496,549,90.3,1040,495,545,90.8
'26310, 울주군,'075005, 74세,2019,1097,513,584,87.8,1088,509,579,87.9
'26310, 울주군,'080,75~79세,2019,5814,2351,3463,67.9,5772,2338,3434,68.1
'26310, 울주군,'080001, 75세,2019,1126,461,665,69.3,1118,457,661,69.1
'26310, 울주군,'080002, 76세,2019,1241,545,696,78.3,1234,543,691,78.6
'26310, 울주군,'080003, 77세,2019,1362,552,810,68.1,1350,549,801,68.5
'26310, 울주군,'080004, 78세,2019,1062,412,650,63.4,1055,410,645,63.6
'26310, 울주군,'080005, 79세,2019,1023,381,642,59.3,1015,379,636,59.6
'26310, 울주군,'085,80~84세,2019,3904,1320,2584,51.1,3883,1311,2572,51
'26310, 울주군,'085001, 80세,2019,993,352,641,54.9,987,349,638,54.7
'26310, 울주군,'085002, 81세,2019,889,321,568,56.5,882,319,563,56.7
'26310, 울주군,'085003, 82세,2019,738,243,495,49.1,732,241,491,49.1
'26310, 울주군,'085004, 83세,2019,640,209,431,48.5,639,208,431,48.3
'26310, 울주군,'085005, 84세,2019,644,195,449,43.4,643,194,449,43.2
'26310, 울주군,'086,85세이상,2019,2876,666,2210,30.1,2868,663,2205,30.1
'26310, 울주군,'090,85~89세,2019,2014,515,1499,34.4,2008,513,1495,34.3
'26310, 울주군,'090001, 85세,2019,579,162,417,38.8,577,161,416,38.7
'26310, 울주군,'090002, 86세,2019,451,124,327,37.9,450,124,326,38
'26310, 울주군,'090003, 87세,2019,403,103,300,34.3,402,103,299,34.4
'26310, 울주군,'090004, 88세,2019,327,75,252,29.8,326,74,252,29.4
'26310, 울주군,'090005, 89세,2019,254,51,203,25.1,253,51,202,25.2
'26310, 울주군,'095,90~94세,2019,726,134,592,22.6,724,133,591,22.5
'26310, 울주군,'095001, 90세,2019,224,49,175,28,224,49,175,28
'26310, 울주군,'095002, 91세,2019,189,37,152,24.3,188,36,152,23.7
'26310, 울주군,'095003, 92세,2019,144,26,118,22,143,26,117,22.2
'26310, 울주군,'095004, 93세,2019,96,14,82,17.1,96,14,82,17.1
'26310, 울주군,'095005, 94세,2019,73,8,65,12.3,73,8,65,12.3
'26310, 울주군,'100,95~99세,2019,121,17,104,16.3,121,17,104,16.3
'26310, 울주군,'100001, 95세,2019,46,5,41,12.2,46,5,41,12.2
'26310, 울주군,'100002, 96세,2019,39,9,30,30,39,9,30,30
'26310, 울주군,'100003, 97세,2019,22,X,20,10,22,X,20,10
'26310, 울주군,'100004, 98세,2019,9,X,9,0,9,X,9,0
'26310, 울주군,'100005, 99세,2019,5,X,X,25,5,X,X,25
'26310, 울주군,'101,100세이상,2019,15,X,15,0,15,X,15,0
'26310, 울주군,'102,15세미만,2019,30006,15487,14519,106.7,29607,15280,14327,106.7
'26310, 울주군,'103,15~64세,2019,166740,90597,76143,119,156921,83676,73245,114.2
'26310, 울주군,'104,65세이상,2019,29755,12921,16834,76.8,29497,12804,16693,76.7
'26310, 울주군,'126,평균연령,2019,41.8,40.6,43.2,,42,40.8,43.3,
'26310, 울주군,'127,중위연령,2019,43.7,42.1,45.4,,44.3,42.9,45.6,
'29,세종특별자치시,'000,합계,2019,338136,170148,167988,101.3,330307,165288,165019,100.2
'29,세종특별자치시,'005,0~4세,2019,21785,11135,10650,104.6,21683,11074,10609,104.4
'29,세종특별자치시,'005001, 0세,2019,3798,1939,1859,104.3,3786,1931,1855,104.1
'29,세종특별자치시,'005002, 1세,2019,3958,1989,1969,101,3941,1979,1962,100.9
'29,세종특별자치시,'005003, 2세,2019,4346,2214,2132,103.8,4316,2195,2121,103.5
'29,세종특별자치시,'005004, 3세,2019,4777,2480,2297,108,4753,2465,2288,107.7
'29,세종특별자치시,'005005, 4세,2019,4906,2513,2393,105,4887,2504,2383,105.1
'29,세종특별자치시,'010,5~9세,2019,24398,12477,11921,104.7,24325,12438,11887,104.6
'29,세종특별자치시,'010001, 5세,2019,4752,2428,2324,104.5,4731,2414,2317,104.2
'29,세종특별자치시,'010002, 6세,2019,4837,2455,2382,103.1,4822,2449,2373,103.2
'29,세종특별자치시,'010003, 7세,2019,5121,2634,2487,105.9,5105,2624,2481,105.8
'29,세종특별자치시,'010004, 8세,2019,4967,2558,2409,106.2,4955,2552,2403,106.2
'29,세종특별자치시,'010005, 9세,2019,4721,2402,2319,103.6,4712,2399,2313,103.7
'29,세종특별자치시,'015,10~14세,2019,21380,10682,10698,99.9,21337,10670,10667,100
'29,세종특별자치시,'015001, 10세,2019,4547,2314,2233,103.6,4538,2309,2229,103.6
'29,세종특별자치시,'015002, 11세,2019,4658,2313,2345,98.6,4652,2313,2339,98.9
'29,세종특별자치시,'015003, 12세,2019,4432,2179,2253,96.7,4420,2173,2247,96.7
'29,세종특별자치시,'015004, 13세,2019,4111,2090,2021,103.4,4100,2089,2011,103.9
'29,세종특별자치시,'015005, 14세,2019,3632,1786,1846,96.7,3627,1786,1841,97
'29,세종특별자치시,'020,15~19세,2019,17841,8968,8873,101.1,17469,8744,8725,100.2
'29,세종특별자치시,'020001, 15세,2019,3781,1858,1923,96.6,3776,1855,1921,96.6
'29,세종특별자치시,'020002, 16세,2019,3594,1772,1822,97.3,3584,1771,1813,97.7
'29,세종특별자치시,'020003, 17세,2019,3325,1687,1638,103,3311,1680,1631,103
'29,세종특별자치시,'020004, 18세,2019,3318,1654,1664,99.4,3225,1599,1626,98.3
'29,세종특별자치시,'020005, 19세,2019,3823,1997,1826,109.4,3573,1839,1734,106.1
'29,세종특별자치시,'025,20~24세,2019,20804,11216,9588,117,19491,10351,9140,113.2
'29,세종특별자치시,'025001, 20세,2019,4056,2043,2013,101.5,3816,1890,1926,98.1
'29,세종특별자치시,'025002, 21세,2019,3980,2047,1933,105.9,3725,1890,1835,103
'29,세종특별자치시,'025003, 22세,2019,4137,2224,1913,116.3,3893,2066,1827,113.1
'29,세종특별자치시,'025004, 23세,2019,4441,2484,1957,126.9,4148,2282,1866,122.3
'29,세종특별자치시,'025005, 24세,2019,4190,2418,1772,136.5,3909,2223,1686,131.9
'29,세종특별자치시,'030,25~29세,2019,20867,10901,9966,109.4,19449,9953,9496,104.8
'29,세종특별자치시,'030001, 25세,2019,4104,2376,1728,137.5,3802,2183,1619,134.8
'29,세종특별자치시,'030002, 26세,2019,4021,2225,1796,123.9,3725,2015,1710,117.8
'29,세종특별자치시,'030003, 27세,2019,4202,2110,2092,100.9,3914,1929,1985,97.2
'29,세종특별자치시,'030004, 28세,2019,4202,2036,2166,94,3920,1849,2071,89.3
'29,세종특별자치시,'030005, 29세,2019,4338,2154,2184,98.6,4088,1977,2111,93.7
'29,세종특별자치시,'035,30~34세,2019,25627,12677,12950,97.9,24383,11840,12543,94.4
'29,세종특별자치시,'035001, 30세,2019,4514,2225,2289,97.2,4253,2052,2201,93.2
'29,세종특별자치시,'035002, 31세,2019,4805,2395,2410,99.4,4553,2222,2331,95.3
'29,세종특별자치시,'035003, 32세,2019,5193,2489,2704,92,4949,2324,2625,88.5
'29,세종특별자치시,'035004, 33세,2019,5445,2719,2726,99.7,5195,2546,2649,96.1
'29,세종특별자치시,'035005, 34세,2019,5670,2849,2821,101,5433,2696,2737,98.5
'29,세종특별자치시,'040,35~39세,2019,35451,17382,18069,96.2,34602,16872,17730,95.2
'29,세종특별자치시,'040001, 35세,2019,6054,3003,3051,98.4,5880,2901,2979,97.4
'29,세종특별자치시,'040002, 36세,2019,6746,3209,3537,90.7,6565,3103,3462,89.6
'29,세종특별자치시,'040003, 37세,2019,7631,3745,3886,96.4,7446,3634,3812,95.3
'29,세종특별자치시,'040004, 38세,2019,7513,3676,3837,95.8,7353,3574,3779,94.6
'29,세종특별자치시,'040005, 39세,2019,7507,3749,3758,99.8,7358,3660,3698,99
'29,세종특별자치시,'045,40~44세,2019,32778,16485,16293,101.2,32156,16132,16024,100.7
'29,세종특별자치시,'045001, 40세,2019,7343,3637,3706,98.1,7182,3542,3640,97.3
'29,세종특별자치시,'045002, 41세,2019,6488,3235,3253,99.4,6348,3155,3193,98.8
'29,세종특별자치시,'045003, 42세,2019,6581,3311,3270,101.3,6473,3254,3219,101.1
'29,세종특별자치시,'045004, 43세,2019,6142,3082,3060,100.7,6032,3020,3012,100.3
'29,세종특별자치시,'045005, 44세,2019,6224,3220,3004,107.2,6121,3161,2960,106.8
'29,세종특별자치시,'050,45~49세,2019,29517,15700,13817,113.6,28974,15368,13606,113
'29,세종특별자치시,'050001, 45세,2019,6534,3401,3133,108.6,6412,3319,3093,107.3
'29,세종특별자치시,'050002, 46세,2019,6130,3220,2910,110.7,6035,3158,2877,109.8
'29,세종특별자치시,'050003, 47세,2019,5669,3106,2563,121.2,5563,3040,2523,120.5
'29,세종특별자치시,'050004, 48세,2019,5962,3154,2808,112.3,5845,3091,2754,112.2
'29,세종특별자치시,'050005, 49세,2019,5222,2819,2403,117.3,5119,2760,2359,117
'29,세종특별자치시,'055,50~54세,2019,22016,11488,10528,109.1,21590,11238,10352,108.6
'29,세종특별자치시,'055001, 50세,2019,5110,2736,2374,115.2,5011,2678,2333,114.8
'29,세종특별자치시,'055002, 51세,2019,4795,2478,2317,106.9,4712,2437,2275,107.1
'29,세종특별자치시,'055003, 52세,2019,4207,2166,2041,106.1,4124,2117,2007,105.5
'29,세종특별자치시,'055004, 53세,2019,3809,1990,1819,109.4,3732,1942,1790,108.5
'29,세종특별자치시,'055005, 54세,2019,4095,2118,1977,107.1,4011,2064,1947,106
'29,세종특별자치시,'060,55~59세,2019,19389,9897,9492,104.3,18987,9689,9298,104.2
'29,세종특별자치시,'060001, 55세,2019,3614,1878,1736,108.2,3532,1832,1700,107.8
'29,세종특별자치시,'060002, 56세,2019,3781,1951,1830,106.6,3664,1894,1770,107
'29,세종특별자치시,'060003, 57세,2019,3799,1950,1849,105.5,3723,1916,1807,106
'29,세종특별자치시,'060004, 58세,2019,4246,2132,2114,100.9,4195,2106,2089,100.8
'29,세종특별자치시,'060005, 59세,2019,3949,1986,1963,101.2,3873,1941,1932,100.5
'29,세종특별자치시,'065,60~64세,2019,16003,7992,8011,99.8,15747,7854,7893,99.5
'29,세종특별자치시,'065001, 60세,2019,3507,1767,1740,101.6,3448,1737,1711,101.5
'29,세종특별자치시,'065002, 61세,2019,3261,1625,1636,99.3,3209,1595,1614,98.8
'29,세종특별자치시,'065003, 62세,2019,3192,1586,1606,98.8,3142,1560,1582,98.6
'29,세종특별자치시,'065004, 63세,2019,2984,1497,1487,100.7,2945,1472,1473,99.9
'29,세종특별자치시,'065005, 64세,2019,3059,1517,1542,98.4,3003,1490,1513,98.5
'29,세종특별자치시,'070,65~69세,2019,10237,4985,5252,94.9,10135,4928,5207,94.6
'29,세종특별자치시,'070001, 65세,2019,2485,1196,1289,92.8,2457,1186,1271,93.3
'29,세종특별자치시,'070002, 66세,2019,2016,1003,1013,99,1990,985,1005,98
'29,세종특별자치시,'070003, 67세,2019,2245,1075,1170,91.9,2226,1063,1163,91.4
'29,세종특별자치시,'070004, 68세,2019,1625,787,838,93.9,1615,782,833,93.9
'29,세종특별자치시,'070005, 69세,2019,1866,924,942,98.1,1847,912,935,97.5
'29,세종특별자치시,'075,70~74세,2019,7160,3408,3752,90.8,7124,3390,3734,90.8
'29,세종특별자치시,'075001, 70세,2019,1785,853,932,91.5,1775,847,928,91.3
'29,세종특별자치시,'075002, 71세,2019,1556,775,781,99.2,1547,772,775,99.6
'29,세종특별자치시,'075003, 72세,2019,1516,709,807,87.9,1506,704,802,87.8
'29,세종특별자치시,'075004, 73세,2019,1181,557,624,89.3,1176,554,622,89.1
'29,세종특별자치시,'075005, 74세,2019,1122,514,608,84.5,1120,513,607,84.5
'29,세종특별자치시,'080,75~79세,2019,5793,2462,3331,73.9,5780,2458,3322,74
'29,세종특별자치시,'080001, 75세,2019,1141,491,650,75.5,1139,490,649,75.5
'29,세종특별자치시,'080002, 76세,2019,1114,503,611,82.3,1111,503,608,82.7
'29,세종특별자치시,'080003, 77세,2019,1438,625,813,76.9,1436,624,812,76.8
'29,세종특별자치시,'080004, 78세,2019,1130,460,670,68.7,1126,458,668,68.6
'29,세종특별자치시,'080005, 79세,2019,970,383,587,65.2,968,383,585,65.5
'29,세종특별자치시,'085,80~84세,2019,4045,1475,2570,57.4,4038,1473,2565,57.4
'29,세종특별자치시,'085001, 80세,2019,988,367,621,59.1,987,366,621,58.9
'29,세종특별자치시,'085002, 81세,2019,898,344,554,62.1,896,344,552,62.3
'29,세종특별자치시,'085003, 82세,2019,754,273,481,56.8,752,273,479,57
'29,세종특별자치시,'085004, 83세,2019,737,271,466,58.2,736,270,466,57.9
'29,세종특별자치시,'085005, 84세,2019,668,220,448,49.1,667,220,447,49.2
'29,세종특별자치시,'086,85세이상,2019,3045,818,2227,36.7,3037,816,2221,36.7
'29,세종특별자치시,'090,85~89세,2019,2154,618,1536,40.2,2148,616,1532,40.2
'29,세종특별자치시,'090001, 85세,2019,602,205,397,51.6,599,205,394,52
'29,세종특별자치시,'090002, 86세,2019,507,139,368,37.8,505,137,368,37.2
'29,세종특별자치시,'090003, 87세,2019,417,105,312,33.7,417,105,312,33.7
'29,세종특별자치시,'090004, 88세,2019,340,92,248,37.1,340,92,248,37.1
'29,세종특별자치시,'090005, 89세,2019,288,77,211,36.5,287,77,210,36.7
'29,세종특별자치시,'095,90~94세,2019,745,173,572,30.2,743,173,570,30.4
'29,세종특별자치시,'095001, 90세,2019,265,63,202,31.2,265,63,202,31.2
'29,세종특별자치시,'095002, 91세,2019,183,42,141,29.8,183,42,141,29.8
'29,세종특별자치시,'095003, 92세,2019,134,36,98,36.7,134,36,98,36.7
'29,세종특별자치시,'095004, 93세,2019,86,16,70,22.9,85,16,69,23.2
'29,세종특별자치시,'095005, 94세,2019,77,16,61,26.2,76,16,60,26.7
'29,세종특별자치시,'100,95~99세,2019,125,25,100,25,125,25,100,25
'29,세종특별자치시,'100001, 95세,2019,42,7,35,20,42,7,35,20
'29,세종특별자치시,'100002, 96세,2019,33,6,27,22.2,33,6,27,22.2
'29,세종특별자치시,'100003, 97세,2019,30,8,22,36.4,30,8,22,36.4
'29,세종특별자치시,'100004, 98세,2019,12,X,9,33.3,12,X,9,33.3
'29,세종특별자치시,'100005, 99세,2019,8,X,7,14.3,8,X,7,14.3
'29,세종특별자치시,'101,100세이상,2019,21,X,19,10.5,21,X,19,10.5
'29,세종특별자치시,'102,15세미만,2019,67563,34294,33269,103.1,67345,34182,33163,103.1
'29,세종특별자치시,'103,15~64세,2019,240293,122706,117587,104.4,232848,118041,114807,102.8
'29,세종특별자치시,'104,65세이상,2019,30280,13148,17132,76.7,30114,13065,17049,76.6
'29,세종특별자치시,'126,평균연령,2019,36.5,35.9,37.1,,36.5,36,37.1,
'29,세종특별자치시,'127,중위연령,2019,37.5,37.2,37.7,,37.6,37.4,37.8,
'29004, 읍부,'000,합계,2019,50338,26341,23997,109.8,48174,25150,23024,109.2
'29004, 읍부,'005,0~4세,2019,1531,831,700,118.7,1488,803,685,117.2
'29004, 읍부,'005001, 0세,2019,260,145,115,126.1,252,139,113,123
'29004, 읍부,'005002, 1세,2019,251,128,123,104.1,243,123,120,102.5
'29004, 읍부,'005003, 2세,2019,303,157,146,107.5,290,148,142,104.2
'29004, 읍부,'005004, 3세,2019,332,177,155,114.2,322,170,152,111.8
'29004, 읍부,'005005, 4세,2019,385,224,161,139.1,381,223,158,141.1
'29004, 읍부,'010,5~9세,2019,2073,1057,1016,104,2037,1039,998,104.1
'29004, 읍부,'010001, 5세,2019,378,188,190,98.9,368,182,186,97.8
'29004, 읍부,'010002, 6세,2019,377,178,199,89.4,366,175,191,91.6
'29004, 읍부,'010003, 7세,2019,443,232,211,110,435,228,207,110.1
'29004, 읍부,'010004, 8세,2019,423,231,192,120.3,420,229,191,119.9
'29004, 읍부,'010005, 9세,2019,452,228,224,101.8,448,225,223,100.9
'29004, 읍부,'015,10~14세,2019,2009,1023,986,103.8,1996,1020,976,104.5
'29004, 읍부,'015001, 10세,2019,390,203,187,108.6,387,202,185,109.2
'29004, 읍부,'015002, 11세,2019,479,239,240,99.6,476,239,237,100.8
'29004, 읍부,'015003, 12세,2019,399,197,202,97.5,395,195,200,97.5
'29004, 읍부,'015004, 13세,2019,366,190,176,108,364,190,174,109.2
'29004, 읍부,'015005, 14세,2019,375,194,181,107.2,374,194,180,107.8
'29004, 읍부,'020,15~19세,2019,3254,1718,1536,111.8,3058,1610,1448,111.2
'29004, 읍부,'020001, 15세,2019,404,213,191,111.5,402,212,190,111.6
'29004, 읍부,'020002, 16세,2019,434,255,179,142.5,430,255,175,145.7
'29004, 읍부,'020003, 17세,2019,474,268,206,130.1,470,267,203,131.5
'29004, 읍부,'020004, 18세,2019,599,323,276,117,533,282,251,112.4
'29004, 읍부,'020005, 19세,2019,1343,659,684,96.3,1223,594,629,94.4
'29004, 읍부,'025,20~24세,2019,7733,3969,3764,105.4,7388,3792,3596,105.5
'29004, 읍부,'025001, 20세,2019,1688,738,950,77.7,1593,693,900,77
'29004, 읍부,'025002, 21세,2019,1480,615,865,71.1,1388,563,825,68.2
'29004, 읍부,'025003, 22세,2019,1557,788,769,102.5,1498,753,745,101.1
'29004, 읍부,'025004, 23세,2019,1645,951,694,137,1586,922,664,138.9
'29004, 읍부,'025005, 24세,2019,1363,877,486,180.5,1323,861,462,186.4
'29004, 읍부,'030,25~29세,2019,4202,2727,1475,184.9,3923,2579,1344,191.9
'29004, 읍부,'030001, 25세,2019,1131,788,343,229.7,1076,767,309,248.2
'29004, 읍부,'030002, 26세,2019,997,688,309,222.7,944,657,287,228.9
'29004, 읍부,'030003, 27세,2019,794,489,305,160.3,740,464,276,168.1
'29004, 읍부,'030004, 28세,2019,685,419,266,157.5,619,379,240,157.9
'29004, 읍부,'030005, 29세,2019,595,343,252,136.1,544,312,232,134.5
'29004, 읍부,'035,30~34세,2019,2682,1489,1193,124.8,2406,1323,1083,122.2
'29004, 읍부,'035001, 30세,2019,529,299,230,130,473,267,206,129.6
'29004, 읍부,'035002, 31세,2019,543,325,218,149.1,488,286,202,141.6
'29004, 읍부,'035003, 32세,2019,526,288,238,121,470,256,214,119.6
'29004, 읍부,'035004, 33세,2019,556,295,261,113,495,261,234,111.5
'29004, 읍부,'035005, 34세,2019,528,282,246,114.6,480,253,227,111.5
'29004, 읍부,'040,35~39세,2019,3213,1704,1509,112.9,3061,1616,1445,111.8
'29004, 읍부,'040001, 35세,2019,552,311,241,129,520,298,222,134.2
'29004, 읍부,'040002, 36세,2019,591,301,290,103.8,564,284,280,101.4
'29004, 읍부,'040003, 37세,2019,700,376,324,116,664,354,310,114.2
'29004, 읍부,'040004, 38세,2019,675,354,321,110.3,646,335,311,107.7
'29004, 읍부,'040005, 39세,2019,695,362,333,108.7,667,345,322,107.1
'29004, 읍부,'045,40~44세,2019,3283,1724,1559,110.6,3134,1648,1486,110.9
'29004, 읍부,'045001, 40세,2019,653,326,327,99.7,618,309,309,100
'29004, 읍부,'045002, 41세,2019,635,340,295,115.3,603,326,277,117.7
'29004, 읍부,'045003, 42세,2019,702,368,334,110.2,668,352,316,111.4
'29004, 읍부,'045004, 43세,2019,659,348,311,111.9,632,331,301,110
'29004, 읍부,'045005, 44세,2019,634,342,292,117.1,613,330,283,116.6
'29004, 읍부,'050,45~49세,2019,3833,2105,1728,121.8,3665,2001,1664,120.3
'29004, 읍부,'050001, 45세,2019,767,422,345,122.3,740,404,336,120.2
'29004, 읍부,'050002, 46세,2019,769,415,354,117.2,740,399,341,117
'29004, 읍부,'050003, 47세,2019,780,436,344,126.7,742,411,331,124.2
'29004, 읍부,'050004, 48세,2019,793,431,362,119.1,755,406,349,116.3
'29004, 읍부,'050005, 49세,2019,724,401,323,124.1,688,381,307,124.1
'29004, 읍부,'055,50~54세,2019,3524,1832,1692,108.3,3346,1737,1609,108
'29004, 읍부,'055001, 50세,2019,775,416,359,115.9,737,395,342,115.5
'29004, 읍부,'055002, 51세,2019,730,386,344,112.2,696,369,327,112.8
'29004, 읍부,'055003, 52세,2019,680,345,335,103,642,326,316,103.2
'29004, 읍부,'055004, 53세,2019,637,333,304,109.5,605,317,288,110.1
'29004, 읍부,'055005, 54세,2019,702,352,350,100.6,666,330,336,98.2
'29004, 읍부,'060,55~59세,2019,3458,1820,1638,111.1,3291,1728,1563,110.6
'29004, 읍부,'060001, 55세,2019,630,351,279,125.8,597,330,267,123.6
'29004, 읍부,'060002, 56세,2019,675,356,319,111.6,625,332,293,113.3
'29004, 읍부,'060003, 57세,2019,664,341,323,105.6,635,327,308,106.2
'29004, 읍부,'060004, 58세,2019,753,396,357,110.9,733,385,348,110.6
'29004, 읍부,'060005, 59세,2019,736,376,360,104.4,701,354,347,102
'29004, 읍부,'065,60~64세,2019,2922,1483,1439,103.1,2823,1428,1395,102.4
'29004, 읍부,'065001, 60세,2019,604,300,304,98.7,581,288,293,98.3
'29004, 읍부,'065002, 61세,2019,564,286,278,102.9,541,275,266,103.4
'29004, 읍부,'065003, 62세,2019,610,298,312,95.5,592,287,305,94.1
'29004, 읍부,'065004, 63세,2019,526,291,235,123.8,512,283,229,123.6
'29004, 읍부,'065005, 64세,2019,618,308,310,99.4,597,295,302,97.7
'29004, 읍부,'070,65~69세,2019,2037,986,1051,93.8,1997,962,1035,92.9
'29004, 읍부,'070001, 65세,2019,471,222,249,89.2,461,219,242,90.5
'29004, 읍부,'070002, 66세,2019,411,198,213,93,399,189,210,90
'29004, 읍부,'070003, 67세,2019,440,232,208,111.5,433,227,206,110.2
'29004, 읍부,'070004, 68세,2019,333,151,182,83,327,147,180,81.7
'29004, 읍부,'070005, 69세,2019,382,183,199,92,377,180,197,91.4
'29004, 읍부,'075,70~74세,2019,1582,714,868,82.3,1569,707,862,82
'29004, 읍부,'075001, 70세,2019,379,177,202,87.6,374,174,200,87
'29004, 읍부,'075002, 71세,2019,336,167,169,98.8,332,165,167,98.8
'29004, 읍부,'075003, 72세,2019,332,153,179,85.5,329,152,177,85.9
'29004, 읍부,'075004, 73세,2019,282,114,168,67.9,281,113,168,67.3
'29004, 읍부,'075005, 74세,2019,253,103,150,68.7,253,103,150,68.7
'29004, 읍부,'080,75~79세,2019,1393,588,805,73,1386,586,800,73.3
'29004, 읍부,'080001, 75세,2019,267,99,168,58.9,266,98,168,58.3
'29004, 읍부,'080002, 76세,2019,283,123,160,76.9,281,123,158,77.8
'29004, 읍부,'080003, 77세,2019,327,144,183,78.7,326,143,183,78.1
'29004, 읍부,'080004, 78세,2019,295,125,170,73.5,293,125,168,74.4
'29004, 읍부,'080005, 79세,2019,221,97,124,78.2,220,97,123,78.9
'29004, 읍부,'085,80~84세,2019,956,383,573,66.8,954,383,571,67.1
'29004, 읍부,'085001, 80세,2019,250,93,157,59.2,250,93,157,59.2
'29004, 읍부,'085002, 81세,2019,215,95,120,79.2,215,95,120,79.2
'29004, 읍부,'085003, 82세,2019,158,68,90,75.6,157,68,89,76.4
'29004, 읍부,'085004, 83세,2019,175,70,105,66.7,175,70,105,66.7
'29004, 읍부,'085005, 84세,2019,158,57,101,56.4,157,57,100,57
'29004, 읍부,'086,85세이상,2019,653,188,465,40.4,652,188,464,40.5
'29004, 읍부,'090,85~89세,2019,428,131,297,44.1,427,131,296,44.3
'29004, 읍부,'090001, 85세,2019,114,44,70,62.9,113,44,69,63.8
'29004, 읍부,'090002, 86세,2019,88,22,66,33.3,88,22,66,33.3
'29004, 읍부,'090003, 87세,2019,85,25,60,41.7,85,25,60,41.7
'29004, 읍부,'090004, 88세,2019,73,17,56,30.4,73,17,56,30.4
'29004, 읍부,'090005, 89세,2019,68,23,45,51.1,68,23,45,51.1
'29004, 읍부,'095,90~94세,2019,187,48,139,34.5,187,48,139,34.5
'29004, 읍부,'095001, 90세,2019,71,19,52,36.5,71,19,52,36.5
'29004, 읍부,'095002, 91세,2019,35,5,30,16.7,35,5,30,16.7
'29004, 읍부,'095003, 92세,2019,36,16,20,80,36,16,20,80
'29004, 읍부,'095004, 93세,2019,22,X,18,22.2,22,X,18,22.2
'29004, 읍부,'095005, 94세,2019,23,X,19,21.1,23,X,19,21.1
'29004, 읍부,'100,95~99세,2019,32,8,24,33.3,32,8,24,33.3
'29004, 읍부,'100001, 95세,2019,12,X,10,20,12,X,10,20
'29004, 읍부,'100002, 96세,2019,7,X,5,40,7,X,5,40
'29004, 읍부,'100003, 97세,2019,9,X,6,50,9,X,6,50
'29004, 읍부,'100004, 98세,2019,X,X,X,100,X,X,X,100
'29004, 읍부,'100005, 99세,2019,X,X,X,0,X,X,X,0
'29004, 읍부,'101,100세이상,2019,6,X,5,20,6,X,5,20
'29004, 읍부,'102,15세미만,2019,5613,2911,2702,107.7,5521,2862,2659,107.6
'29004, 읍부,'103,15~64세,2019,38104,20571,17533,117.3,36095,19462,16633,117
'29004, 읍부,'104,65세이상,2019,6621,2859,3762,76,6558,2826,3732,75.7
'29004, 읍부,'126,평균연령,2019,39.4,38.3,40.6,,39.6,38.4,40.8,
'29004, 읍부,'127,중위연령,2019,37.8,36.1,39.5,,38.1,36.4,39.8,
'29005, 면부,'000,합계,2019,51408,28335,23073,122.8,47450,25419,22031,115.4
'29005, 면부,'005,0~4세,2019,914,472,442,106.8,900,462,438,105.5
'29005, 면부,'005001, 0세,2019,196,96,100,96,196,96,100,96
'29005, 면부,'005002, 1세,2019,176,90,86,104.7,172,86,86,100
'29005, 면부,'005003, 2세,2019,157,80,77,103.9,151,76,75,101.3
'29005, 면부,'005004, 3세,2019,189,101,88,114.8,186,99,87,113.8
'29005, 면부,'005005, 4세,2019,196,105,91,115.4,195,105,90,116.7
'29005, 면부,'010,5~9세,2019,1047,509,538,94.6,1031,500,531,94.2
'29005, 면부,'010001, 5세,2019,199,94,105,89.5,194,90,104,86.5
'29005, 면부,'010002, 6세,2019,214,113,101,111.9,212,112,100,112
'29005, 면부,'010003, 7세,2019,210,102,108,94.4,206,99,107,92.5
'29005, 면부,'010004, 8세,2019,199,88,111,79.3,197,87,110,79.1
'29005, 면부,'010005, 9세,2019,225,112,113,99.1,222,112,110,101.8
'29005, 면부,'015,10~14세,2019,1101,551,550,100.2,1091,549,542,101.3
'29005, 면부,'015001, 10세,2019,213,109,104,104.8,212,108,104,103.8
'29005, 면부,'015002, 11세,2019,253,124,129,96.1,252,124,128,96.9
'29005, 면부,'015003, 12세,2019,203,99,104,95.2,199,98,101,97
'29005, 면부,'015004, 13세,2019,229,118,111,106.3,225,118,107,110.3
'29005, 면부,'015005, 14세,2019,203,101,102,99,203,101,102,99
'29005, 면부,'020,15~19세,2019,2145,1139,1006,113.2,2001,1040,961,108.2
'29005, 면부,'020001, 15세,2019,240,121,119,101.7,238,119,119,100
'29005, 면부,'020002, 16세,2019,237,136,101,134.7,233,136,97,140.2
'29005, 면부,'020003, 17세,2019,236,135,101,133.7,229,130,99,131.3
'29005, 면부,'020004, 18세,2019,488,265,223,118.8,469,255,214,119.2
'29005, 면부,'020005, 19세,2019,944,482,462,104.3,832,400,432,92.6
'29005, 면부,'025,20~24세,2019,4832,2842,1990,142.8,4063,2242,1821,123.1
'29005, 면부,'025001, 20세,2019,823,393,430,91.4,708,301,407,74
'29005, 면부,'025002, 21세,2019,861,424,437,97,734,337,397,84.9
'29005, 면부,'025003, 22세,2019,984,562,422,133.2,833,449,384,116.9
'29005, 면부,'025004, 23세,2019,1083,714,369,193.5,898,562,336,167.3
'29005, 면부,'025005, 24세,2019,1081,749,332,225.6,890,593,297,199.7
'29005, 면부,'030,25~29세,2019,4167,2864,1303,219.8,3304,2172,1132,191.9
'29005, 면부,'030001, 25세,2019,974,702,272,258.1,781,546,235,232.3
'29005, 면부,'030002, 26세,2019,838,587,251,233.9,646,428,218,196.3
'29005, 면부,'030003, 27세,2019,802,518,284,182.4,634,390,244,159.8
'29005, 면부,'030004, 28세,2019,794,524,270,194.1,635,402,233,172.5
'29005, 면부,'030005, 29세,2019,759,533,226,235.8,608,406,202,201
'29005, 면부,'035,30~34세,2019,2925,1948,977,199.4,2286,1435,851,168.6
'29005, 면부,'035001, 30세,2019,670,431,239,180.3,529,321,208,154.3
'29005, 면부,'035002, 31세,2019,609,419,190,220.5,477,315,162,194.4
'29005, 면부,'035003, 32세,2019,584,382,202,189.1,456,278,178,156.2
'29005, 면부,'035004, 33세,2019,544,376,168,223.8,422,272,150,181.3
'29005, 면부,'035005, 34세,2019,518,340,178,191,402,249,153,162.7
'29005, 면부,'040,35~39세,2019,2767,1743,1024,170.2,2307,1406,901,156
'29005, 면부,'040001, 35세,2019,526,328,198,165.7,434,259,175,148
'29005, 면부,'040002, 36세,2019,508,310,198,156.6,409,240,169,142
'29005, 면부,'040003, 37세,2019,595,387,208,186.1,506,319,187,170.6
'29005, 면부,'040004, 38세,2019,570,359,211,170.1,474,285,189,150.8
'29005, 면부,'040005, 39세,2019,568,359,209,171.8,484,303,181,167.4
'29005, 면부,'045,40~44세,2019,2729,1754,975,179.9,2415,1547,868,178.2
'29005, 면부,'045001, 40세,2019,557,370,187,197.9,476,313,163,192
'29005, 면부,'045002, 41세,2019,525,357,168,212.5,450,305,145,210.3
'29005, 면부,'045003, 42세,2019,530,339,191,177.5,482,309,173,178.6
'29005, 면부,'045004, 43세,2019,530,325,205,158.5,481,295,186,158.6
'29005, 면부,'045005, 44세,2019,587,363,224,162.1,526,325,201,161.7
'29005, 면부,'050,45~49세,2019,3374,2067,1307,158.1,3111,1896,1215,156
'29005, 면부,'050001, 45세,2019,646,407,239,170.3,587,362,225,160.9
'29005, 면부,'050002, 46세,2019,641,386,255,151.4,593,352,241,146.1
'29005, 면부,'050003, 47세,2019,594,373,221,168.8,542,341,201,169.7
'29005, 면부,'050004, 48세,2019,736,449,287,156.4,682,420,262,160.3
'29005, 면부,'050005, 49세,2019,757,452,305,148.2,707,421,286,147.2
'29005, 면부,'055,50~54세,2019,3957,2276,1681,135.4,3779,2156,1623,132.8
'29005, 면부,'055001, 50세,2019,811,494,317,155.8,766,465,301,154.5
'29005, 면부,'055002, 51세,2019,771,421,350,120.3,737,402,335,120
'29005, 면부,'055003, 52세,2019,742,405,337,120.2,708,382,326,117.2
'29005, 면부,'055004, 53세,2019,717,409,308,132.8,686,387,299,129.4
'29005, 면부,'055005, 54세,2019,916,547,369,148.2,882,520,362,143.6
'29005, 면부,'060,55~59세,2019,4694,2533,2161,117.2,4549,2453,2096,117
'29005, 면부,'060001, 55세,2019,789,423,366,115.6,755,403,352,114.5
'29005, 면부,'060002, 56세,2019,860,463,397,116.6,820,439,381,115.2
'29005, 면부,'060003, 57세,2019,950,512,438,116.9,920,499,421,118.5
'29005, 면부,'060004, 58세,2019,1054,556,498,111.6,1034,546,488,111.9
'29005, 면부,'060005, 59세,2019,1041,579,462,125.3,1020,566,454,124.7
'29005, 면부,'065,60~64세,2019,4558,2403,2155,111.5,4469,2355,2114,111.4
'29005, 면부,'065001, 60세,2019,972,527,445,118.4,949,516,433,119.2
'29005, 면부,'065002, 61세,2019,867,456,411,110.9,854,446,408,109.3
'29005, 면부,'065003, 62세,2019,881,455,426,106.8,862,449,413,108.7
'29005, 면부,'065004, 63세,2019,902,471,431,109.3,885,458,427,107.3
'29005, 면부,'065005, 64세,2019,936,494,442,111.8,919,486,433,112.2
'29005, 면부,'070,65~69세,2019,3353,1721,1632,105.5,3321,1703,1618,105.3
'29005, 면부,'070001, 65세,2019,794,409,385,106.2,780,403,377,106.9
'29005, 면부,'070002, 66세,2019,626,324,302,107.3,622,321,301,106.6
'29005, 면부,'070003, 67세,2019,747,357,390,91.5,741,352,389,90.5
'29005, 면부,'070004, 68세,2019,542,285,257,110.9,540,285,255,111.8
'29005, 면부,'070005, 69세,2019,644,346,298,116.1,638,342,296,115.5
'29005, 면부,'075,70~74세,2019,2588,1240,1348,92,2574,1234,1340,92.1
'29005, 면부,'075001, 70세,2019,651,319,332,96.1,649,318,331,96.1
'29005, 면부,'075002, 71세,2019,560,266,294,90.5,557,266,291,91.4
'29005, 면부,'075003, 72세,2019,515,248,267,92.9,510,245,265,92.5
'29005, 면부,'075004, 73세,2019,439,210,229,91.7,436,209,227,92.1
'29005, 면부,'075005, 74세,2019,423,197,226,87.2,422,196,226,86.7
'29005, 면부,'080,75~79세,2019,2607,1060,1547,68.5,2606,1059,1547,68.5
'29005, 면부,'080001, 75세,2019,483,200,283,70.7,483,200,283,70.7
'29005, 면부,'080002, 76세,2019,464,199,265,75.1,464,199,265,75.1
'29005, 면부,'080003, 77세,2019,667,285,382,74.6,667,285,382,74.6
'29005, 면부,'080004, 78세,2019,501,189,312,60.6,500,188,312,60.3
'29005, 면부,'080005, 79세,2019,492,187,305,61.3,492,187,305,61.3
'29005, 면부,'085,80~84세,2019,2060,776,1284,60.4,2057,775,1282,60.5
'29005, 면부,'085001, 80세,2019,490,193,297,65,489,192,297,64.6
'29005, 면부,'085002, 81세,2019,447,170,277,61.4,446,170,276,61.6
'29005, 면부,'085003, 82세,2019,407,146,261,55.9,406,146,260,56.2
'29005, 면부,'085004, 83세,2019,379,138,241,57.3,379,138,241,57.3
'29005, 면부,'085005, 84세,2019,337,129,208,62,337,129,208,62
'29005, 면부,'086,85세이상,2019,1590,437,1153,37.9,1586,435,1151,37.8
'29005, 면부,'090,85~89세,2019,1159,351,808,43.4,1156,349,807,43.2
'29005, 면부,'090001, 85세,2019,326,115,211,54.5,325,115,210,54.8
'29005, 면부,'090002, 86세,2019,300,87,213,40.8,298,85,213,39.9
'29005, 면부,'090003, 87세,2019,221,58,163,35.6,221,58,163,35.6
'29005, 면부,'090004, 88세,2019,176,53,123,43.1,176,53,123,43.1
'29005, 면부,'090005, 89세,2019,136,38,98,38.8,136,38,98,38.8
'29005, 면부,'095,90~94세,2019,360,76,284,26.8,359,76,283,26.9
'29005, 면부,'095001, 90세,2019,122,24,98,24.5,122,24,98,24.5
'29005, 면부,'095002, 91세,2019,90,22,68,32.4,90,22,68,32.4
'29005, 면부,'095003, 92세,2019,70,15,55,27.3,70,15,55,27.3
'29005, 면부,'095004, 93세,2019,44,8,36,22.2,43,8,35,22.9
'29005, 면부,'095005, 94세,2019,34,7,27,25.9,34,7,27,25.9
'29005, 면부,'100,95~99세,2019,58,9,49,18.4,58,9,49,18.4
'29005, 면부,'100001, 95세,2019,19,X,17,11.8,19,X,17,11.8
'29005, 면부,'100002, 96세,2019,16,X,13,23.1,16,X,13,23.1
'29005, 면부,'100003, 97세,2019,15,X,12,25,15,X,12,25
'29005, 면부,'100004, 98세,2019,7,X,6,16.7,7,X,6,16.7
'29005, 면부,'100005, 99세,2019,X,X,X,0,X,X,X,0
'29005, 면부,'101,100세이상,2019,13,X,12,8.3,13,X,12,8.3
'29005, 면부,'102,15세미만,2019,3062,1532,1530,100.1,3022,1511,1511,100
'29005, 면부,'103,15~64세,2019,36148,21569,14579,147.9,32284,18702,13582,137.7
'29005, 면부,'104,65세이상,2019,12198,5234,6964,75.2,12144,5206,6938,75
'29005, 면부,'126,평균연령,2019,47.7,45.3,50.6,,48.8,46.7,51.3,
'29005, 면부,'127,중위연령,2019,49.6,45.8,54.3,,51.6,48.7,55.4,
'29003, 동부,'000,합계,2019,236390,115472,120918,95.5,234683,114719,119964,95.6
'29003, 동부,'005,0~4세,2019,19340,9832,9508,103.4,19295,9809,9486,103.4
'29003, 동부,'005001, 0세,2019,3342,1698,1644,103.3,3338,1696,1642,103.3
'29003, 동부,'005002, 1세,2019,3531,1771,1760,100.6,3526,1770,1756,100.8
'29003, 동부,'005003, 2세,2019,3886,1977,1909,103.6,3875,1971,1904,103.5
'29003, 동부,'005004, 3세,2019,4256,2202,2054,107.2,4245,2196,2049,107.2
'29003, 동부,'005005, 4세,2019,4325,2184,2141,102,4311,2176,2135,101.9
'29003, 동부,'010,5~9세,2019,21278,10911,10367,105.2,21257,10899,10358,105.2
'29003, 동부,'010001, 5세,2019,4175,2146,2029,105.8,4169,2142,2027,105.7
'29003, 동부,'010002, 6세,2019,4246,2164,2082,103.9,4244,2162,2082,103.8
'29003, 동부,'010003, 7세,2019,4468,2300,2168,106.1,4464,2297,2167,106
'29003, 동부,'010004, 8세,2019,4345,2239,2106,106.3,4338,2236,2102,106.4
'29003, 동부,'010005, 9세,2019,4044,2062,1982,104,4042,2062,1980,104.1
'29003, 동부,'015,10~14세,2019,18270,9108,9162,99.4,18250,9101,9149,99.5
'29003, 동부,'015001, 10세,2019,3944,2002,1942,103.1,3939,1999,1940,103
'29003, 동부,'015002, 11세,2019,3926,1950,1976,98.7,3924,1950,1974,98.8
'29003, 동부,'015003, 12세,2019,3830,1883,1947,96.7,3826,1880,1946,96.6
'29003, 동부,'015004, 13세,2019,3516,1782,1734,102.8,3511,1781,1730,102.9
'29003, 동부,'015005, 14세,2019,3054,1491,1563,95.4,3050,1491,1559,95.6
'29003, 동부,'020,15~19세,2019,12442,6111,6331,96.5,12410,6094,6316,96.5
'29003, 동부,'020001, 15세,2019,3137,1524,1613,94.5,3136,1524,1612,94.5
'29003, 동부,'020002, 16세,2019,2923,1381,1542,89.6,2921,1380,1541,89.6
'29003, 동부,'020003, 17세,2019,2615,1284,1331,96.5,2612,1283,1329,96.5
'29003, 동부,'020004, 18세,2019,2231,1066,1165,91.5,2223,1062,1161,91.5
'29003, 동부,'020005, 19세,2019,1536,856,680,125.9,1518,845,673,125.6
'29003, 동부,'025,20~24세,2019,8239,4405,3834,114.9,8040,4317,3723,116
'29003, 동부,'025001, 20세,2019,1545,912,633,144.1,1515,896,619,144.7
'29003, 동부,'025002, 21세,2019,1639,1008,631,159.7,1603,990,613,161.5
'29003, 동부,'025003, 22세,2019,1596,874,722,121.1,1562,864,698,123.8
'29003, 동부,'025004, 23세,2019,1713,819,894,91.6,1664,798,866,92.1
'29003, 동부,'025005, 24세,2019,1746,792,954,83,1696,769,927,83
'29003, 동부,'030,25~29세,2019,12498,5310,7188,73.9,12222,5202,7020,74.1
'29003, 동부,'030001, 25세,2019,1999,886,1113,79.6,1945,870,1075,80.9
'29003, 동부,'030002, 26세,2019,2186,950,1236,76.9,2135,930,1205,77.2
'29003, 동부,'030003, 27세,2019,2606,1103,1503,73.4,2540,1075,1465,73.4
'29003, 동부,'030004, 28세,2019,2723,1093,1630,67.1,2666,1068,1598,66.8
'29003, 동부,'030005, 29세,2019,2984,1278,1706,74.9,2936,1259,1677,75.1
'29003, 동부,'035,30~34세,2019,20020,9240,10780,85.7,19691,9082,10609,85.6
'29003, 동부,'035001, 30세,2019,3315,1495,1820,82.1,3251,1464,1787,81.9
'29003, 동부,'035002, 31세,2019,3653,1651,2002,82.5,3588,1621,1967,82.4
'29003, 동부,'035003, 32세,2019,4083,1819,2264,80.3,4023,1790,2233,80.2
'29003, 동부,'035004, 33세,2019,4345,2048,2297,89.2,4278,2013,2265,88.9
'29003, 동부,'035005, 34세,2019,4624,2227,2397,92.9,4551,2194,2357,93.1
'29003, 동부,'040,35~39세,2019,29471,13935,15536,89.7,29234,13850,15384,90
'29003, 동부,'040001, 35세,2019,4976,2364,2612,90.5,4926,2344,2582,90.8
'29003, 동부,'040002, 36세,2019,5647,2598,3049,85.2,5592,2579,3013,85.6
'29003, 동부,'040003, 37세,2019,6336,2982,3354,88.9,6276,2961,3315,89.3
'29003, 동부,'040004, 38세,2019,6268,2963,3305,89.7,6233,2954,3279,90.1
'29003, 동부,'040005, 39세,2019,6244,3028,3216,94.2,6207,3012,3195,94.3
'29003, 동부,'045,40~44세,2019,26766,13007,13759,94.5,26607,12937,13670,94.6
'29003, 동부,'045001, 40세,2019,6133,2941,3192,92.1,6088,2920,3168,92.2
'29003, 동부,'045002, 41세,2019,5328,2538,2790,91,5295,2524,2771,91.1
'29003, 동부,'045003, 42세,2019,5349,2604,2745,94.9,5323,2593,2730,95
'29003, 동부,'045004, 43세,2019,4953,2409,2544,94.7,4919,2394,2525,94.8
'29003, 동부,'045005, 44세,2019,5003,2515,2488,101.1,4982,2506,2476,101.2
'29003, 동부,'050,45~49세,2019,22310,11528,10782,106.9,22198,11471,10727,106.9
'29003, 동부,'050001, 45세,2019,5121,2572,2549,100.9,5085,2553,2532,100.8
'29003, 동부,'050002, 46세,2019,4720,2419,2301,105.1,4702,2407,2295,104.9
'29003, 동부,'050003, 47세,2019,4295,2297,1998,115,4279,2288,1991,114.9
'29003, 동부,'050004, 48세,2019,4433,2274,2159,105.3,4408,2265,2143,105.7
'29003, 동부,'050005, 49세,2019,3741,1966,1775,110.8,3724,1958,1766,110.9
'29003, 동부,'055,50~54세,2019,14535,7380,7155,103.1,14465,7345,7120,103.2
'29003, 동부,'055001, 50세,2019,3524,1826,1698,107.5,3508,1818,1690,107.6
'29003, 동부,'055002, 51세,2019,3294,1671,1623,103,3279,1666,1613,103.3
'29003, 동부,'055003, 52세,2019,2785,1416,1369,103.4,2774,1409,1365,103.2
'29003, 동부,'055004, 53세,2019,2455,1248,1207,103.4,2441,1238,1203,102.9
'29003, 동부,'055005, 54세,2019,2477,1219,1258,96.9,2463,1214,1249,97.2
'29003, 동부,'060,55~59세,2019,11237,5544,5693,97.4,11147,5508,5639,97.7
'29003, 동부,'060001, 55세,2019,2195,1104,1091,101.2,2180,1099,1081,101.7
'29003, 동부,'060002, 56세,2019,2246,1132,1114,101.6,2219,1123,1096,102.5
'29003, 동부,'060003, 57세,2019,2185,1097,1088,100.8,2168,1090,1078,101.1
'29003, 동부,'060004, 58세,2019,2439,1180,1259,93.7,2428,1175,1253,93.8
'29003, 동부,'060005, 59세,2019,2172,1031,1141,90.4,2152,1021,1131,90.3
'29003, 동부,'065,60~64세,2019,8523,4106,4417,93,8455,4071,4384,92.9
'29003, 동부,'065001, 60세,2019,1931,940,991,94.9,1918,933,985,94.7
'29003, 동부,'065002, 61세,2019,1830,883,947,93.2,1814,874,940,93
'29003, 동부,'065003, 62세,2019,1701,833,868,96,1688,824,864,95.4
'29003, 동부,'065004, 63세,2019,1556,735,821,89.5,1548,731,817,89.5
'29003, 동부,'065005, 64세,2019,1505,715,790,90.5,1487,709,778,91.1
'29003, 동부,'070,65~69세,2019,4847,2278,2569,88.7,4817,2263,2554,88.6
'29003, 동부,'070001, 65세,2019,1220,565,655,86.3,1216,564,652,86.5
'29003, 동부,'070002, 66세,2019,979,481,498,96.6,969,475,494,96.2
'29003, 동부,'070003, 67세,2019,1058,486,572,85,1052,484,568,85.2
'29003, 동부,'070004, 68세,2019,750,351,399,88,748,350,398,87.9
'29003, 동부,'070005, 69세,2019,840,395,445,88.8,832,390,442,88.2
'29003, 동부,'075,70~74세,2019,2990,1454,1536,94.7,2981,1449,1532,94.6
'29003, 동부,'075001, 70세,2019,755,357,398,89.7,752,355,397,89.4
'29003, 동부,'075002, 71세,2019,660,342,318,107.5,658,341,317,107.6
'29003, 동부,'075003, 72세,2019,669,308,361,85.3,667,307,360,85.3
'29003, 동부,'075004, 73세,2019,460,233,227,102.6,459,232,227,102.2
'29003, 동부,'075005, 74세,2019,446,214,232,92.2,445,214,231,92.6
'29003, 동부,'080,75~79세,2019,1793,814,979,83.1,1788,813,975,83.4
'29003, 동부,'080001, 75세,2019,391,192,199,96.5,390,192,198,97
'29003, 동부,'080002, 76세,2019,367,181,186,97.3,366,181,185,97.8
'29003, 동부,'080003, 77세,2019,444,196,248,79,443,196,247,79.4
'29003, 동부,'080004, 78세,2019,334,146,188,77.7,333,145,188,77.1
'29003, 동부,'080005, 79세,2019,257,99,158,62.7,256,99,157,63.1
'29003, 동부,'085,80~84세,2019,1029,316,713,44.3,1027,315,712,44.2
'29003, 동부,'085001, 80세,2019,248,81,167,48.5,248,81,167,48.5
'29003, 동부,'085002, 81세,2019,236,79,157,50.3,235,79,156,50.6
'29003, 동부,'085003, 82세,2019,189,59,130,45.4,189,59,130,45.4
'29003, 동부,'085004, 83세,2019,183,63,120,52.5,182,62,120,51.7
'29003, 동부,'085005, 84세,2019,173,34,139,24.5,173,34,139,24.5
'29003, 동부,'086,85세이상,2019,802,193,609,31.7,799,193,606,31.8
'29003, 동부,'090,85~89세,2019,567,136,431,31.6,565,136,429,31.7
'29003, 동부,'090001, 85세,2019,162,46,116,39.7,161,46,115,40
'29003, 동부,'090002, 86세,2019,119,30,89,33.7,119,30,89,33.7
'29003, 동부,'090003, 87세,2019,111,22,89,24.7,111,22,89,24.7
'29003, 동부,'090004, 88세,2019,91,22,69,31.9,91,22,69,31.9
'29003, 동부,'090005, 89세,2019,84,16,68,23.5,83,16,67,23.9
'29003, 동부,'095,90~94세,2019,198,49,149,32.9,197,49,148,33.1
'29003, 동부,'095001, 90세,2019,72,20,52,38.5,72,20,52,38.5
'29003, 동부,'095002, 91세,2019,58,15,43,34.9,58,15,43,34.9
'29003, 동부,'095003, 92세,2019,28,5,23,21.7,28,5,23,21.7
'29003, 동부,'095004, 93세,2019,20,X,16,25,20,X,16,25
'29003, 동부,'095005, 94세,2019,20,5,15,33.3,19,5,14,35.7
'29003, 동부,'100,95~99세,2019,35,8,27,29.6,35,8,27,29.6
'29003, 동부,'100001, 95세,2019,11,X,8,37.5,11,X,8,37.5
'29003, 동부,'100002, 96세,2019,10,X,9,11.1,10,X,9,11.1
'29003, 동부,'100003, 97세,2019,6,X,X,50,6,X,X,50
'29003, 동부,'100004, 98세,2019,X,X,X,50,X,X,X,50
'29003, 동부,'100005, 99세,2019,5,X,X,25,5,X,X,25
'29003, 동부,'101,100세이상,2019,X,X,X,0,X,X,X,0
'29003, 동부,'102,15세미만,2019,58888,29851,29037,102.8,58802,29809,28993,102.8
'29003, 동부,'103,15~64세,2019,166041,80566,85475,94.3,164469,79877,84592,94.4
'29003, 동부,'104,65세이상,2019,11461,5055,6406,78.9,11412,5033,6379,78.9
'29003, 동부,'126,평균연령,2019,33.5,33.1,33.8,,33.4,33.1,33.8,
'29003, 동부,'127,중위연령,2019,36.2,36.2,36.2,,36.2,36.2,36.2,
'29010, 세종시,'000,합계,2019,338136,170148,167988,101.3,330307,165288,165019,100.2
'29010, 세종시,'005,0~4세,2019,21785,11135,10650,104.6,21683,11074,10609,104.4
'29010, 세종시,'005001, 0세,2019,3798,1939,1859,104.3,3786,1931,1855,104.1
'29010, 세종시,'005002, 1세,2019,3958,1989,1969,101,3941,1979,1962,100.9
'29010, 세종시,'005003, 2세,2019,4346,2214,2132,103.8,4316,2195,2121,103.5
'29010, 세종시,'005004, 3세,2019,4777,2480,2297,108,4753,2465,2288,107.7
'29010, 세종시,'005005, 4세,2019,4906,2513,2393,105,4887,2504,2383,105.1
'29010, 세종시,'010,5~9세,2019,24398,12477,11921,104.7,24325,12438,11887,104.6
'29010, 세종시,'010001, 5세,2019,4752,2428,2324,104.5,4731,2414,2317,104.2
'29010, 세종시,'010002, 6세,2019,4837,2455,2382,103.1,4822,2449,2373,103.2
'29010, 세종시,'010003, 7세,2019,5121,2634,2487,105.9,5105,2624,2481,105.8
'29010, 세종시,'010004, 8세,2019,4967,2558,2409,106.2,4955,2552,2403,106.2
'29010, 세종시,'010005, 9세,2019,4721,2402,2319,103.6,4712,2399,2313,103.7
'29010, 세종시,'015,10~14세,2019,21380,10682,10698,99.9,21337,10670,10667,100
'29010, 세종시,'015001, 10세,2019,4547,2314,2233,103.6,4538,2309,2229,103.6
'29010, 세종시,'015002, 11세,2019,4658,2313,2345,98.6,4652,2313,2339,98.9
'29010, 세종시,'015003, 12세,2019,4432,2179,2253,96.7,4420,2173,2247,96.7
'29010, 세종시,'015004, 13세,2019,4111,2090,2021,103.4,4100,2089,2011,103.9
'29010, 세종시,'015005, 14세,2019,3632,1786,1846,96.7,3627,1786,1841,97
'29010, 세종시,'020,15~19세,2019,17841,8968,8873,101.1,17469,8744,8725,100.2
'29010, 세종시,'020001, 15세,2019,3781,1858,1923,96.6,3776,1855,1921,96.6
'29010, 세종시,'020002, 16세,2019,3594,1772,1822,97.3,3584,1771,1813,97.7
'29010, 세종시,'020003, 17세,2019,3325,1687,1638,103,3311,1680,1631,103
'29010, 세종시,'020004, 18세,2019,3318,1654,1664,99.4,3225,1599,1626,98.3
'29010, 세종시,'020005, 19세,2019,3823,1997,1826,109.4,3573,1839,1734,106.1
'29010, 세종시,'025,20~24세,2019,20804,11216,9588,117,19491,10351,9140,113.2
'29010, 세종시,'025001, 20세,2019,4056,2043,2013,101.5,3816,1890,1926,98.1
'29010, 세종시,'025002, 21세,2019,3980,2047,1933,105.9,3725,1890,1835,103
'29010, 세종시,'025003, 22세,2019,4137,2224,1913,116.3,3893,2066,1827,113.1
'29010, 세종시,'025004, 23세,2019,4441,2484,1957,126.9,4148,2282,1866,122.3
'29010, 세종시,'025005, 24세,2019,4190,2418,1772,136.5,3909,2223,1686,131.9
'29010, 세종시,'030,25~29세,2019,20867,10901,9966,109.4,19449,9953,9496,104.8
'29010, 세종시,'030001, 25세,2019,4104,2376,1728,137.5,3802,2183,1619,134.8
'29010, 세종시,'030002, 26세,2019,4021,2225,1796,123.9,3725,2015,1710,117.8
'29010, 세종시,'030003, 27세,2019,4202,2110,2092,100.9,3914,1929,1985,97.2
'29010, 세종시,'030004, 28세,2019,4202,2036,2166,94,3920,1849,2071,89.3
'29010, 세종시,'030005, 29세,2019,4338,2154,2184,98.6,4088,1977,2111,93.7
'29010, 세종시,'035,30~34세,2019,25627,12677,12950,97.9,24383,11840,12543,94.4
'29010, 세종시,'035001, 30세,2019,4514,2225,2289,97.2,4253,2052,2201,93.2
'29010, 세종시,'035002, 31세,2019,4805,2395,2410,99.4,4553,2222,2331,95.3
'29010, 세종시,'035003, 32세,2019,5193,2489,2704,92,4949,2324,2625,88.5
'29010, 세종시,'035004, 33세,2019,5445,2719,2726,99.7,5195,2546,2649,96.1
'29010, 세종시,'035005, 34세,2019,5670,2849,2821,101,5433,2696,2737,98.5
'29010, 세종시,'040,35~39세,2019,35451,17382,18069,96.2,34602,16872,17730,95.2
'29010, 세종시,'040001, 35세,2019,6054,3003,3051,98.4,5880,2901,2979,97.4
'29010, 세종시,'040002, 36세,2019,6746,3209,3537,90.7,6565,3103,3462,89.6
'29010, 세종시,'040003, 37세,2019,7631,3745,3886,96.4,7446,3634,3812,95.3
'29010, 세종시,'040004, 38세,2019,7513,3676,3837,95.8,7353,3574,3779,94.6
'29010, 세종시,'040005, 39세,2019,7507,3749,3758,99.8,7358,3660,3698,99
'29010, 세종시,'045,40~44세,2019,32778,16485,16293,101.2,32156,16132,16024,100.7
'29010, 세종시,'045001, 40세,2019,7343,3637,3706,98.1,7182,3542,3640,97.3
'29010, 세종시,'045002, 41세,2019,6488,3235,3253,99.4,6348,3155,3193,98.8
'29010, 세종시,'045003, 42세,2019,6581,3311,3270,101.3,6473,3254,3219,101.1
'29010, 세종시,'045004, 43세,2019,6142,3082,3060,100.7,6032,3020,3012,100.3
'29010, 세종시,'045005, 44세,2019,6224,3220,3004,107.2,6121,3161,2960,106.8
'29010, 세종시,'050,45~49세,2019,29517,15700,13817,113.6,28974,15368,13606,113
'29010, 세종시,'050001, 45세,2019,6534,3401,3133,108.6,6412,3319,3093,107.3
'29010, 세종시,'050002, 46세,2019,6130,3220,2910,110.7,6035,3158,2877,109.8
'29010, 세종시,'050003, 47세,2019,5669,3106,2563,121.2,5563,3040,2523,120.5
'29010, 세종시,'050004, 48세,2019,5962,3154,2808,112.3,5845,3091,2754,112.2
'29010, 세종시,'050005, 49세,2019,5222,2819,2403,117.3,5119,2760,2359,117
'29010, 세종시,'055,50~54세,2019,22016,11488,10528,109.1,21590,11238,10352,108.6
'29010, 세종시,'055001, 50세,2019,5110,2736,2374,115.2,5011,2678,2333,114.8
'29010, 세종시,'055002, 51세,2019,4795,2478,2317,106.9,4712,2437,2275,107.1
'29010, 세종시,'055003, 52세,2019,4207,2166,2041,106.1,4124,2117,2007,105.5
'29010, 세종시,'055004, 53세,2019,3809,1990,1819,109.4,3732,1942,1790,108.5
'29010, 세종시,'055005, 54세,2019,4095,2118,1977,107.1,4011,2064,1947,106
'29010, 세종시,'060,55~59세,2019,19389,9897,9492,104.3,18987,9689,9298,104.2
'29010, 세종시,'060001, 55세,2019,3614,1878,1736,108.2,3532,1832,1700,107.8
'29010, 세종시,'060002, 56세,2019,3781,1951,1830,106.6,3664,1894,1770,107
'29010, 세종시,'060003, 57세,2019,3799,1950,1849,105.5,3723,1916,1807,106
'29010, 세종시,'060004, 58세,2019,4246,2132,2114,100.9,4195,2106,2089,100.8
'29010, 세종시,'060005, 59세,2019,3949,1986,1963,101.2,3873,1941,1932,100.5
'29010, 세종시,'065,60~64세,2019,16003,7992,8011,99.8,15747,7854,7893,99.5
'29010, 세종시,'065001, 60세,2019,3507,1767,1740,101.6,3448,1737,1711,101.5
'29010, 세종시,'065002, 61세,2019,3261,1625,1636,99.3,3209,1595,1614,98.8
'29010, 세종시,'065003, 62세,2019,3192,1586,1606,98.8,3142,1560,1582,98.6
'29010, 세종시,'065004, 63세,2019,2984,1497,1487,100.7,2945,1472,1473,99.9
'29010, 세종시,'065005, 64세,2019,3059,1517,1542,98.4,3003,1490,1513,98.5
'29010, 세종시,'070,65~69세,2019,10237,4985,5252,94.9,10135,4928,5207,94.6
'29010, 세종시,'070001, 65세,2019,2485,1196,1289,92.8,2457,1186,1271,93.3
'29010, 세종시,'070002, 66세,2019,2016,1003,1013,99,1990,985,1005,98
'29010, 세종시,'070003, 67세,2019,2245,1075,1170,91.9,2226,1063,1163,91.4
'29010, 세종시,'070004, 68세,2019,1625,787,838,93.9,1615,782,833,93.9
'29010, 세종시,'070005, 69세,2019,1866,924,942,98.1,1847,912,935,97.5
'29010, 세종시,'075,70~74세,2019,7160,3408,3752,90.8,7124,3390,3734,90.8
'29010, 세종시,'075001, 70세,2019,1785,853,932,91.5,1775,847,928,91.3
'29010, 세종시,'075002, 71세,2019,1556,775,781,99.2,1547,772,775,99.6
'29010, 세종시,'075003, 72세,2019,1516,709,807,87.9,1506,704,802,87.8
'29010, 세종시,'075004, 73세,2019,1181,557,624,89.3,1176,554,622,89.1
'29010, 세종시,'075005, 74세,2019,1122,514,608,84.5,1120,513,607,84.5
'29010, 세종시,'080,75~79세,2019,5793,2462,3331,73.9,5780,2458,3322,74
'29010, 세종시,'080001, 75세,2019,1141,491,650,75.5,1139,490,649,75.5
'29010, 세종시,'080002, 76세,2019,1114,503,611,82.3,1111,503,608,82.7
'29010, 세종시,'080003, 77세,2019,1438,625,813,76.9,1436,624,812,76.8
'29010, 세종시,'080004, 78세,2019,1130,460,670,68.7,1126,458,668,68.6
'29010, 세종시,'080005, 79세,2019,970,383,587,65.2,968,383,585,65.5
'29010, 세종시,'085,80~84세,2019,4045,1475,2570,57.4,4038,1473,2565,57.4
'29010, 세종시,'085001, 80세,2019,988,367,621,59.1,987,366,621,58.9
'29010, 세종시,'085002, 81세,2019,898,344,554,62.1,896,344,552,62.3
'29010, 세종시,'085003, 82세,2019,754,273,481,56.8,752,273,479,57
'29010, 세종시,'085004, 83세,2019,737,271,466,58.2,736,270,466,57.9
'29010, 세종시,'085005, 84세,2019,668,220,448,49.1,667,220,447,49.2
'29010, 세종시,'086,85세이상,2019,3045,818,2227,36.7,3037,816,2221,36.7
'29010, 세종시,'090,85~89세,2019,2154,618,1536,40.2,2148,616,1532,40.2
'29010, 세종시,'090001, 85세,2019,602,205,397,51.6,599,205,394,52
'29010, 세종시,'090002, 86세,2019,507,139,368,37.8,505,137,368,37.2
'29010, 세종시,'090003, 87세,2019,417,105,312,33.7,417,105,312,33.7
'29010, 세종시,'090004, 88세,2019,340,92,248,37.1,340,92,248,37.1
'29010, 세종시,'090005, 89세,2019,288,77,211,36.5,287,77,210,36.7
'29010, 세종시,'095,90~94세,2019,745,173,572,30.2,743,173,570,30.4
'29010, 세종시,'095001, 90세,2019,265,63,202,31.2,265,63,202,31.2
'29010, 세종시,'095002, 91세,2019,183,42,141,29.8,183,42,141,29.8
'29010, 세종시,'095003, 92세,2019,134,36,98,36.7,134,36,98,36.7
'29010, 세종시,'095004, 93세,2019,86,16,70,22.9,85,16,69,23.2
'29010, 세종시,'095005, 94세,2019,77,16,61,26.2,76,16,60,26.7
'29010, 세종시,'100,95~99세,2019,125,25,100,25,125,25,100,25
'29010, 세종시,'100001, 95세,2019,42,7,35,20,42,7,35,20
'29010, 세종시,'100002, 96세,2019,33,6,27,22.2,33,6,27,22.2
'29010, 세종시,'100003, 97세,2019,30,8,22,36.4,30,8,22,36.4
'29010, 세종시,'100004, 98세,2019,12,X,9,33.3,12,X,9,33.3
'29010, 세종시,'100005, 99세,2019,8,X,7,14.3,8,X,7,14.3
'29010, 세종시,'101,100세이상,2019,21,X,19,10.5,21,X,19,10.5
'29010, 세종시,'102,15세미만,2019,67563,34294,33269,103.1,67345,34182,33163,103.1
'29010, 세종시,'103,15~64세,2019,240293,122706,117587,104.4,232848,118041,114807,102.8
'29010, 세종시,'104,65세이상,2019,30280,13148,17132,76.7,30114,13065,17049,76.6
'29010, 세종시,'126,평균연령,2019,36.5,35.9,37.1,,36.5,36,37.1,
'29010, 세종시,'127,중위연령,2019,37.5,37.2,37.7,,37.6,37.4,37.8,
'31,경기도,'000,합계,2019,13300900,6740448,6560452,102.7,12706105,6385194,6320911,101
'31,경기도,'005,0~4세,2019,538700,276443,262257,105.4,523378,268607,254771,105.4
'31,경기도,'005001, 0세,2019,87866,45202,42664,105.9,85051,43766,41285,106
'31,경기도,'005002, 1세,2019,97047,49757,47290,105.2,93940,48146,45794,105.1
'31,경기도,'005003, 2세,2019,105830,54458,51372,106,102631,52849,49782,106.2
'31,경기도,'005004, 3세,2019,120858,61861,58997,104.9,117435,60108,57327,104.9
'31,경기도,'005005, 4세,2019,127099,65165,61934,105.2,124321,63738,60583,105.2
'31,경기도,'010,5~9세,2019,648107,332102,316005,105.1,638841,327453,311388,105.2
'31,경기도,'010001, 5세,2019,124912,63830,61082,104.5,122490,62625,59865,104.6
'31,경기도,'010002, 6세,2019,125369,64026,61343,104.4,123303,63015,60288,104.5
'31,경기도,'010003, 7세,2019,136542,70102,66440,105.5,134634,69152,65482,105.6
'31,경기도,'010004, 8세,2019,133240,68274,64966,105.1,131687,67471,64216,105.1
'31,경기도,'010005, 9세,2019,128044,65870,62174,105.9,126727,65190,61537,105.9
'31,경기도,'015,10~14세,2019,624707,320316,304391,105.2,619547,317745,301802,105.3
'31,경기도,'015001, 10세,2019,124046,63770,60276,105.8,122776,63116,59660,105.8
'31,경기도,'015002, 11세,2019,130552,66949,63603,105.3,129391,66346,63045,105.2
'31,경기도,'015003, 12세,2019,132249,67717,64532,104.9,131208,67210,63998,105
'31,경기도,'015004, 13세,2019,120549,61894,58655,105.5,119682,61468,58214,105.6
'31,경기도,'015005, 14세,2019,117311,59986,57325,104.6,116490,59605,56885,104.8
'31,경기도,'020,15~19세,2019,684717,353116,331601,106.5,676519,349037,327482,106.6
'31,경기도,'020001, 15세,2019,126722,65054,61668,105.5,125911,64648,61263,105.5
'31,경기도,'020002, 16세,2019,126954,65191,61763,105.6,126247,64843,61404,105.6
'31,경기도,'020003, 17세,2019,129861,66991,62870,106.6,128985,66542,62443,106.6
'31,경기도,'020004, 18세,2019,145942,75012,70930,105.8,144184,74192,69992,106
'31,경기도,'020005, 19세,2019,155238,80868,74370,108.7,151192,78812,72380,108.9
'31,경기도,'025,20~24세,2019,834387,444948,389439,114.3,786388,413913,372475,111.1
'31,경기도,'025001, 20세,2019,151643,80825,70818,114.1,145860,77589,68271,113.6
'31,경기도,'025002, 21세,2019,159752,86016,73736,116.7,152173,81398,70775,115
'31,경기도,'025003, 22세,2019,166268,88551,77717,113.9,156781,82392,74389,110.8
'31,경기도,'025004, 23세,2019,173996,92255,81741,112.9,162475,84497,77978,108.4
'31,경기도,'025005, 24세,2019,182728,97301,85427,113.9,169099,88037,81062,108.6
'31,경기도,'030,25~29세,2019,953622,517879,435743,118.8,868553,460084,408469,112.6
'31,경기도,'030001, 25세,2019,189172,102257,86915,117.7,174652,92180,82472,111.8
'31,경기도,'030002, 26세,2019,193895,105435,88460,119.2,177803,94371,83432,113.1
'31,경기도,'030003, 27세,2019,198630,108519,90111,120.4,181455,96759,84696,114.2
'31,경기도,'030004, 28세,2019,189642,102889,86753,118.6,172043,91069,80974,112.5
'31,경기도,'030005, 29세,2019,182283,98779,83504,118.3,162600,85705,76895,111.5
'31,경기도,'035,30~34세,2019,906611,483344,423267,114.2,810656,420945,389711,108
'31,경기도,'035001, 30세,2019,179357,97285,82072,118.5,159865,84379,75486,111.8
'31,경기도,'035002, 31세,2019,177592,94984,82608,115,157868,82190,75678,108.6
'31,경기도,'035003, 32세,2019,179138,95221,83917,113.5,159261,82305,76956,107
'31,경기도,'035004, 33세,2019,182776,96959,85817,113,163738,84702,79036,107.2
'31,경기도,'035005, 34세,2019,187748,98895,88853,111.3,169924,87369,82555,105.8
'31,경기도,'040,35~39세,2019,1118336,582039,536297,108.5,1044396,534214,510182,104.7
'31,경기도,'040001, 35세,2019,194490,102175,92315,110.7,177749,91231,86518,105.4
'31,경기도,'040002, 36세,2019,215074,112244,102830,109.2,199457,102140,97317,105
'31,경기도,'040003, 37세,2019,234240,121999,112241,108.7,218592,111944,106648,105
'31,경기도,'040004, 38세,2019,235288,122396,112892,108.4,222033,113839,108194,105.2
'31,경기도,'040005, 39세,2019,239244,123225,116019,106.2,226565,115060,111505,103.2
'31,경기도,'045,40~44세,2019,1079145,554175,524970,105.6,1027063,521697,505366,103.2
'31,경기도,'045001, 40세,2019,227368,116812,110556,105.7,214858,108899,105959,102.8
'31,경기도,'045002, 41세,2019,208171,107342,100829,106.5,197193,100422,96771,103.8
'31,경기도,'045003, 42세,2019,214865,110065,104800,105,204919,103814,101105,102.7
'31,경기도,'045004, 43세,2019,210001,108442,101559,106.8,200268,102367,97901,104.6
'31,경기도,'045005, 44세,2019,218740,111514,107226,104,209825,106195,103630,102.5
'31,경기도,'050,45~49세,2019,1214187,619038,595149,104,1163248,589713,573535,102.8
'31,경기도,'050001, 45세,2019,237216,121204,116012,104.5,228147,115857,112290,103.2
'31,경기도,'050002, 46세,2019,238453,120795,117658,102.7,228721,115160,113561,101.4
'31,경기도,'050003, 47세,2019,241092,123953,117139,105.8,230696,117819,112877,104.4
'31,경기도,'050004, 48세,2019,253741,129240,124501,103.8,242944,123151,119793,102.8
'31,경기도,'050005, 49세,2019,243685,123846,119839,103.3,232740,117726,115014,102.4
'31,경기도,'055,50~54세,2019,1138512,572780,565732,101.2,1090769,547215,543554,100.7
'31,경기도,'055001, 50세,2019,245806,123499,122307,101,235679,117968,117711,100.2
'31,경기도,'055002, 51세,2019,240614,119661,120953,98.9,230575,114200,116375,98.1
'31,경기도,'055003, 52세,2019,217961,108416,109545,99,209562,103913,105649,98.4
'31,경기도,'055004, 53세,2019,213361,109388,103973,105.2,204206,104579,99627,105
'31,경기도,'055005, 54세,2019,220770,111816,108954,102.6,210747,106555,104192,102.3
'31,경기도,'060,55~59세,2019,1073487,544882,528605,103.1,1029560,522724,506836,103.1
'31,경기도,'060001, 55세,2019,204476,104115,100361,103.7,194753,99060,95693,103.5
'31,경기도,'060002, 56세,2019,214752,110318,104434,105.6,203144,104395,98749,105.7
'31,경기도,'060003, 57세,2019,211498,107907,103591,104.2,202700,103550,99150,104.4
'31,경기도,'060004, 58세,2019,223874,112507,111367,101,218243,109762,108481,101.2
'31,경기도,'060005, 59세,2019,218887,110035,108852,101.1,210720,105957,104763,101.1
'31,경기도,'065,60~64세,2019,856522,428906,427616,100.3,824209,412981,411228,100.4
'31,경기도,'065001, 60세,2019,194016,97991,96025,102,187273,94634,92639,102.2
'31,경기도,'065002, 61세,2019,180880,91590,89290,102.6,173698,88037,85661,102.8
'31,경기도,'065003, 62세,2019,172041,86256,85785,100.5,164969,82802,82167,100.8
'31,경기도,'065004, 63세,2019,153844,76588,77256,99.1,148016,73705,74311,99.2
'31,경기도,'065005, 64세,2019,155741,76481,79260,96.5,150253,73803,76450,96.5
'31,경기도,'070,65~69세,2019,531844,258300,273544,94.4,515623,250655,264968,94.6
'31,경기도,'070001, 65세,2019,128500,63148,65352,96.6,123891,60927,62964,96.8
'31,경기도,'070002, 66세,2019,111404,54454,56950,95.6,107635,52637,54998,95.7
'31,경기도,'070003, 67세,2019,120483,58882,61601,95.6,117314,57407,59907,95.8
'31,경기도,'070004, 68세,2019,81182,38983,42199,92.4,78614,37809,40805,92.7
'31,경기도,'070005, 69세,2019,90275,42833,47442,90.3,88169,41875,46294,90.5
'31,경기도,'075,70~74세,2019,405474,189352,216122,87.6,399915,186982,212933,87.8
'31,경기도,'075001, 70세,2019,90646,43172,47474,90.9,88844,42381,46463,91.2
'31,경기도,'075002, 71세,2019,88650,41956,46694,89.9,87435,41421,46014,90
'31,경기도,'075003, 72세,2019,89757,41672,48085,86.7,88685,41217,47468,86.8
'31,경기도,'075004, 73세,2019,69605,32159,37446,85.9,68775,31836,36939,86.2
'31,경기도,'075005, 74세,2019,66816,30393,36423,83.4,66176,30127,36049,83.6
'31,경기도,'080,75~79세,2019,323247,138510,184737,75,320620,137648,182972,75.2
'31,경기도,'080001, 75세,2019,65730,28853,36877,78.2,65142,28640,36502,78.5
'31,경기도,'080002, 76세,2019,65804,28548,37256,76.6,65290,28392,36898,76.9
'31,경기도,'080003, 77세,2019,75543,32616,42927,76,75022,32442,42580,76.2
'31,경기도,'080004, 78세,2019,61299,25914,35385,73.2,60758,25740,35018,73.5
'31,경기도,'080005, 79세,2019,54871,22579,32292,69.9,54408,22434,31974,70.2
'31,경기도,'085,80~84세,2019,218192,82160,136032,60.4,216629,81691,134938,60.5
'31,경기도,'085001, 80세,2019,53408,21297,32111,66.3,53032,21191,31841,66.6
'31,경기도,'085002, 81세,2019,47996,18697,29299,63.8,47593,18562,29031,63.9
'31,경기도,'085003, 82세,2019,43134,16309,26825,60.8,42833,16213,26620,60.9
'31,경기도,'085004, 83세,2019,38335,13838,24497,56.5,38063,13764,24299,56.6
'31,경기도,'085005, 84세,2019,35319,12019,23300,51.6,35108,11961,23147,51.7
'31,경기도,'086,85세이상,2019,151103,42158,108945,38.7,150191,41890,108301,38.7
'31,경기도,'090,85~89세,2019,104068,31406,72662,43.2,103440,31223,72217,43.2
'31,경기도,'090001, 85세,2019,29002,9583,19419,49.3,28795,9523,19272,49.4
'31,경기도,'090002, 86세,2019,24081,7509,16572,45.3,23934,7464,16470,45.3
'31,경기도,'090003, 87세,2019,20781,6191,14590,42.4,20679,6159,14520,42.4
'31,경기도,'090004, 88세,2019,15695,4414,11281,39.1,15599,4386,11213,39.1
'31,경기도,'090005, 89세,2019,14509,3709,10800,34.3,14433,3691,10742,34.4
'31,경기도,'095,90~94세,2019,37290,8581,28709,29.9,37091,8526,28565,29.8
'31,경기도,'095001, 90세,2019,11935,3062,8873,34.5,11866,3043,8823,34.5
'31,경기도,'095002, 91세,2019,9384,2187,7197,30.4,9341,2172,7169,30.3
'31,경기도,'095003, 92세,2019,7104,1552,5552,28,7068,1545,5523,28
'31,경기도,'095004, 93세,2019,4931,1027,3904,26.3,4902,1016,3886,26.1
'31,경기도,'095005, 94세,2019,3936,753,3183,23.7,3914,750,3164,23.7
'31,경기도,'100,95~99세,2019,8600,1948,6652,29.3,8522,1922,6600,29.1
'31,경기도,'100001, 95세,2019,2682,626,2056,30.4,2660,619,2041,30.3
'31,경기도,'100002, 96세,2019,2453,589,1864,31.6,2430,582,1848,31.5
'31,경기도,'100003, 97세,2019,1702,359,1343,26.7,1687,353,1334,26.5
'31,경기도,'100004, 98세,2019,1031,220,811,27.1,1024,218,806,27
'31,경기도,'100005, 99세,2019,732,154,578,26.6,721,150,571,26.3
'31,경기도,'101,100세이상,2019,1145,223,922,24.2,1138,219,919,23.8
'31,경기도,'102,15세미만,2019,1811514,928861,882653,105.2,1781766,913805,867961,105.3
'31,경기도,'103,15~64세,2019,9859526,5101107,4758419,107.2,9321361,4772523,4548838,104.9
'31,경기도,'104,65세이상,2019,1629860,710480,919380,77.3,1602978,698866,904112,77.3
'31,경기도,'126,평균연령,2019,40.8,39.9,41.8,,40.9,40,41.8,
'31,경기도,'127,중위연령,2019,41.5,40.5,42.7,,41.9,40.9,42.8,
'31004, 읍부,'000,합계,2019,1459827,760526,699301,108.8,1372375,702336,670039,104.8
'31004, 읍부,'005,0~4세,2019,58133,29956,28177,106.3,56561,29159,27402,106.4
'31004, 읍부,'005001, 0세,2019,8970,4718,4252,111,8699,4574,4125,110.9
'31004, 읍부,'005002, 1세,2019,10526,5383,5143,104.7,10198,5216,4982,104.7
'31004, 읍부,'005003, 2세,2019,11363,5727,5636,101.6,11031,5572,5459,102.1
'31004, 읍부,'005004, 3세,2019,13337,6916,6421,107.7,12981,6730,6251,107.7
'31004, 읍부,'005005, 4세,2019,13937,7212,6725,107.2,13652,7067,6585,107.3
'31004, 읍부,'010,5~9세,2019,73718,37718,36000,104.8,72665,37198,35467,104.9
'31004, 읍부,'010001, 5세,2019,13856,7091,6765,104.8,13594,6962,6632,105
'31004, 읍부,'010002, 6세,2019,14083,7217,6866,105.1,13837,7097,6740,105.3
'31004, 읍부,'010003, 7세,2019,15489,7911,7578,104.4,15270,7800,7470,104.4
'31004, 읍부,'010004, 8세,2019,15521,7931,7590,104.5,15335,7834,7501,104.4
'31004, 읍부,'010005, 9세,2019,14769,7568,7201,105.1,14629,7505,7124,105.3
'31004, 읍부,'015,10~14세,2019,72535,37338,35197,106.1,71880,36999,34881,106.1
'31004, 읍부,'015001, 10세,2019,14347,7288,7059,103.2,14200,7210,6990,103.1
'31004, 읍부,'015002, 11세,2019,15274,7847,7427,105.7,15121,7763,7358,105.5
'31004, 읍부,'015003, 12세,2019,15241,7825,7416,105.5,15109,7760,7349,105.6
'31004, 읍부,'015004, 13세,2019,14007,7219,6788,106.3,13902,7161,6741,106.2
'31004, 읍부,'015005, 14세,2019,13666,7159,6507,110,13548,7105,6443,110.3
'31004, 읍부,'020,15~19세,2019,76183,39128,37055,105.6,75169,38602,36567,105.6
'31004, 읍부,'020001, 15세,2019,14308,7451,6857,108.7,14209,7393,6816,108.5
'31004, 읍부,'020002, 16세,2019,14146,7214,6932,104.1,14054,7168,6886,104.1
'31004, 읍부,'020003, 17세,2019,15055,7684,7371,104.2,14952,7628,7324,104.2
'31004, 읍부,'020004, 18세,2019,16016,8129,7887,103.1,15825,8030,7795,103
'31004, 읍부,'020005, 19세,2019,16658,8650,8008,108,16129,8383,7746,108.2
'31004, 읍부,'025,20~24세,2019,87035,48333,38702,124.9,78227,42056,36171,116.3
'31004, 읍부,'025001, 20세,2019,16305,8790,7515,117,15472,8283,7189,115.2
'31004, 읍부,'025002, 21세,2019,16778,9274,7504,123.6,15455,8428,7027,119.9
'31004, 읍부,'025003, 22세,2019,17224,9496,7728,122.9,15473,8261,7212,114.5
'31004, 읍부,'025004, 23세,2019,17983,10025,7958,126,15746,8356,7390,113.1
'31004, 읍부,'025005, 24세,2019,18745,10748,7997,134.4,16081,8728,7353,118.7
'31004, 읍부,'030,25~29세,2019,98256,57428,40828,140.7,81824,45074,36750,122.7
'31004, 읍부,'030001, 25세,2019,19339,11244,8095,138.9,16398,8982,7416,121.1
'31004, 읍부,'030002, 26세,2019,19710,11468,8242,139.1,16548,9089,7459,121.9
'31004, 읍부,'030003, 27세,2019,20523,12029,8494,141.6,17137,9470,7667,123.5
'31004, 읍부,'030004, 28세,2019,19430,11431,7999,142.9,16176,8998,7178,125.4
'31004, 읍부,'030005, 29세,2019,19254,11256,7998,140.7,15565,8535,7030,121.4
'31004, 읍부,'035,30~34세,2019,96005,54363,41642,130.5,79488,42510,36978,115
'31004, 읍부,'035001, 30세,2019,18758,10960,7798,140.5,15260,8382,6878,121.9
'31004, 읍부,'035002, 31세,2019,18640,10633,8007,132.8,15217,8179,7038,116.2
'31004, 읍부,'035003, 32세,2019,18969,10763,8206,131.2,15570,8344,7226,115.5
'31004, 읍부,'035004, 33세,2019,19411,10818,8593,125.9,16283,8590,7693,111.7
'31004, 읍부,'035005, 34세,2019,20227,11189,9038,123.8,17158,9015,8143,110.7
'31004, 읍부,'040,35~39세,2019,123022,66608,56414,118.1,110521,57858,52663,109.9
'31004, 읍부,'040001, 35세,2019,21020,11566,9454,122.3,18186,9552,8634,110.6
'31004, 읍부,'040002, 36세,2019,23271,12684,10587,119.8,20600,10784,9816,109.9
'31004, 읍부,'040003, 37세,2019,25765,13809,11956,115.5,23132,11998,11134,107.8
'31004, 읍부,'040004, 38세,2019,26150,14372,11778,122,23841,12750,11091,115
'31004, 읍부,'040005, 39세,2019,26816,14177,12639,112.2,24762,12774,11988,106.6
'31004, 읍부,'045,40~44세,2019,122115,64597,57518,112.3,113998,59200,54798,108
'31004, 읍부,'045001, 40세,2019,25629,13500,12129,111.3,23587,12133,11454,105.9
'31004, 읍부,'045002, 41세,2019,23882,12624,11258,112.1,22092,11377,10715,106.2
'31004, 읍부,'045003, 42세,2019,24309,12856,11453,112.3,22725,11804,10921,108.1
'31004, 읍부,'045004, 43세,2019,23697,12559,11138,112.8,22241,11617,10624,109.3
'31004, 읍부,'045005, 44세,2019,24598,13058,11540,113.2,23353,12269,11084,110.7
'31004, 읍부,'050,45~49세,2019,132395,71016,61379,115.7,125849,67076,58773,114.1
'31004, 읍부,'050001, 45세,2019,26510,14144,12366,114.4,25243,13336,11907,112
'31004, 읍부,'050002, 46세,2019,26360,14033,12327,113.8,25121,13306,11815,112.6
'31004, 읍부,'050003, 47세,2019,26498,14347,12151,118.1,25151,13539,11612,116.6
'31004, 읍부,'050004, 48세,2019,27174,14627,12547,116.6,25864,13848,12016,115.2
'31004, 읍부,'050005, 49세,2019,25853,13865,11988,115.7,24470,13047,11423,114.2
'31004, 읍부,'055,50~54세,2019,120340,63286,57054,110.9,115115,60371,54744,110.3
'31004, 읍부,'055001, 50세,2019,26018,13661,12357,110.6,24815,12959,11856,109.3
'31004, 읍부,'055002, 51세,2019,25420,13244,12176,108.8,24294,12624,11670,108.2
'31004, 읍부,'055003, 52세,2019,22862,11906,10956,108.7,21961,11401,10560,108
'31004, 읍부,'055004, 53세,2019,22928,12350,10578,116.8,21954,11814,10140,116.5
'31004, 읍부,'055005, 54세,2019,23112,12125,10987,110.4,22091,11573,10518,110
'31004, 읍부,'060,55~59세,2019,113766,59208,54558,108.5,109671,57039,52632,108.4
'31004, 읍부,'060001, 55세,2019,21568,11381,10187,111.7,20593,10840,9753,111.1
'31004, 읍부,'060002, 56세,2019,22481,11908,10573,112.6,21423,11335,10088,112.4
'31004, 읍부,'060003, 57세,2019,22453,11796,10657,110.7,21635,11359,10276,110.5
'31004, 읍부,'060004, 58세,2019,24141,12343,11798,104.6,23571,12074,11497,105
'31004, 읍부,'060005, 59세,2019,23123,11780,11343,103.9,22449,11431,11018,103.7
'31004, 읍부,'065,60~64세,2019,94282,47308,46974,100.7,91612,45952,45660,100.6
'31004, 읍부,'065001, 60세,2019,20954,10587,10367,102.1,20388,10297,10091,102
'31004, 읍부,'065002, 61세,2019,19936,10127,9809,103.2,19328,9805,9523,103
'31004, 읍부,'065003, 62세,2019,18736,9452,9284,101.8,18150,9172,8978,102.2
'31004, 읍부,'065004, 63세,2019,17295,8676,8619,100.7,16816,8431,8385,100.5
'31004, 읍부,'065005, 64세,2019,17361,8466,8895,95.2,16930,8247,8683,95
'31004, 읍부,'070,65~69세,2019,60744,29648,31096,95.3,59455,29034,30421,95.4
'31004, 읍부,'070001, 65세,2019,14585,7172,7413,96.7,14224,7004,7220,97
'31004, 읍부,'070002, 66세,2019,12513,6189,6324,97.9,12197,6033,6164,97.9
'31004, 읍부,'070003, 67세,2019,13944,6850,7094,96.6,13715,6748,6967,96.9
'31004, 읍부,'070004, 68세,2019,9316,4491,4825,93.1,9106,4387,4719,93
'31004, 읍부,'070005, 69세,2019,10386,4946,5440,90.9,10213,4862,5351,90.9
'31004, 읍부,'075,70~74세,2019,48234,22719,25515,89,47743,22511,25232,89.2
'31004, 읍부,'075001, 70세,2019,10701,4995,5706,87.5,10561,4938,5623,87.8
'31004, 읍부,'075002, 71세,2019,10497,5006,5491,91.2,10370,4954,5416,91.5
'31004, 읍부,'075003, 72세,2019,10658,5080,5578,91.1,10557,5036,5521,91.2
'31004, 읍부,'075004, 73세,2019,8268,3893,4375,89,8199,3863,4336,89.1
'31004, 읍부,'075005, 74세,2019,8110,3745,4365,85.8,8056,3720,4336,85.8
'31004, 읍부,'080,75~79세,2019,38956,16801,22155,75.8,38712,16706,22006,75.9
'31004, 읍부,'080001, 75세,2019,7769,3462,4307,80.4,7715,3438,4277,80.4
'31004, 읍부,'080002, 76세,2019,7880,3453,4427,78,7830,3434,4396,78.1
'31004, 읍부,'080003, 77세,2019,9193,3993,5200,76.8,9140,3973,5167,76.9
'31004, 읍부,'080004, 78세,2019,7458,3164,4294,73.7,7408,3139,4269,73.5
'31004, 읍부,'080005, 79세,2019,6656,2729,3927,69.5,6619,2722,3897,69.8
'31004, 읍부,'085,80~84세,2019,26523,10097,16426,61.5,26379,10048,16331,61.5
'31004, 읍부,'085001, 80세,2019,6507,2578,3929,65.6,6470,2568,3902,65.8
'31004, 읍부,'085002, 81세,2019,5795,2256,3539,63.7,5766,2248,3518,63.9
'31004, 읍부,'085003, 82세,2019,5181,2037,3144,64.8,5144,2020,3124,64.7
'31004, 읍부,'085004, 83세,2019,4715,1706,3009,56.7,4692,1701,2991,56.9
'31004, 읍부,'085005, 84세,2019,4325,1520,2805,54.2,4307,1511,2796,54
'31004, 읍부,'086,85세이상,2019,17585,4974,12611,39.4,17506,4943,12563,39.3
'31004, 읍부,'090,85~89세,2019,12238,3748,8490,44.1,12182,3727,8455,44.1
'31004, 읍부,'090001, 85세,2019,3533,1223,2310,52.9,3515,1216,2299,52.9
'31004, 읍부,'090002, 86세,2019,2876,890,1986,44.8,2861,882,1979,44.6
'31004, 읍부,'090003, 87세,2019,2417,706,1711,41.3,2408,704,1704,41.3
'31004, 읍부,'090004, 88세,2019,1757,487,1270,38.3,1747,486,1261,38.5
'31004, 읍부,'090005, 89세,2019,1655,442,1213,36.4,1651,439,1212,36.2
'31004, 읍부,'095,90~94세,2019,4230,952,3278,29,4215,946,3269,28.9
'31004, 읍부,'095001, 90세,2019,1355,337,1018,33.1,1351,336,1015,33.1
'31004, 읍부,'095002, 91세,2019,1026,239,787,30.4,1023,236,787,30
'31004, 읍부,'095003, 92세,2019,797,158,639,24.7,794,157,637,24.6
'31004, 읍부,'095004, 93세,2019,598,134,464,28.9,595,133,462,28.8
'31004, 읍부,'095005, 94세,2019,454,84,370,22.7,452,84,368,22.8
'31004, 읍부,'100,95~99세,2019,984,249,735,33.9,976,245,731,33.5
'31004, 읍부,'100001, 95세,2019,294,75,219,34.2,293,74,219,33.8
'31004, 읍부,'100002, 96세,2019,300,85,215,39.5,298,85,213,39.9
'31004, 읍부,'100003, 97세,2019,180,42,138,30.4,178,41,137,29.9
'31004, 읍부,'100004, 98세,2019,125,30,95,31.6,125,30,95,31.6
'31004, 읍부,'100005, 99세,2019,85,17,68,25,82,15,67,22.4
'31004, 읍부,'101,100세이상,2019,133,25,108,23.1,133,25,108,23.1
'31004, 읍부,'102,15세미만,2019,204386,105012,99374,105.7,201106,103356,97750,105.7
'31004, 읍부,'103,15~64세,2019,1063399,571275,492124,116.1,981474,515738,465736,110.7
'31004, 읍부,'104,65세이상,2019,192042,84239,107803,78.1,189795,83242,106553,78.1
'31004, 읍부,'126,평균연령,2019,41.1,40.1,42.1,,41.3,40.4,42.3,
'31004, 읍부,'127,중위연령,2019,41.8,40.7,43.1,,42.6,41.8,43.5,
'31005, 면부,'000,합계,2019,807497,448730,358767,125.1,710653,374316,336337,111.3
'31005, 면부,'005,0~4세,2019,18536,9466,9070,104.4,17931,9180,8751,104.9
'31005, 면부,'005001, 0세,2019,2964,1506,1458,103.3,2874,1466,1408,104.1
'31005, 면부,'005002, 1세,2019,3277,1628,1649,98.7,3166,1580,1586,99.6
'31005, 면부,'005003, 2세,2019,3847,1976,1871,105.6,3705,1907,1798,106.1
'31005, 면부,'005004, 3세,2019,4087,2139,1948,109.8,3957,2070,1887,109.7
'31005, 면부,'005005, 4세,2019,4361,2217,2144,103.4,4229,2157,2072,104.1
'31005, 면부,'010,5~9세,2019,22975,11972,11003,108.8,22576,11775,10801,109
'31005, 면부,'010001, 5세,2019,4239,2256,1983,113.8,4136,2204,1932,114.1
'31005, 면부,'010002, 6세,2019,4331,2247,2084,107.8,4255,2210,2045,108.1
'31005, 면부,'010003, 7세,2019,4858,2463,2395,102.8,4773,2426,2347,103.4
'31005, 면부,'010004, 8세,2019,4918,2600,2318,112.2,4844,2560,2284,112.1
'31005, 면부,'010005, 9세,2019,4629,2406,2223,108.2,4568,2375,2193,108.3
'31005, 면부,'015,10~14세,2019,22468,11775,10693,110.1,22200,11632,10568,110.1
'31005, 면부,'015001, 10세,2019,4568,2410,2158,111.7,4499,2373,2126,111.6
'31005, 면부,'015002, 11세,2019,4669,2441,2228,109.6,4603,2407,2196,109.6
'31005, 면부,'015003, 12세,2019,4622,2364,2258,104.7,4569,2331,2238,104.2
'31005, 면부,'015004, 13세,2019,4369,2301,2068,111.3,4330,2283,2047,111.5
'31005, 면부,'015005, 14세,2019,4240,2259,1981,114,4199,2238,1961,114.1
'31005, 면부,'020,15~19세,2019,34784,18427,16357,112.7,33963,17910,16053,111.6
'31005, 면부,'020001, 15세,2019,4889,2596,2293,113.2,4843,2574,2269,113.4
'31005, 면부,'020002, 16세,2019,5553,2898,2655,109.2,5503,2869,2634,108.9
'31005, 면부,'020003, 17세,2019,5567,3020,2547,118.6,5484,2961,2523,117.4
'31005, 면부,'020004, 18세,2019,7760,4019,3741,107.4,7568,3901,3667,106.4
'31005, 면부,'020005, 19세,2019,11015,5894,5121,115.1,10565,5605,4960,113
'31005, 면부,'025,20~24세,2019,49497,30186,19311,156.3,37964,20983,16981,123.6
'31005, 면부,'025001, 20세,2019,8595,4722,3873,121.9,7758,4090,3668,111.5
'31005, 면부,'025002, 21세,2019,8712,4983,3729,133.6,7237,3869,3368,114.9
'31005, 면부,'025003, 22세,2019,9689,5892,3797,155.2,7389,4075,3314,123
'31005, 면부,'025004, 23세,2019,10684,6824,3860,176.8,7534,4270,3264,130.8
'31005, 면부,'025005, 24세,2019,11817,7765,4052,191.6,8046,4679,3367,139
'31005, 면부,'030,25~29세,2019,65371,44445,20926,212.4,42107,25640,16467,155.7
'31005, 면부,'030001, 25세,2019,12490,8273,4217,196.2,8463,4999,3464,144.3
'31005, 면부,'030002, 26세,2019,13224,8964,4260,210.4,8595,5237,3358,156
'31005, 면부,'030003, 27세,2019,13825,9426,4399,214.3,8969,5495,3474,158.2
'31005, 면부,'030004, 28세,2019,12961,8826,4135,213.4,8242,5011,3231,155.1
'31005, 면부,'030005, 29세,2019,12871,8956,3915,228.8,7838,4898,2940,166.6
'31005, 면부,'035,30~34세,2019,56854,39033,17821,219,35785,21869,13916,157.2
'31005, 면부,'035001, 30세,2019,12089,8443,3646,231.6,7424,4619,2805,164.7
'31005, 면부,'035002, 31세,2019,11658,8103,3555,227.9,7139,4413,2726,161.9
'31005, 면부,'035003, 32세,2019,11387,7768,3619,214.6,7140,4322,2818,153.4
'31005, 면부,'035004, 33세,2019,11100,7620,3480,219,7119,4389,2730,160.8
'31005, 면부,'035005, 34세,2019,10620,7099,3521,201.6,6963,4126,2837,145.4
'31005, 면부,'040,35~39세,2019,54872,34683,20189,171.8,40257,23027,17230,133.6
'31005, 면부,'040001, 35세,2019,10557,6999,3558,196.7,7090,4200,2890,145.3
'31005, 면부,'040002, 36세,2019,10757,6872,3885,176.9,7652,4350,3302,131.7
'31005, 면부,'040003, 37세,2019,11459,7217,4242,170.1,8431,4817,3614,133.3
'31005, 면부,'040004, 38세,2019,10907,6703,4204,159.4,8351,4683,3668,127.7
'31005, 면부,'040005, 39세,2019,11192,6892,4300,160.3,8733,4977,3756,132.5
'31005, 면부,'045,40~44세,2019,48669,29393,19276,152.5,40148,22944,17204,133.4
'31005, 면부,'045001, 40세,2019,10246,6299,3947,159.6,8092,4630,3462,133.7
'31005, 면부,'045002, 41세,2019,9614,5810,3804,152.7,7799,4441,3358,132.3
'31005, 면부,'045003, 42세,2019,9634,5790,3844,150.6,7946,4496,3450,130.3
'31005, 면부,'045004, 43세,2019,9508,5713,3795,150.5,7951,4526,3425,132.1
'31005, 면부,'045005, 44세,2019,9667,5781,3886,148.8,8360,4851,3509,138.2
'31005, 면부,'050,45~49세,2019,55694,32347,23347,138.5,49916,28374,21542,131.7
'31005, 면부,'050001, 45세,2019,10520,6174,4346,142.1,9256,5288,3968,133.3
'31005, 면부,'050002, 46세,2019,10855,6312,4543,138.9,9689,5485,4204,130.5
'31005, 면부,'050003, 47세,2019,11017,6504,4513,144.1,9854,5697,4157,137
'31005, 면부,'050004, 48세,2019,11614,6667,4947,134.8,10513,5931,4582,129.4
'31005, 면부,'050005, 49세,2019,11688,6690,4998,133.9,10604,5973,4631,129
'31005, 면부,'055,50~54세,2019,63169,34832,28337,122.9,59034,32170,26864,119.8
'31005, 면부,'055001, 50세,2019,12372,7017,5355,131,11438,6399,5039,127
'31005, 면부,'055002, 51세,2019,12651,7018,5633,124.6,11701,6395,5306,120.5
'31005, 면부,'055003, 52세,2019,11978,6409,5569,115.1,11232,5931,5301,111.9
'31005, 면부,'055004, 53세,2019,12511,6894,5617,122.7,11762,6428,5334,120.5
'31005, 면부,'055005, 54세,2019,13657,7494,6163,121.6,12901,7017,5884,119.3
'31005, 면부,'060,55~59세,2019,73782,39094,34688,112.7,70883,37374,33509,111.5
'31005, 면부,'060001, 55세,2019,12805,6913,5892,117.3,12130,6514,5616,116
'31005, 면부,'060002, 56세,2019,13888,7409,6479,114.4,13146,6960,6186,112.5
'31005, 면부,'060003, 57세,2019,14227,7605,6622,114.8,13639,7262,6377,113.9
'31005, 면부,'060004, 58세,2019,16512,8653,7859,110.1,16116,8421,7695,109.4
'31005, 면부,'060005, 59세,2019,16350,8514,7836,108.7,15852,8217,7635,107.6
'31005, 면부,'065,60~64세,2019,71139,37277,33862,110.1,69499,36308,33191,109.4
'31005, 면부,'065001, 60세,2019,15276,8037,7239,111,14857,7797,7060,110.4
'31005, 면부,'065002, 61세,2019,14767,7863,6904,113.9,14386,7633,6753,113
'31005, 면부,'065003, 62세,2019,14077,7369,6708,109.9,13736,7159,6577,108.8
'31005, 면부,'065004, 63세,2019,13241,6892,6349,108.6,12987,6742,6245,108
'31005, 면부,'065005, 64세,2019,13778,7116,6662,106.8,13533,6977,6556,106.4
'31005, 면부,'070,65~69세,2019,49041,24851,24190,102.7,48308,24448,23860,102.5
'31005, 면부,'070001, 65세,2019,11647,6002,5645,106.3,11444,5890,5554,106
'31005, 면부,'070002, 66세,2019,10317,5215,5102,102.2,10122,5113,5009,102.1
'31005, 면부,'070003, 67세,2019,11586,5967,5619,106.2,11450,5893,5557,106
'31005, 면부,'070004, 68세,2019,7237,3607,3630,99.4,7127,3544,3583,98.9
'31005, 면부,'070005, 69세,2019,8254,4060,4194,96.8,8165,4008,4157,96.4
'31005, 면부,'075,70~74세,2019,39464,19679,19785,99.5,39197,19537,19660,99.4
'31005, 면부,'075001, 70세,2019,8380,4218,4162,101.3,8304,4174,4130,101.1
'31005, 면부,'075002, 71세,2019,8438,4343,4095,106.1,8371,4308,4063,106
'31005, 면부,'075003, 72세,2019,8772,4324,4448,97.2,8719,4300,4419,97.3
'31005, 면부,'075004, 73세,2019,6968,3466,3502,99,6928,3447,3481,99
'31005, 면부,'075005, 74세,2019,6906,3328,3578,93,6875,3308,3567,92.7
'31005, 면부,'080,75~79세,2019,34470,15309,19161,79.9,34328,15244,19084,79.9
'31005, 면부,'080001, 75세,2019,6719,3112,3607,86.3,6689,3097,3592,86.2
'31005, 면부,'080002, 76세,2019,6850,3045,3805,80,6820,3034,3786,80.1
'31005, 면부,'080003, 77세,2019,8082,3587,4495,79.8,8053,3573,4480,79.8
'31005, 면부,'080004, 78세,2019,6786,2960,3826,77.4,6760,2947,3813,77.3
'31005, 면부,'080005, 79세,2019,6033,2605,3428,76,6006,2593,3413,76
'31005, 면부,'085,80~84세,2019,26562,10359,16203,63.9,26467,10322,16145,63.9
'31005, 면부,'085001, 80세,2019,6288,2602,3686,70.6,6261,2592,3669,70.6
'31005, 면부,'085002, 81세,2019,5680,2218,3462,64.1,5652,2210,3442,64.2
'31005, 면부,'085003, 82세,2019,5382,2127,3255,65.3,5369,2121,3248,65.3
'31005, 면부,'085004, 83세,2019,4822,1891,2931,64.5,4809,1884,2925,64.4
'31005, 면부,'085005, 84세,2019,4390,1521,2869,53,4376,1515,2861,53
'31005, 면부,'086,85세이상,2019,20150,5602,14548,38.5,20090,5579,14511,38.4
'31005, 면부,'090,85~89세,2019,13620,4151,9469,43.8,13581,4136,9445,43.8
'31005, 면부,'090001, 85세,2019,3828,1294,2534,51.1,3819,1288,2531,50.9
'31005, 면부,'090002, 86세,2019,3109,980,2129,46,3098,976,2122,46
'31005, 면부,'090003, 87세,2019,2673,790,1883,42,2669,789,1880,42
'31005, 면부,'090004, 88세,2019,2082,610,1472,41.4,2071,606,1465,41.4
'31005, 면부,'090005, 89세,2019,1928,477,1451,32.9,1924,477,1447,33
'31005, 면부,'095,90~94세,2019,5120,1125,3995,28.2,5108,1121,3987,28.1
'31005, 면부,'095001, 90세,2019,1624,391,1233,31.7,1617,388,1229,31.6
'31005, 면부,'095002, 91세,2019,1246,265,981,27,1244,264,980,26.9
'31005, 면부,'095003, 92세,2019,932,189,743,25.4,929,189,740,25.5
'31005, 면부,'095004, 93세,2019,726,146,580,25.2,726,146,580,25.2
'31005, 면부,'095005, 94세,2019,592,134,458,29.3,592,134,458,29.3
'31005, 면부,'100,95~99세,2019,1256,294,962,30.6,1249,291,958,30.4
'31005, 면부,'100001, 95세,2019,411,109,302,36.1,410,108,302,35.8
'31005, 면부,'100002, 96세,2019,362,87,275,31.6,358,85,273,31.1
'31005, 면부,'100003, 97세,2019,237,46,191,24.1,236,46,190,24.2
'31005, 면부,'100004, 98세,2019,141,28,113,24.8,140,28,112,25
'31005, 면부,'100005, 99세,2019,105,24,81,29.6,105,24,81,29.6
'31005, 면부,'101,100세이상,2019,154,32,122,26.2,152,31,121,25.6
'31005, 면부,'102,15세미만,2019,63979,33213,30766,108,62707,32587,30120,108.2
'31005, 면부,'103,15~64세,2019,573831,339717,234114,145.1,479556,266599,212957,125.2
'31005, 면부,'104,65세이상,2019,169687,75800,93887,80.7,168390,75130,93260,80.6
'31005, 면부,'126,평균연령,2019,46.4,44.3,49,,48,46.4,49.8,
'31005, 면부,'127,중위연령,2019,47.8,44.1,52.1,,51.1,49,53.6,
'31003, 동부,'000,합계,2019,11033576,5531192,5502384,100.5,10623077,5308542,5314535,99.9
'31003, 동부,'005,0~4세,2019,462031,237021,225010,105.3,448886,230268,218618,105.3
'31003, 동부,'005001, 0세,2019,75932,38978,36954,105.5,73478,37726,35752,105.5
'31003, 동부,'005002, 1세,2019,83244,42746,40498,105.6,80576,41350,39226,105.4
'31003, 동부,'005003, 2세,2019,90620,46755,43865,106.6,87895,45370,42525,106.7
'31003, 동부,'005004, 3세,2019,103434,52806,50628,104.3,100497,51308,49189,104.3
'31003, 동부,'005005, 4세,2019,108801,55736,53065,105,106440,54514,51926,105
'31003, 동부,'010,5~9세,2019,551414,282412,269002,105,543600,278480,265120,105
'31003, 동부,'010001, 5세,2019,106817,54483,52334,104.1,104760,53459,51301,104.2
'31003, 동부,'010002, 6세,2019,106955,54562,52393,104.1,105211,53708,51503,104.3
'31003, 동부,'010003, 7세,2019,116195,59728,56467,105.8,114591,58926,55665,105.9
'31003, 동부,'010004, 8세,2019,112801,57743,55058,104.9,111508,57077,54431,104.9
'31003, 동부,'010005, 9세,2019,108646,55896,52750,106,107530,55310,52220,105.9
'31003, 동부,'015,10~14세,2019,529704,271203,258501,104.9,525467,269114,256353,105
'31003, 동부,'015001, 10세,2019,105131,54072,51059,105.9,104077,53533,50544,105.9
'31003, 동부,'015002, 11세,2019,110609,56661,53948,105,109667,56176,53491,105
'31003, 동부,'015003, 12세,2019,112386,57528,54858,104.9,111530,57119,54411,105
'31003, 동부,'015004, 13세,2019,102173,52374,49799,105.2,101450,52024,49426,105.3
'31003, 동부,'015005, 14세,2019,99405,50568,48837,103.5,98743,50262,48481,103.7
'31003, 동부,'020,15~19세,2019,573750,295561,278189,106.2,567387,292525,274862,106.4
'31003, 동부,'020001, 15세,2019,107525,55007,52518,104.7,106859,54681,52178,104.8
'31003, 동부,'020002, 16세,2019,107255,55079,52176,105.6,106690,54806,51884,105.6
'31003, 동부,'020003, 17세,2019,109239,56287,52952,106.3,108549,55953,52596,106.4
'31003, 동부,'020004, 18세,2019,122166,62864,59302,106,120791,62261,58530,106.4
'31003, 동부,'020005, 19세,2019,127565,66324,61241,108.3,124498,64824,59674,108.6
'31003, 동부,'025,20~24세,2019,697855,366429,331426,110.6,670197,350874,319323,109.9
'31003, 동부,'025001, 20세,2019,126743,67313,59430,113.3,122630,65216,57414,113.6
'31003, 동부,'025002, 21세,2019,134262,71759,62503,114.8,129481,69101,60380,114.4
'31003, 동부,'025003, 22세,2019,139355,73163,66192,110.5,133919,70056,63863,109.7
'31003, 동부,'025004, 23세,2019,145329,75406,69923,107.8,139195,71871,67324,106.8
'31003, 동부,'025005, 24세,2019,152166,78788,73378,107.4,144972,74630,70342,106.1
'31003, 동부,'030,25~29세,2019,789995,416006,373989,111.2,744622,389370,355252,109.6
'31003, 동부,'030001, 25세,2019,157343,82740,74603,110.9,149791,78199,71592,109.2
'31003, 동부,'030002, 26세,2019,160961,85003,75958,111.9,152660,80045,72615,110.2
'31003, 동부,'030003, 27세,2019,164282,87064,77218,112.8,155349,81794,73555,111.2
'31003, 동부,'030004, 28세,2019,157251,82632,74619,110.7,147625,77060,70565,109.2
'31003, 동부,'030005, 29세,2019,150158,78567,71591,109.7,139197,72272,66925,108
'31003, 동부,'035,30~34세,2019,753752,389948,363804,107.2,695383,356566,338817,105.2
'31003, 동부,'035001, 30세,2019,148510,77882,70628,110.3,137181,71378,65803,108.5
'31003, 동부,'035002, 31세,2019,147294,76248,71046,107.3,135512,69598,65914,105.6
'31003, 동부,'035003, 32세,2019,148782,76690,72092,106.4,136551,69639,66912,104.1
'31003, 동부,'035004, 33세,2019,152265,78521,73744,106.5,140336,71723,68613,104.5
'31003, 동부,'035005, 34세,2019,156901,80607,76294,105.7,145803,74228,71575,103.7
'31003, 동부,'040,35~39세,2019,940442,480748,459694,104.6,893618,453329,440289,103
'31003, 동부,'040001, 35세,2019,162913,83610,79303,105.4,152473,77479,74994,103.3
'31003, 동부,'040002, 36세,2019,181046,92688,88358,104.9,171205,87006,84199,103.3
'31003, 동부,'040003, 37세,2019,197016,100973,96043,105.1,187029,95129,91900,103.5
'31003, 동부,'040004, 38세,2019,198231,101321,96910,104.6,189841,96406,93435,103.2
'31003, 동부,'040005, 39세,2019,201236,102156,99080,103.1,193070,97309,95761,101.6
'31003, 동부,'045,40~44세,2019,908361,460185,448176,102.7,872917,439553,433364,101.4
'31003, 동부,'045001, 40세,2019,191493,97013,94480,102.7,183179,92136,91043,101.2
'31003, 동부,'045002, 41세,2019,174675,88908,85767,103.7,167302,84604,82698,102.3
'31003, 동부,'045003, 42세,2019,180922,91419,89503,102.1,174248,87514,86734,100.9
'31003, 동부,'045004, 43세,2019,176796,90170,86626,104.1,170076,86224,83852,102.8
'31003, 동부,'045005, 44세,2019,184475,92675,91800,101,178112,89075,89037,100
'31003, 동부,'050,45~49세,2019,1026098,515675,510423,101,987483,494263,493220,100.2
'31003, 동부,'050001, 45세,2019,200186,100886,99300,101.6,193648,97233,96415,100.8
'31003, 동부,'050002, 46세,2019,201238,100450,100788,99.7,193911,96369,97542,98.8
'31003, 동부,'050003, 47세,2019,203577,103102,100475,102.6,195691,98583,97108,101.5
'31003, 동부,'050004, 48세,2019,214953,107946,107007,100.9,206567,103372,103195,100.2
'31003, 동부,'050005, 49세,2019,206144,103291,102853,100.4,197666,98706,98960,99.7
'31003, 동부,'055,50~54세,2019,955003,474662,480341,98.8,916620,454674,461946,98.4
'31003, 동부,'055001, 50세,2019,207416,102821,104595,98.3,199426,98610,100816,97.8
'31003, 동부,'055002, 51세,2019,202543,99399,103144,96.4,194580,95181,99399,95.8
'31003, 동부,'055003, 52세,2019,183121,90101,93020,96.9,176369,86581,89788,96.4
'31003, 동부,'055004, 53세,2019,177922,90144,87778,102.7,170490,86337,84153,102.6
'31003, 동부,'055005, 54세,2019,184001,92197,91804,100.4,175755,87965,87790,100.2
'31003, 동부,'060,55~59세,2019,885939,446580,439359,101.6,849006,428311,420695,101.8
'31003, 동부,'060001, 55세,2019,170103,85821,84282,101.8,162030,81706,80324,101.7
'31003, 동부,'060002, 56세,2019,178383,91001,87382,104.1,168575,86100,82475,104.4
'31003, 동부,'060003, 57세,2019,174818,88506,86312,102.5,167426,84929,82497,102.9
'31003, 동부,'060004, 58세,2019,183221,91511,91710,99.8,178556,89267,89289,100
'31003, 동부,'060005, 59세,2019,179414,89741,89673,100.1,172419,86309,86110,100.2
'31003, 동부,'065,60~64세,2019,691101,344321,346780,99.3,663098,330721,332377,99.5
'31003, 동부,'065001, 60세,2019,157786,79367,78419,101.2,152028,76540,75488,101.4
'31003, 동부,'065002, 61세,2019,146177,73600,72577,101.4,139984,70599,69385,101.7
'31003, 동부,'065003, 62세,2019,139228,69435,69793,99.5,133083,66471,66612,99.8
'31003, 동부,'065004, 63세,2019,123308,61020,62288,98,118213,58532,59681,98.1
'31003, 동부,'065005, 64세,2019,124602,60899,63703,95.6,119790,58579,61211,95.7
'31003, 동부,'070,65~69세,2019,422059,203801,218258,93.4,407860,197173,210687,93.6
'31003, 동부,'070001, 65세,2019,102268,49974,52294,95.6,98223,48033,50190,95.7
'31003, 동부,'070002, 66세,2019,88574,43050,45524,94.6,85316,41491,43825,94.7
'31003, 동부,'070003, 67세,2019,94953,46065,48888,94.2,92149,44766,47383,94.5
'31003, 동부,'070004, 68세,2019,64629,30885,33744,91.5,62381,29878,32503,91.9
'31003, 동부,'070005, 69세,2019,71635,33827,37808,89.5,69791,33005,36786,89.7
'31003, 동부,'075,70~74세,2019,317776,146954,170822,86,312975,144934,168041,86.2
'31003, 동부,'075001, 70세,2019,71565,33959,37606,90.3,69979,33269,36710,90.6
'31003, 동부,'075002, 71세,2019,69715,32607,37108,87.9,68694,32159,36535,88
'31003, 동부,'075003, 72세,2019,70327,32268,38059,84.8,69409,31881,37528,85
'31003, 동부,'075004, 73세,2019,54369,24800,29569,83.9,53648,24526,29122,84.2
'31003, 동부,'075005, 74세,2019,51800,23320,28480,81.9,51245,23099,28146,82.1
'31003, 동부,'080,75~79세,2019,249821,106400,143421,74.2,247580,105698,141882,74.5
'31003, 동부,'080001, 75세,2019,51242,22279,28963,76.9,50738,22105,28633,77.2
'31003, 동부,'080002, 76세,2019,51074,22050,29024,76,50640,21924,28716,76.3
'31003, 동부,'080003, 77세,2019,58268,25036,33232,75.3,57829,24896,32933,75.6
'31003, 동부,'080004, 78세,2019,47055,19790,27265,72.6,46590,19654,26936,73
'31003, 동부,'080005, 79세,2019,42182,17245,24937,69.2,41783,17119,24664,69.4
'31003, 동부,'085,80~84세,2019,165107,61704,103403,59.7,163783,61321,102462,59.8
'31003, 동부,'085001, 80세,2019,40613,16117,24496,65.8,40301,16031,24270,66.1
'31003, 동부,'085002, 81세,2019,36521,14223,22298,63.8,36175,14104,22071,63.9
'31003, 동부,'085003, 82세,2019,32571,12145,20426,59.5,32320,12072,20248,59.6
'31003, 동부,'085004, 83세,2019,28798,10241,18557,55.2,28562,10179,18383,55.4
'31003, 동부,'085005, 84세,2019,26604,8978,17626,50.9,26425,8935,17490,51.1
'31003, 동부,'086,85세이상,2019,113368,31582,81786,38.6,112595,31368,81227,38.6
'31003, 동부,'090,85~89세,2019,78210,23507,54703,43,77677,23360,54317,43
'31003, 동부,'090001, 85세,2019,21641,7066,14575,48.5,21461,7019,14442,48.6
'31003, 동부,'090002, 86세,2019,18096,5639,12457,45.3,17975,5606,12369,45.3
'31003, 동부,'090003, 87세,2019,15691,4695,10996,42.7,15602,4666,10936,42.7
'31003, 동부,'090004, 88세,2019,11856,3317,8539,38.8,11781,3294,8487,38.8
'31003, 동부,'090005, 89세,2019,10926,2790,8136,34.3,10858,2775,8083,34.3
'31003, 동부,'095,90~94세,2019,27940,6504,21436,30.3,27768,6459,21309,30.3
'31003, 동부,'095001, 90세,2019,8956,2334,6622,35.2,8898,2319,6579,35.2
'31003, 동부,'095002, 91세,2019,7112,1683,5429,31,7074,1672,5402,31
'31003, 동부,'095003, 92세,2019,5375,1205,4170,28.9,5345,1199,4146,28.9
'31003, 동부,'095004, 93세,2019,3607,747,2860,26.1,3581,737,2844,25.9
'31003, 동부,'095005, 94세,2019,2890,535,2355,22.7,2870,532,2338,22.8
'31003, 동부,'100,95~99세,2019,6360,1405,4955,28.4,6297,1386,4911,28.2
'31003, 동부,'100001, 95세,2019,1977,442,1535,28.8,1957,437,1520,28.8
'31003, 동부,'100002, 96세,2019,1791,417,1374,30.3,1774,412,1362,30.2
'31003, 동부,'100003, 97세,2019,1285,271,1014,26.7,1273,266,1007,26.4
'31003, 동부,'100004, 98세,2019,765,162,603,26.9,759,160,599,26.7
'31003, 동부,'100005, 99세,2019,542,113,429,26.3,534,111,423,26.2
'31003, 동부,'101,100세이상,2019,858,166,692,24,853,163,690,23.6
'31003, 동부,'102,15세미만,2019,1543149,790636,752513,105.1,1517953,777862,740091,105.1
'31003, 동부,'103,15~64세,2019,8222296,4190115,4032181,103.9,7860331,3990186,3870145,103.1
'31003, 동부,'104,65세이상,2019,1268131,550441,717690,76.7,1244793,540494,704299,76.7
'31003, 동부,'126,평균연령,2019,40.4,39.5,41.3,,40.4,39.5,41.2,
'31003, 동부,'127,중위연령,2019,41.2,40.3,42.1,,41.2,40.4,42.2,
'31010, 수원시,'000,합계,2019,1214986,614493,600493,102.3,1158800,584662,574138,101.8
'31010, 수원시,'005,0~4세,2019,48932,25229,23703,106.4,47040,24252,22788,106.4
'31010, 수원시,'005001, 0세,2019,8161,4198,3963,105.9,7803,4003,3800,105.3
'31010, 수원시,'005002, 1세,2019,8889,4571,4318,105.9,8481,4360,4121,105.8
'31010, 수원시,'005003, 2세,2019,9527,4948,4579,108.1,9152,4767,4385,108.7
'31010, 수원시,'005004, 3세,2019,10832,5597,5235,106.9,10414,5378,5036,106.8
'31010, 수원시,'005005, 4세,2019,11523,5915,5608,105.5,11190,5744,5446,105.5
'31010, 수원시,'010,5~9세,2019,57128,29402,27726,106,56014,28851,27163,106.2
'31010, 수원시,'010001, 5세,2019,11117,5668,5449,104,10821,5526,5295,104.4
'31010, 수원시,'010002, 6세,2019,11126,5722,5404,105.9,10863,5602,5261,106.5
'31010, 수원시,'010003, 7세,2019,12067,6211,5856,106.1,11848,6103,5745,106.2
'31010, 수원시,'010004, 8세,2019,11678,6058,5620,107.8,11486,5955,5531,107.7
'31010, 수원시,'010005, 9세,2019,11140,5743,5397,106.4,10996,5665,5331,106.3
'31010, 수원시,'015,10~14세,2019,55850,28685,27165,105.6,55308,28434,26874,105.8
'31010, 수원시,'015001, 10세,2019,10863,5617,5246,107.1,10714,5539,5175,107
'31010, 수원시,'015002, 11세,2019,11717,6031,5686,106.1,11602,5970,5632,106
'31010, 수원시,'015003, 12세,2019,11945,6170,5775,106.8,11844,6122,5722,107
'31010, 수원시,'015004, 13세,2019,10768,5543,5225,106.1,10675,5509,5166,106.6
'31010, 수원시,'015005, 14세,2019,10557,5324,5233,101.7,10473,5294,5179,102.2
'31010, 수원시,'020,15~19세,2019,66045,34587,31458,109.9,64958,34183,30775,111.1
'31010, 수원시,'020001, 15세,2019,11789,6144,5645,108.8,11718,6110,5608,109
'31010, 수원시,'020002, 16세,2019,12037,6270,5767,108.7,11964,6233,5731,108.8
'31010, 수원시,'020003, 17세,2019,12208,6356,5852,108.6,12112,6324,5788,109.3
'31010, 수원시,'020004, 18세,2019,14371,7621,6750,112.9,14076,7528,6548,115
'31010, 수원시,'020005, 19세,2019,15640,8196,7444,110.1,15088,7988,7100,112.5
'31010, 수원시,'025,20~24세,2019,87552,46075,41477,111.1,83766,44163,39603,111.5
'31010, 수원시,'025001, 20세,2019,15366,8134,7232,112.5,14725,7840,6885,113.9
'31010, 수원시,'025002, 21세,2019,16537,8742,7795,112.1,15811,8391,7420,113.1
'31010, 수원시,'025003, 22세,2019,17399,9186,8213,111.8,16625,8778,7847,111.9
'31010, 수원시,'025004, 23세,2019,18638,9773,8865,110.2,17841,9353,8488,110.2
'31010, 수원시,'025005, 24세,2019,19612,10240,9372,109.3,18764,9801,8963,109.3
'31010, 수원시,'030,25~29세,2019,100619,53987,46632,115.8,95125,50992,44133,115.5
'31010, 수원시,'030001, 25세,2019,20167,10725,9442,113.6,19292,10218,9074,112.6
'31010, 수원시,'030002, 26세,2019,20827,11197,9630,116.3,19787,10627,9160,116
'31010, 수원시,'030003, 27세,2019,21007,11357,9650,117.7,19898,10758,9140,117.7
'31010, 수원시,'030004, 28세,2019,19904,10729,9175,116.9,18769,10122,8647,117.1
'31010, 수원시,'030005, 29세,2019,18714,9979,8735,114.2,17379,9267,8112,114.2
'31010, 수원시,'035,30~34세,2019,89557,47236,42321,111.6,82425,43317,39108,110.8
'31010, 수원시,'035001, 30세,2019,18547,9936,8611,115.4,17152,9204,7948,115.8
'31010, 수원시,'035002, 31세,2019,17837,9457,8380,112.9,16409,8692,7717,112.6
'31010, 수원시,'035003, 32세,2019,17660,9356,8304,112.7,16185,8497,7688,110.5
'31010, 수원시,'035004, 33세,2019,17597,9251,8346,110.8,16111,8407,7704,109.1
'31010, 수원시,'035005, 34세,2019,17916,9236,8680,106.4,16568,8517,8051,105.8
'31010, 수원시,'040,35~39세,2019,102824,52946,49878,106.2,97278,49676,47602,104.4
'31010, 수원시,'040001, 35세,2019,18168,9491,8677,109.4,16898,8749,8149,107.4
'31010, 수원시,'040002, 36세,2019,19776,10296,9480,108.6,18619,9650,8969,107.6
'31010, 수원시,'040003, 37세,2019,21610,11043,10567,104.5,20408,10316,10092,102.2
'31010, 수원시,'040004, 38세,2019,21719,11023,10696,103.1,20744,10446,10298,101.4
'31010, 수원시,'040005, 39세,2019,21551,11093,10458,106.1,20609,10515,10094,104.2
'31010, 수원시,'045,40~44세,2019,98501,50183,48318,103.9,94035,47579,46456,102.4
'31010, 수원시,'045001, 40세,2019,20853,10589,10264,103.2,19823,9974,9849,101.3
'31010, 수원시,'045002, 41세,2019,18951,9813,9138,107.4,18051,9301,8750,106.3
'31010, 수원시,'045003, 42세,2019,19674,9916,9758,101.6,18798,9414,9384,100.3
'31010, 수원시,'045004, 43세,2019,19271,9874,9397,105.1,18420,9366,9054,103.4
'31010, 수원시,'045005, 44세,2019,19752,9991,9761,102.4,18943,9524,9419,101.1
'31010, 수원시,'050,45~49세,2019,110074,55471,54603,101.6,104704,52441,52263,100.3
'31010, 수원시,'050001, 45세,2019,21335,10680,10655,100.2,20456,10161,10295,98.7
'31010, 수원시,'050002, 46세,2019,21761,10809,10952,98.7,20807,10291,10516,97.9
'31010, 수원시,'050003, 47세,2019,21602,11023,10579,104.2,20441,10349,10092,102.5
'31010, 수원시,'050004, 48세,2019,23179,11700,11479,101.9,21998,11047,10951,100.9
'31010, 수원시,'050005, 49세,2019,22197,11259,10938,102.9,21002,10593,10409,101.8
'31010, 수원시,'055,50~54세,2019,105898,52133,53765,97,100069,49090,50979,96.3
'31010, 수원시,'055001, 50세,2019,22892,11158,11734,95.1,21730,10544,11186,94.3
'31010, 수원시,'055002, 51세,2019,22490,10805,11685,92.5,21339,10203,11136,91.6
'31010, 수원시,'055003, 52세,2019,20377,9997,10380,96.3,19392,9465,9927,95.3
'31010, 수원시,'055004, 53세,2019,19735,9927,9808,101.2,18563,9325,9238,100.9
'31010, 수원시,'055005, 54세,2019,20404,10246,10158,100.9,19045,9553,9492,100.6
'31010, 수원시,'060,55~59세,2019,97235,49374,47861,103.2,91170,46269,44901,103
'31010, 수원시,'060001, 55세,2019,18847,9541,9306,102.5,17531,8849,8682,101.9
'31010, 수원시,'060002, 56세,2019,20057,10276,9781,105.1,18379,9413,8966,105
'31010, 수원시,'060003, 57세,2019,19007,9685,9322,103.9,17779,9086,8693,104.5
'31010, 수원시,'060004, 58세,2019,20102,10078,10024,100.5,19364,9706,9658,100.5
'31010, 수원시,'060005, 59세,2019,19222,9794,9428,103.9,18117,9215,8902,103.5
'31010, 수원시,'065,60~64세,2019,71114,35641,35473,100.5,66731,33403,33328,100.2
'31010, 수원시,'065001, 60세,2019,16698,8509,8189,103.9,15813,8036,7777,103.3
'31010, 수원시,'065002, 61세,2019,15234,7715,7519,102.6,14252,7203,7049,102.2
'31010, 수원시,'065003, 62세,2019,13933,7025,6908,101.7,12940,6535,6405,102
'31010, 수원시,'065004, 63세,2019,12627,6298,6329,99.5,11848,5903,5945,99.3
'31010, 수원시,'065005, 64세,2019,12622,6094,6528,93.4,11878,5726,6152,93.1
'31010, 수원시,'070,65~69세,2019,42578,20523,22055,93.1,40459,19490,20969,92.9
'31010, 수원시,'070001, 65세,2019,10253,4981,5272,94.5,9636,4682,4954,94.5
'31010, 수원시,'070002, 66세,2019,8924,4246,4678,90.8,8454,4019,4435,90.6
'31010, 수원시,'070003, 67세,2019,9726,4767,4959,96.1,9315,4561,4754,95.9
'31010, 수원시,'070004, 68세,2019,6487,3100,3387,91.5,6141,2936,3205,91.6
'31010, 수원시,'070005, 69세,2019,7188,3429,3759,91.2,6913,3292,3621,90.9
'31010, 수원시,'075,70~74세,2019,31033,14431,16602,86.9,30312,14107,16205,87.1
'31010, 수원시,'075001, 70세,2019,7041,3386,3655,92.6,6817,3280,3537,92.7
'31010, 수원시,'075002, 71세,2019,6876,3245,3631,89.4,6720,3169,3551,89.2
'31010, 수원시,'075003, 72세,2019,6886,3147,3739,84.2,6733,3078,3655,84.2
'31010, 수원시,'075004, 73세,2019,5189,2400,2789,86.1,5087,2364,2723,86.8
'31010, 수원시,'075005, 74세,2019,5041,2253,2788,80.8,4955,2216,2739,80.9
'31010, 수원시,'080,75~79세,2019,23779,9955,13824,72,23432,9866,13566,72.7
'31010, 수원시,'080001, 75세,2019,5001,2148,2853,75.3,4915,2126,2789,76.2
'31010, 수원시,'080002, 76세,2019,4896,2072,2824,73.4,4834,2056,2778,74
'31010, 수원시,'080003, 77세,2019,5482,2354,3128,75.3,5415,2335,3080,75.8
'31010, 수원시,'080004, 78세,2019,4516,1836,2680,68.5,4441,1825,2616,69.8
'31010, 수원시,'080005, 79세,2019,3884,1545,2339,66.1,3827,1524,2303,66.2
'31010, 수원시,'085,80~84세,2019,15625,5708,9917,57.6,15425,5646,9779,57.7
'31010, 수원시,'085001, 80세,2019,3851,1505,2346,64.2,3795,1490,2305,64.6
'31010, 수원시,'085002, 81세,2019,3438,1356,2082,65.1,3394,1336,2058,64.9
'31010, 수원시,'085003, 82세,2019,3087,1121,1966,57,3042,1109,1933,57.4
'31010, 수원시,'085004, 83세,2019,2766,907,1859,48.8,2733,895,1838,48.7
'31010, 수원시,'085005, 84세,2019,2483,819,1664,49.2,2461,816,1645,49.6
'31010, 수원시,'086,85세이상,2019,10642,2927,7715,37.9,10549,2903,7646,38
'31010, 수원시,'090,85~89세,2019,7337,2168,5169,41.9,7263,2150,5113,42
'31010, 수원시,'090001, 85세,2019,2036,681,1355,50.3,2012,675,1337,50.5
'31010, 수원시,'090002, 86세,2019,1705,513,1192,43,1688,510,1178,43.3
'31010, 수원시,'090003, 87세,2019,1485,431,1054,40.9,1472,427,1045,40.9
'31010, 수원시,'090004, 88세,2019,1062,287,775,37,1051,284,767,37
'31010, 수원시,'090005, 89세,2019,1049,256,793,32.3,1040,254,786,32.3
'31010, 수원시,'095,90~94세,2019,2649,611,2038,30,2637,608,2029,30
'31010, 수원시,'095001, 90세,2019,857,216,641,33.7,855,216,639,33.8
'31010, 수원시,'095002, 91세,2019,658,152,506,30,653,151,502,30.1
'31010, 수원시,'095003, 92세,2019,519,128,391,32.7,517,127,390,32.6
'31010, 수원시,'095004, 93세,2019,340,68,272,25,337,67,270,24.8
'31010, 수원시,'095005, 94세,2019,275,47,228,20.6,275,47,228,20.6
'31010, 수원시,'100,95~99세,2019,586,134,452,29.6,579,131,448,29.2
'31010, 수원시,'100001, 95세,2019,177,40,137,29.2,176,40,136,29.4
'31010, 수원시,'100002, 96세,2019,162,50,112,44.6,159,48,111,43.2
'31010, 수원시,'100003, 97세,2019,137,26,111,23.4,136,25,111,22.5
'31010, 수원시,'100004, 98세,2019,73,14,59,23.7,72,14,58,24.1
'31010, 수원시,'100005, 99세,2019,37,X,33,12.1,36,X,32,12.5
'31010, 수원시,'101,100세이상,2019,70,14,56,25,70,14,56,25
'31010, 수원시,'102,15세미만,2019,161910,83316,78594,106,158362,81537,76825,106.1
'31010, 수원시,'103,15~64세,2019,929419,477633,451786,105.7,880261,451113,429148,105.1
'31010, 수원시,'104,65세이상,2019,123657,53544,70113,76.4,120177,52012,68165,76.3
'31010, 수원시,'126,평균연령,2019,39.6,38.7,40.5,,39.5,38.6,40.4,
'31010, 수원시,'127,중위연령,2019,40,39,41,,39.9,38.9,40.9,
'31011, 장안구,'000,합계,2019,282288,143174,139114,102.9,271875,137699,134176,102.6
'31011, 장안구,'005,0~4세,2019,8656,4434,4222,105,8348,4281,4067,105.3
'31011, 장안구,'005001, 0세,2019,1387,676,711,95.1,1315,638,677,94.2
'31011, 장안구,'005002, 1세,2019,1481,771,710,108.6,1417,741,676,109.6
'31011, 장안구,'005003, 2세,2019,1688,880,808,108.9,1625,855,770,111
'31011, 장안구,'005004, 3세,2019,1960,1002,958,104.6,1895,964,931,103.5
'31011, 장안구,'005005, 4세,2019,2140,1105,1035,106.8,2096,1083,1013,106.9
'31011, 장안구,'010,5~9세,2019,11791,6125,5666,108.1,11620,6039,5581,108.2
'31011, 장안구,'010001, 5세,2019,2133,1112,1021,108.9,2089,1090,999,109.1
'31011, 장안구,'010002, 6세,2019,2256,1184,1072,110.4,2208,1161,1047,110.9
'31011, 장안구,'010003, 7세,2019,2418,1230,1188,103.5,2390,1219,1171,104.1
'31011, 장안구,'010004, 8세,2019,2528,1338,1190,112.4,2503,1325,1178,112.5
'31011, 장안구,'010005, 9세,2019,2456,1261,1195,105.5,2430,1244,1186,104.9
'31011, 장안구,'015,10~14세,2019,13402,6870,6532,105.2,13329,6839,6490,105.4
'31011, 장안구,'015001, 10세,2019,2517,1286,1231,104.5,2493,1273,1220,104.3
'31011, 장안구,'015002, 11세,2019,2779,1432,1347,106.3,2763,1426,1337,106.7
'31011, 장안구,'015003, 12세,2019,2838,1459,1379,105.8,2828,1455,1373,106
'31011, 장안구,'015004, 13세,2019,2633,1353,1280,105.7,2620,1348,1272,106
'31011, 장안구,'015005, 14세,2019,2635,1340,1295,103.5,2625,1337,1288,103.8
'31011, 장안구,'020,15~19세,2019,17342,9440,7902,119.5,17007,9330,7677,121.5
'31011, 장안구,'020001, 15세,2019,2912,1563,1349,115.9,2904,1561,1343,116.2
'31011, 장안구,'020002, 16세,2019,3108,1662,1446,114.9,3098,1656,1442,114.8
'31011, 장안구,'020003, 17세,2019,3133,1706,1427,119.6,3122,1701,1421,119.7
'31011, 장안구,'020004, 18세,2019,3798,2118,1680,126.1,3727,2095,1632,128.4
'31011, 장안구,'020005, 19세,2019,4391,2391,2000,119.6,4156,2317,1839,126
'31011, 장안구,'025,20~24세,2019,23784,13341,10443,127.8,22491,12646,9845,128.5
'31011, 장안구,'025001, 20세,2019,4310,2449,1861,131.6,4059,2337,1722,135.7
'31011, 장안구,'025002, 21세,2019,4642,2512,2130,117.9,4400,2386,2014,118.5
'31011, 장안구,'025003, 22세,2019,4894,2760,2134,129.3,4599,2605,1994,130.6
'31011, 장안구,'025004, 23세,2019,4993,2782,2211,125.8,4738,2628,2110,124.5
'31011, 장안구,'025005, 24세,2019,4945,2838,2107,134.7,4695,2690,2005,134.2
'31011, 장안구,'030,25~29세,2019,22181,12303,9878,124.5,20833,11555,9278,124.5
'31011, 장안구,'030001, 25세,2019,4891,2778,2113,131.5,4643,2635,2008,131.2
'31011, 장안구,'030002, 26세,2019,4807,2678,2129,125.8,4533,2524,2009,125.6
'31011, 장안구,'030003, 27세,2019,4508,2499,2009,124.4,4231,2336,1895,123.3
'31011, 장안구,'030004, 28세,2019,4187,2283,1904,119.9,3929,2152,1777,121.1
'31011, 장안구,'030005, 29세,2019,3788,2065,1723,119.8,3497,1908,1589,120.1
'31011, 장안구,'035,30~34세,2019,16162,8661,7501,115.5,14943,8010,6933,115.5
'31011, 장안구,'035001, 30세,2019,3532,1959,1573,124.5,3275,1825,1450,125.9
'31011, 장안구,'035002, 31세,2019,3197,1712,1485,115.3,2956,1588,1368,116.1
'31011, 장안구,'035003, 32세,2019,3102,1663,1439,115.6,2842,1516,1326,114.3
'31011, 장안구,'035004, 33세,2019,3135,1649,1486,111,2894,1516,1378,110
'31011, 장안구,'035005, 34세,2019,3196,1678,1518,110.5,2976,1565,1411,110.9
'31011, 장안구,'040,35~39세,2019,19259,9738,9521,102.3,18357,9205,9152,100.6
'31011, 장안구,'040001, 35세,2019,3235,1641,1594,102.9,3022,1516,1506,100.7
'31011, 장안구,'040002, 36세,2019,3616,1884,1732,108.8,3426,1777,1649,107.8
'31011, 장안구,'040003, 37세,2019,4037,2013,2024,99.5,3852,1901,1951,97.4
'31011, 장안구,'040004, 38세,2019,4136,2053,2083,98.6,3973,1956,2017,97
'31011, 장안구,'040005, 39세,2019,4235,2147,2088,102.8,4084,2055,2029,101.3
'31011, 장안구,'045,40~44세,2019,21203,10527,10676,98.6,20487,10132,10355,97.8
'31011, 장안구,'045001, 40세,2019,4325,2125,2200,96.6,4149,2021,2128,95
'31011, 장안구,'045002, 41세,2019,3988,2040,1948,104.7,3829,1955,1874,104.3
'31011, 장안구,'045003, 42세,2019,4213,2053,2160,95,4082,1986,2096,94.8
'31011, 장안구,'045004, 43세,2019,4241,2127,2114,100.6,4102,2047,2055,99.6
'31011, 장안구,'045005, 44세,2019,4436,2182,2254,96.8,4325,2123,2202,96.4
'31011, 장안구,'050,45~49세,2019,26419,13153,13266,99.1,25532,12659,12873,98.3
'31011, 장안구,'050001, 45세,2019,5058,2517,2541,99.1,4913,2437,2476,98.4
'31011, 장안구,'050002, 46세,2019,5164,2496,2668,93.6,4982,2407,2575,93.5
'31011, 장안구,'050003, 47세,2019,5158,2617,2541,103,4983,2503,2480,100.9
'31011, 장안구,'050004, 48세,2019,5542,2727,2815,96.9,5362,2636,2726,96.7
'31011, 장안구,'050005, 49세,2019,5497,2796,2701,103.5,5292,2676,2616,102.3
'31011, 장안구,'055,50~54세,2019,26370,12979,13391,96.9,25417,12490,12927,96.6
'31011, 장안구,'055001, 50세,2019,5690,2747,2943,93.3,5499,2655,2844,93.4
'31011, 장안구,'055002, 51세,2019,5647,2703,2944,91.8,5437,2599,2838,91.6
'31011, 장안구,'055003, 52세,2019,5114,2480,2634,94.2,4943,2381,2562,92.9
'31011, 장안구,'055004, 53세,2019,4968,2519,2449,102.9,4788,2429,2359,103
'31011, 장안구,'055005, 54세,2019,4951,2530,2421,104.5,4750,2426,2324,104.4
'31011, 장안구,'060,55~59세,2019,23719,12025,11694,102.8,22793,11562,11231,102.9
'31011, 장안구,'060001, 55세,2019,4516,2289,2227,102.8,4303,2180,2123,102.7
'31011, 장안구,'060002, 56세,2019,4897,2531,2366,107,4658,2411,2247,107.3
'31011, 장안구,'060003, 57세,2019,4633,2348,2285,102.8,4450,2259,2191,103.1
'31011, 장안구,'060004, 58세,2019,4942,2465,2477,99.5,4838,2416,2422,99.8
'31011, 장안구,'060005, 59세,2019,4731,2392,2339,102.3,4544,2296,2248,102.1
'31011, 장안구,'065,60~64세,2019,17664,8835,8829,100.1,16982,8471,8511,99.5
'31011, 장안구,'065001, 60세,2019,4137,2103,2034,103.4,3993,2027,1966,103.1
'31011, 장안구,'065002, 61세,2019,3788,1924,1864,103.2,3636,1837,1799,102.1
'31011, 장안구,'065003, 62세,2019,3417,1724,1693,101.8,3280,1653,1627,101.6
'31011, 장안구,'065004, 63세,2019,3168,1589,1579,100.6,3045,1519,1526,99.5
'31011, 장안구,'065005, 64세,2019,3154,1495,1659,90.1,3028,1435,1593,90.1
'31011, 장안구,'070,65~69세,2019,10954,5244,5710,91.8,10604,5078,5526,91.9
'31011, 장안구,'070001, 65세,2019,2621,1298,1323,98.1,2521,1257,1264,99.4
'31011, 장안구,'070002, 66세,2019,2281,1084,1197,90.6,2197,1041,1156,90.1
'31011, 장안구,'070003, 67세,2019,2467,1192,1275,93.5,2401,1158,1243,93.2
'31011, 장안구,'070004, 68세,2019,1665,781,884,88.3,1608,756,852,88.7
'31011, 장안구,'070005, 69세,2019,1920,889,1031,86.2,1877,866,1011,85.7
'31011, 장안구,'075,70~74세,2019,8449,3877,4572,84.8,8326,3817,4509,84.7
'31011, 장안구,'075001, 70세,2019,1877,901,976,92.3,1843,887,956,92.8
'31011, 장안구,'075002, 71세,2019,1840,893,947,94.3,1819,878,941,93.3
'31011, 장안구,'075003, 72세,2019,1879,847,1032,82.1,1854,832,1022,81.4
'31011, 장안구,'075004, 73세,2019,1428,650,778,83.5,1408,642,766,83.8
'31011, 장안구,'075005, 74세,2019,1425,586,839,69.8,1402,578,824,70.1
'31011, 장안구,'080,75~79세,2019,6865,2911,3954,73.6,6803,2898,3905,74.2
'31011, 장안구,'080001, 75세,2019,1394,596,798,74.7,1379,596,783,76.1
'31011, 장안구,'080002, 76세,2019,1435,618,817,75.6,1422,614,808,76
'31011, 장안구,'080003, 77세,2019,1586,667,919,72.6,1570,661,909,72.7
'31011, 장안구,'080004, 78세,2019,1310,570,740,77,1301,569,732,77.7
'31011, 장안구,'080005, 79세,2019,1140,460,680,67.6,1131,458,673,68.1
'31011, 장안구,'085,80~84세,2019,4728,1775,2953,60.1,4685,1758,2927,60.1
'31011, 장안구,'085001, 80세,2019,1117,452,665,68,1103,447,656,68.1
'31011, 장안구,'085002, 81세,2019,1039,427,612,69.8,1034,424,610,69.5
'31011, 장안구,'085003, 82세,2019,936,357,579,61.7,927,354,573,61.8
'31011, 장안구,'085004, 83세,2019,865,287,578,49.7,857,283,574,49.3
'31011, 장안구,'085005, 84세,2019,771,252,519,48.6,764,250,514,48.6
'31011, 장안구,'086,85세이상,2019,3340,936,2404,38.9,3318,929,2389,38.9
'31011, 장안구,'090,85~89세,2019,2266,680,1586,42.9,2250,675,1575,42.9
'31011, 장안구,'090001, 85세,2019,601,208,393,52.9,596,206,390,52.8
'31011, 장안구,'090002, 86세,2019,513,148,365,40.5,509,147,362,40.6
'31011, 장안구,'090003, 87세,2019,473,142,331,42.9,468,140,328,42.7
'31011, 장안구,'090004, 88세,2019,338,98,240,40.8,336,98,238,41.2
'31011, 장안구,'090005, 89세,2019,341,84,257,32.7,341,84,257,32.7
'31011, 장안구,'095,90~94세,2019,865,213,652,32.7,861,212,649,32.7
'31011, 장안구,'095001, 90세,2019,277,73,204,35.8,277,73,204,35.8
'31011, 장안구,'095002, 91세,2019,208,55,153,35.9,205,54,151,35.8
'31011, 장안구,'095003, 92세,2019,176,37,139,26.6,175,37,138,26.8
'31011, 장안구,'095004, 93세,2019,110,26,84,31,110,26,84,31
'31011, 장안구,'095005, 94세,2019,94,22,72,30.6,94,22,72,30.6
'31011, 장안구,'100,95~99세,2019,187,39,148,26.4,185,38,147,25.9
'31011, 장안구,'100001, 95세,2019,59,14,45,31.1,59,14,45,31.1
'31011, 장안구,'100002, 96세,2019,46,14,32,43.8,44,13,31,41.9
'31011, 장안구,'100003, 97세,2019,48,X,44,9.1,48,X,44,9.1
'31011, 장안구,'100004, 98세,2019,24,7,17,41.2,24,7,17,41.2
'31011, 장안구,'100005, 99세,2019,10,X,10,0,10,X,10,0
'31011, 장안구,'101,100세이상,2019,22,X,18,22.2,22,X,18,22.2
'31011, 장안구,'102,15세미만,2019,33849,17429,16420,106.1,33297,17159,16138,106.3
'31011, 장안구,'103,15~64세,2019,214103,111002,103101,107.7,204842,106060,98782,107.4
'31011, 장안구,'104,65세이상,2019,34336,14743,19593,75.2,33736,14480,19256,75.2
'31011, 장안구,'126,평균연령,2019,40.9,39.7,42.2,,41,39.7,42.3,
'31011, 장안구,'127,중위연령,2019,42.1,40.3,43.7,,42.3,40.5,44,
'31012, 권선구,'000,합계,2019,374770,189282,185488,102,359431,181368,178063,101.9
'31012, 권선구,'005,0~4세,2019,16941,8776,8165,107.5,16401,8502,7899,107.6
'31012, 권선구,'005001, 0세,2019,2802,1465,1337,109.6,2689,1401,1288,108.8
'31012, 권선구,'005002, 1세,2019,3065,1563,1502,104.1,2945,1502,1443,104.1
'31012, 권선구,'005003, 2세,2019,3395,1749,1646,106.3,3276,1693,1583,106.9
'31012, 권선구,'005004, 3세,2019,3817,2005,1812,110.7,3707,1951,1756,111.1
'31012, 권선구,'005005, 4세,2019,3862,1994,1868,106.7,3784,1955,1829,106.9
'31012, 권선구,'010,5~9세,2019,18314,9308,9006,103.4,18044,9183,8861,103.6
'31012, 권선구,'010001, 5세,2019,3790,1909,1881,101.5,3707,1874,1833,102.2
'31012, 권선구,'010002, 6세,2019,3636,1839,1797,102.3,3576,1817,1759,103.3
'31012, 권선구,'010003, 7세,2019,3893,2008,1885,106.5,3848,1986,1862,106.7
'31012, 권선구,'010004, 8세,2019,3682,1891,1791,105.6,3636,1865,1771,105.3
'31012, 권선구,'010005, 9세,2019,3313,1661,1652,100.5,3277,1641,1636,100.3
'31012, 권선구,'015,10~14세,2019,15911,8207,7704,106.5,15779,8155,7624,107
'31012, 권선구,'015001, 10세,2019,3231,1671,1560,107.1,3198,1657,1541,107.5
'31012, 권선구,'015002, 11세,2019,3344,1746,1598,109.3,3317,1735,1582,109.7
'31012, 권선구,'015003, 12세,2019,3395,1746,1649,105.9,3367,1735,1632,106.3
'31012, 권선구,'015004, 13세,2019,3035,1570,1465,107.2,3016,1561,1455,107.3
'31012, 권선구,'015005, 14세,2019,2906,1474,1432,102.9,2881,1467,1414,103.7
'31012, 권선구,'020,15~19세,2019,17440,9115,8325,109.5,17303,9063,8240,110
'31012, 권선구,'020001, 15세,2019,3283,1740,1543,112.8,3258,1729,1529,113.1
'31012, 권선구,'020002, 16세,2019,3239,1701,1538,110.6,3218,1692,1526,110.9
'31012, 권선구,'020003, 17세,2019,3274,1712,1562,109.6,3250,1706,1544,110.5
'31012, 권선구,'020004, 18세,2019,3780,1984,1796,110.5,3754,1973,1781,110.8
'31012, 권선구,'020005, 19세,2019,3864,1978,1886,104.9,3823,1963,1860,105.5
'31012, 권선구,'025,20~24세,2019,23795,12275,11520,106.6,23292,12021,11271,106.7
'31012, 권선구,'025001, 20세,2019,3947,2104,1843,114.2,3899,2083,1816,114.7
'31012, 권선구,'025002, 21세,2019,4433,2415,2018,119.7,4363,2383,1980,120.4
'31012, 권선구,'025003, 22세,2019,4772,2386,2386,100,4678,2340,2338,100.1
'31012, 권선구,'025004, 23세,2019,5107,2579,2528,102,4976,2520,2456,102.6
'31012, 권선구,'025005, 24세,2019,5536,2791,2745,101.7,5376,2695,2681,100.5
'31012, 권선구,'030,25~29세,2019,29601,15528,14073,110.3,28340,14901,13439,110.9
'31012, 권선구,'030001, 25세,2019,5731,2964,2767,107.1,5556,2868,2688,106.7
'31012, 권선구,'030002, 26세,2019,6022,3178,2844,111.7,5791,3059,2732,112
'31012, 권선구,'030003, 27세,2019,6221,3278,2943,111.4,5986,3164,2822,112.1
'31012, 권선구,'030004, 28세,2019,6051,3185,2866,111.1,5769,3050,2719,112.2
'31012, 권선구,'030005, 29세,2019,5576,2923,2653,110.2,5238,2760,2478,111.4
'31012, 권선구,'035,30~34세,2019,28720,14953,13767,108.6,26611,13847,12764,108.5
'31012, 권선구,'035001, 30세,2019,5677,2967,2710,109.5,5298,2779,2519,110.3
'31012, 권선구,'035002, 31세,2019,5549,2914,2635,110.6,5133,2704,2429,111.3
'31012, 권선구,'035003, 32세,2019,5744,3028,2716,111.5,5296,2773,2523,109.9
'31012, 권선구,'035004, 33세,2019,5747,2959,2788,106.1,5298,2723,2575,105.7
'31012, 권선구,'035005, 34세,2019,6003,3085,2918,105.7,5586,2868,2718,105.5
'31012, 권선구,'040,35~39세,2019,34518,18103,16415,110.3,32882,17173,15709,109.3
'31012, 권선구,'040001, 35세,2019,6214,3317,2897,114.5,5826,3094,2732,113.3
'31012, 권선구,'040002, 36세,2019,6658,3471,3187,108.9,6330,3294,3036,108.5
'31012, 권선구,'040003, 37세,2019,7234,3754,3480,107.9,6883,3549,3334,106.4
'31012, 권선구,'040004, 38세,2019,7286,3760,3526,106.6,6993,3607,3386,106.5
'31012, 권선구,'040005, 39세,2019,7126,3801,3325,114.3,6850,3629,3221,112.7
'31012, 권선구,'045,40~44세,2019,30214,15874,14340,110.7,28881,15105,13776,109.6
'31012, 권선구,'045001, 40세,2019,6688,3494,3194,109.4,6388,3326,3062,108.6
'31012, 권선구,'045002, 41세,2019,5898,3119,2779,112.2,5645,2971,2674,111.1
'31012, 권선구,'045003, 42세,2019,5945,3138,2807,111.8,5680,2989,2691,111.1
'31012, 권선구,'045004, 43세,2019,5785,3074,2711,113.4,5524,2917,2607,111.9
'31012, 권선구,'045005, 44세,2019,5898,3049,2849,107,5644,2902,2742,105.8
'31012, 권선구,'050,45~49세,2019,32260,16407,15853,103.5,30766,15590,15176,102.7
'31012, 권선구,'050001, 45세,2019,6278,3237,3041,106.4,6034,3087,2947,104.8
'31012, 권선구,'050002, 46세,2019,6367,3250,3117,104.3,6120,3122,2998,104.1
'31012, 권선구,'050003, 47세,2019,6321,3237,3084,105,5996,3059,2937,104.2
'31012, 권선구,'050004, 48세,2019,6858,3503,3355,104.4,6518,3317,3201,103.6
'31012, 권선구,'050005, 49세,2019,6436,3180,3256,97.7,6098,3005,3093,97.2
'31012, 권선구,'055,50~54세,2019,33144,15999,17145,93.3,31449,15132,16317,92.7
'31012, 권선구,'055001, 50세,2019,6905,3269,3636,89.9,6551,3089,3462,89.2
'31012, 권선구,'055002, 51세,2019,6883,3225,3658,88.2,6535,3050,3485,87.5
'31012, 권선구,'055003, 52세,2019,6458,3131,3327,94.1,6180,2977,3203,92.9
'31012, 권선구,'055004, 53세,2019,6220,3107,3113,99.8,5909,2947,2962,99.5
'31012, 권선구,'055005, 54세,2019,6678,3267,3411,95.8,6274,3069,3205,95.8
'31012, 권선구,'060,55~59세,2019,31800,15957,15843,100.7,29969,15066,14903,101.1
'31012, 권선구,'060001, 55세,2019,6071,3047,3024,100.8,5680,2853,2827,100.9
'31012, 권선구,'060002, 56세,2019,6379,3242,3137,103.3,5872,3007,2865,105
'31012, 권선구,'060003, 57세,2019,6171,3106,3065,101.3,5823,2947,2876,102.5
'31012, 권선구,'060004, 58세,2019,6723,3316,3407,97.3,6488,3190,3298,96.7
'31012, 권선구,'060005, 59세,2019,6456,3246,3210,101.1,6106,3069,3037,101.1
'31012, 권선구,'065,60~64세,2019,23604,11767,11837,99.4,22253,11103,11150,99.6
'31012, 권선구,'065001, 60세,2019,5622,2792,2830,98.7,5374,2668,2706,98.6
'31012, 권선구,'065002, 61세,2019,4986,2498,2488,100.4,4681,2349,2332,100.7
'31012, 권선구,'065003, 62세,2019,4621,2320,2301,100.8,4297,2160,2137,101.1
'31012, 권선구,'065004, 63세,2019,4217,2101,2116,99.3,3965,1976,1989,99.3
'31012, 권선구,'065005, 64세,2019,4158,2056,2102,97.8,3936,1950,1986,98.2
'31012, 권선구,'070,65~69세,2019,13908,6812,7096,96,13241,6460,6781,95.3
'31012, 권선구,'070001, 65세,2019,3352,1628,1724,94.4,3154,1520,1634,93
'31012, 권선구,'070002, 66세,2019,3008,1461,1547,94.4,2850,1379,1471,93.7
'31012, 권선구,'070003, 67세,2019,3205,1623,1582,102.6,3070,1555,1515,102.6
'31012, 권선구,'070004, 68세,2019,2116,1010,1106,91.3,2022,957,1065,89.9
'31012, 권선구,'070005, 69세,2019,2227,1090,1137,95.9,2145,1049,1096,95.7
'31012, 권선구,'075,70~74세,2019,9779,4653,5126,90.8,9584,4574,5010,91.3
'31012, 권선구,'075001, 70세,2019,2249,1108,1141,97.1,2193,1077,1116,96.5
'31012, 권선구,'075002, 71세,2019,2157,1026,1131,90.7,2116,1013,1103,91.8
'31012, 권선구,'075003, 72세,2019,2227,1055,1172,90,2182,1040,1142,91.1
'31012, 권선구,'075004, 73세,2019,1611,737,874,84.3,1583,729,854,85.4
'31012, 권선구,'075005, 74세,2019,1535,727,808,90,1510,715,795,89.9
'31012, 권선구,'080,75~79세,2019,7063,3002,4061,73.9,6960,2970,3990,74.4
'31012, 권선구,'080001, 75세,2019,1552,705,847,83.2,1531,696,835,83.4
'31012, 권선구,'080002, 76세,2019,1417,602,815,73.9,1399,598,801,74.7
'31012, 권선구,'080003, 77세,2019,1617,720,897,80.3,1596,711,885,80.3
'31012, 권선구,'080004, 78세,2019,1342,538,804,66.9,1312,534,778,68.6
'31012, 권선구,'080005, 79세,2019,1135,437,698,62.6,1122,431,691,62.4
'31012, 권선구,'085,80~84세,2019,4642,1688,2954,57.1,4582,1671,2911,57.4
'31012, 권선구,'085001, 80세,2019,1192,453,739,61.3,1177,451,726,62.1
'31012, 권선구,'085002, 81세,2019,1021,397,624,63.6,1005,391,614,63.7
'31012, 권선구,'085003, 82세,2019,927,330,597,55.3,910,325,585,55.6
'31012, 권선구,'085004, 83세,2019,787,274,513,53.4,780,271,509,53.2
'31012, 권선구,'085005, 84세,2019,715,234,481,48.6,710,233,477,48.8
'31012, 권선구,'086,85세이상,2019,3116,858,2258,38,3094,852,2242,38
'31012, 권선구,'090,85~89세,2019,2188,650,1538,42.3,2171,645,1526,42.3
'31012, 권선구,'090001, 85세,2019,618,204,414,49.3,613,203,410,49.5
'31012, 권선구,'090002, 86세,2019,522,156,366,42.6,517,154,363,42.4
'31012, 권선구,'090003, 87세,2019,432,130,302,43,431,130,301,43.2
'31012, 권선구,'090004, 88세,2019,304,87,217,40.1,300,86,214,40.2
'31012, 권선구,'090005, 89세,2019,312,73,239,30.5,310,72,238,30.3
'31012, 권선구,'095,90~94세,2019,756,172,584,29.5,752,171,581,29.4
'31012, 권선구,'095001, 90세,2019,249,62,187,33.2,248,62,186,33.3
'31012, 권선구,'095002, 91세,2019,187,44,143,30.8,186,44,142,31
'31012, 권선구,'095003, 92세,2019,147,39,108,36.1,147,39,108,36.1
'31012, 권선구,'095004, 93세,2019,92,18,74,24.3,90,17,73,23.3
'31012, 권선구,'095005, 94세,2019,81,9,72,12.5,81,9,72,12.5
'31012, 권선구,'100,95~99세,2019,149,31,118,26.3,148,31,117,26.5
'31012, 권선구,'100001, 95세,2019,46,11,35,31.4,45,11,34,32.4
'31012, 권선구,'100002, 96세,2019,40,9,31,29,40,9,31,29
'31012, 권선구,'100003, 97세,2019,33,7,26,26.9,33,7,26,26.9
'31012, 권선구,'100004, 98세,2019,23,X,20,15,23,X,20,15
'31012, 권선구,'100005, 99세,2019,7,X,6,16.7,7,X,6,16.7
'31012, 권선구,'101,100세이상,2019,23,5,18,27.8,23,5,18,27.8
'31012, 권선구,'102,15세미만,2019,51166,26291,24875,105.7,50224,25840,24384,106
'31012, 권선구,'103,15~64세,2019,285096,145978,139118,104.9,271746,139001,132745,104.7
'31012, 권선구,'104,65세이상,2019,38508,17013,21495,79.1,37461,16527,20934,78.9
'31012, 권선구,'126,평균연령,2019,40,39.2,40.8,,39.8,39,40.7,
'31012, 권선구,'127,중위연령,2019,40.3,39.6,41.2,,40.2,39.4,41.1,
'31013, 팔달구,'000,합계,2019,189052,95973,93079,103.1,168601,84799,83802,101.2
'31013, 팔달구,'005,0~4세,2019,5262,2648,2614,101.3,4672,2338,2334,100.2
'31013, 팔달구,'005001, 0세,2019,899,457,442,103.4,787,397,390,101.8
'31013, 팔달구,'005002, 1세,2019,995,500,495,101,869,437,432,101.2
'31013, 팔달구,'005003, 2세,2019,1032,514,518,99.2,926,460,466,98.7
'31013, 팔달구,'005004, 3세,2019,1175,582,593,98.1,1040,509,531,95.9
'31013, 팔달구,'005005, 4세,2019,1161,595,566,105.1,1050,535,515,103.9
'31013, 팔달구,'010,5~9세,2019,5983,3060,2923,104.7,5633,2897,2736,105.9
'31013, 팔달구,'010001, 5세,2019,1174,604,570,106,1080,565,515,109.7
'31013, 팔달구,'010002, 6세,2019,1139,573,566,101.2,1069,544,525,103.6
'31013, 팔달구,'010003, 7세,2019,1244,637,607,104.9,1164,591,573,103.1
'31013, 팔달구,'010004, 8세,2019,1199,617,582,106,1138,589,549,107.3
'31013, 팔달구,'010005, 9세,2019,1227,629,598,105.2,1182,608,574,105.9
'31013, 팔달구,'015,10~14세,2019,6271,3211,3060,104.9,6080,3121,2959,105.5
'31013, 팔달구,'015001, 10세,2019,1161,627,534,117.4,1111,601,510,117.8
'31013, 팔달구,'015002, 11세,2019,1304,681,623,109.3,1264,659,605,108.9
'31013, 팔달구,'015003, 12세,2019,1332,671,661,101.5,1297,654,643,101.7
'31013, 팔달구,'015004, 13세,2019,1225,617,608,101.5,1187,602,585,102.9
'31013, 팔달구,'015005, 14세,2019,1249,615,634,97,1221,605,616,98.2
'31013, 팔달구,'020,15~19세,2019,8216,4258,3958,107.6,8001,4166,3835,108.6
'31013, 팔달구,'020001, 15세,2019,1450,732,718,101.9,1427,719,708,101.6
'31013, 팔달구,'020002, 16세,2019,1471,778,693,112.3,1444,763,681,112
'31013, 팔달구,'020003, 17세,2019,1584,816,768,106.3,1553,804,749,107.3
'31013, 팔달구,'020004, 18세,2019,1818,945,873,108.2,1757,926,831,111.4
'31013, 팔달구,'020005, 19세,2019,1893,987,906,108.9,1820,954,866,110.2
'31013, 팔달구,'025,20~24세,2019,12178,6191,5987,103.4,11596,5889,5707,103.2
'31013, 팔달구,'025001, 20세,2019,1976,1049,927,113.2,1904,1007,897,112.3
'31013, 팔달구,'025002, 21세,2019,2133,1101,1032,106.7,2046,1061,985,107.7
'31013, 팔달구,'025003, 22세,2019,2350,1197,1153,103.8,2238,1129,1109,101.8
'31013, 팔달구,'025004, 23세,2019,2743,1387,1356,102.3,2592,1312,1280,102.5
'31013, 팔달구,'025005, 24세,2019,2976,1457,1519,95.9,2816,1380,1436,96.1
'31013, 팔달구,'030,25~29세,2019,16187,8729,7458,117,14746,7933,6813,116.4
'31013, 팔달구,'030001, 25세,2019,3133,1666,1467,113.6,2953,1553,1400,110.9
'31013, 팔달구,'030002, 26세,2019,3242,1753,1489,117.7,3025,1634,1391,117.5
'31013, 팔달구,'030003, 27세,2019,3447,1856,1591,116.7,3136,1694,1442,117.5
'31013, 팔달구,'030004, 28세,2019,3252,1759,1493,117.8,2941,1585,1356,116.9
'31013, 팔달구,'030005, 29세,2019,3113,1695,1418,119.5,2691,1467,1224,119.9
'31013, 팔달구,'035,30~34세,2019,14226,7814,6412,121.9,11870,6443,5427,118.7
'31013, 팔달구,'035001, 30세,2019,3101,1731,1370,126.4,2631,1464,1167,125.4
'31013, 팔달구,'035002, 31세,2019,2894,1571,1323,118.7,2424,1303,1121,116.2
'31013, 팔달구,'035003, 32세,2019,2842,1537,1305,117.8,2356,1239,1117,110.9
'31013, 팔달구,'035004, 33세,2019,2795,1575,1220,129.1,2283,1273,1010,126
'31013, 팔달구,'035005, 34세,2019,2594,1400,1194,117.3,2176,1164,1012,115
'31013, 팔달구,'040,35~39세,2019,14441,7817,6624,118,12522,6635,5887,112.7
'31013, 팔달구,'040001, 35세,2019,2671,1468,1203,122,2264,1220,1044,116.9
'31013, 팔달구,'040002, 36세,2019,2842,1543,1299,118.8,2433,1303,1130,115.3
'31013, 팔달구,'040003, 37세,2019,3003,1605,1398,114.8,2570,1337,1233,108.4
'31013, 팔달구,'040004, 38세,2019,2952,1584,1368,115.8,2616,1365,1251,109.1
'31013, 팔달구,'040005, 39세,2019,2973,1617,1356,119.2,2639,1410,1229,114.7
'31013, 팔달구,'045,40~44세,2019,13922,7253,6669,108.8,12250,6270,5980,104.8
'31013, 팔달구,'045001, 40세,2019,2865,1511,1354,111.6,2483,1277,1206,105.9
'31013, 팔달구,'045002, 41세,2019,2639,1387,1252,110.8,2297,1196,1101,108.6
'31013, 팔달구,'045003, 42세,2019,2780,1425,1355,105.2,2451,1237,1214,101.9
'31013, 팔달구,'045004, 43세,2019,2709,1405,1304,107.7,2409,1226,1183,103.6
'31013, 팔달구,'045005, 44세,2019,2929,1525,1404,108.6,2610,1334,1276,104.5
'31013, 팔달구,'050,45~49세,2019,17009,8883,8126,109.3,14709,7561,7148,105.8
'31013, 팔달구,'050001, 45세,2019,3179,1648,1531,107.6,2831,1447,1384,104.6
'31013, 팔달구,'050002, 46세,2019,3287,1696,1591,106.6,2896,1469,1427,102.9
'31013, 팔달구,'050003, 47세,2019,3307,1756,1551,113.2,2806,1464,1342,109.1
'31013, 팔달구,'050004, 48세,2019,3651,1891,1760,107.4,3122,1589,1533,103.7
'31013, 팔달구,'050005, 49세,2019,3585,1892,1693,111.8,3054,1592,1462,108.9
'31013, 팔달구,'055,50~54세,2019,17316,8787,8529,103,14716,7395,7321,101
'31013, 팔달구,'055001, 50세,2019,3608,1835,1773,103.5,3120,1560,1560,100
'31013, 팔달구,'055002, 51세,2019,3673,1808,1865,96.9,3195,1544,1651,93.5
'31013, 팔달구,'055003, 52세,2019,3254,1658,1596,103.9,2823,1435,1388,103.4
'31013, 팔달구,'055004, 53세,2019,3339,1713,1626,105.4,2765,1415,1350,104.8
'31013, 팔달구,'055005, 54세,2019,3442,1773,1669,106.2,2813,1441,1372,105
'31013, 팔달구,'060,55~59세,2019,17764,9051,8713,103.9,15022,7569,7453,101.6
'31013, 팔달구,'060001, 55세,2019,3409,1776,1633,108.8,2810,1442,1368,105.4
'31013, 팔달구,'060002, 56세,2019,3767,1906,1861,102.4,2989,1474,1515,97.3
'31013, 팔달구,'060003, 57세,2019,3445,1751,1694,103.4,2877,1457,1420,102.6
'31013, 팔달구,'060004, 58세,2019,3616,1831,1785,102.6,3295,1670,1625,102.8
'31013, 팔달구,'060005, 59세,2019,3527,1787,1740,102.7,3051,1526,1525,100.1
'31013, 팔달구,'065,60~64세,2019,14208,7024,7184,97.8,12253,6003,6250,96
'31013, 팔달구,'065001, 60세,2019,3154,1596,1558,102.4,2734,1361,1373,99.1
'31013, 팔달구,'065002, 61세,2019,2987,1512,1475,102.5,2559,1286,1273,101
'31013, 팔달구,'065003, 62세,2019,2875,1430,1445,99,2426,1210,1216,99.5
'31013, 팔달구,'065004, 63세,2019,2541,1223,1318,92.8,2209,1061,1148,92.4
'31013, 팔달구,'065005, 64세,2019,2651,1263,1388,91,2325,1085,1240,87.5
'31013, 팔달구,'070,65~69세,2019,9095,4320,4775,90.5,8159,3875,4284,90.5
'31013, 팔달구,'070001, 65세,2019,2225,1068,1157,92.3,1945,936,1009,92.8
'31013, 팔달구,'070002, 66세,2019,1815,841,974,86.3,1623,752,871,86.3
'31013, 팔달구,'070003, 67세,2019,2085,995,1090,91.3,1905,907,998,90.9
'31013, 팔달구,'070004, 68세,2019,1410,672,738,91.1,1252,597,655,91.1
'31013, 팔달구,'070005, 69세,2019,1560,744,816,91.2,1434,683,751,90.9
'31013, 팔달구,'075,70~74세,2019,6638,3057,3581,85.4,6305,2898,3407,85.1
'31013, 팔달구,'075001, 70세,2019,1484,708,776,91.2,1369,654,715,91.5
'31013, 팔달구,'075002, 71세,2019,1506,697,809,86.2,1429,655,774,84.6
'31013, 팔달구,'075003, 72세,2019,1468,633,835,75.8,1399,601,798,75.3
'31013, 팔달구,'075004, 73세,2019,1110,517,593,87.2,1069,501,568,88.2
'31013, 팔달구,'075005, 74세,2019,1070,502,568,88.4,1039,487,552,88.2
'31013, 팔달구,'080,75~79세,2019,5155,2147,3008,71.4,5003,2111,2892,73
'31013, 팔달구,'080001, 75세,2019,1100,463,637,72.7,1058,454,604,75.2
'31013, 팔달구,'080002, 76세,2019,1063,455,608,74.8,1039,448,591,75.8
'31013, 팔달구,'080003, 77세,2019,1208,524,684,76.6,1182,521,661,78.8
'31013, 팔달구,'080004, 78세,2019,959,380,579,65.6,929,374,555,67.4
'31013, 팔달구,'080005, 79세,2019,825,325,500,65,795,314,481,65.3
'31013, 팔달구,'085,80~84세,2019,3191,1190,2001,59.5,3108,1168,1940,60.2
'31013, 팔달구,'085001, 80세,2019,809,329,480,68.5,784,322,462,69.7
'31013, 팔달구,'085002, 81세,2019,695,278,417,66.7,675,269,406,66.3
'31013, 팔달구,'085003, 82세,2019,615,220,395,55.7,601,218,383,56.9
'31013, 팔달구,'085004, 83세,2019,582,184,398,46.2,566,180,386,46.6
'31013, 팔달구,'085005, 84세,2019,490,179,311,57.6,482,179,303,59.1
'31013, 팔달구,'086,85세이상,2019,1990,533,1457,36.6,1956,527,1429,36.9
'31013, 팔달구,'090,85~89세,2019,1361,398,963,41.3,1334,394,940,41.9
'31013, 팔달구,'090001, 85세,2019,381,129,252,51.2,373,127,246,51.6
'31013, 팔달구,'090002, 86세,2019,325,99,226,43.8,319,99,220,45
'31013, 팔달구,'090003, 87세,2019,282,77,205,37.6,278,76,202,37.6
'31013, 팔달구,'090004, 88세,2019,204,49,155,31.6,200,48,152,31.6
'31013, 팔달구,'090005, 89세,2019,169,44,125,35.2,164,44,120,36.7
'31013, 팔달구,'095,90~94세,2019,495,99,396,25,491,98,393,24.9
'31013, 팔달구,'095001, 90세,2019,158,33,125,26.4,157,33,124,26.6
'31013, 팔달구,'095002, 91세,2019,122,25,97,25.8,121,25,96,26
'31013, 팔달구,'095003, 92세,2019,99,24,75,32,98,23,75,30.7
'31013, 팔달구,'095004, 93세,2019,66,13,53,24.5,65,13,52,25
'31013, 팔달구,'095005, 94세,2019,50,X,46,8.7,50,X,46,8.7
'31013, 팔달구,'100,95~99세,2019,125,35,90,38.9,122,34,88,38.6
'31013, 팔달구,'100001, 95세,2019,35,10,25,40,35,10,25,40
'31013, 팔달구,'100002, 96세,2019,41,14,27,51.9,41,14,27,51.9
'31013, 팔달구,'100003, 97세,2019,27,9,18,50,26,8,18,44.4
'31013, 팔달구,'100004, 98세,2019,13,X,12,8.3,12,X,11,9.1
'31013, 팔달구,'100005, 99세,2019,9,X,8,12.5,8,X,7,14.3
'31013, 팔달구,'101,100세이상,2019,9,X,8,12.5,9,X,8,12.5
'31013, 팔달구,'102,15세미만,2019,17516,8919,8597,103.7,16385,8356,8029,104.1
'31013, 팔달구,'103,15~64세,2019,145467,75807,69660,108.8,127685,65864,61821,106.5
'31013, 팔달구,'104,65세이상,2019,26069,11247,14822,75.9,24531,10579,13952,75.8
'31013, 팔달구,'126,평균연령,2019,43.1,42.2,44.2,,42.9,41.9,44,
'31013, 팔달구,'127,중위연령,2019,44.3,43,45.5,,43.8,42.4,45.2,
'31014, 영통구,'000,합계,2019,368876,186064,182812,101.8,358893,180796,178097,101.5
'31014, 영통구,'005,0~4세,2019,18073,9371,8702,107.7,17619,9131,8488,107.6
'31014, 영통구,'005001, 0세,2019,3073,1600,1473,108.6,3012,1567,1445,108.4
'31014, 영통구,'005002, 1세,2019,3348,1737,1611,107.8,3250,1680,1570,107
'31014, 영통구,'005003, 2세,2019,3412,1805,1607,112.3,3325,1759,1566,112.3
'31014, 영통구,'005004, 3세,2019,3880,2008,1872,107.3,3772,1954,1818,107.5
'31014, 영통구,'005005, 4세,2019,4360,2221,2139,103.8,4260,2171,2089,103.9
'31014, 영통구,'010,5~9세,2019,21040,10909,10131,107.7,20717,10732,9985,107.5
'31014, 영통구,'010001, 5세,2019,4020,2043,1977,103.3,3945,1997,1948,102.5
'31014, 영통구,'010002, 6세,2019,4095,2126,1969,108,4010,2080,1930,107.8
'31014, 영통구,'010003, 7세,2019,4512,2336,2176,107.4,4446,2307,2139,107.9
'31014, 영통구,'010004, 8세,2019,4269,2212,2057,107.5,4209,2176,2033,107
'31014, 영통구,'010005, 9세,2019,4144,2192,1952,112.3,4107,2172,1935,112.2
'31014, 영통구,'015,10~14세,2019,20266,10397,9869,105.4,20120,10319,9801,105.3
'31014, 영통구,'015001, 10세,2019,3954,2033,1921,105.8,3912,2008,1904,105.5
'31014, 영통구,'015002, 11세,2019,4290,2172,2118,102.5,4258,2150,2108,102
'31014, 영통구,'015003, 12세,2019,4380,2294,2086,110,4352,2278,2074,109.8
'31014, 영통구,'015004, 13세,2019,3875,2003,1872,107,3852,1998,1854,107.8
'31014, 영통구,'015005, 14세,2019,3767,1895,1872,101.2,3746,1885,1861,101.3
'31014, 영통구,'020,15~19세,2019,23047,11774,11273,104.4,22647,11624,11023,105.5
'31014, 영통구,'020001, 15세,2019,4144,2109,2035,103.6,4129,2101,2028,103.6
'31014, 영통구,'020002, 16세,2019,4219,2129,2090,101.9,4204,2122,2082,101.9
'31014, 영통구,'020003, 17세,2019,4217,2122,2095,101.3,4187,2113,2074,101.9
'31014, 영통구,'020004, 18세,2019,4975,2574,2401,107.2,4838,2534,2304,110
'31014, 영통구,'020005, 19세,2019,5492,2840,2652,107.1,5289,2754,2535,108.6
'31014, 영통구,'025,20~24세,2019,27795,14268,13527,105.5,26387,13607,12780,106.5
'31014, 영통구,'025001, 20세,2019,5133,2532,2601,97.3,4863,2413,2450,98.5
'31014, 영통구,'025002, 21세,2019,5329,2714,2615,103.8,5002,2561,2441,104.9
'31014, 영통구,'025003, 22세,2019,5383,2843,2540,111.9,5110,2704,2406,112.4
'31014, 영통구,'025004, 23세,2019,5795,3025,2770,109.2,5535,2893,2642,109.5
'31014, 영통구,'025005, 24세,2019,6155,3154,3001,105.1,5877,3036,2841,106.9
'31014, 영통구,'030,25~29세,2019,32650,17427,15223,114.5,31206,16603,14603,113.7
'31014, 영통구,'030001, 25세,2019,6412,3317,3095,107.2,6140,3162,2978,106.2
'31014, 영통구,'030002, 26세,2019,6756,3588,3168,113.3,6438,3410,3028,112.6
'31014, 영통구,'030003, 27세,2019,6831,3724,3107,119.9,6545,3564,2981,119.6
'31014, 영통구,'030004, 28세,2019,6414,3502,2912,120.3,6130,3335,2795,119.3
'31014, 영통구,'030005, 29세,2019,6237,3296,2941,112.1,5953,3132,2821,111
'31014, 영통구,'035,30~34세,2019,30449,15808,14641,108,29001,15017,13984,107.4
'31014, 영통구,'035001, 30세,2019,6237,3279,2958,110.9,5948,3136,2812,111.5
'31014, 영통구,'035002, 31세,2019,6197,3260,2937,111,5896,3097,2799,110.6
'31014, 영통구,'035003, 32세,2019,5972,3128,2844,110,5691,2969,2722,109.1
'31014, 영통구,'035004, 33세,2019,5920,3068,2852,107.6,5636,2895,2741,105.6
'31014, 영통구,'035005, 34세,2019,6123,3073,3050,100.8,5830,2920,2910,100.3
'31014, 영통구,'040,35~39세,2019,34606,17288,17318,99.8,33517,16663,16854,98.9
'31014, 영통구,'040001, 35세,2019,6048,3065,2983,102.7,5786,2919,2867,101.8
'31014, 영통구,'040002, 36세,2019,6660,3398,3262,104.2,6430,3276,3154,103.9
'31014, 영통구,'040003, 37세,2019,7336,3671,3665,100.2,7103,3529,3574,98.7
'31014, 영통구,'040004, 38세,2019,7345,3626,3719,97.5,7162,3518,3644,96.5
'31014, 영통구,'040005, 39세,2019,7217,3528,3689,95.6,7036,3421,3615,94.6
'31014, 영통구,'045,40~44세,2019,33162,16529,16633,99.4,32417,16072,16345,98.3
'31014, 영통구,'045001, 40세,2019,6975,3459,3516,98.4,6803,3350,3453,97
'31014, 영통구,'045002, 41세,2019,6426,3267,3159,103.4,6280,3179,3101,102.5
'31014, 영통구,'045003, 42세,2019,6736,3300,3436,96,6585,3202,3383,94.6
'31014, 영통구,'045004, 43세,2019,6536,3268,3268,100,6385,3176,3209,99
'31014, 영통구,'045005, 44세,2019,6489,3235,3254,99.4,6364,3165,3199,98.9
'31014, 영통구,'050,45~49세,2019,34386,17028,17358,98.1,33697,16631,17066,97.5
'31014, 영통구,'050001, 45세,2019,6820,3278,3542,92.5,6678,3190,3488,91.5
'31014, 영통구,'050002, 46세,2019,6943,3367,3576,94.2,6809,3293,3516,93.7
'31014, 영통구,'050003, 47세,2019,6816,3413,3403,100.3,6656,3323,3333,99.7
'31014, 영통구,'050004, 48세,2019,7128,3579,3549,100.8,6996,3505,3491,100.4
'31014, 영통구,'050005, 49세,2019,6679,3391,3288,103.1,6558,3320,3238,102.5
'31014, 영통구,'055,50~54세,2019,29068,14368,14700,97.7,28487,14073,14414,97.6
'31014, 영통구,'055001, 50세,2019,6689,3307,3382,97.8,6560,3240,3320,97.6
'31014, 영통구,'055002, 51세,2019,6287,3069,3218,95.4,6172,3010,3162,95.2
'31014, 영통구,'055003, 52세,2019,5551,2728,2823,96.6,5446,2672,2774,96.3
'31014, 영통구,'055004, 53세,2019,5208,2588,2620,98.8,5101,2534,2567,98.7
'31014, 영통구,'055005, 54세,2019,5333,2676,2657,100.7,5208,2617,2591,101
'31014, 영통구,'060,55~59세,2019,23952,12341,11611,106.3,23386,12072,11314,106.7
'31014, 영통구,'060001, 55세,2019,4851,2429,2422,100.3,4738,2374,2364,100.4
'31014, 영통구,'060002, 56세,2019,5014,2597,2417,107.4,4860,2521,2339,107.8
'31014, 영통구,'060003, 57세,2019,4758,2480,2278,108.9,4629,2423,2206,109.8
'31014, 영통구,'060004, 58세,2019,4821,2466,2355,104.7,4743,2430,2313,105.1
'31014, 영통구,'060005, 59세,2019,4508,2369,2139,110.8,4416,2324,2092,111.1
'31014, 영통구,'065,60~64세,2019,15638,8015,7623,105.1,15243,7826,7417,105.5
'31014, 영통구,'065001, 60세,2019,3785,2018,1767,114.2,3712,1980,1732,114.3
'31014, 영통구,'065002, 61세,2019,3473,1781,1692,105.3,3376,1731,1645,105.2
'31014, 영통구,'065003, 62세,2019,3020,1551,1469,105.6,2937,1512,1425,106.1
'31014, 영통구,'065004, 63세,2019,2701,1385,1316,105.2,2629,1347,1282,105.1
'31014, 영통구,'065005, 64세,2019,2659,1280,1379,92.8,2589,1256,1333,94.2
'31014, 영통구,'070,65~69세,2019,8621,4147,4474,92.7,8455,4077,4378,93.1
'31014, 영통구,'070001, 65세,2019,2055,987,1068,92.4,2016,969,1047,92.6
'31014, 영통구,'070002, 66세,2019,1820,860,960,89.6,1784,847,937,90.4
'31014, 영통구,'070003, 67세,2019,1969,957,1012,94.6,1939,941,998,94.3
'31014, 영통구,'070004, 68세,2019,1296,637,659,96.7,1259,626,633,98.9
'31014, 영통구,'070005, 69세,2019,1481,706,775,91.1,1457,694,763,91
'31014, 영통구,'075,70~74세,2019,6167,2844,3323,85.6,6097,2818,3279,85.9
'31014, 영통구,'075001, 70세,2019,1431,669,762,87.8,1412,662,750,88.3
'31014, 영통구,'075002, 71세,2019,1373,629,744,84.5,1356,623,733,85
'31014, 영통구,'075003, 72세,2019,1312,612,700,87.4,1298,605,693,87.3
'31014, 영통구,'075004, 73세,2019,1040,496,544,91.2,1027,492,535,92
'31014, 영통구,'075005, 74세,2019,1011,438,573,76.4,1004,436,568,76.8
'31014, 영통구,'080,75~79세,2019,4696,1895,2801,67.7,4666,1887,2779,67.9
'31014, 영통구,'080001, 75세,2019,955,384,571,67.3,947,380,567,67
'31014, 영통구,'080002, 76세,2019,981,397,584,68,974,396,578,68.5
'31014, 영통구,'080003, 77세,2019,1071,443,628,70.5,1067,442,625,70.7
'31014, 영통구,'080004, 78세,2019,905,348,557,62.5,899,348,551,63.2
'31014, 영통구,'080005, 79세,2019,784,323,461,70.1,779,321,458,70.1
'31014, 영통구,'085,80~84세,2019,3064,1055,2009,52.5,3050,1049,2001,52.4
'31014, 영통구,'085001, 80세,2019,733,271,462,58.7,731,270,461,58.6
'31014, 영통구,'085002, 81세,2019,683,254,429,59.2,680,252,428,58.9
'31014, 영통구,'085003, 82세,2019,609,214,395,54.2,604,212,392,54.1
'31014, 영통구,'085004, 83세,2019,532,162,370,43.8,530,161,369,43.6
'31014, 영통구,'085005, 84세,2019,507,154,353,43.6,505,154,351,43.9
'31014, 영통구,'086,85세이상,2019,2196,600,1596,37.6,2181,595,1586,37.5
'31014, 영통구,'090,85~89세,2019,1522,440,1082,40.7,1508,436,1072,40.7
'31014, 영통구,'090001, 85세,2019,436,140,296,47.3,430,139,291,47.8
'31014, 영통구,'090002, 86세,2019,345,110,235,46.8,343,110,233,47.2
'31014, 영통구,'090003, 87세,2019,298,82,216,38,295,81,214,37.9
'31014, 영통구,'090004, 88세,2019,216,53,163,32.5,215,52,163,31.9
'31014, 영통구,'090005, 89세,2019,227,55,172,32,225,54,171,31.6
'31014, 영통구,'095,90~94세,2019,533,127,406,31.3,533,127,406,31.3
'31014, 영통구,'095001, 90세,2019,173,48,125,38.4,173,48,125,38.4
'31014, 영통구,'095002, 91세,2019,141,28,113,24.8,141,28,113,24.8
'31014, 영통구,'095003, 92세,2019,97,28,69,40.6,97,28,69,40.6
'31014, 영통구,'095004, 93세,2019,72,11,61,18,72,11,61,18
'31014, 영통구,'095005, 94세,2019,50,12,38,31.6,50,12,38,31.6
'31014, 영통구,'100,95~99세,2019,125,29,96,30.2,124,28,96,29.2
'31014, 영통구,'100001, 95세,2019,37,5,32,15.6,37,5,32,15.6
'31014, 영통구,'100002, 96세,2019,35,13,22,59.1,34,12,22,54.5
'31014, 영통구,'100003, 97세,2019,29,6,23,26.1,29,6,23,26.1
'31014, 영통구,'100004, 98세,2019,13,X,10,30,13,X,10,30
'31014, 영통구,'100005, 99세,2019,11,X,9,22.2,11,X,9,22.2
'31014, 영통구,'101,100세이상,2019,16,X,12,33.3,16,X,12,33.3
'31014, 영통구,'102,15세미만,2019,59379,30677,28702,106.9,58456,30182,28274,106.7
'31014, 영통구,'103,15~64세,2019,284753,144846,139907,103.5,275988,140188,135800,103.2
'31014, 영통구,'104,65세이상,2019,24744,10541,14203,74.2,24449,10426,14023,74.3
'31014, 영통구,'126,평균연령,2019,36.4,35.8,37.1,,36.5,35.8,37.2,
'31014, 영통구,'127,중위연령,2019,36.8,36,37.5,,36.9,36.1,37.7,
'31020, 성남시,'000,합계,2019,919895,455369,464526,98,893188,441870,451318,97.9
'31020, 성남시,'005,0~4세,2019,31739,16204,15535,104.3,30963,15832,15131,104.6
'31020, 성남시,'005001, 0세,2019,5666,2845,2821,100.9,5542,2787,2755,101.2
'31020, 성남시,'005002, 1세,2019,5674,2885,2789,103.4,5532,2817,2715,103.8
'31020, 성남시,'005003, 2세,2019,6147,3188,2959,107.7,5983,3113,2870,108.5
'31020, 성남시,'005004, 3세,2019,6904,3518,3386,103.9,6712,3423,3289,104.1
'31020, 성남시,'005005, 4세,2019,7348,3768,3580,105.3,7194,3692,3502,105.4
'31020, 성남시,'010,5~9세,2019,38681,19913,18768,106.1,38210,19664,18546,106
'31020, 성남시,'010001, 5세,2019,7389,3723,3666,101.6,7250,3646,3604,101.2
'31020, 성남시,'010002, 6세,2019,7478,3838,3640,105.4,7385,3791,3594,105.5
'31020, 성남시,'010003, 7세,2019,8038,4229,3809,111,7933,4177,3756,111.2
'31020, 성남시,'010004, 8세,2019,7984,4144,3840,107.9,7913,4105,3808,107.8
'31020, 성남시,'010005, 9세,2019,7792,3979,3813,104.4,7729,3945,3784,104.3
'31020, 성남시,'015,10~14세,2019,39714,20347,19367,105.1,39427,20202,19225,105.1
'31020, 성남시,'015001, 10세,2019,7680,3929,3751,104.7,7617,3892,3725,104.5
'31020, 성남시,'015002, 11세,2019,8077,4130,3947,104.6,8022,4102,3920,104.6
'31020, 성남시,'015003, 12세,2019,8484,4399,4085,107.7,8420,4372,4048,108
'31020, 성남시,'015004, 13세,2019,7753,3941,3812,103.4,7707,3917,3790,103.4
'31020, 성남시,'015005, 14세,2019,7720,3948,3772,104.7,7661,3919,3742,104.7
'31020, 성남시,'020,15~19세,2019,46131,23446,22685,103.4,45567,23160,22407,103.4
'31020, 성남시,'020001, 15세,2019,8647,4454,4193,106.2,8587,4423,4164,106.2
'31020, 성남시,'020002, 16세,2019,8451,4351,4100,106.1,8411,4330,4081,106.1
'31020, 성남시,'020003, 17세,2019,8552,4374,4178,104.7,8503,4351,4152,104.8
'31020, 성남시,'020004, 18세,2019,9785,4955,4830,102.6,9672,4905,4767,102.9
'31020, 성남시,'020005, 19세,2019,10696,5312,5384,98.7,10394,5151,5243,98.2
'31020, 성남시,'025,20~24세,2019,56635,28999,27636,104.9,54552,27877,26675,104.5
'31020, 성남시,'025001, 20세,2019,10209,5222,4987,104.7,9839,5014,4825,103.9
'31020, 성남시,'025002, 21세,2019,10770,5702,5068,112.5,10375,5469,4906,111.5
'31020, 성남시,'025003, 22세,2019,11224,5792,5432,106.6,10823,5579,5244,106.4
'31020, 성남시,'025004, 23세,2019,11927,6041,5886,102.6,11473,5807,5666,102.5
'31020, 성남시,'025005, 24세,2019,12505,6242,6263,99.7,12042,6008,6034,99.6
'31020, 성남시,'030,25~29세,2019,68939,35527,33412,106.3,66347,34213,32134,106.5
'31020, 성남시,'030001, 25세,2019,13475,6810,6665,102.2,12999,6566,6433,102.1
'31020, 성남시,'030002, 26세,2019,13765,7184,6581,109.2,13229,6901,6328,109.1
'31020, 성남시,'030003, 27세,2019,14488,7524,6964,108,13983,7279,6704,108.6
'31020, 성남시,'030004, 28세,2019,13996,7204,6792,106.1,13484,6950,6534,106.4
'31020, 성남시,'030005, 29세,2019,13215,6805,6410,106.2,12652,6517,6135,106.2
'31020, 성남시,'035,30~34세,2019,64321,32962,31359,105.1,61329,31426,29903,105.1
'31020, 성남시,'035001, 30세,2019,13071,6752,6319,106.9,12476,6455,6021,107.2
'31020, 성남시,'035002, 31세,2019,12747,6507,6240,104.3,12111,6198,5913,104.8
'31020, 성남시,'035003, 32세,2019,12883,6651,6232,106.7,12239,6300,5939,106.1
'31020, 성남시,'035004, 33세,2019,12646,6429,6217,103.4,12098,6140,5958,103.1
'31020, 성남시,'035005, 34세,2019,12974,6623,6351,104.3,12405,6333,6072,104.3
'31020, 성남시,'040,35~39세,2019,73050,36865,36185,101.9,70699,35564,35135,101.2
'31020, 성남시,'040001, 35세,2019,13077,6670,6407,104.1,12563,6389,6174,103.5
'31020, 성남시,'040002, 36세,2019,14189,7161,7028,101.9,13731,6917,6814,101.5
'31020, 성남시,'040003, 37세,2019,15192,7721,7471,103.3,14659,7436,7223,102.9
'31020, 성남시,'040004, 38세,2019,15103,7634,7469,102.2,14701,7402,7299,101.4
'31020, 성남시,'040005, 39세,2019,15489,7679,7810,98.3,15045,7420,7625,97.3
'31020, 성남시,'045,40~44세,2019,71199,35325,35874,98.5,69194,34211,34983,97.8
'31020, 성남시,'045001, 40세,2019,14818,7329,7489,97.9,14394,7098,7296,97.3
'31020, 성남시,'045002, 41세,2019,13520,6645,6875,96.7,13107,6409,6698,95.7
'31020, 성남시,'045003, 42세,2019,14263,7109,7154,99.4,13861,6892,6969,98.9
'31020, 성남시,'045004, 43세,2019,13940,7029,6911,101.7,13567,6821,6746,101.1
'31020, 성남시,'045005, 44세,2019,14658,7213,7445,96.9,14265,6991,7274,96.1
'31020, 성남시,'050,45~49세,2019,85453,42610,42843,99.5,82803,41211,41592,99.1
'31020, 성남시,'050001, 45세,2019,16048,7908,8140,97.1,15625,7681,7944,96.7
'31020, 성남시,'050002, 46세,2019,16507,8034,8473,94.8,16046,7801,8245,94.6
'31020, 성남시,'050003, 47세,2019,17072,8477,8595,98.6,16537,8190,8347,98.1
'31020, 성남시,'050004, 48세,2019,18271,9262,9009,102.8,17648,8922,8726,102.2
'31020, 성남시,'050005, 49세,2019,17555,8929,8626,103.5,16947,8617,8330,103.4
'31020, 성남시,'055,50~54세,2019,79566,39521,40045,98.7,76550,38049,38501,98.8
'31020, 성남시,'055001, 50세,2019,17420,8596,8824,97.4,16801,8288,8513,97.4
'31020, 성남시,'055002, 51세,2019,16612,8168,8444,96.7,16015,7878,8137,96.8
'31020, 성남시,'055003, 52세,2019,15456,7675,7781,98.6,14900,7400,7500,98.7
'31020, 성남시,'055004, 53세,2019,14855,7537,7318,103,14254,7251,7003,103.5
'31020, 성남시,'055005, 54세,2019,15223,7545,7678,98.3,14580,7232,7348,98.4
'31020, 성남시,'060,55~59세,2019,77333,37944,39389,96.3,74369,36574,37795,96.8
'31020, 성남시,'060001, 55세,2019,14566,7167,7399,96.9,13949,6892,7057,97.7
'31020, 성남시,'060002, 56세,2019,15527,7734,7793,99.2,14705,7348,7357,99.9
'31020, 성남시,'060003, 57세,2019,14969,7410,7559,98,14351,7117,7234,98.4
'31020, 성남시,'060004, 58세,2019,16185,7785,8400,92.7,15833,7620,8213,92.8
'31020, 성남시,'060005, 59세,2019,16086,7848,8238,95.3,15531,7597,7934,95.8
'31020, 성남시,'065,60~64세,2019,64629,32035,32594,98.3,62455,30976,31479,98.4
'31020, 성남시,'065001, 60세,2019,14322,7030,7292,96.4,13891,6833,7058,96.8
'31020, 성남시,'065002, 61세,2019,13469,6883,6586,104.5,12983,6638,6345,104.6
'31020, 성남시,'065003, 62세,2019,13167,6563,6604,99.4,12679,6332,6347,99.8
'31020, 성남시,'065004, 63세,2019,11731,5734,5997,95.6,11301,5522,5779,95.6
'31020, 성남시,'065005, 64세,2019,11940,5825,6115,95.3,11601,5651,5950,95
'31020, 성남시,'070,65~69세,2019,41024,19704,21320,92.4,39978,19215,20763,92.5
'31020, 성남시,'070001, 65세,2019,9820,4707,5113,92.1,9529,4567,4962,92
'31020, 성남시,'070002, 66세,2019,8633,4170,4463,93.4,8415,4064,4351,93.4
'31020, 성남시,'070003, 67세,2019,9186,4459,4727,94.3,8958,4357,4601,94.7
'31020, 성남시,'070004, 68세,2019,6384,3017,3367,89.6,6212,2948,3264,90.3
'31020, 성남시,'070005, 69세,2019,7001,3351,3650,91.8,6864,3279,3585,91.5
'31020, 성남시,'075,70~74세,2019,31546,14468,17078,84.7,31167,14300,16867,84.8
'31020, 성남시,'075001, 70세,2019,7219,3371,3848,87.6,7078,3309,3769,87.8
'31020, 성남시,'075002, 71세,2019,6847,3179,3668,86.7,6763,3138,3625,86.6
'31020, 성남시,'075003, 72세,2019,7069,3263,3806,85.7,7019,3241,3778,85.8
'31020, 성남시,'075004, 73세,2019,5301,2364,2937,80.5,5244,2341,2903,80.6
'31020, 성남시,'075005, 74세,2019,5110,2291,2819,81.3,5063,2271,2792,81.3
'31020, 성남시,'080,75~79세,2019,23896,10525,13371,78.7,23719,10465,13254,79
'31020, 성남시,'080001, 75세,2019,4976,2217,2759,80.4,4933,2203,2730,80.7
'31020, 성남시,'080002, 76세,2019,4952,2197,2755,79.7,4918,2189,2729,80.2
'31020, 성남시,'080003, 77세,2019,5637,2529,3108,81.4,5601,2513,3088,81.4
'31020, 성남시,'080004, 78세,2019,4351,1919,2432,78.9,4312,1905,2407,79.1
'31020, 성남시,'080005, 79세,2019,3980,1663,2317,71.8,3955,1655,2300,72
'31020, 성남시,'085,80~84세,2019,15327,5922,9405,63,15217,5898,9319,63.3
'31020, 성남시,'085001, 80세,2019,3818,1552,2266,68.5,3790,1549,2241,69.1
'31020, 성남시,'085002, 81세,2019,3363,1343,2020,66.5,3338,1339,1999,67
'31020, 성남시,'085003, 82세,2019,3038,1156,1882,61.4,3016,1149,1867,61.5
'31020, 성남시,'085004, 83세,2019,2683,1024,1659,61.7,2666,1018,1648,61.8
'31020, 성남시,'085005, 84세,2019,2425,847,1578,53.7,2407,843,1564,53.9
'31020, 성남시,'086,85세이상,2019,10712,3052,7660,39.8,10642,3033,7609,39.9
'31020, 성남시,'090,85~89세,2019,7262,2208,5054,43.7,7226,2198,5028,43.7
'31020, 성남시,'090001, 85세,2019,2002,659,1343,49.1,1990,655,1335,49.1
'31020, 성남시,'090002, 86세,2019,1633,502,1131,44.4,1626,499,1127,44.3
'31020, 성남시,'090003, 87세,2019,1436,424,1012,41.9,1428,422,1006,41.9
'31020, 성남시,'090004, 88세,2019,1102,316,786,40.2,1097,315,782,40.3
'31020, 성남시,'090005, 89세,2019,1089,307,782,39.3,1085,307,778,39.5
'31020, 성남시,'095,90~94세,2019,2750,676,2074,32.6,2729,671,2058,32.6
'31020, 성남시,'095001, 90세,2019,911,251,660,38,903,250,653,38.3
'31020, 성남시,'095002, 91세,2019,702,188,514,36.6,699,187,512,36.5
'31020, 성남시,'095003, 92세,2019,539,126,413,30.5,535,126,409,30.8
'31020, 성남시,'095004, 93세,2019,317,66,251,26.3,314,65,249,26.1
'31020, 성남시,'095005, 94세,2019,281,45,236,19.1,278,43,235,18.3
'31020, 성남시,'100,95~99세,2019,627,150,477,31.4,618,148,470,31.5
'31020, 성남시,'100001, 95세,2019,197,48,149,32.2,195,48,147,32.7
'31020, 성남시,'100002, 96세,2019,168,40,128,31.3,166,40,126,31.7
'31020, 성남시,'100003, 97세,2019,140,29,111,26.1,138,28,110,25.5
'31020, 성남시,'100004, 98세,2019,73,17,56,30.4,73,17,56,30.4
'31020, 성남시,'100005, 99세,2019,49,16,33,48.5,46,15,31,48.4
'31020, 성남시,'101,100세이상,2019,73,18,55,32.7,69,16,53,30.2
'31020, 성남시,'102,15세미만,2019,110134,56464,53670,105.2,108600,55698,52902,105.3
'31020, 성남시,'103,15~64세,2019,687256,345234,342022,100.9,663865,333261,330604,100.8
'31020, 성남시,'104,65세이상,2019,122505,53671,68834,78,120723,52911,67812,78
'31020, 성남시,'126,평균연령,2019,41.9,41,42.8,,41.9,41,42.8,
'31020, 성남시,'127,중위연령,2019,42.9,41.9,43.8,,42.9,41.9,43.8,
'31021, 수정구,'000,합계,2019,241256,121729,119527,101.8,225627,113783,111844,101.7
'31021, 수정구,'005,0~4세,2019,7870,3946,3924,100.6,7463,3760,3703,101.5
'31021, 수정구,'005001, 0세,2019,1463,713,750,95.1,1379,673,706,95.3
'31021, 수정구,'005002, 1세,2019,1466,750,716,104.7,1381,712,669,106.4
'31021, 수정구,'005003, 2세,2019,1535,780,755,103.3,1454,748,706,105.9
'31021, 수정구,'005004, 3세,2019,1697,868,829,104.7,1611,824,787,104.7
'31021, 수정구,'005005, 4세,2019,1709,835,874,95.5,1638,803,835,96.2
'31021, 수정구,'010,5~9세,2019,8446,4284,4162,102.9,8201,4164,4037,103.1
'31021, 수정구,'010001, 5세,2019,1730,877,853,102.8,1650,834,816,102.2
'31021, 수정구,'010002, 6세,2019,1613,825,788,104.7,1561,803,758,105.9
'31021, 수정구,'010003, 7세,2019,1675,854,821,104,1622,831,791,105.1
'31021, 수정구,'010004, 8세,2019,1733,880,853,103.2,1698,860,838,102.6
'31021, 수정구,'010005, 9세,2019,1695,848,847,100.1,1670,836,834,100.2
'31021, 수정구,'015,10~14세,2019,7798,3980,3818,104.2,7644,3921,3723,105.3
'31021, 수정구,'015001, 10세,2019,1502,776,726,106.9,1464,757,707,107.1
'31021, 수정구,'015002, 11세,2019,1613,826,787,105,1583,813,770,105.6
'31021, 수정구,'015003, 12세,2019,1708,873,835,104.6,1673,862,811,106.3
'31021, 수정구,'015004, 13세,2019,1460,735,725,101.4,1437,729,708,103
'31021, 수정구,'015005, 14세,2019,1515,770,745,103.4,1487,760,727,104.5
'31021, 수정구,'020,15~19세,2019,10260,5263,4997,105.3,9901,5088,4813,105.7
'31021, 수정구,'020001, 15세,2019,1697,908,789,115.1,1663,891,772,115.4
'31021, 수정구,'020002, 16세,2019,1681,845,836,101.1,1667,838,829,101.1
'31021, 수정구,'020003, 17세,2019,1698,888,810,109.6,1674,876,798,109.8
'31021, 수정구,'020004, 18세,2019,2172,1120,1052,106.5,2089,1086,1003,108.3
'31021, 수정구,'020005, 19세,2019,3012,1502,1510,99.5,2808,1397,1411,99
'31021, 수정구,'025,20~24세,2019,16724,8500,8224,103.4,15465,7847,7618,103
'31021, 수정구,'025001, 20세,2019,3045,1492,1553,96.1,2788,1353,1435,94.3
'31021, 수정구,'025002, 21세,2019,3136,1565,1571,99.6,2873,1414,1459,96.9
'31021, 수정구,'025003, 22세,2019,3407,1677,1730,96.9,3165,1563,1602,97.6
'31021, 수정구,'025004, 23세,2019,3521,1839,1682,109.3,3260,1712,1548,110.6
'31021, 수정구,'025005, 24세,2019,3615,1927,1688,114.2,3379,1805,1574,114.7
'31021, 수정구,'030,25~29세,2019,18917,10130,8787,115.3,17738,9528,8210,116.1
'31021, 수정구,'030001, 25세,2019,3808,2042,1766,115.6,3591,1928,1663,115.9
'31021, 수정구,'030002, 26세,2019,3877,2058,1819,113.1,3619,1926,1693,113.8
'31021, 수정구,'030003, 27세,2019,3949,2094,1855,112.9,3737,1985,1752,113.3
'31021, 수정구,'030004, 28세,2019,3786,2039,1747,116.7,3540,1918,1622,118.2
'31021, 수정구,'030005, 29세,2019,3497,1897,1600,118.6,3251,1771,1480,119.7
'31021, 수정구,'035,30~34세,2019,17028,9164,7864,116.5,15587,8413,7174,117.3
'31021, 수정구,'035001, 30세,2019,3416,1841,1575,116.9,3137,1696,1441,117.7
'31021, 수정구,'035002, 31세,2019,3358,1772,1586,111.7,3053,1623,1430,113.5
'31021, 수정구,'035003, 32세,2019,3427,1865,1562,119.4,3113,1692,1421,119.1
'31021, 수정구,'035004, 33세,2019,3348,1834,1514,121.1,3075,1683,1392,120.9
'31021, 수정구,'035005, 34세,2019,3479,1852,1627,113.8,3209,1719,1490,115.4
'31021, 수정구,'040,35~39세,2019,19136,10182,8954,113.7,17989,9523,8466,112.5
'31021, 수정구,'040001, 35세,2019,3423,1846,1577,117.1,3170,1703,1467,116.1
'31021, 수정구,'040002, 36세,2019,3724,1957,1767,110.8,3515,1836,1679,109.4
'31021, 수정구,'040003, 37세,2019,4040,2134,1906,112,3774,1990,1784,111.5
'31021, 수정구,'040004, 38세,2019,4000,2165,1835,118,3806,2051,1755,116.9
'31021, 수정구,'040005, 39세,2019,3949,2080,1869,111.3,3724,1943,1781,109.1
'31021, 수정구,'045,40~44세,2019,17672,9482,8190,115.8,16606,8851,7755,114.1
'31021, 수정구,'045001, 40세,2019,3758,2004,1754,114.3,3541,1872,1669,112.2
'31021, 수정구,'045002, 41세,2019,3385,1788,1597,112,3177,1672,1505,111.1
'31021, 수정구,'045003, 42세,2019,3609,1956,1653,118.3,3394,1832,1562,117.3
'31021, 수정구,'045004, 43세,2019,3332,1829,1503,121.7,3130,1705,1425,119.6
'31021, 수정구,'045005, 44세,2019,3588,1905,1683,113.2,3364,1770,1594,111
'31021, 수정구,'050,45~49세,2019,20402,10760,9642,111.6,18781,9889,8892,111.2
'31021, 수정구,'050001, 45세,2019,3726,2021,1705,118.5,3500,1889,1611,117.3
'31021, 수정구,'050002, 46세,2019,3923,1996,1927,103.6,3671,1867,1804,103.5
'31021, 수정구,'050003, 47세,2019,4092,2210,1882,117.4,3760,2035,1725,118
'31021, 수정구,'050004, 48세,2019,4397,2326,2071,112.3,3978,2090,1888,110.7
'31021, 수정구,'050005, 49세,2019,4264,2207,2057,107.3,3872,2008,1864,107.7
'31021, 수정구,'055,50~54세,2019,20717,10446,10271,101.7,18734,9478,9256,102.4
'31021, 수정구,'055001, 50세,2019,4252,2150,2102,102.3,3864,1958,1906,102.7
'31021, 수정구,'055002, 51세,2019,4228,2163,2065,104.7,3843,1969,1874,105.1
'31021, 수정구,'055003, 52세,2019,4047,2035,2012,101.1,3689,1853,1836,100.9
'31021, 수정구,'055004, 53세,2019,4057,2064,1993,103.6,3647,1873,1774,105.6
'31021, 수정구,'055005, 54세,2019,4133,2034,2099,96.9,3691,1825,1866,97.8
'31021, 수정구,'060,55~59세,2019,22129,11010,11119,99,20052,10008,10044,99.6
'31021, 수정구,'060001, 55세,2019,4133,2075,2058,100.8,3697,1871,1826,102.5
'31021, 수정구,'060002, 56세,2019,4494,2287,2207,103.6,3894,1995,1899,105.1
'31021, 수정구,'060003, 57세,2019,4260,2169,2091,103.7,3835,1957,1878,104.2
'31021, 수정구,'060004, 58세,2019,4516,2209,2307,95.8,4291,2097,2194,95.6
'31021, 수정구,'060005, 59세,2019,4726,2270,2456,92.4,4335,2088,2247,92.9
'31021, 수정구,'065,60~64세,2019,18972,9267,9705,95.5,17470,8518,8952,95.2
'31021, 수정구,'065001, 60세,2019,4134,2031,2103,96.6,3850,1904,1946,97.8
'31021, 수정구,'065002, 61세,2019,3936,1972,1964,100.4,3607,1796,1811,99.2
'31021, 수정구,'065003, 62세,2019,3848,1842,2006,91.8,3499,1670,1829,91.3
'31021, 수정구,'065004, 63세,2019,3522,1706,1816,93.9,3219,1558,1661,93.8
'31021, 수정구,'065005, 64세,2019,3532,1716,1816,94.5,3295,1590,1705,93.3
'31021, 수정구,'070,65~69세,2019,12626,5984,6642,90.1,11885,5628,6257,89.9
'31021, 수정구,'070001, 65세,2019,3043,1425,1618,88.1,2837,1327,1510,87.9
'31021, 수정구,'070002, 66세,2019,2658,1278,1380,92.6,2501,1200,1301,92.2
'31021, 수정구,'070003, 67세,2019,2802,1333,1469,90.7,2641,1256,1385,90.7
'31021, 수정구,'070004, 68세,2019,2006,944,1062,88.9,1877,886,991,89.4
'31021, 수정구,'070005, 69세,2019,2117,1004,1113,90.2,2029,959,1070,89.6
'31021, 수정구,'075,70~74세,2019,9341,4281,5060,84.6,9097,4166,4931,84.5
'31021, 수정구,'075001, 70세,2019,2199,1021,1178,86.7,2111,983,1128,87.1
'31021, 수정구,'075002, 71세,2019,2077,980,1097,89.3,2021,948,1073,88.4
'31021, 수정구,'075003, 72세,2019,2049,945,1104,85.6,2013,926,1087,85.2
'31021, 수정구,'075004, 73세,2019,1562,700,862,81.2,1527,686,841,81.6
'31021, 수정구,'075005, 74세,2019,1454,635,819,77.5,1425,623,802,77.7
'31021, 수정구,'080,75~79세,2019,6849,2975,3874,76.8,6746,2945,3801,77.5
'31021, 수정구,'080001, 75세,2019,1436,645,791,81.5,1409,635,774,82
'31021, 수정구,'080002, 76세,2019,1455,617,838,73.6,1435,613,822,74.6
'31021, 수정구,'080003, 77세,2019,1656,738,918,80.4,1635,731,904,80.9
'31021, 수정구,'080004, 78세,2019,1204,513,691,74.2,1183,508,675,75.3
'31021, 수정구,'080005, 79세,2019,1098,462,636,72.6,1084,458,626,73.2
'31021, 수정구,'085,80~84세,2019,3953,1474,2479,59.5,3884,1463,2421,60.4
'31021, 수정구,'085001, 80세,2019,1071,421,650,64.8,1056,421,635,66.3
'31021, 수정구,'085002, 81세,2019,894,350,544,64.3,875,348,527,66
'31021, 수정구,'085003, 82세,2019,712,278,434,64.1,702,275,427,64.4
'31021, 수정구,'085004, 83세,2019,670,234,436,53.7,656,229,427,53.6
'31021, 수정구,'085005, 84세,2019,606,191,415,46,595,190,405,46.9
'31021, 수정구,'086,85세이상,2019,2416,601,1815,33.1,2384,593,1791,33.1
'31021, 수정구,'090,85~89세,2019,1645,452,1193,37.9,1625,447,1178,37.9
'31021, 수정구,'090001, 85세,2019,478,147,331,44.4,469,144,325,44.3
'31021, 수정구,'090002, 86세,2019,396,113,283,39.9,393,112,281,39.9
'31021, 수정구,'090003, 87세,2019,307,79,228,34.6,302,78,224,34.8
'31021, 수정구,'090004, 88세,2019,222,55,167,32.9,220,55,165,33.3
'31021, 수정구,'090005, 89세,2019,242,58,184,31.5,241,58,183,31.7
'31021, 수정구,'095,90~94세,2019,620,125,495,25.3,611,124,487,25.5
'31021, 수정구,'095001, 90세,2019,211,40,171,23.4,207,40,167,24
'31021, 수정구,'095002, 91세,2019,144,35,109,32.1,143,34,109,31.2
'31021, 수정구,'095003, 92세,2019,121,27,94,28.7,119,27,92,29.3
'31021, 수정구,'095004, 93세,2019,79,13,66,19.7,77,13,64,20.3
'31021, 수정구,'095005, 94세,2019,65,10,55,18.2,65,10,55,18.2
'31021, 수정구,'100,95~99세,2019,138,21,117,17.9,136,20,116,17.2
'31021, 수정구,'100001, 95세,2019,42,9,33,27.3,42,9,33,27.3
'31021, 수정구,'100002, 96세,2019,43,X,39,10.3,43,X,39,10.3
'31021, 수정구,'100003, 97세,2019,25,X,23,8.7,24,X,23,4.3
'31021, 수정구,'100004, 98세,2019,16,X,13,23.1,16,X,13,23.1
'31021, 수정구,'100005, 99세,2019,12,X,9,33.3,11,X,8,37.5
'31021, 수정구,'101,100세이상,2019,13,X,10,30,12,X,10,20
'31021, 수정구,'102,15세미만,2019,24114,12210,11904,102.6,23308,11845,11463,103.3
'31021, 수정구,'103,15~64세,2019,181957,94204,87753,107.4,168323,87143,81180,107.3
'31021, 수정구,'104,65세이상,2019,35185,15315,19870,77.1,33996,14795,19201,77.1
'31021, 수정구,'126,평균연령,2019,43.1,42.1,44.1,,43,42,44.1,
'31021, 수정구,'127,중위연령,2019,44.1,42.8,45.5,,43.9,42.6,45.3,
'31022, 중원구,'000,합계,2019,216005,108919,107086,101.7,211236,106644,104592,102
'31022, 중원구,'005,0~4세,2019,6629,3401,3228,105.4,6562,3367,3195,105.4
'31022, 중원구,'005001, 0세,2019,1183,584,599,97.5,1171,580,591,98.1
'31022, 중원구,'005002, 1세,2019,1208,606,602,100.7,1194,597,597,100
'31022, 중원구,'005003, 2세,2019,1319,714,605,118,1307,709,598,118.6
'31022, 중원구,'005004, 3세,2019,1400,701,699,100.3,1385,692,693,99.9
'31022, 중원구,'005005, 4세,2019,1519,796,723,110.1,1505,789,716,110.2
'31022, 중원구,'010,5~9세,2019,7480,3898,3582,108.8,7426,3871,3555,108.9
'31022, 중원구,'010001, 5세,2019,1442,730,712,102.5,1428,723,705,102.6
'31022, 중원구,'010002, 6세,2019,1433,737,696,105.9,1422,730,692,105.5
'31022, 중원구,'010003, 7세,2019,1575,838,737,113.7,1561,830,731,113.5
'31022, 중원구,'010004, 8세,2019,1552,829,723,114.7,1545,827,718,115.2
'31022, 중원구,'010005, 9세,2019,1478,764,714,107,1470,761,709,107.3
'31022, 중원구,'015,10~14세,2019,7678,3884,3794,102.4,7641,3864,3777,102.3
'31022, 중원구,'015001, 10세,2019,1484,716,768,93.2,1479,712,767,92.8
'31022, 중원구,'015002, 11세,2019,1539,829,710,116.8,1532,826,706,117
'31022, 중원구,'015003, 12세,2019,1664,826,838,98.6,1656,824,832,99
'31022, 중원구,'015004, 13세,2019,1473,756,717,105.4,1467,752,715,105.2
'31022, 중원구,'015005, 14세,2019,1518,757,761,99.5,1507,750,757,99.1
'31022, 중원구,'020,15~19세,2019,9547,4900,4647,105.4,9497,4873,4624,105.4
'31022, 중원구,'020001, 15세,2019,1656,874,782,111.8,1648,870,778,111.8
'31022, 중원구,'020002, 16세,2019,1691,919,772,119,1685,916,769,119.1
'31022, 중원구,'020003, 17세,2019,1748,886,862,102.8,1746,886,860,103
'31022, 중원구,'020004, 18세,2019,2108,1093,1015,107.7,2097,1085,1012,107.2
'31022, 중원구,'020005, 19세,2019,2344,1128,1216,92.8,2321,1116,1205,92.6
'31022, 중원구,'025,20~24세,2019,13619,6988,6631,105.4,13354,6871,6483,106
'31022, 중원구,'025001, 20세,2019,2359,1189,1170,101.6,2336,1184,1152,102.8
'31022, 중원구,'025002, 21세,2019,2474,1301,1173,110.9,2427,1279,1148,111.4
'31022, 중원구,'025003, 22세,2019,2652,1350,1302,103.7,2600,1323,1277,103.6
'31022, 중원구,'025004, 23세,2019,2930,1506,1424,105.8,2874,1480,1394,106.2
'31022, 중원구,'025005, 24세,2019,3204,1642,1562,105.1,3117,1605,1512,106.2
'31022, 중원구,'030,25~29세,2019,17122,9066,8056,112.5,16641,8835,7806,113.2
'31022, 중원구,'030001, 25세,2019,3340,1694,1646,102.9,3267,1663,1604,103.7
'31022, 중원구,'030002, 26세,2019,3495,1881,1614,116.5,3405,1831,1574,116.3
'31022, 중원구,'030003, 27세,2019,3613,1943,1670,116.3,3506,1893,1613,117.4
'31022, 중원구,'030004, 28세,2019,3431,1813,1618,112.1,3350,1773,1577,112.4
'31022, 중원구,'030005, 29세,2019,3243,1735,1508,115.1,3113,1675,1438,116.5
'31022, 중원구,'035,30~34세,2019,15025,8069,6956,116,14438,7798,6640,117.4
'31022, 중원구,'035001, 30세,2019,3130,1664,1466,113.5,3028,1627,1401,116.1
'31022, 중원구,'035002, 31세,2019,2989,1620,1369,118.3,2846,1558,1288,121
'31022, 중원구,'035003, 32세,2019,3085,1701,1384,122.9,2951,1626,1325,122.7
'31022, 중원구,'035004, 33세,2019,2870,1530,1340,114.2,2764,1479,1285,115.1
'31022, 중원구,'035005, 34세,2019,2951,1554,1397,111.2,2849,1508,1341,112.5
'31022, 중원구,'040,35~39세,2019,16885,8932,7953,112.3,16395,8706,7689,113.2
'31022, 중원구,'040001, 35세,2019,3125,1627,1498,108.6,3022,1586,1436,110.4
'31022, 중원구,'040002, 36세,2019,3402,1828,1574,116.1,3298,1780,1518,117.3
'31022, 중원구,'040003, 37세,2019,3502,1876,1626,115.4,3389,1819,1570,115.9
'31022, 중원구,'040004, 38세,2019,3380,1766,1614,109.4,3297,1726,1571,109.9
'31022, 중원구,'040005, 39세,2019,3476,1835,1641,111.8,3389,1795,1594,112.6
'31022, 중원구,'045,40~44세,2019,15362,8112,7250,111.9,14956,7912,7044,112.3
'31022, 중원구,'045001, 40세,2019,3329,1734,1595,108.7,3245,1698,1547,109.8
'31022, 중원구,'045002, 41세,2019,2987,1602,1385,115.7,2901,1551,1350,114.9
'31022, 중원구,'045003, 42세,2019,3044,1613,1431,112.7,2961,1574,1387,113.5
'31022, 중원구,'045004, 43세,2019,2913,1578,1335,118.2,2837,1540,1297,118.7
'31022, 중원구,'045005, 44세,2019,3089,1585,1504,105.4,3012,1549,1463,105.9
'31022, 중원구,'050,45~49세,2019,18461,9662,8799,109.8,17968,9419,8549,110.2
'31022, 중원구,'050001, 45세,2019,3488,1819,1669,109,3402,1774,1628,109
'31022, 중원구,'050002, 46세,2019,3578,1847,1731,106.7,3477,1807,1670,108.2
'31022, 중원구,'050003, 47세,2019,3715,1966,1749,112.4,3619,1915,1704,112.4
'31022, 중원구,'050004, 48세,2019,3886,2056,1830,112.3,3790,2011,1779,113
'31022, 중원구,'050005, 49세,2019,3794,1974,1820,108.5,3680,1912,1768,108.1
'31022, 중원구,'055,50~54세,2019,19338,9659,9679,99.8,18755,9369,9386,99.8
'31022, 중원구,'055001, 50세,2019,3950,1957,1993,98.2,3826,1896,1930,98.2
'31022, 중원구,'055002, 51세,2019,3934,1968,1966,100.1,3817,1918,1899,101
'31022, 중원구,'055003, 52세,2019,3824,1906,1918,99.4,3717,1851,1866,99.2
'31022, 중원구,'055004, 53세,2019,3766,1884,1882,100.1,3651,1826,1825,100.1
'31022, 중원구,'055005, 54세,2019,3864,1944,1920,101.3,3744,1878,1866,100.6
'31022, 중원구,'060,55~59세,2019,20302,9935,10367,95.8,19784,9701,10083,96.2
'31022, 중원구,'060001, 55세,2019,3580,1727,1853,93.2,3462,1680,1782,94.3
'31022, 중원구,'060002, 56세,2019,3871,1957,1914,102.2,3740,1899,1841,103.2
'31022, 중원구,'060003, 57세,2019,4020,1979,2041,97,3916,1929,1987,97.1
'31022, 중원구,'060004, 58세,2019,4382,2042,2340,87.3,4325,2013,2312,87.1
'31022, 중원구,'060005, 59세,2019,4449,2230,2219,100.5,4341,2180,2161,100.9
'31022, 중원구,'065,60~64세,2019,17297,8625,8672,99.5,16903,8421,8482,99.3
'31022, 중원구,'065001, 60세,2019,3809,1882,1927,97.7,3722,1841,1881,97.9
'31022, 중원구,'065002, 61세,2019,3634,1860,1774,104.8,3539,1810,1729,104.7
'31022, 중원구,'065003, 62세,2019,3537,1814,1723,105.3,3456,1772,1684,105.2
'31022, 중원구,'065004, 63세,2019,3112,1540,1572,98,3036,1495,1541,97
'31022, 중원구,'065005, 64세,2019,3205,1529,1676,91.2,3150,1503,1647,91.3
'31022, 중원구,'070,65~69세,2019,11068,5369,5699,94.2,10878,5277,5601,94.2
'31022, 중원구,'070001, 65세,2019,2612,1280,1332,96.1,2567,1258,1309,96.1
'31022, 중원구,'070002, 66세,2019,2242,1091,1151,94.8,2204,1069,1135,94.2
'31022, 중원구,'070003, 67세,2019,2531,1231,1300,94.7,2481,1212,1269,95.5
'31022, 중원구,'070004, 68세,2019,1777,827,950,87.1,1749,819,930,88.1
'31022, 중원구,'070005, 69세,2019,1906,940,966,97.3,1877,919,958,95.9
'31022, 중원구,'075,70~74세,2019,8316,3932,4384,89.7,8241,3900,4341,89.8
'31022, 중원구,'075001, 70세,2019,1970,962,1008,95.4,1940,947,993,95.4
'31022, 중원구,'075002, 71세,2019,1811,866,945,91.6,1797,861,936,92
'31022, 중원구,'075003, 72세,2019,1872,879,993,88.5,1865,877,988,88.8
'31022, 중원구,'075004, 73세,2019,1335,614,721,85.2,1322,609,713,85.4
'31022, 중원구,'075005, 74세,2019,1328,611,717,85.2,1317,606,711,85.2
'31022, 중원구,'080,75~79세,2019,6088,2629,3459,76,6045,2612,3433,76.1
'31022, 중원구,'080001, 75세,2019,1276,534,742,72,1269,532,737,72.2
'31022, 중원구,'080002, 76세,2019,1267,581,686,84.7,1259,579,680,85.1
'31022, 중원구,'080003, 77세,2019,1490,644,846,76.1,1480,639,841,76
'31022, 중원구,'080004, 78세,2019,1082,479,603,79.4,1071,474,597,79.4
'31022, 중원구,'080005, 79세,2019,973,391,582,67.2,966,388,578,67.1
'31022, 중원구,'085,80~84세,2019,3552,1311,2241,58.5,3530,1307,2223,58.8
'31022, 중원구,'085001, 80세,2019,911,356,555,64.1,901,354,547,64.7
'31022, 중원구,'085002, 81세,2019,801,299,502,59.6,800,299,501,59.7
'31022, 중원구,'085003, 82세,2019,714,240,474,50.6,708,239,469,51
'31022, 중원구,'085004, 83세,2019,609,242,367,65.9,608,242,366,66.1
'31022, 중원구,'085005, 84세,2019,517,174,343,50.7,513,173,340,50.9
'31022, 중원구,'086,85세이상,2019,2236,547,1689,32.4,2222,541,1681,32.2
'31022, 중원구,'090,85~89세,2019,1538,412,1126,36.6,1532,409,1123,36.4
'31022, 중원구,'090001, 85세,2019,455,147,308,47.7,453,146,307,47.6
'31022, 중원구,'090002, 86세,2019,338,82,256,32,337,81,256,31.6
'31022, 중원구,'090003, 87세,2019,295,82,213,38.5,295,82,213,38.5
'31022, 중원구,'090004, 88세,2019,226,48,178,27,224,47,177,26.6
'31022, 중원구,'090005, 89세,2019,224,53,171,31,223,53,170,31.2
'31022, 중원구,'095,90~94세,2019,549,109,440,24.8,545,107,438,24.4
'31022, 중원구,'095001, 90세,2019,166,42,124,33.9,165,42,123,34.1
'31022, 중원구,'095002, 91세,2019,133,28,105,26.7,133,28,105,26.7
'31022, 중원구,'095003, 92세,2019,111,21,90,23.3,110,21,89,23.6
'31022, 중원구,'095004, 93세,2019,70,12,58,20.7,69,11,58,19
'31022, 중원구,'095005, 94세,2019,69,6,63,9.5,68,5,63,7.9
'31022, 중원구,'100,95~99세,2019,131,23,108,21.3,128,23,105,21.9
'31022, 중원구,'100001, 95세,2019,42,8,34,23.5,40,8,32,25
'31022, 중원구,'100002, 96세,2019,31,6,25,24,31,6,25,24
'31022, 중원구,'100003, 97세,2019,34,5,29,17.2,34,5,29,17.2
'31022, 중원구,'100004, 98세,2019,13,X,12,8.3,13,X,12,8.3
'31022, 중원구,'100005, 99세,2019,11,X,8,37.5,10,X,7,42.9
'31022, 중원구,'101,100세이상,2019,18,X,15,20,17,X,15,13.3
'31022, 중원구,'102,15세미만,2019,21787,11183,10604,105.5,21629,11102,10527,105.5
'31022, 중원구,'103,15~64세,2019,162958,83948,79010,106.2,158691,81905,76786,106.7
'31022, 중원구,'104,65세이상,2019,31260,13788,17472,78.9,30916,13637,17279,78.9
'31022, 중원구,'126,평균연령,2019,43.2,42.3,44.2,,43.2,42.2,44.2,
'31022, 중원구,'127,중위연령,2019,44.6,43.2,45.9,,44.6,43.2,45.9,
'31023, 분당구,'000,합계,2019,462634,224721,237913,94.5,456325,221443,234882,94.3
'31023, 분당구,'005,0~4세,2019,17240,8857,8383,105.7,16938,8705,8233,105.7
'31023, 분당구,'005001, 0세,2019,3020,1548,1472,105.2,2992,1534,1458,105.2
'31023, 분당구,'005002, 1세,2019,3000,1529,1471,103.9,2957,1508,1449,104.1
'31023, 분당구,'005003, 2세,2019,3293,1694,1599,105.9,3222,1656,1566,105.7
'31023, 분당구,'005004, 3세,2019,3807,1949,1858,104.9,3716,1907,1809,105.4
'31023, 분당구,'005005, 4세,2019,4120,2137,1983,107.8,4051,2100,1951,107.6
'31023, 분당구,'010,5~9세,2019,22755,11731,11024,106.4,22583,11629,10954,106.2
'31023, 분당구,'010001, 5세,2019,4217,2116,2101,100.7,4172,2089,2083,100.3
'31023, 분당구,'010002, 6세,2019,4432,2276,2156,105.6,4402,2258,2144,105.3
'31023, 분당구,'010003, 7세,2019,4788,2537,2251,112.7,4750,2516,2234,112.6
'31023, 분당구,'010004, 8세,2019,4699,2435,2264,107.6,4670,2418,2252,107.4
'31023, 분당구,'010005, 9세,2019,4619,2367,2252,105.1,4589,2348,2241,104.8
'31023, 분당구,'015,10~14세,2019,24238,12483,11755,106.2,24142,12417,11725,105.9
'31023, 분당구,'015001, 10세,2019,4694,2437,2257,108,4674,2423,2251,107.6
'31023, 분당구,'015002, 11세,2019,4925,2475,2450,101,4907,2463,2444,100.8
'31023, 분당구,'015003, 12세,2019,5112,2700,2412,111.9,5091,2686,2405,111.7
'31023, 분당구,'015004, 13세,2019,4820,2450,2370,103.4,4803,2436,2367,102.9
'31023, 분당구,'015005, 14세,2019,4687,2421,2266,106.8,4667,2409,2258,106.7
'31023, 분당구,'020,15~19세,2019,26324,13283,13041,101.9,26169,13199,12970,101.8
'31023, 분당구,'020001, 15세,2019,5294,2672,2622,101.9,5276,2662,2614,101.8
'31023, 분당구,'020002, 16세,2019,5079,2587,2492,103.8,5059,2576,2483,103.7
'31023, 분당구,'020003, 17세,2019,5106,2600,2506,103.8,5083,2589,2494,103.8
'31023, 분당구,'020004, 18세,2019,5505,2742,2763,99.2,5486,2734,2752,99.3
'31023, 분당구,'020005, 19세,2019,5340,2682,2658,100.9,5265,2638,2627,100.4
'31023, 분당구,'025,20~24세,2019,26292,13511,12781,105.7,25733,13159,12574,104.7
'31023, 분당구,'025001, 20세,2019,4805,2541,2264,112.2,4715,2477,2238,110.7
'31023, 분당구,'025002, 21세,2019,5160,2836,2324,122,5075,2776,2299,120.7
'31023, 분당구,'025003, 22세,2019,5165,2765,2400,115.2,5058,2693,2365,113.9
'31023, 분당구,'025004, 23세,2019,5476,2696,2780,97,5339,2615,2724,96
'31023, 분당구,'025005, 24세,2019,5686,2673,3013,88.7,5546,2598,2948,88.1
'31023, 분당구,'030,25~29세,2019,32900,16331,16569,98.6,31968,15850,16118,98.3
'31023, 분당구,'030001, 25세,2019,6327,3074,3253,94.5,6141,2975,3166,94
'31023, 분당구,'030002, 26세,2019,6393,3245,3148,103.1,6205,3144,3061,102.7
'31023, 분당구,'030003, 27세,2019,6926,3487,3439,101.4,6740,3401,3339,101.9
'31023, 분당구,'030004, 28세,2019,6779,3352,3427,97.8,6594,3259,3335,97.7
'31023, 분당구,'030005, 29세,2019,6475,3173,3302,96.1,6288,3071,3217,95.5
'31023, 분당구,'035,30~34세,2019,32268,15729,16539,95.1,31304,15215,16089,94.6
'31023, 분당구,'035001, 30세,2019,6525,3247,3278,99.1,6311,3132,3179,98.5
'31023, 분당구,'035002, 31세,2019,6400,3115,3285,94.8,6212,3017,3195,94.4
'31023, 분당구,'035003, 32세,2019,6371,3085,3286,93.9,6175,2982,3193,93.4
'31023, 분당구,'035004, 33세,2019,6428,3065,3363,91.1,6259,2978,3281,90.8
'31023, 분당구,'035005, 34세,2019,6544,3217,3327,96.7,6347,3106,3241,95.8
'31023, 분당구,'040,35~39세,2019,37029,17751,19278,92.1,36315,17335,18980,91.3
'31023, 분당구,'040001, 35세,2019,6529,3197,3332,95.9,6371,3100,3271,94.8
'31023, 분당구,'040002, 36세,2019,7063,3376,3687,91.6,6918,3301,3617,91.3
'31023, 분당구,'040003, 37세,2019,7650,3711,3939,94.2,7496,3627,3869,93.7
'31023, 분당구,'040004, 38세,2019,7723,3703,4020,92.1,7598,3625,3973,91.2
'31023, 분당구,'040005, 39세,2019,8064,3764,4300,87.5,7932,3682,4250,86.6
'31023, 분당구,'045,40~44세,2019,38165,17731,20434,86.8,37632,17448,20184,86.4
'31023, 분당구,'045001, 40세,2019,7731,3591,4140,86.7,7608,3528,4080,86.5
'31023, 분당구,'045002, 41세,2019,7148,3255,3893,83.6,7029,3186,3843,82.9
'31023, 분당구,'045003, 42세,2019,7610,3540,4070,87,7506,3486,4020,86.7
'31023, 분당구,'045004, 43세,2019,7695,3622,4073,88.9,7600,3576,4024,88.9
'31023, 분당구,'045005, 44세,2019,7981,3723,4258,87.4,7889,3672,4217,87.1
'31023, 분당구,'050,45~49세,2019,46590,22188,24402,90.9,46054,21903,24151,90.7
'31023, 분당구,'050001, 45세,2019,8834,4068,4766,85.4,8723,4018,4705,85.4
'31023, 분당구,'050002, 46세,2019,9006,4191,4815,87,8898,4127,4771,86.5
'31023, 분당구,'050003, 47세,2019,9265,4301,4964,86.6,9158,4240,4918,86.2
'31023, 분당구,'050004, 48세,2019,9988,4880,5108,95.5,9880,4821,5059,95.3
'31023, 분당구,'050005, 49세,2019,9497,4748,4749,100,9395,4697,4698,100
'31023, 분당구,'055,50~54세,2019,39511,19416,20095,96.6,39061,19202,19859,96.7
'31023, 분당구,'055001, 50세,2019,9218,4489,4729,94.9,9111,4434,4677,94.8
'31023, 분당구,'055002, 51세,2019,8450,4037,4413,91.5,8355,3991,4364,91.5
'31023, 분당구,'055003, 52세,2019,7585,3734,3851,97,7494,3696,3798,97.3
'31023, 분당구,'055004, 53세,2019,7032,3589,3443,104.2,6956,3552,3404,104.3
'31023, 분당구,'055005, 54세,2019,7226,3567,3659,97.5,7145,3529,3616,97.6
'31023, 분당구,'060,55~59세,2019,34902,16999,17903,95,34533,16865,17668,95.5
'31023, 분당구,'060001, 55세,2019,6853,3365,3488,96.5,6790,3341,3449,96.9
'31023, 분당구,'060002, 56세,2019,7162,3490,3672,95,7071,3454,3617,95.5
'31023, 분당구,'060003, 57세,2019,6689,3262,3427,95.2,6600,3231,3369,95.9
'31023, 분당구,'060004, 58세,2019,7287,3534,3753,94.2,7217,3510,3707,94.7
'31023, 분당구,'060005, 59세,2019,6911,3348,3563,94,6855,3329,3526,94.4
'31023, 분당구,'065,60~64세,2019,28360,14143,14217,99.5,28082,14037,14045,99.9
'31023, 분당구,'065001, 60세,2019,6379,3117,3262,95.6,6319,3088,3231,95.6
'31023, 분당구,'065002, 61세,2019,5899,3051,2848,107.1,5837,3032,2805,108.1
'31023, 분당구,'065003, 62세,2019,5782,2907,2875,101.1,5724,2890,2834,102
'31023, 분당구,'065004, 63세,2019,5097,2488,2609,95.4,5046,2469,2577,95.8
'31023, 분당구,'065005, 64세,2019,5203,2580,2623,98.4,5156,2558,2598,98.5
'31023, 분당구,'070,65~69세,2019,17330,8351,8979,93,17215,8310,8905,93.3
'31023, 분당구,'070001, 65세,2019,4165,2002,2163,92.6,4125,1982,2143,92.5
'31023, 분당구,'070002, 66세,2019,3733,1801,1932,93.2,3710,1795,1915,93.7
'31023, 분당구,'070003, 67세,2019,3853,1895,1958,96.8,3836,1889,1947,97
'31023, 분당구,'070004, 68세,2019,2601,1246,1355,92,2586,1243,1343,92.6
'31023, 분당구,'070005, 69세,2019,2978,1407,1571,89.6,2958,1401,1557,90
'31023, 분당구,'075,70~74세,2019,13889,6255,7634,81.9,13829,6234,7595,82.1
'31023, 분당구,'075001, 70세,2019,3050,1388,1662,83.5,3027,1379,1648,83.7
'31023, 분당구,'075002, 71세,2019,2959,1333,1626,82,2945,1329,1616,82.2
'31023, 분당구,'075003, 72세,2019,3148,1439,1709,84.2,3141,1438,1703,84.4
'31023, 분당구,'075004, 73세,2019,2404,1050,1354,77.5,2395,1046,1349,77.5
'31023, 분당구,'075005, 74세,2019,2328,1045,1283,81.4,2321,1042,1279,81.5
'31023, 분당구,'080,75~79세,2019,10959,4921,6038,81.5,10928,4908,6020,81.5
'31023, 분당구,'080001, 75세,2019,2264,1038,1226,84.7,2255,1036,1219,85
'31023, 분당구,'080002, 76세,2019,2230,999,1231,81.2,2224,997,1227,81.3
'31023, 분당구,'080003, 77세,2019,2491,1147,1344,85.3,2486,1143,1343,85.1
'31023, 분당구,'080004, 78세,2019,2065,927,1138,81.5,2058,923,1135,81.3
'31023, 분당구,'080005, 79세,2019,1909,810,1099,73.7,1905,809,1096,73.8
'31023, 분당구,'085,80~84세,2019,7822,3137,4685,67,7803,3128,4675,66.9
'31023, 분당구,'085001, 80세,2019,1836,775,1061,73,1833,774,1059,73.1
'31023, 분당구,'085002, 81세,2019,1668,694,974,71.3,1663,692,971,71.3
'31023, 분당구,'085003, 82세,2019,1612,638,974,65.5,1606,635,971,65.4
'31023, 분당구,'085004, 83세,2019,1404,548,856,64,1402,547,855,64
'31023, 분당구,'085005, 84세,2019,1302,482,820,58.8,1299,480,819,58.6
'31023, 분당구,'086,85세이상,2019,6060,1904,4156,45.8,6036,1899,4137,45.9
'31023, 분당구,'090,85~89세,2019,4079,1344,2735,49.1,4069,1342,2727,49.2
'31023, 분당구,'090001, 85세,2019,1069,365,704,51.8,1068,365,703,51.9
'31023, 분당구,'090002, 86세,2019,899,307,592,51.9,896,306,590,51.9
'31023, 분당구,'090003, 87세,2019,834,263,571,46.1,831,262,569,46
'31023, 분당구,'090004, 88세,2019,654,213,441,48.3,653,213,440,48.4
'31023, 분당구,'090005, 89세,2019,623,196,427,45.9,621,196,425,46.1
'31023, 분당구,'095,90~94세,2019,1581,442,1139,38.8,1573,440,1133,38.8
'31023, 분당구,'095001, 90세,2019,534,169,365,46.3,531,168,363,46.3
'31023, 분당구,'095002, 91세,2019,425,125,300,41.7,423,125,298,41.9
'31023, 분당구,'095003, 92세,2019,307,78,229,34.1,306,78,228,34.2
'31023, 분당구,'095004, 93세,2019,168,41,127,32.3,168,41,127,32.3
'31023, 분당구,'095005, 94세,2019,147,29,118,24.6,145,28,117,23.9
'31023, 분당구,'100,95~99세,2019,358,106,252,42.1,354,105,249,42.2
'31023, 분당구,'100001, 95세,2019,113,31,82,37.8,113,31,82,37.8
'31023, 분당구,'100002, 96세,2019,94,30,64,46.9,92,30,62,48.4
'31023, 분당구,'100003, 97세,2019,81,22,59,37.3,80,22,58,37.9
'31023, 분당구,'100004, 98세,2019,44,13,31,41.9,44,13,31,41.9
'31023, 분당구,'100005, 99세,2019,26,10,16,62.5,25,9,16,56.3
'31023, 분당구,'101,100세이상,2019,42,12,30,40,40,12,28,42.9
'31023, 분당구,'102,15세미만,2019,64233,33071,31162,106.1,63663,32751,30912,105.9
'31023, 분당구,'103,15~64세,2019,342341,167082,175259,95.3,336851,164213,172638,95.1
'31023, 분당구,'104,65세이상,2019,56060,24568,31492,78,55811,24479,31332,78.1
'31023, 분당구,'126,평균연령,2019,40.7,39.8,41.5,,40.7,39.9,41.5,
'31023, 분당구,'127,중위연령,2019,41.6,40.7,42.4,,41.8,40.9,42.5,
'31030, 의정부시,'000,합계,2019,440357,216737,223620,96.9,433491,213519,219972,97.1
'31030, 의정부시,'005,0~4세,2019,15793,8246,7547,109.3,15644,8171,7473,109.3
'31030, 의정부시,'005001, 0세,2019,2514,1335,1179,113.2,2498,1328,1170,113.5
'31030, 의정부시,'005002, 1세,2019,2841,1511,1330,113.6,2814,1496,1318,113.5
'31030, 의정부시,'005003, 2세,2019,3116,1641,1475,111.3,3090,1629,1461,111.5
'31030, 의정부시,'005004, 3세,2019,3509,1764,1745,101.1,3472,1747,1725,101.3
'31030, 의정부시,'005005, 4세,2019,3813,1995,1818,109.7,3770,1971,1799,109.6
'31030, 의정부시,'010,5~9세,2019,19295,9868,9427,104.7,19210,9834,9376,104.9
'31030, 의정부시,'010001, 5세,2019,3707,1900,1807,105.1,3688,1892,1796,105.3
'31030, 의정부시,'010002, 6세,2019,3691,1887,1804,104.6,3671,1880,1791,105
'31030, 의정부시,'010003, 7세,2019,4040,2037,2003,101.7,4021,2030,1991,102
'31030, 의정부시,'010004, 8세,2019,3942,2030,1912,106.2,3928,2023,1905,106.2
'31030, 의정부시,'010005, 9세,2019,3915,2014,1901,105.9,3902,2009,1893,106.1
'31030, 의정부시,'015,10~14세,2019,19246,9896,9350,105.8,19185,9858,9327,105.7
'31030, 의정부시,'015001, 10세,2019,3700,1852,1848,100.2,3678,1837,1841,99.8
'31030, 의정부시,'015002, 11세,2019,3891,2039,1852,110.1,3882,2034,1848,110.1
'31030, 의정부시,'015003, 12세,2019,4205,2233,1972,113.2,4195,2227,1968,113.2
'31030, 의정부시,'015004, 13세,2019,3731,1881,1850,101.7,3718,1873,1845,101.5
'31030, 의정부시,'015005, 14세,2019,3719,1891,1828,103.4,3712,1887,1825,103.4
'31030, 의정부시,'020,15~19세,2019,22594,11599,10995,105.5,22373,11507,10866,105.9
'31030, 의정부시,'020001, 15세,2019,4050,2065,1985,104,4042,2062,1980,104.1
'31030, 의정부시,'020002, 16세,2019,4083,2134,1949,109.5,4070,2129,1941,109.7
'31030, 의정부시,'020003, 17세,2019,4421,2314,2107,109.8,4405,2307,2098,110
'31030, 의정부시,'020004, 18세,2019,4827,2453,2374,103.3,4765,2432,2333,104.2
'31030, 의정부시,'020005, 19세,2019,5213,2633,2580,102.1,5091,2577,2514,102.5
'31030, 의정부시,'025,20~24세,2019,28866,14621,14245,102.6,27921,14129,13792,102.4
'31030, 의정부시,'025001, 20세,2019,5237,2743,2494,110,5084,2664,2420,110.1
'31030, 의정부시,'025002, 21세,2019,5460,2863,2597,110.2,5251,2746,2505,109.6
'31030, 의정부시,'025003, 22세,2019,5842,2914,2928,99.5,5667,2818,2849,98.9
'31030, 의정부시,'025004, 23세,2019,6001,2992,3009,99.4,5803,2886,2917,98.9
'31030, 의정부시,'025005, 24세,2019,6326,3109,3217,96.6,6116,3015,3101,97.2
'31030, 의정부시,'030,25~29세,2019,30797,15675,15122,103.7,29846,15241,14605,104.4
'31030, 의정부시,'030001, 25세,2019,6420,3260,3160,103.2,6231,3177,3054,104
'31030, 의정부시,'030002, 26세,2019,6416,3281,3135,104.7,6250,3202,3048,105.1
'31030, 의정부시,'030003, 27세,2019,6466,3330,3136,106.2,6249,3217,3032,106.1
'31030, 의정부시,'030004, 28세,2019,5952,3027,2925,103.5,5758,2936,2822,104
'31030, 의정부시,'030005, 29세,2019,5543,2777,2766,100.4,5358,2709,2649,102.3
'31030, 의정부시,'035,30~34세,2019,25975,13052,12923,101,25049,12643,12406,101.9
'31030, 의정부시,'035001, 30세,2019,5197,2584,2613,98.9,5004,2508,2496,100.5
'31030, 의정부시,'035002, 31세,2019,5101,2544,2557,99.5,4904,2468,2436,101.3
'31030, 의정부시,'035003, 32세,2019,5068,2546,2522,101,4866,2447,2419,101.2
'31030, 의정부시,'035004, 33세,2019,5279,2689,2590,103.8,5101,2603,2498,104.2
'31030, 의정부시,'035005, 34세,2019,5330,2689,2641,101.8,5174,2617,2557,102.3
'31030, 의정부시,'040,35~39세,2019,33246,17016,16230,104.8,32486,16665,15821,105.3
'31030, 의정부시,'040001, 35세,2019,5701,2896,2805,103.2,5521,2817,2704,104.2
'31030, 의정부시,'040002, 36세,2019,6497,3306,3191,103.6,6347,3238,3109,104.1
'31030, 의정부시,'040003, 37세,2019,6867,3506,3361,104.3,6708,3436,3272,105
'31030, 의정부시,'040004, 38세,2019,7023,3606,3417,105.5,6892,3541,3351,105.7
'31030, 의정부시,'040005, 39세,2019,7158,3702,3456,107.1,7018,3633,3385,107.3
'31030, 의정부시,'045,40~44세,2019,32450,16324,16126,101.2,31921,16066,15855,101.3
'31030, 의정부시,'045001, 40세,2019,6794,3446,3348,102.9,6685,3400,3285,103.5
'31030, 의정부시,'045002, 41세,2019,6157,3139,3018,104,6040,3075,2965,103.7
'31030, 의정부시,'045003, 42세,2019,6461,3225,3236,99.7,6340,3167,3173,99.8
'31030, 의정부시,'045004, 43세,2019,6207,3132,3075,101.9,6107,3079,3028,101.7
'31030, 의정부시,'045005, 44세,2019,6831,3382,3449,98.1,6749,3345,3404,98.3
'31030, 의정부시,'050,45~49세,2019,40247,19944,20303,98.2,39651,19656,19995,98.3
'31030, 의정부시,'050001, 45세,2019,7734,3849,3885,99.1,7637,3799,3838,99
'31030, 의정부시,'050002, 46세,2019,7696,3747,3949,94.9,7593,3697,3896,94.9
'31030, 의정부시,'050003, 47세,2019,8095,4022,4073,98.7,7960,3959,4001,99
'31030, 의정부시,'050004, 48세,2019,8488,4247,4241,100.1,8365,4189,4176,100.3
'31030, 의정부시,'050005, 49세,2019,8234,4079,4155,98.2,8096,4012,4084,98.2
'31030, 의정부시,'055,50~54세,2019,39209,19140,20069,95.4,38685,18888,19797,95.4
'31030, 의정부시,'055001, 50세,2019,8298,4058,4240,95.7,8187,4010,4177,96
'31030, 의정부시,'055002, 51세,2019,8233,3925,4308,91.1,8110,3861,4249,90.9
'31030, 의정부시,'055003, 52세,2019,7450,3617,3833,94.4,7362,3573,3789,94.3
'31030, 의정부시,'055004, 53세,2019,7551,3716,3835,96.9,7462,3674,3788,97
'31030, 의정부시,'055005, 54세,2019,7677,3824,3853,99.2,7564,3770,3794,99.4
'31030, 의정부시,'060,55~59세,2019,37656,18785,18871,99.5,37209,18582,18627,99.8
'31030, 의정부시,'060001, 55세,2019,7096,3576,3520,101.6,6992,3526,3466,101.7
'31030, 의정부시,'060002, 56세,2019,7558,3795,3763,100.9,7458,3748,3710,101
'31030, 의정부시,'060003, 57세,2019,7457,3710,3747,99,7360,3666,3694,99.2
'31030, 의정부시,'060004, 58세,2019,7744,3794,3950,96.1,7683,3769,3914,96.3
'31030, 의정부시,'060005, 59세,2019,7801,3910,3891,100.5,7716,3873,3843,100.8
'31030, 의정부시,'065,60~64세,2019,30826,15157,15669,96.7,30519,15011,15508,96.8
'31030, 의정부시,'065001, 60세,2019,6809,3384,3425,98.8,6745,3355,3390,99
'31030, 의정부시,'065002, 61세,2019,6561,3299,3262,101.1,6501,3274,3227,101.5
'31030, 의정부시,'065003, 62세,2019,6332,3146,3186,98.7,6264,3113,3151,98.8
'31030, 의정부시,'065004, 63세,2019,5492,2692,2800,96.1,5443,2664,2779,95.9
'31030, 의정부시,'065005, 64세,2019,5632,2636,2996,88,5566,2605,2961,88
'31030, 의정부시,'070,65~69세,2019,19807,9353,10454,89.5,19615,9268,10347,89.6
'31030, 의정부시,'070001, 65세,2019,4829,2335,2494,93.6,4787,2317,2470,93.8
'31030, 의정부시,'070002, 66세,2019,4081,1991,2090,95.3,4037,1972,2065,95.5
'31030, 의정부시,'070003, 67세,2019,4434,2067,2367,87.3,4388,2046,2342,87.4
'31030, 의정부시,'070004, 68세,2019,2983,1378,1605,85.9,2944,1362,1582,86.1
'31030, 의정부시,'070005, 69세,2019,3480,1582,1898,83.4,3459,1571,1888,83.2
'31030, 의정부시,'075,70~74세,2019,16327,7352,8975,81.9,16240,7319,8921,82
'31030, 의정부시,'075001, 70세,2019,3565,1659,1906,87,3533,1651,1882,87.7
'31030, 의정부시,'075002, 71세,2019,3515,1577,1938,81.4,3499,1568,1931,81.2
'31030, 의정부시,'075003, 72세,2019,3649,1651,1998,82.6,3626,1640,1986,82.6
'31030, 의정부시,'075004, 73세,2019,2849,1238,1611,76.8,2841,1237,1604,77.1
'31030, 의정부시,'075005, 74세,2019,2749,1227,1522,80.6,2741,1223,1518,80.6
'31030, 의정부시,'080,75~79세,2019,13486,5727,7759,73.8,13446,5717,7729,74
'31030, 의정부시,'080001, 75세,2019,2705,1178,1527,77.1,2697,1175,1522,77.2
'31030, 의정부시,'080002, 76세,2019,2726,1162,1564,74.3,2714,1158,1556,74.4
'31030, 의정부시,'080003, 77세,2019,3164,1354,1810,74.8,3157,1352,1805,74.9
'31030, 의정부시,'080004, 78세,2019,2541,1075,1466,73.3,2536,1074,1462,73.5
'31030, 의정부시,'080005, 79세,2019,2350,958,1392,68.8,2342,958,1384,69.2
'31030, 의정부시,'085,80~84세,2019,8857,3366,5491,61.3,8829,3356,5473,61.3
'31030, 의정부시,'085001, 80세,2019,2260,904,1356,66.7,2253,900,1353,66.5
'31030, 의정부시,'085002, 81세,2019,2014,803,1211,66.3,2007,800,1207,66.3
'31030, 의정부시,'085003, 82세,2019,1702,639,1063,60.1,1698,639,1059,60.3
'31030, 의정부시,'085004, 83세,2019,1532,540,992,54.4,1526,539,987,54.6
'31030, 의정부시,'085005, 84세,2019,1349,480,869,55.2,1345,478,867,55.1
'31030, 의정부시,'086,85세이상,2019,5680,1616,4064,39.8,5662,1608,4054,39.7
'31030, 의정부시,'090,85~89세,2019,3964,1225,2739,44.7,3956,1221,2735,44.6
'31030, 의정부시,'090001, 85세,2019,1142,359,783,45.8,1141,358,783,45.7
'31030, 의정부시,'090002, 86세,2019,919,332,587,56.6,917,332,585,56.8
'31030, 의정부시,'090003, 87세,2019,783,243,540,45,780,241,539,44.7
'31030, 의정부시,'090004, 88세,2019,572,161,411,39.2,571,160,411,38.9
'31030, 의정부시,'090005, 89세,2019,548,130,418,31.1,547,130,417,31.2
'31030, 의정부시,'095,90~94세,2019,1382,320,1062,30.1,1374,316,1058,29.9
'31030, 의정부시,'095001, 90세,2019,444,109,335,32.5,442,108,334,32.3
'31030, 의정부시,'095002, 91세,2019,374,87,287,30.3,374,87,287,30.3
'31030, 의정부시,'095003, 92세,2019,268,64,204,31.4,265,63,202,31.2
'31030, 의정부시,'095004, 93세,2019,163,37,126,29.4,161,35,126,27.8
'31030, 의정부시,'095005, 94세,2019,133,23,110,20.9,132,23,109,21.1
'31030, 의정부시,'100,95~99세,2019,294,62,232,26.7,292,62,230,27
'31030, 의정부시,'100001, 95세,2019,94,19,75,25.3,92,19,73,26
'31030, 의정부시,'100002, 96세,2019,72,15,57,26.3,72,15,57,26.3
'31030, 의정부시,'100003, 97세,2019,66,15,51,29.4,66,15,51,29.4
'31030, 의정부시,'100004, 98세,2019,38,8,30,26.7,38,8,30,26.7
'31030, 의정부시,'100005, 99세,2019,24,5,19,26.3,24,5,19,26.3
'31030, 의정부시,'101,100세이상,2019,40,9,31,29,40,9,31,29
'31030, 의정부시,'102,15세미만,2019,54334,28010,26324,106.4,54039,27863,26176,106.4
'31030, 의정부시,'103,15~64세,2019,321866,161313,160553,100.5,315660,158388,157272,100.7
'31030, 의정부시,'104,65세이상,2019,64157,27414,36743,74.6,63792,27268,36524,74.7
'31030, 의정부시,'126,평균연령,2019,42.4,41.3,43.4,,42.4,41.3,43.5,
'31030, 의정부시,'127,중위연령,2019,43.8,42.6,45,,44,42.7,45.1,
'31040, 안양시,'000,합계,2019,557339,275659,281680,97.9,546191,270130,276061,97.9
'31040, 안양시,'005,0~4세,2019,19759,10079,9680,104.1,19460,9905,9555,103.7
'31040, 안양시,'005001, 0세,2019,3555,1829,1726,106,3498,1795,1703,105.4
'31040, 안양시,'005002, 1세,2019,3761,1902,1859,102.3,3698,1864,1834,101.6
'31040, 안양시,'005003, 2세,2019,3688,1930,1758,109.8,3637,1900,1737,109.4
'31040, 안양시,'005004, 3세,2019,4330,2206,2124,103.9,4254,2162,2092,103.3
'31040, 안양시,'005005, 4세,2019,4425,2212,2213,100,4373,2184,2189,99.8
'31040, 안양시,'010,5~9세,2019,22631,11589,11042,105,22437,11498,10939,105.1
'31040, 안양시,'010001, 5세,2019,4322,2203,2119,104,4268,2178,2090,104.2
'31040, 안양시,'010002, 6세,2019,4261,2160,2101,102.8,4219,2139,2080,102.8
'31040, 안양시,'010003, 7세,2019,4690,2445,2245,108.9,4652,2425,2227,108.9
'31040, 안양시,'010004, 8세,2019,4764,2383,2381,100.1,4737,2372,2365,100.3
'31040, 안양시,'010005, 9세,2019,4594,2398,2196,109.2,4561,2384,2177,109.5
'31040, 안양시,'015,10~14세,2019,24242,12559,11683,107.5,24151,12514,11637,107.5
'31040, 안양시,'015001, 10세,2019,4493,2338,2155,108.5,4473,2325,2148,108.2
'31040, 안양시,'015002, 11세,2019,4927,2532,2395,105.7,4905,2521,2384,105.7
'31040, 안양시,'015003, 12세,2019,5104,2664,2440,109.2,5082,2654,2428,109.3
'31040, 안양시,'015004, 13세,2019,4940,2559,2381,107.5,4927,2553,2374,107.5
'31040, 안양시,'015005, 14세,2019,4778,2466,2312,106.7,4764,2461,2303,106.9
'31040, 안양시,'020,15~19세,2019,28888,14855,14033,105.9,28765,14800,13965,106
'31040, 안양시,'020001, 15세,2019,5169,2680,2489,107.7,5151,2671,2480,107.7
'31040, 안양시,'020002, 16세,2019,5395,2801,2594,108,5391,2799,2592,108
'31040, 안양시,'020003, 17세,2019,5397,2825,2572,109.8,5381,2817,2564,109.9
'31040, 안양시,'020004, 18세,2019,6301,3220,3081,104.5,6277,3206,3071,104.4
'31040, 안양시,'020005, 19세,2019,6626,3329,3297,101,6565,3307,3258,101.5
'31040, 안양시,'025,20~24세,2019,36935,19075,17860,106.8,36276,18779,17497,107.3
'31040, 안양시,'025001, 20세,2019,6681,3503,3178,110.2,6577,3453,3124,110.5
'31040, 안양시,'025002, 21세,2019,7324,3805,3519,108.1,7178,3744,3434,109
'31040, 안양시,'025003, 22세,2019,7587,3903,3684,105.9,7472,3856,3616,106.6
'31040, 안양시,'025004, 23세,2019,7512,3862,3650,105.8,7373,3791,3582,105.8
'31040, 안양시,'025005, 24세,2019,7831,4002,3829,104.5,7676,3935,3741,105.2
'31040, 안양시,'030,25~29세,2019,41083,21345,19738,108.1,40019,20853,19166,108.8
'31040, 안양시,'030001, 25세,2019,8224,4176,4048,103.2,8042,4090,3952,103.5
'31040, 안양시,'030002, 26세,2019,8202,4297,3905,110,8022,4209,3813,110.4
'31040, 안양시,'030003, 27세,2019,8552,4444,4108,108.2,8340,4343,3997,108.7
'31040, 안양시,'030004, 28세,2019,8273,4305,3968,108.5,8045,4210,3835,109.8
'31040, 안양시,'030005, 29세,2019,7832,4123,3709,111.2,7570,4001,3569,112.1
'31040, 안양시,'035,30~34세,2019,37953,19605,18348,106.9,36595,18939,17656,107.3
'31040, 안양시,'035001, 30세,2019,7710,3933,3777,104.1,7457,3816,3641,104.8
'31040, 안양시,'035002, 31세,2019,7613,3945,3668,107.6,7332,3819,3513,108.7
'31040, 안양시,'035003, 32세,2019,7608,3892,3716,104.7,7325,3756,3569,105.2
'31040, 안양시,'035004, 33세,2019,7618,3991,3627,110,7329,3835,3494,109.8
'31040, 안양시,'035005, 34세,2019,7404,3844,3560,108,7152,3713,3439,108
'31040, 안양시,'040,35~39세,2019,42032,21479,20553,104.5,40953,20901,20052,104.2
'31040, 안양시,'040001, 35세,2019,7708,3951,3757,105.2,7458,3822,3636,105.1
'31040, 안양시,'040002, 36세,2019,8219,4236,3983,106.4,7982,4108,3874,106
'31040, 안양시,'040003, 37세,2019,8784,4583,4201,109.1,8539,4449,4090,108.8
'31040, 안양시,'040004, 38세,2019,8568,4393,4175,105.2,8398,4316,4082,105.7
'31040, 안양시,'040005, 39세,2019,8753,4316,4437,97.3,8576,4206,4370,96.2
'31040, 안양시,'045,40~44세,2019,40438,19983,20455,97.7,39567,19502,20065,97.2
'31040, 안양시,'045001, 40세,2019,8217,4143,4074,101.7,8019,4043,3976,101.7
'31040, 안양시,'045002, 41세,2019,7602,3743,3859,97,7405,3639,3766,96.6
'31040, 안양시,'045003, 42세,2019,8015,3921,4094,95.8,7855,3832,4023,95.3
'31040, 안양시,'045004, 43세,2019,7981,3963,4018,98.6,7825,3872,3953,98
'31040, 안양시,'045005, 44세,2019,8623,4213,4410,95.5,8463,4116,4347,94.7
'31040, 안양시,'050,45~49세,2019,50321,24435,25886,94.4,49202,23861,25341,94.2
'31040, 안양시,'050001, 45세,2019,9496,4702,4794,98.1,9292,4595,4697,97.8
'31040, 안양시,'050002, 46세,2019,9665,4608,5057,91.1,9476,4510,4966,90.8
'31040, 안양시,'050003, 47세,2019,9950,4902,5048,97.1,9703,4768,4935,96.6
'31040, 안양시,'050004, 48세,2019,10707,5168,5539,93.3,10490,5073,5417,93.6
'31040, 안양시,'050005, 49세,2019,10503,5055,5448,92.8,10241,4915,5326,92.3
'31040, 안양시,'055,50~54세,2019,50517,24382,26135,93.3,49357,23784,25573,93
'31040, 안양시,'055001, 50세,2019,10668,5132,5536,92.7,10417,5012,5405,92.7
'31040, 안양시,'055002, 51세,2019,10643,5126,5517,92.9,10414,5000,5414,92.4
'31040, 안양시,'055003, 52세,2019,9779,4621,5158,89.6,9561,4507,5054,89.2
'31040, 안양시,'055004, 53세,2019,9546,4745,4801,98.8,9327,4628,4699,98.5
'31040, 안양시,'055005, 54세,2019,9881,4758,5123,92.9,9638,4637,5001,92.7
'31040, 안양시,'060,55~59세,2019,50808,24755,26053,95,49564,24138,25426,94.9
'31040, 안양시,'060001, 55세,2019,9333,4629,4704,98.4,9076,4496,4580,98.2
'31040, 안양시,'060002, 56세,2019,9809,4854,4955,98,9492,4695,4797,97.9
'31040, 안양시,'060003, 57세,2019,10114,4869,5245,92.8,9867,4739,5128,92.4
'31040, 안양시,'060004, 58세,2019,10712,5163,5549,93,10536,5090,5446,93.5
'31040, 안양시,'060005, 59세,2019,10840,5240,5600,93.6,10593,5118,5475,93.5
'31040, 안양시,'065,60~64세,2019,41332,20515,20817,98.5,40274,20006,20268,98.7
'31040, 안양시,'065001, 60세,2019,9384,4606,4778,96.4,9187,4520,4667,96.9
'31040, 안양시,'065002, 61세,2019,8752,4393,4359,100.8,8493,4268,4225,101
'31040, 안양시,'065003, 62세,2019,8334,4128,4206,98.1,8093,4012,4081,98.3
'31040, 안양시,'065004, 63세,2019,7316,3629,3687,98.4,7133,3538,3595,98.4
'31040, 안양시,'065005, 64세,2019,7546,3759,3787,99.3,7368,3668,3700,99.1
'31040, 안양시,'070,65~69세,2019,24731,12440,12291,101.2,24240,12196,12044,101.3
'31040, 안양시,'070001, 65세,2019,6046,3095,2951,104.9,5909,3015,2894,104.2
'31040, 안양시,'070002, 66세,2019,5249,2672,2577,103.7,5119,2610,2509,104
'31040, 안양시,'070003, 67세,2019,5490,2741,2749,99.7,5386,2690,2696,99.8
'31040, 안양시,'070004, 68세,2019,3742,1816,1926,94.3,3669,1782,1887,94.4
'31040, 안양시,'070005, 69세,2019,4204,2116,2088,101.3,4157,2099,2058,102
'31040, 안양시,'075,70~74세,2019,17217,8063,9154,88.1,17047,8004,9043,88.5
'31040, 안양시,'075001, 70세,2019,3917,1929,1988,97,3844,1899,1945,97.6
'31040, 안양시,'075002, 71세,2019,3841,1812,2029,89.3,3808,1803,2005,89.9
'31040, 안양시,'075003, 72세,2019,3746,1734,2012,86.2,3719,1722,1997,86.2
'31040, 안양시,'075004, 73세,2019,2908,1347,1561,86.3,2885,1343,1542,87.1
'31040, 안양시,'075005, 74세,2019,2805,1241,1564,79.3,2791,1237,1554,79.6
'31040, 안양시,'080,75~79세,2019,13162,5591,7571,73.8,13074,5566,7508,74.1
'31040, 안양시,'080001, 75세,2019,2757,1190,1567,75.9,2740,1186,1554,76.3
'31040, 안양시,'080002, 76세,2019,2683,1182,1501,78.7,2662,1175,1487,79
'31040, 안양시,'080003, 77세,2019,3171,1376,1795,76.7,3156,1371,1785,76.8
'31040, 안양시,'080004, 78세,2019,2416,1003,1413,71,2392,995,1397,71.2
'31040, 안양시,'080005, 79세,2019,2135,840,1295,64.9,2124,839,1285,65.3
'31040, 안양시,'085,80~84세,2019,8955,3237,5718,56.6,8904,3220,5684,56.7
'31040, 안양시,'085001, 80세,2019,2211,909,1302,69.8,2202,905,1297,69.8
'31040, 안양시,'085002, 81세,2019,1997,756,1241,60.9,1987,752,1235,60.9
'31040, 안양시,'085003, 82세,2019,1762,620,1142,54.3,1750,615,1135,54.2
'31040, 안양시,'085004, 83세,2019,1531,486,1045,46.5,1521,484,1037,46.7
'31040, 안양시,'085005, 84세,2019,1454,466,988,47.2,1444,464,980,47.3
'31040, 안양시,'086,85세이상,2019,6335,1672,4663,35.9,6306,1664,4642,35.8
'31040, 안양시,'090,85~89세,2019,4472,1265,3207,39.4,4454,1260,3194,39.4
'31040, 안양시,'090001, 85세,2019,1215,366,849,43.1,1209,365,844,43.2
'31040, 안양시,'090002, 86세,2019,1040,312,728,42.9,1036,310,726,42.7
'31040, 안양시,'090003, 87세,2019,884,249,635,39.2,879,247,632,39.1
'31040, 안양시,'090004, 88세,2019,718,186,532,35,717,186,531,35
'31040, 안양시,'090005, 89세,2019,615,152,463,32.8,613,152,461,33
'31040, 안양시,'095,90~94세,2019,1513,329,1184,27.8,1504,327,1177,27.8
'31040, 안양시,'095001, 90세,2019,461,104,357,29.1,458,103,355,29
'31040, 안양시,'095002, 91세,2019,398,92,306,30.1,394,91,303,30
'31040, 안양시,'095003, 92세,2019,280,60,220,27.3,279,60,219,27.4
'31040, 안양시,'095004, 93세,2019,195,33,162,20.4,195,33,162,20.4
'31040, 안양시,'095005, 94세,2019,179,40,139,28.8,178,40,138,29
'31040, 안양시,'100,95~99세,2019,315,73,242,30.2,313,72,241,29.9
'31040, 안양시,'100001, 95세,2019,104,34,70,48.6,102,33,69,47.8
'31040, 안양시,'100002, 96세,2019,96,22,74,29.7,96,22,74,29.7
'31040, 안양시,'100003, 97세,2019,60,11,49,22.4,60,11,49,22.4
'31040, 안양시,'100004, 98세,2019,29,X,27,7.4,29,X,27,7.4
'31040, 안양시,'100005, 99세,2019,26,X,22,18.2,26,X,22,18.2
'31040, 안양시,'101,100세이상,2019,35,5,30,16.7,35,5,30,16.7
'31040, 안양시,'102,15세미만,2019,66632,34227,32405,105.6,66048,33917,32131,105.6
'31040, 안양시,'103,15~64세,2019,420307,210429,209878,100.3,410572,205563,205009,100.3
'31040, 안양시,'104,65세이상,2019,70400,31003,39397,78.7,69571,30650,38921,78.7
'31040, 안양시,'126,평균연령,2019,41.8,40.8,42.8,,41.8,40.8,42.8,
'31040, 안양시,'127,중위연령,2019,43.2,41.8,44.4,,43.1,41.8,44.4,
'31041, 만안구,'000,합계,2019,246200,122820,123380,99.5,237827,118626,119201,99.5
'31041, 만안구,'005,0~4세,2019,8436,4282,4154,103.1,8189,4139,4050,102.2
'31041, 만안구,'005001, 0세,2019,1505,768,737,104.2,1455,738,717,102.9
'31041, 만안구,'005002, 1세,2019,1590,802,788,101.8,1542,774,768,100.8
'31041, 만안구,'005003, 2세,2019,1613,844,769,109.8,1570,818,752,108.8
'31041, 만안구,'005004, 3세,2019,1913,957,956,100.1,1849,920,929,99
'31041, 만안구,'005005, 4세,2019,1815,911,904,100.8,1773,889,884,100.6
'31041, 만안구,'010,5~9세,2019,8538,4381,4157,105.4,8398,4316,4082,105.7
'31041, 만안구,'010001, 5세,2019,1727,869,858,101.3,1686,850,836,101.7
'31041, 만안구,'010002, 6세,2019,1658,851,807,105.5,1627,836,791,105.7
'31041, 만안구,'010003, 7세,2019,1775,936,839,111.6,1745,922,823,112
'31041, 만안구,'010004, 8세,2019,1708,861,847,101.7,1694,854,840,101.7
'31041, 만안구,'010005, 9세,2019,1670,864,806,107.2,1646,854,792,107.8
'31041, 만안구,'015,10~14세,2019,8418,4417,4001,110.4,8352,4386,3966,110.6
'31041, 만안구,'015001, 10세,2019,1558,819,739,110.8,1543,811,732,110.8
'31041, 만안구,'015002, 11세,2019,1743,917,826,111,1726,908,818,111
'31041, 만안구,'015003, 12세,2019,1729,918,811,113.2,1713,911,802,113.6
'31041, 만안구,'015004, 13세,2019,1736,902,834,108.2,1728,898,830,108.2
'31041, 만안구,'015005, 14세,2019,1652,861,791,108.8,1642,858,784,109.4
'31041, 만안구,'020,15~19세,2019,11303,5774,5529,104.4,11215,5739,5476,104.8
'31041, 만안구,'020001, 15세,2019,1827,966,861,112.2,1816,962,854,112.6
'31041, 만안구,'020002, 16세,2019,2080,1126,954,118,2077,1125,952,118.2
'31041, 만안구,'020003, 17세,2019,2049,1078,971,111,2037,1072,965,111.1
'31041, 만안구,'020004, 18세,2019,2428,1242,1186,104.7,2410,1231,1179,104.4
'31041, 만안구,'020005, 19세,2019,2919,1362,1557,87.5,2875,1349,1526,88.4
'31041, 만안구,'025,20~24세,2019,17056,8594,8462,101.6,16602,8396,8206,102.3
'31041, 만안구,'025001, 20세,2019,2997,1491,1506,99,2914,1454,1460,99.6
'31041, 만안구,'025002, 21세,2019,3402,1681,1721,97.7,3290,1635,1655,98.8
'31041, 만안구,'025003, 22세,2019,3605,1773,1832,96.8,3523,1740,1783,97.6
'31041, 만안구,'025004, 23세,2019,3427,1782,1645,108.3,3341,1738,1603,108.4
'31041, 만안구,'025005, 24세,2019,3625,1867,1758,106.2,3534,1829,1705,107.3
'31041, 만안구,'030,25~29세,2019,18810,9911,8899,111.4,18090,9577,8513,112.5
'31041, 만안구,'030001, 25세,2019,3834,1968,1866,105.5,3714,1910,1804,105.9
'31041, 만안구,'030002, 26세,2019,3835,2033,1802,112.8,3709,1970,1739,113.3
'31041, 만안구,'030003, 27세,2019,3926,2050,1876,109.3,3789,1987,1802,110.3
'31041, 만안구,'030004, 28세,2019,3690,1967,1723,114.2,3537,1902,1635,116.3
'31041, 만안구,'030005, 29세,2019,3525,1893,1632,116,3341,1808,1533,117.9
'31041, 만안구,'035,30~34세,2019,16814,8817,7997,110.3,15869,8341,7528,110.8
'31041, 만안구,'035001, 30세,2019,3448,1774,1674,106,3273,1688,1585,106.5
'31041, 만안구,'035002, 31세,2019,3471,1833,1638,111.9,3281,1740,1541,112.9
'31041, 만안구,'035003, 32세,2019,3342,1713,1629,105.2,3137,1610,1527,105.4
'31041, 만안구,'035004, 33세,2019,3336,1775,1561,113.7,3139,1670,1469,113.7
'31041, 만안구,'035005, 34세,2019,3217,1722,1495,115.2,3039,1633,1406,116.1
'31041, 만안구,'040,35~39세,2019,18408,9785,8623,113.5,17653,9362,8291,112.9
'31041, 만안구,'040001, 35세,2019,3341,1780,1561,114,3161,1683,1478,113.9
'31041, 만안구,'040002, 36세,2019,3685,1943,1742,111.5,3523,1856,1667,111.3
'31041, 만안구,'040003, 37세,2019,3887,2088,1799,116.1,3712,1985,1727,114.9
'31041, 만안구,'040004, 38세,2019,3745,2028,1717,118.1,3632,1975,1657,119.2
'31041, 만안구,'040005, 39세,2019,3750,1946,1804,107.9,3625,1863,1762,105.7
'31041, 만안구,'045,40~44세,2019,16451,8631,7820,110.4,15815,8268,7547,109.6
'31041, 만안구,'045001, 40세,2019,3461,1830,1631,112.2,3314,1752,1562,112.2
'31041, 만안구,'045002, 41세,2019,3148,1656,1492,111,3009,1579,1430,110.4
'31041, 만안구,'045003, 42세,2019,3276,1708,1568,108.9,3162,1642,1520,108
'31041, 만안구,'045004, 43세,2019,3202,1698,1504,112.9,3086,1629,1457,111.8
'31041, 만안구,'045005, 44세,2019,3364,1739,1625,107,3244,1666,1578,105.6
'31041, 만안구,'050,45~49세,2019,20054,9969,10085,98.8,19207,9536,9671,98.6
'31041, 만안구,'050001, 45세,2019,3721,1945,1776,109.5,3569,1866,1703,109.6
'31041, 만안구,'050002, 46세,2019,3803,1880,1923,97.8,3670,1807,1863,97
'31041, 만안구,'050003, 47세,2019,3990,2001,1989,100.6,3809,1905,1904,100.1
'31041, 만안구,'050004, 48세,2019,4255,2083,2172,95.9,4078,2004,2074,96.6
'31041, 만안구,'050005, 49세,2019,4285,2060,2225,92.6,4081,1954,2127,91.9
'31041, 만안구,'055,50~54세,2019,22039,10632,11407,93.2,21139,10162,10977,92.6
'31041, 만안구,'055001, 50세,2019,4408,2105,2303,91.4,4222,2021,2201,91.8
'31041, 만안구,'055002, 51세,2019,4496,2180,2316,94.1,4326,2083,2243,92.9
'31041, 만안구,'055003, 52세,2019,4299,2025,2274,89.1,4126,1927,2199,87.6
'31041, 만안구,'055004, 53세,2019,4334,2150,2184,98.4,4157,2053,2104,97.6
'31041, 만안구,'055005, 54세,2019,4502,2172,2330,93.2,4308,2078,2230,93.2
'31041, 만안구,'060,55~59세,2019,23753,11728,12025,97.5,22712,11213,11499,97.5
'31041, 만안구,'060001, 55세,2019,4267,2192,2075,105.6,4053,2079,1974,105.3
'31041, 만안구,'060002, 56세,2019,4589,2270,2319,97.9,4324,2139,2185,97.9
'31041, 만안구,'060003, 57세,2019,4743,2337,2406,97.1,4536,2230,2306,96.7
'31041, 만안구,'060004, 58세,2019,5047,2452,2595,94.5,4900,2388,2512,95.1
'31041, 만안구,'060005, 59세,2019,5107,2477,2630,94.2,4899,2377,2522,94.3
'31041, 만안구,'065,60~64세,2019,20035,9863,10172,97,19150,9428,9722,97
'31041, 만안구,'065001, 60세,2019,4490,2185,2305,94.8,4326,2113,2213,95.5
'31041, 만안구,'065002, 61세,2019,4235,2130,2105,101.2,4016,2022,1994,101.4
'31041, 만안구,'065003, 62세,2019,4086,2005,2081,96.3,3881,1905,1976,96.4
'31041, 만안구,'065004, 63세,2019,3586,1770,1816,97.5,3431,1689,1742,97
'31041, 만안구,'065005, 64세,2019,3638,1773,1865,95.1,3496,1699,1797,94.5
'31041, 만안구,'070,65~69세,2019,12560,6306,6254,100.8,12161,6109,6052,100.9
'31041, 만안구,'070001, 65세,2019,3070,1572,1498,104.9,2960,1510,1450,104.1
'31041, 만안구,'070002, 66세,2019,2622,1321,1301,101.5,2514,1272,1242,102.4
'31041, 만안구,'070003, 67세,2019,2808,1378,1430,96.4,2719,1334,1385,96.3
'31041, 만안구,'070004, 68세,2019,1923,938,985,95.2,1867,909,958,94.9
'31041, 만안구,'070005, 69세,2019,2137,1097,1040,105.5,2101,1084,1017,106.6
'31041, 만안구,'075,70~74세,2019,8950,4231,4719,89.7,8829,4191,4638,90.4
'31041, 만안구,'075001, 70세,2019,2044,1028,1016,101.2,1993,1006,987,101.9
'31041, 만안구,'075002, 71세,2019,1988,959,1029,93.2,1964,954,1010,94.5
'31041, 만안구,'075003, 72세,2019,1924,894,1030,86.8,1905,887,1018,87.1
'31041, 만안구,'075004, 73세,2019,1519,706,813,86.8,1500,702,798,88
'31041, 만안구,'075005, 74세,2019,1475,644,831,77.5,1467,642,825,77.8
'31041, 만안구,'080,75~79세,2019,6894,2995,3899,76.8,6823,2976,3847,77.4
'31041, 만안구,'080001, 75세,2019,1433,638,795,80.3,1419,635,784,81
'31041, 만안구,'080002, 76세,2019,1428,640,788,81.2,1410,634,776,81.7
'31041, 만안구,'080003, 77세,2019,1704,750,954,78.6,1694,746,948,78.7
'31041, 만안구,'080004, 78세,2019,1238,530,708,74.9,1219,525,694,75.6
'31041, 만안구,'080005, 79세,2019,1091,437,654,66.8,1081,436,645,67.6
'31041, 만안구,'085,80~84세,2019,4560,1689,2871,58.8,4521,1676,2845,58.9
'31041, 만안구,'085001, 80세,2019,1121,481,640,75.2,1116,479,637,75.2
'31041, 만안구,'085002, 81세,2019,1044,391,653,59.9,1036,388,648,59.9
'31041, 만안구,'085003, 82세,2019,900,327,573,57.1,891,322,569,56.6
'31041, 만안구,'085004, 83세,2019,768,255,513,49.7,759,254,505,50.3
'31041, 만안구,'085005, 84세,2019,727,235,492,47.8,719,233,486,47.9
'31041, 만안구,'086,85세이상,2019,3121,815,2306,35.3,3102,811,2291,35.4
'31041, 만안구,'090,85~89세,2019,2184,618,1566,39.5,2170,615,1555,39.5
'31041, 만안구,'090001, 85세,2019,602,191,411,46.5,597,191,406,47
'31041, 만안구,'090002, 86세,2019,520,165,355,46.5,517,164,353,46.5
'31041, 만안구,'090003, 87세,2019,435,119,316,37.7,431,117,314,37.3
'31041, 만안구,'090004, 88세,2019,340,86,254,33.9,339,86,253,34
'31041, 만안구,'090005, 89세,2019,287,57,230,24.8,286,57,229,24.9
'31041, 만안구,'095,90~94세,2019,748,154,594,25.9,743,153,590,25.9
'31041, 만안구,'095001, 90세,2019,226,48,178,27,223,47,176,26.7
'31041, 만안구,'095002, 91세,2019,193,42,151,27.8,192,42,150,28
'31041, 만안구,'095003, 92세,2019,146,28,118,23.7,145,28,117,23.9
'31041, 만안구,'095004, 93세,2019,93,14,79,17.7,93,14,79,17.7
'31041, 만안구,'095005, 94세,2019,90,22,68,32.4,90,22,68,32.4
'31041, 만안구,'100,95~99세,2019,172,41,131,31.3,172,41,131,31.3
'31041, 만안구,'100001, 95세,2019,56,21,35,60,56,21,35,60
'31041, 만안구,'100002, 96세,2019,56,12,44,27.3,56,12,44,27.3
'31041, 만안구,'100003, 97세,2019,34,6,28,21.4,34,6,28,21.4
'31041, 만안구,'100004, 98세,2019,14,X,14,0,14,X,14,0
'31041, 만안구,'100005, 99세,2019,12,X,10,20,12,X,10,20
'31041, 만안구,'101,100세이상,2019,17,X,15,13.3,17,X,15,13.3
'31041, 만안구,'102,15세미만,2019,25392,13080,12312,106.2,24939,12841,12098,106.1
'31041, 만안구,'103,15~64세,2019,184723,93704,91019,102.9,177452,90022,87430,103
'31041, 만안구,'104,65세이상,2019,36085,16036,20049,80,35436,15763,19673,80.1
'31041, 만안구,'126,평균연령,2019,43.2,42.2,44.2,,43.2,42.1,44.2,
'31041, 만안구,'127,중위연령,2019,44.7,43.1,46.1,,44.6,43.1,46.1,
'31042, 동안구,'000,합계,2019,311139,152839,158300,96.6,308364,151504,156860,96.6
'31042, 동안구,'005,0~4세,2019,11323,5797,5526,104.9,11271,5766,5505,104.7
'31042, 동안구,'005001, 0세,2019,2050,1061,989,107.3,2043,1057,986,107.2
'31042, 동안구,'005002, 1세,2019,2171,1100,1071,102.7,2156,1090,1066,102.3
'31042, 동안구,'005003, 2세,2019,2075,1086,989,109.8,2067,1082,985,109.8
'31042, 동안구,'005004, 3세,2019,2417,1249,1168,106.9,2405,1242,1163,106.8
'31042, 동안구,'005005, 4세,2019,2610,1301,1309,99.4,2600,1295,1305,99.2
'31042, 동안구,'010,5~9세,2019,14093,7208,6885,104.7,14039,7182,6857,104.7
'31042, 동안구,'010001, 5세,2019,2595,1334,1261,105.8,2582,1328,1254,105.9
'31042, 동안구,'010002, 6세,2019,2603,1309,1294,101.2,2592,1303,1289,101.1
'31042, 동안구,'010003, 7세,2019,2915,1509,1406,107.3,2907,1503,1404,107.1
'31042, 동안구,'010004, 8세,2019,3056,1522,1534,99.2,3043,1518,1525,99.5
'31042, 동안구,'010005, 9세,2019,2924,1534,1390,110.4,2915,1530,1385,110.5
'31042, 동안구,'015,10~14세,2019,15824,8142,7682,106,15799,8128,7671,106
'31042, 동안구,'015001, 10세,2019,2935,1519,1416,107.3,2930,1514,1416,106.9
'31042, 동안구,'015002, 11세,2019,3184,1615,1569,102.9,3179,1613,1566,103
'31042, 동안구,'015003, 12세,2019,3375,1746,1629,107.2,3369,1743,1626,107.2
'31042, 동안구,'015004, 13세,2019,3204,1657,1547,107.1,3199,1655,1544,107.2
'31042, 동안구,'015005, 14세,2019,3126,1605,1521,105.5,3122,1603,1519,105.5
'31042, 동안구,'020,15~19세,2019,17585,9081,8504,106.8,17550,9061,8489,106.7
'31042, 동안구,'020001, 15세,2019,3342,1714,1628,105.3,3335,1709,1626,105.1
'31042, 동안구,'020002, 16세,2019,3315,1675,1640,102.1,3314,1674,1640,102.1
'31042, 동안구,'020003, 17세,2019,3348,1747,1601,109.1,3344,1745,1599,109.1
'31042, 동안구,'020004, 18세,2019,3873,1978,1895,104.4,3867,1975,1892,104.4
'31042, 동안구,'020005, 19세,2019,3707,1967,1740,113,3690,1958,1732,113
'31042, 동안구,'025,20~24세,2019,19879,10481,9398,111.5,19674,10383,9291,111.8
'31042, 동안구,'025001, 20세,2019,3684,2012,1672,120.3,3663,1999,1664,120.1
'31042, 동안구,'025002, 21세,2019,3922,2124,1798,118.1,3888,2109,1779,118.5
'31042, 동안구,'025003, 22세,2019,3982,2130,1852,115,3949,2116,1833,115.4
'31042, 동안구,'025004, 23세,2019,4085,2080,2005,103.7,4032,2053,1979,103.7
'31042, 동안구,'025005, 24세,2019,4206,2135,2071,103.1,4142,2106,2036,103.4
'31042, 동안구,'030,25~29세,2019,22273,11434,10839,105.5,21929,11276,10653,105.8
'31042, 동안구,'030001, 25세,2019,4390,2208,2182,101.2,4328,2180,2148,101.5
'31042, 동안구,'030002, 26세,2019,4367,2264,2103,107.7,4313,2239,2074,108
'31042, 동안구,'030003, 27세,2019,4626,2394,2232,107.3,4551,2356,2195,107.3
'31042, 동안구,'030004, 28세,2019,4583,2338,2245,104.1,4508,2308,2200,104.9
'31042, 동안구,'030005, 29세,2019,4307,2230,2077,107.4,4229,2193,2036,107.7
'31042, 동안구,'035,30~34세,2019,21139,10788,10351,104.2,20726,10598,10128,104.6
'31042, 동안구,'035001, 30세,2019,4262,2159,2103,102.7,4184,2128,2056,103.5
'31042, 동안구,'035002, 31세,2019,4142,2112,2030,104,4051,2079,1972,105.4
'31042, 동안구,'035003, 32세,2019,4266,2179,2087,104.4,4188,2146,2042,105.1
'31042, 동안구,'035004, 33세,2019,4282,2216,2066,107.3,4190,2165,2025,106.9
'31042, 동안구,'035005, 34세,2019,4187,2122,2065,102.8,4113,2080,2033,102.3
'31042, 동안구,'040,35~39세,2019,23624,11694,11930,98,23300,11539,11761,98.1
'31042, 동안구,'040001, 35세,2019,4367,2171,2196,98.9,4297,2139,2158,99.1
'31042, 동안구,'040002, 36세,2019,4534,2293,2241,102.3,4459,2252,2207,102
'31042, 동안구,'040003, 37세,2019,4897,2495,2402,103.9,4827,2464,2363,104.3
'31042, 동안구,'040004, 38세,2019,4823,2365,2458,96.2,4766,2341,2425,96.5
'31042, 동안구,'040005, 39세,2019,5003,2370,2633,90,4951,2343,2608,89.8
'31042, 동안구,'045,40~44세,2019,23987,11352,12635,89.8,23752,11234,12518,89.7
'31042, 동안구,'045001, 40세,2019,4756,2313,2443,94.7,4705,2291,2414,94.9
'31042, 동안구,'045002, 41세,2019,4454,2087,2367,88.2,4396,2060,2336,88.2
'31042, 동안구,'045003, 42세,2019,4739,2213,2526,87.6,4693,2190,2503,87.5
'31042, 동안구,'045004, 43세,2019,4779,2265,2514,90.1,4739,2243,2496,89.9
'31042, 동안구,'045005, 44세,2019,5259,2474,2785,88.8,5219,2450,2769,88.5
'31042, 동안구,'050,45~49세,2019,30267,14466,15801,91.6,29995,14325,15670,91.4
'31042, 동안구,'050001, 45세,2019,5775,2757,3018,91.4,5723,2729,2994,91.1
'31042, 동안구,'050002, 46세,2019,5862,2728,3134,87,5806,2703,3103,87.1
'31042, 동안구,'050003, 47세,2019,5960,2901,3059,94.8,5894,2863,3031,94.5
'31042, 동안구,'050004, 48세,2019,6452,3085,3367,91.6,6412,3069,3343,91.8
'31042, 동안구,'050005, 49세,2019,6218,2995,3223,92.9,6160,2961,3199,92.6
'31042, 동안구,'055,50~54세,2019,28478,13750,14728,93.4,28218,13622,14596,93.3
'31042, 동안구,'055001, 50세,2019,6260,3027,3233,93.6,6195,2991,3204,93.4
'31042, 동안구,'055002, 51세,2019,6147,2946,3201,92,6088,2917,3171,92
'31042, 동안구,'055003, 52세,2019,5480,2596,2884,90,5435,2580,2855,90.4
'31042, 동안구,'055004, 53세,2019,5212,2595,2617,99.2,5170,2575,2595,99.2
'31042, 동안구,'055005, 54세,2019,5379,2586,2793,92.6,5330,2559,2771,92.3
'31042, 동안구,'060,55~59세,2019,27055,13027,14028,92.9,26852,12925,13927,92.8
'31042, 동안구,'060001, 55세,2019,5066,2437,2629,92.7,5023,2417,2606,92.7
'31042, 동안구,'060002, 56세,2019,5220,2584,2636,98,5168,2556,2612,97.9
'31042, 동안구,'060003, 57세,2019,5371,2532,2839,89.2,5331,2509,2822,88.9
'31042, 동안구,'060004, 58세,2019,5665,2711,2954,91.8,5636,2702,2934,92.1
'31042, 동안구,'060005, 59세,2019,5733,2763,2970,93,5694,2741,2953,92.8
'31042, 동안구,'065,60~64세,2019,21297,10652,10645,100.1,21124,10578,10546,100.3
'31042, 동안구,'065001, 60세,2019,4894,2421,2473,97.9,4861,2407,2454,98.1
'31042, 동안구,'065002, 61세,2019,4517,2263,2254,100.4,4477,2246,2231,100.7
'31042, 동안구,'065003, 62세,2019,4248,2123,2125,99.9,4212,2107,2105,100.1
'31042, 동안구,'065004, 63세,2019,3730,1859,1871,99.4,3702,1849,1853,99.8
'31042, 동안구,'065005, 64세,2019,3908,1986,1922,103.3,3872,1969,1903,103.5
'31042, 동안구,'070,65~69세,2019,12171,6134,6037,101.6,12079,6087,5992,101.6
'31042, 동안구,'070001, 65세,2019,2976,1523,1453,104.8,2949,1505,1444,104.2
'31042, 동안구,'070002, 66세,2019,2627,1351,1276,105.9,2605,1338,1267,105.6
'31042, 동안구,'070003, 67세,2019,2682,1363,1319,103.3,2667,1356,1311,103.4
'31042, 동안구,'070004, 68세,2019,1819,878,941,93.3,1802,873,929,94
'31042, 동안구,'070005, 69세,2019,2067,1019,1048,97.2,2056,1015,1041,97.5
'31042, 동안구,'075,70~74세,2019,8267,3832,4435,86.4,8218,3813,4405,86.6
'31042, 동안구,'075001, 70세,2019,1873,901,972,92.7,1851,893,958,93.2
'31042, 동안구,'075002, 71세,2019,1853,853,1000,85.3,1844,849,995,85.3
'31042, 동안구,'075003, 72세,2019,1822,840,982,85.5,1814,835,979,85.3
'31042, 동안구,'075004, 73세,2019,1389,641,748,85.7,1385,641,744,86.2
'31042, 동안구,'075005, 74세,2019,1330,597,733,81.4,1324,595,729,81.6
'31042, 동안구,'080,75~79세,2019,6268,2596,3672,70.7,6251,2590,3661,70.7
'31042, 동안구,'080001, 75세,2019,1324,552,772,71.5,1321,551,770,71.6
'31042, 동안구,'080002, 76세,2019,1255,542,713,76,1252,541,711,76.1
'31042, 동안구,'080003, 77세,2019,1467,626,841,74.4,1462,625,837,74.7
'31042, 동안구,'080004, 78세,2019,1178,473,705,67.1,1173,470,703,66.9
'31042, 동안구,'080005, 79세,2019,1044,403,641,62.9,1043,403,640,63
'31042, 동안구,'085,80~84세,2019,4395,1548,2847,54.4,4383,1544,2839,54.4
'31042, 동안구,'085001, 80세,2019,1090,428,662,64.7,1086,426,660,64.5
'31042, 동안구,'085002, 81세,2019,953,365,588,62.1,951,364,587,62
'31042, 동안구,'085003, 82세,2019,862,293,569,51.5,859,293,566,51.8
'31042, 동안구,'085004, 83세,2019,763,231,532,43.4,762,230,532,43.2
'31042, 동안구,'085005, 84세,2019,727,231,496,46.6,725,231,494,46.8
'31042, 동안구,'086,85세이상,2019,3214,857,2357,36.4,3204,853,2351,36.3
'31042, 동안구,'090,85~89세,2019,2288,647,1641,39.4,2284,645,1639,39.4
'31042, 동안구,'090001, 85세,2019,613,175,438,40,612,174,438,39.7
'31042, 동안구,'090002, 86세,2019,520,147,373,39.4,519,146,373,39.1
'31042, 동안구,'090003, 87세,2019,449,130,319,40.8,448,130,318,40.9
'31042, 동안구,'090004, 88세,2019,378,100,278,36,378,100,278,36
'31042, 동안구,'090005, 89세,2019,328,95,233,40.8,327,95,232,40.9
'31042, 동안구,'095,90~94세,2019,765,175,590,29.7,761,174,587,29.6
'31042, 동안구,'095001, 90세,2019,235,56,179,31.3,235,56,179,31.3
'31042, 동안구,'095002, 91세,2019,205,50,155,32.3,202,49,153,32
'31042, 동안구,'095003, 92세,2019,134,32,102,31.4,134,32,102,31.4
'31042, 동안구,'095004, 93세,2019,102,19,83,22.9,102,19,83,22.9
'31042, 동안구,'095005, 94세,2019,89,18,71,25.4,88,18,70,25.7
'31042, 동안구,'100,95~99세,2019,143,32,111,28.8,141,31,110,28.2
'31042, 동안구,'100001, 95세,2019,48,13,35,37.1,46,12,34,35.3
'31042, 동안구,'100002, 96세,2019,40,10,30,33.3,40,10,30,33.3
'31042, 동안구,'100003, 97세,2019,26,5,21,23.8,26,5,21,23.8
'31042, 동안구,'100004, 98세,2019,15,X,13,15.4,15,X,13,15.4
'31042, 동안구,'100005, 99세,2019,14,X,12,16.7,14,X,12,16.7
'31042, 동안구,'101,100세이상,2019,18,X,15,20,18,X,15,20
'31042, 동안구,'102,15세미만,2019,41240,21147,20093,105.2,41109,21076,20033,105.2
'31042, 동안구,'103,15~64세,2019,235584,116725,118859,98.2,233120,115541,117579,98.3
'31042, 동안구,'104,65세이상,2019,34315,14967,19348,77.4,34135,14887,19248,77.3
'31042, 동안구,'126,평균연령,2019,40.7,39.7,41.7,,40.7,39.7,41.7,
'31042, 동안구,'127,중위연령,2019,42.1,40.8,43.3,,42.2,40.8,43.3,
'31050, 부천시,'000,합계,2019,836751,415264,421487,98.5,801074,397134,403940,98.3
'31050, 부천시,'005,0~4세,2019,29413,15110,14303,105.6,28076,14428,13648,105.7
'31050, 부천시,'005001, 0세,2019,4994,2550,2444,104.3,4681,2397,2284,104.9
'31050, 부천시,'005002, 1세,2019,5506,2842,2664,106.7,5223,2692,2531,106.4
'31050, 부천시,'005003, 2세,2019,5796,2977,2819,105.6,5514,2821,2693,104.8
'31050, 부천시,'005004, 3세,2019,6492,3315,3177,104.3,6226,3194,3032,105.3
'31050, 부천시,'005005, 4세,2019,6625,3426,3199,107.1,6432,3324,3108,106.9
'31050, 부천시,'010,5~9세,2019,33861,17255,16606,103.9,33117,16896,16221,104.2
'31050, 부천시,'010001, 5세,2019,6724,3418,3306,103.4,6529,3320,3209,103.5
'31050, 부천시,'010002, 6세,2019,6491,3313,3178,104.2,6331,3234,3097,104.4
'31050, 부천시,'010003, 7세,2019,7061,3623,3438,105.4,6894,3546,3348,105.9
'31050, 부천시,'010004, 8세,2019,6925,3489,3436,101.5,6789,3425,3364,101.8
'31050, 부천시,'010005, 9세,2019,6660,3412,3248,105,6574,3371,3203,105.2
'31050, 부천시,'015,10~14세,2019,33172,17054,16118,105.8,32789,16844,15945,105.6
'31050, 부천시,'015001, 10세,2019,6448,3329,3119,106.7,6356,3277,3079,106.4
'31050, 부천시,'015002, 11세,2019,6789,3499,3290,106.4,6700,3452,3248,106.3
'31050, 부천시,'015003, 12세,2019,7118,3641,3477,104.7,7044,3606,3438,104.9
'31050, 부천시,'015004, 13세,2019,6462,3342,3120,107.1,6391,3301,3090,106.8
'31050, 부천시,'015005, 14세,2019,6355,3243,3112,104.2,6298,3208,3090,103.8
'31050, 부천시,'020,15~19세,2019,38921,19865,19056,104.2,38489,19650,18839,104.3
'31050, 부천시,'020001, 15세,2019,6949,3486,3463,100.7,6883,3454,3429,100.7
'31050, 부천시,'020002, 16세,2019,7120,3691,3429,107.6,7090,3674,3416,107.6
'31050, 부천시,'020003, 17세,2019,7392,3779,3613,104.6,7352,3760,3592,104.7
'31050, 부천시,'020004, 18세,2019,8431,4327,4104,105.4,8324,4270,4054,105.3
'31050, 부천시,'020005, 19세,2019,9029,4582,4447,103,8840,4492,4348,103.3
'31050, 부천시,'025,20~24세,2019,54118,28004,26114,107.2,52503,27160,25343,107.2
'31050, 부천시,'025001, 20세,2019,9454,4924,4530,108.7,9210,4815,4395,109.6
'31050, 부천시,'025002, 21세,2019,10176,5375,4801,112,9913,5235,4678,111.9
'31050, 부천시,'025003, 22세,2019,10879,5574,5305,105.1,10553,5391,5162,104.4
'31050, 부천시,'025004, 23세,2019,11494,5946,5548,107.2,11139,5748,5391,106.6
'31050, 부천시,'025005, 24세,2019,12115,6185,5930,104.3,11688,5971,5717,104.4
'31050, 부천시,'030,25~29세,2019,63649,32807,30842,106.4,60515,31239,29276,106.7
'31050, 부천시,'030001, 25세,2019,12711,6605,6106,108.2,12248,6375,5873,108.5
'31050, 부천시,'030002, 26세,2019,12980,6758,6222,108.6,12459,6501,5958,109.1
'31050, 부천시,'030003, 27세,2019,13425,6963,6462,107.8,12837,6671,6166,108.2
'31050, 부천시,'030004, 28세,2019,12541,6378,6163,103.5,11874,6049,5825,103.8
'31050, 부천시,'030005, 29세,2019,11992,6103,5889,103.6,11097,5643,5454,103.5
'31050, 부천시,'035,30~34세,2019,58527,30199,28328,106.6,53623,27624,25999,106.3
'31050, 부천시,'035001, 30세,2019,11843,6149,5694,108,10908,5640,5268,107.1
'31050, 부천시,'035002, 31세,2019,11798,6123,5675,107.9,10802,5621,5181,108.5
'31050, 부천시,'035003, 32세,2019,11501,5875,5626,104.4,10441,5323,5118,104
'31050, 부천시,'035004, 33세,2019,11484,5888,5596,105.2,10514,5379,5135,104.8
'31050, 부천시,'035005, 34세,2019,11901,6164,5737,107.4,10958,5661,5297,106.9
'31050, 부천시,'040,35~39세,2019,67180,34617,32563,106.3,63566,32579,30987,105.1
'31050, 부천시,'040001, 35세,2019,12030,6180,5850,105.6,11199,5721,5478,104.4
'31050, 부천시,'040002, 36세,2019,13261,6896,6365,108.3,12415,6414,6001,106.9
'31050, 부천시,'040003, 37세,2019,14096,7297,6799,107.3,13317,6869,6448,106.5
'31050, 부천시,'040004, 38세,2019,13849,7191,6658,108,13255,6848,6407,106.9
'31050, 부천시,'040005, 39세,2019,13944,7053,6891,102.4,13380,6727,6653,101.1
'31050, 부천시,'045,40~44세,2019,61213,31257,29956,104.3,58655,29790,28865,103.2
'31050, 부천시,'045001, 40세,2019,13143,6757,6386,105.8,12581,6424,6157,104.3
'31050, 부천시,'045002, 41세,2019,11824,6112,5712,107,11275,5799,5476,105.9
'31050, 부천시,'045003, 42세,2019,12161,6195,5966,103.8,11680,5902,5778,102.1
'31050, 부천시,'045004, 43세,2019,11728,5997,5731,104.6,11227,5718,5509,103.8
'31050, 부천시,'045005, 44세,2019,12357,6196,6161,100.6,11892,5947,5945,100
'31050, 부천시,'050,45~49세,2019,72066,35921,36145,99.4,69077,34388,34689,99.1
'31050, 부천시,'050001, 45세,2019,13746,6961,6785,102.6,13246,6694,6552,102.2
'31050, 부천시,'050002, 46세,2019,13918,6994,6924,101,13349,6705,6644,100.9
'31050, 부천시,'050003, 47세,2019,14157,7166,6991,102.5,13548,6841,6707,102
'31050, 부천시,'050004, 48세,2019,15414,7621,7793,97.8,14783,7298,7485,97.5
'31050, 부천시,'050005, 49세,2019,14831,7179,7652,93.8,14151,6850,7301,93.8
'31050, 부천시,'055,50~54세,2019,74657,35882,38775,92.5,71208,34185,37023,92.3
'31050, 부천시,'055001, 50세,2019,15255,7432,7823,95,14559,7049,7510,93.9
'31050, 부천시,'055002, 51세,2019,15476,7387,8089,91.3,14778,7067,7711,91.6
'31050, 부천시,'055003, 52세,2019,14100,6679,7421,90,13524,6405,7119,90
'31050, 부천시,'055004, 53세,2019,14266,6943,7323,94.8,13612,6622,6990,94.7
'31050, 부천시,'055005, 54세,2019,15560,7441,8119,91.6,14735,7042,7693,91.5
'31050, 부천시,'060,55~59세,2019,79668,39038,40630,96.1,75556,37017,38539,96.1
'31050, 부천시,'060001, 55세,2019,14536,7020,7516,93.4,13721,6602,7119,92.7
'31050, 부천시,'060002, 56세,2019,15478,7663,7815,98.1,14411,7139,7272,98.2
'31050, 부천시,'060003, 57세,2019,15848,7854,7994,98.2,14980,7438,7542,98.6
'31050, 부천시,'060004, 58세,2019,16753,8160,8593,95,16227,7903,8324,94.9
'31050, 부천시,'060005, 59세,2019,17053,8341,8712,95.7,16217,7935,8282,95.8
'31050, 부천시,'065,60~64세,2019,65358,32381,32977,98.2,61864,30704,31160,98.5
'31050, 부천시,'065001, 60세,2019,15024,7487,7537,99.3,14325,7136,7189,99.3
'31050, 부천시,'065002, 61세,2019,13737,6800,6937,98,13000,6450,6550,98.5
'31050, 부천시,'065003, 62세,2019,13246,6568,6678,98.4,12487,6198,6289,98.6
'31050, 부천시,'065004, 63세,2019,11666,5730,5936,96.5,10999,5409,5590,96.8
'31050, 부천시,'065005, 64세,2019,11685,5796,5889,98.4,11053,5511,5542,99.4
'31050, 부천시,'070,65~69세,2019,38257,18915,19342,97.8,36363,18025,18338,98.3
'31050, 부천시,'070001, 65세,2019,9459,4626,4833,95.7,8916,4363,4553,95.8
'31050, 부천시,'070002, 66세,2019,8033,3974,4059,97.9,7612,3776,3836,98.4
'31050, 부천시,'070003, 67세,2019,8521,4206,4315,97.5,8145,4020,4125,97.5
'31050, 부천시,'070004, 68세,2019,5873,3007,2866,104.9,5569,2865,2704,106
'31050, 부천시,'070005, 69세,2019,6371,3102,3269,94.9,6121,3001,3120,96.2
'31050, 부천시,'075,70~74세,2019,25426,12296,13130,93.6,24902,12079,12823,94.2
'31050, 부천시,'075001, 70세,2019,6084,2988,3096,96.5,5903,2920,2983,97.9
'31050, 부천시,'075002, 71세,2019,5758,2830,2928,96.7,5649,2780,2869,96.9
'31050, 부천시,'075003, 72세,2019,5568,2616,2952,88.6,5486,2582,2904,88.9
'31050, 부천시,'075004, 73세,2019,4155,2047,2108,97.1,4062,2011,2051,98
'31050, 부천시,'075005, 74세,2019,3861,1815,2046,88.7,3802,1786,2016,88.6
'31050, 부천시,'080,75~79세,2019,18969,7927,11042,71.8,18736,7859,10877,72.3
'31050, 부천시,'080001, 75세,2019,3932,1721,2211,77.8,3880,1703,2177,78.2
'31050, 부천시,'080002, 76세,2019,3833,1644,2189,75.1,3792,1632,2160,75.6
'31050, 부천시,'080003, 77세,2019,4570,1948,2622,74.3,4521,1935,2586,74.8
'31050, 부천시,'080004, 78세,2019,3443,1345,2098,64.1,3395,1333,2062,64.6
'31050, 부천시,'080005, 79세,2019,3191,1269,1922,66,3148,1256,1892,66.4
'31050, 부천시,'085,80~84세,2019,12778,4328,8450,51.2,12605,4281,8324,51.4
'31050, 부천시,'085001, 80세,2019,3126,1154,1972,58.5,3087,1143,1944,58.8
'31050, 부천시,'085002, 81세,2019,2750,966,1784,54.1,2699,953,1746,54.6
'31050, 부천시,'085003, 82세,2019,2427,836,1591,52.5,2399,824,1575,52.3
'31050, 부천시,'085004, 83세,2019,2281,730,1551,47.1,2256,724,1532,47.3
'31050, 부천시,'085005, 84세,2019,2194,642,1552,41.4,2164,637,1527,41.7
'31050, 부천시,'086,85세이상,2019,9518,2408,7110,33.9,9430,2386,7044,33.9
'31050, 부천시,'090,85~89세,2019,6456,1759,4697,37.4,6392,1742,4650,37.5
'31050, 부천시,'090001, 85세,2019,1675,515,1160,44.4,1659,511,1148,44.5
'31050, 부천시,'090002, 86세,2019,1555,430,1125,38.2,1535,424,1111,38.2
'31050, 부천시,'090003, 87세,2019,1307,338,969,34.9,1295,333,962,34.6
'31050, 부천시,'090004, 88세,2019,996,258,738,35,990,257,733,35.1
'31050, 부천시,'090005, 89세,2019,923,218,705,30.9,913,217,696,31.2
'31050, 부천시,'095,90~94세,2019,2433,534,1899,28.1,2415,530,1885,28.1
'31050, 부천시,'095001, 90세,2019,817,196,621,31.6,814,196,618,31.7
'31050, 부천시,'095002, 91세,2019,606,135,471,28.7,601,134,467,28.7
'31050, 부천시,'095003, 92세,2019,471,106,365,29,464,104,360,28.9
'31050, 부천시,'095004, 93세,2019,312,63,249,25.3,310,62,248,25
'31050, 부천시,'095005, 94세,2019,227,34,193,17.6,226,34,192,17.7
'31050, 부천시,'100,95~99세,2019,551,102,449,22.7,545,101,444,22.7
'31050, 부천시,'100001, 95세,2019,162,32,130,24.6,160,32,128,25
'31050, 부천시,'100002, 96세,2019,159,31,128,24.2,159,31,128,24.2
'31050, 부천시,'100003, 97세,2019,108,19,89,21.3,107,19,88,21.6
'31050, 부천시,'100004, 98세,2019,75,10,65,15.4,73,10,63,15.9
'31050, 부천시,'100005, 99세,2019,47,10,37,27,46,9,37,24.3
'31050, 부천시,'101,100세이상,2019,78,13,65,20,78,13,65,20
'31050, 부천시,'102,15세미만,2019,96446,49419,47027,105.1,93982,48168,45814,105.1
'31050, 부천시,'103,15~64세,2019,635357,319971,315386,101.5,605056,304336,300720,101.2
'31050, 부천시,'104,65세이상,2019,104948,45874,59074,77.7,102036,44630,57406,77.7
'31050, 부천시,'126,평균연령,2019,42.1,41.1,43,,42.1,41.1,43,
'31050, 부천시,'127,중위연령,2019,43.2,42,44.5,,43.2,42,44.5,
'31060, 광명시,'000,합계,2019,313462,154896,158566,97.7,304507,150471,154036,97.7
'31060, 광명시,'005,0~4세,2019,11431,5817,5614,103.6,11147,5680,5467,103.9
'31060, 광명시,'005001, 0세,2019,1862,942,920,102.4,1808,917,891,102.9
'31060, 광명시,'005002, 1세,2019,2138,1085,1053,103,2079,1057,1022,103.4
'31060, 광명시,'005003, 2세,2019,2201,1110,1091,101.7,2142,1081,1061,101.9
'31060, 광명시,'005004, 3세,2019,2569,1304,1265,103.1,2502,1271,1231,103.2
'31060, 광명시,'005005, 4세,2019,2661,1376,1285,107.1,2616,1354,1262,107.3
'31060, 광명시,'010,5~9세,2019,14481,7451,7030,106,14341,7382,6959,106.1
'31060, 광명시,'010001, 5세,2019,2747,1415,1332,106.2,2717,1404,1313,106.9
'31060, 광명시,'010002, 6세,2019,2735,1403,1332,105.3,2702,1381,1321,104.5
'31060, 광명시,'010003, 7세,2019,3033,1564,1469,106.5,3001,1547,1454,106.4
'31060, 광명시,'010004, 8세,2019,3006,1533,1473,104.1,2989,1525,1464,104.2
'31060, 광명시,'010005, 9세,2019,2960,1536,1424,107.9,2932,1525,1407,108.4
'31060, 광명시,'015,10~14세,2019,15079,7667,7412,103.4,15012,7637,7375,103.6
'31060, 광명시,'015001, 10세,2019,2838,1458,1380,105.7,2823,1451,1372,105.8
'31060, 광명시,'015002, 11세,2019,3153,1582,1571,100.7,3138,1573,1565,100.5
'31060, 광명시,'015003, 12세,2019,3170,1565,1605,97.5,3155,1562,1593,98.1
'31060, 광명시,'015004, 13세,2019,3004,1547,1457,106.2,2992,1540,1452,106.1
'31060, 광명시,'015005, 14세,2019,2914,1515,1399,108.3,2904,1511,1393,108.5
'31060, 광명시,'020,15~19세,2019,16676,8686,7990,108.7,16617,8655,7962,108.7
'31060, 광명시,'020001, 15세,2019,3248,1674,1574,106.4,3243,1670,1573,106.2
'31060, 광명시,'020002, 16세,2019,3213,1700,1513,112.4,3202,1694,1508,112.3
'31060, 광명시,'020003, 17세,2019,3204,1692,1512,111.9,3194,1687,1507,111.9
'31060, 광명시,'020004, 18세,2019,3574,1815,1759,103.2,3562,1810,1752,103.3
'31060, 광명시,'020005, 19세,2019,3437,1805,1632,110.6,3416,1794,1622,110.6
'31060, 광명시,'025,20~24세,2019,18145,9594,8551,112.2,17853,9459,8394,112.7
'31060, 광명시,'025001, 20세,2019,3361,1806,1555,116.1,3323,1785,1538,116.1
'31060, 광명시,'025002, 21세,2019,3593,1950,1643,118.7,3548,1929,1619,119.1
'31060, 광명시,'025003, 22세,2019,3623,1889,1734,108.9,3566,1864,1702,109.5
'31060, 광명시,'025004, 23세,2019,3666,1921,1745,110.1,3609,1897,1712,110.8
'31060, 광명시,'025005, 24세,2019,3902,2028,1874,108.2,3807,1984,1823,108.8
'31060, 광명시,'030,25~29세,2019,20438,10680,9758,109.4,19738,10322,9416,109.6
'31060, 광명시,'030001, 25세,2019,4060,2125,1935,109.8,3963,2069,1894,109.2
'31060, 광명시,'030002, 26세,2019,3986,2071,1915,108.1,3849,2000,1849,108.2
'31060, 광명시,'030003, 27세,2019,4201,2224,1977,112.5,4087,2160,1927,112.1
'31060, 광명시,'030004, 28세,2019,4199,2195,2004,109.5,4049,2123,1926,110.2
'31060, 광명시,'030005, 29세,2019,3992,2065,1927,107.2,3790,1970,1820,108.2
'31060, 광명시,'035,30~34세,2019,20346,10335,10011,103.2,19275,9802,9473,103.5
'31060, 광명시,'035001, 30세,2019,3999,2035,1964,103.6,3780,1935,1845,104.9
'31060, 광명시,'035002, 31세,2019,3962,2001,1961,102,3741,1891,1850,102.2
'31060, 광명시,'035003, 32세,2019,4002,2027,1975,102.6,3769,1917,1852,103.5
'31060, 광명시,'035004, 33세,2019,4209,2167,2042,106.1,3995,2057,1938,106.1
'31060, 광명시,'035005, 34세,2019,4174,2105,2069,101.7,3990,2002,1988,100.7
'31060, 광명시,'040,35~39세,2019,25369,12816,12553,102.1,24541,12392,12149,102
'31060, 광명시,'040001, 35세,2019,4431,2271,2160,105.1,4233,2163,2070,104.5
'31060, 광명시,'040002, 36세,2019,4688,2421,2267,106.8,4506,2335,2171,107.6
'31060, 광명시,'040003, 37세,2019,5485,2747,2738,100.3,5310,2658,2652,100.2
'31060, 광명시,'040004, 38세,2019,5316,2638,2678,98.5,5186,2571,2615,98.3
'31060, 광명시,'040005, 39세,2019,5449,2739,2710,101.1,5306,2665,2641,100.9
'31060, 광명시,'045,40~44세,2019,25473,12567,12906,97.4,24839,12237,12602,97.1
'31060, 광명시,'045001, 40세,2019,5229,2584,2645,97.7,5075,2502,2573,97.2
'31060, 광명시,'045002, 41세,2019,4835,2398,2437,98.4,4702,2324,2378,97.7
'31060, 광명시,'045003, 42세,2019,5058,2445,2613,93.6,4930,2381,2549,93.4
'31060, 광명시,'045004, 43세,2019,4976,2487,2489,99.9,4872,2435,2437,99.9
'31060, 광명시,'045005, 44세,2019,5375,2653,2722,97.5,5260,2595,2665,97.4
'31060, 광명시,'050,45~49세,2019,29280,14573,14707,99.1,28431,14135,14296,98.9
'31060, 광명시,'050001, 45세,2019,5752,2906,2846,102.1,5634,2845,2789,102
'31060, 광명시,'050002, 46세,2019,5914,2930,2984,98.2,5752,2844,2908,97.8
'31060, 광명시,'050003, 47세,2019,5825,2884,2941,98.1,5660,2793,2867,97.4
'31060, 광명시,'050004, 48세,2019,6089,3048,3041,100.2,5895,2955,2940,100.5
'31060, 광명시,'050005, 49세,2019,5700,2805,2895,96.9,5490,2698,2792,96.6
'31060, 광명시,'055,50~54세,2019,27176,13478,13698,98.4,26161,12983,13178,98.5
'31060, 광명시,'055001, 50세,2019,5864,2934,2930,100.1,5684,2849,2835,100.5
'31060, 광명시,'055002, 51세,2019,5747,2791,2956,94.4,5508,2673,2835,94.3
'31060, 광명시,'055003, 52세,2019,5243,2534,2709,93.5,5062,2448,2614,93.6
'31060, 광명시,'055004, 53세,2019,5024,2571,2453,104.8,4825,2476,2349,105.4
'31060, 광명시,'055005, 54세,2019,5298,2648,2650,99.9,5082,2537,2545,99.7
'31060, 광명시,'060,55~59세,2019,26112,12829,13283,96.6,24910,12239,12671,96.6
'31060, 광명시,'060001, 55세,2019,4844,2470,2374,104,4586,2336,2250,103.8
'31060, 광명시,'060002, 56세,2019,5088,2540,2548,99.7,4763,2375,2388,99.5
'31060, 광명시,'060003, 57세,2019,5101,2516,2585,97.3,4880,2412,2468,97.7
'31060, 광명시,'060004, 58세,2019,5578,2695,2883,93.5,5439,2621,2818,93
'31060, 광명시,'060005, 59세,2019,5501,2608,2893,90.1,5242,2495,2747,90.8
'31060, 광명시,'065,60~64세,2019,22909,10947,11962,91.5,21867,10427,11440,91.1
'31060, 광명시,'065001, 60세,2019,5083,2353,2730,86.2,4872,2269,2603,87.2
'31060, 광명시,'065002, 61세,2019,4737,2313,2424,95.4,4508,2193,2315,94.7
'31060, 광명시,'065003, 62세,2019,4603,2187,2416,90.5,4372,2055,2317,88.7
'31060, 광명시,'065004, 63세,2019,4233,2009,2224,90.3,4062,1921,2141,89.7
'31060, 광명시,'065005, 64세,2019,4253,2085,2168,96.2,4053,1989,2064,96.4
'31060, 광명시,'070,65~69세,2019,14478,6969,7509,92.8,13978,6734,7244,93
'31060, 광명시,'070001, 65세,2019,3588,1733,1855,93.4,3472,1681,1791,93.9
'31060, 광명시,'070002, 66세,2019,3005,1438,1567,91.8,2879,1378,1501,91.8
'31060, 광명시,'070003, 67세,2019,3185,1545,1640,94.2,3065,1488,1577,94.4
'31060, 광명시,'070004, 68세,2019,2227,1086,1141,95.2,2153,1048,1105,94.8
'31060, 광명시,'070005, 69세,2019,2473,1167,1306,89.4,2409,1139,1270,89.7
'31060, 광명시,'075,70~74세,2019,10140,4727,5413,87.3,9995,4662,5333,87.4
'31060, 광명시,'075001, 70세,2019,2370,1127,1243,90.7,2322,1103,1219,90.5
'31060, 광명시,'075002, 71세,2019,2257,1090,1167,93.4,2229,1078,1151,93.7
'31060, 광명시,'075003, 72세,2019,2320,1075,1245,86.3,2289,1060,1229,86.2
'31060, 광명시,'075004, 73세,2019,1612,725,887,81.7,1591,718,873,82.2
'31060, 광명시,'075005, 74세,2019,1581,710,871,81.5,1564,703,861,81.6
'31060, 광명시,'080,75~79세,2019,7734,3213,4521,71.1,7667,3191,4476,71.3
'31060, 광명시,'080001, 75세,2019,1537,679,858,79.1,1521,672,849,79.2
'31060, 광명시,'080002, 76세,2019,1632,690,942,73.2,1619,687,932,73.7
'31060, 광명시,'080003, 77세,2019,1867,755,1112,67.9,1860,753,1107,68
'31060, 광명시,'080004, 78세,2019,1450,580,870,66.7,1435,576,859,67.1
'31060, 광명시,'080005, 79세,2019,1248,509,739,68.9,1232,503,729,69
'31060, 광명시,'085,80~84세,2019,4885,1710,3175,53.9,4847,1700,3147,54
'31060, 광명시,'085001, 80세,2019,1212,475,737,64.5,1207,473,734,64.4
'31060, 광명시,'085002, 81세,2019,1067,381,686,55.5,1056,379,677,56
'31060, 광명시,'085003, 82세,2019,932,341,591,57.7,924,338,586,57.7
'31060, 광명시,'085004, 83세,2019,859,278,581,47.8,848,275,573,48
'31060, 광명시,'085005, 84세,2019,815,235,580,40.5,812,235,577,40.7
'31060, 광명시,'086,85세이상,2019,3310,837,2473,33.8,3288,834,2454,34
'31060, 광명시,'090,85~89세,2019,2379,634,1745,36.3,2360,631,1729,36.5
'31060, 광명시,'090001, 85세,2019,679,191,488,39.1,668,190,478,39.7
'31060, 광명시,'090002, 86세,2019,549,153,396,38.6,547,152,395,38.5
'31060, 광명시,'090003, 87세,2019,482,134,348,38.5,482,134,348,38.5
'31060, 광명시,'090004, 88세,2019,348,83,265,31.3,345,83,262,31.7
'31060, 광명시,'090005, 89세,2019,321,73,248,29.4,318,72,246,29.3
'31060, 광명시,'095,90~94세,2019,732,160,572,28,731,160,571,28
'31060, 광명시,'095001, 90세,2019,249,59,190,31.1,249,59,190,31.1
'31060, 광명시,'095002, 91세,2019,185,40,145,27.6,185,40,145,27.6
'31060, 광명시,'095003, 92세,2019,130,32,98,32.7,130,32,98,32.7
'31060, 광명시,'095004, 93세,2019,99,18,81,22.2,98,18,80,22.5
'31060, 광명시,'095005, 94세,2019,69,11,58,19,69,11,58,19
'31060, 광명시,'100,95~99세,2019,169,38,131,29,167,38,129,29.5
'31060, 광명시,'100001, 95세,2019,56,9,47,19.1,56,9,47,19.1
'31060, 광명시,'100002, 96세,2019,49,15,34,44.1,49,15,34,44.1
'31060, 광명시,'100003, 97세,2019,30,5,25,20,28,5,23,21.7
'31060, 광명시,'100004, 98세,2019,20,6,14,42.9,20,6,14,42.9
'31060, 광명시,'100005, 99세,2019,14,X,11,27.3,14,X,11,27.3
'31060, 광명시,'101,100세이상,2019,30,5,25,20,30,5,25,20
'31060, 광명시,'102,15세미만,2019,40991,20935,20056,104.4,40500,20699,19801,104.5
'31060, 광명시,'103,15~64세,2019,231924,116505,115419,100.9,224232,112651,111581,101
'31060, 광명시,'104,65세이상,2019,40547,17456,23091,75.6,39775,17121,22654,75.6
'31060, 광명시,'126,평균연령,2019,41.6,40.5,42.7,,41.5,40.4,42.6,
'31060, 광명시,'127,중위연령,2019,42.9,41.8,44.1,,42.8,41.6,44,
'31070, 평택시,'000,합계,2019,521172,271966,249206,109.1,487635,252234,235401,107.2
'31070, 평택시,'005,0~4세,2019,22759,11642,11117,104.7,21619,11094,10525,105.4
'31070, 평택시,'005001, 0세,2019,3801,1913,1888,101.3,3617,1822,1795,101.5
'31070, 평택시,'005002, 1세,2019,4153,2170,1983,109.4,3931,2057,1874,109.8
'31070, 평택시,'005003, 2세,2019,4493,2253,2240,100.6,4251,2142,2109,101.6
'31070, 평택시,'005004, 3세,2019,5052,2590,2462,105.2,4781,2468,2313,106.7
'31070, 평택시,'005005, 4세,2019,5260,2716,2544,106.8,5039,2605,2434,107
'31070, 평택시,'010,5~9세,2019,26128,13309,12819,103.8,25504,13021,12483,104.3
'31070, 평택시,'010001, 5세,2019,4986,2538,2448,103.7,4833,2468,2365,104.4
'31070, 평택시,'010002, 6세,2019,5068,2510,2558,98.1,4911,2440,2471,98.7
'31070, 평택시,'010003, 7세,2019,5482,2823,2659,106.2,5363,2766,2597,106.5
'31070, 평택시,'010004, 8세,2019,5362,2716,2646,102.6,5263,2667,2596,102.7
'31070, 평택시,'010005, 9세,2019,5230,2722,2508,108.5,5134,2680,2454,109.2
'31070, 평택시,'015,10~14세,2019,24937,12771,12166,105,24604,12611,11993,105.2
'31070, 평택시,'015001, 10세,2019,5072,2619,2453,106.8,4986,2576,2410,106.9
'31070, 평택시,'015002, 11세,2019,5202,2645,2557,103.4,5124,2608,2516,103.7
'31070, 평택시,'015003, 12세,2019,5233,2695,2538,106.2,5167,2667,2500,106.7
'31070, 평택시,'015004, 13세,2019,4816,2454,2362,103.9,4767,2424,2343,103.5
'31070, 평택시,'015005, 14세,2019,4614,2358,2256,104.5,4560,2336,2224,105
'31070, 평택시,'020,15~19세,2019,26556,13878,12678,109.5,25935,13575,12360,109.8
'31070, 평택시,'020001, 15세,2019,4858,2504,2354,106.4,4809,2480,2329,106.5
'31070, 평택시,'020002, 16세,2019,5069,2605,2464,105.7,5027,2585,2442,105.9
'31070, 평택시,'020003, 17세,2019,5237,2770,2467,112.3,5189,2745,2444,112.3
'31070, 평택시,'020004, 18세,2019,5529,2873,2656,108.2,5426,2818,2608,108.1
'31070, 평택시,'020005, 19세,2019,5863,3126,2737,114.2,5484,2947,2537,116.2
'31070, 평택시,'025,20~24세,2019,32704,17943,14761,121.6,29842,16141,13701,117.8
'31070, 평택시,'025001, 20세,2019,5814,3256,2558,127.3,5326,2990,2336,128
'31070, 평택시,'025002, 21세,2019,6335,3491,2844,122.7,5862,3227,2635,122.5
'31070, 평택시,'025003, 22세,2019,6495,3596,2899,124,5960,3235,2725,118.7
'31070, 평택시,'025004, 23세,2019,6682,3558,3124,113.9,6078,3154,2924,107.9
'31070, 평택시,'025005, 24세,2019,7378,4042,3336,121.2,6616,3535,3081,114.7
'31070, 평택시,'030,25~29세,2019,39288,22378,16910,132.3,34719,19448,15271,127.4
'31070, 평택시,'030001, 25세,2019,7514,4166,3348,124.4,6767,3685,3082,119.6
'31070, 평택시,'030002, 26세,2019,7849,4464,3385,131.9,7009,3917,3092,126.7
'31070, 평택시,'030003, 27세,2019,8152,4700,3452,136.2,7210,4090,3120,131.1
'31070, 평택시,'030004, 28세,2019,7934,4553,3381,134.7,6984,3957,3027,130.7
'31070, 평택시,'030005, 29세,2019,7839,4495,3344,134.4,6749,3799,2950,128.8
'31070, 평택시,'035,30~34세,2019,38630,21854,16776,130.3,33075,18346,14729,124.6
'31070, 평택시,'035001, 30세,2019,7615,4433,3182,139.3,6503,3721,2782,133.8
'31070, 평택시,'035002, 31세,2019,7440,4229,3211,131.7,6334,3521,2813,125.2
'31070, 평택시,'035003, 32세,2019,7787,4399,3388,129.8,6610,3658,2952,123.9
'31070, 평택시,'035004, 33세,2019,7807,4413,3394,130,6698,3703,2995,123.6
'31070, 평택시,'035005, 34세,2019,7981,4380,3601,121.6,6930,3743,3187,117.4
'31070, 평택시,'040,35~39세,2019,45770,24964,20806,120,41252,22055,19197,114.9
'31070, 평택시,'040001, 35세,2019,8045,4438,3607,123,7045,3783,3262,116
'31070, 평택시,'040002, 36세,2019,8808,4771,4037,118.2,7830,4144,3686,112.4
'31070, 평택시,'040003, 37세,2019,9664,5240,4424,118.4,8695,4646,4049,114.7
'31070, 평택시,'040004, 38세,2019,9578,5252,4326,121.4,8747,4710,4037,116.7
'31070, 평택시,'040005, 39세,2019,9675,5263,4412,119.3,8935,4772,4163,114.6
'31070, 평택시,'045,40~44세,2019,43887,23560,20327,115.9,40780,21578,19202,112.4
'31070, 평택시,'045001, 40세,2019,9356,5018,4338,115.7,8530,4495,4035,111.4
'31070, 평택시,'045002, 41세,2019,8656,4686,3970,118,7999,4248,3751,113.2
'31070, 평택시,'045003, 42세,2019,8584,4662,3922,118.9,8007,4299,3708,115.9
'31070, 평택시,'045004, 43세,2019,8421,4505,3916,115,7859,4152,3707,112
'31070, 평택시,'045005, 44세,2019,8870,4689,4181,112.2,8385,4384,4001,109.6
'31070, 평택시,'050,45~49세,2019,47819,25446,22373,113.7,45008,23825,21183,112.5
'31070, 평택시,'050001, 45세,2019,9401,5012,4389,114.2,8898,4703,4195,112.1
'31070, 평택시,'050002, 46세,2019,9445,4866,4579,106.3,8917,4567,4350,105
'31070, 평택시,'050003, 47세,2019,9481,5125,4356,117.7,8926,4819,4107,117.3
'31070, 평택시,'050004, 48세,2019,9897,5290,4607,114.8,9290,4946,4344,113.9
'31070, 평택시,'050005, 49세,2019,9595,5153,4442,116,8977,4790,4187,114.4
'31070, 평택시,'055,50~54세,2019,43989,22884,21105,108.4,41550,21578,19972,108
'31070, 평택시,'055001, 50세,2019,9703,4959,4744,104.5,9166,4688,4478,104.7
'31070, 평택시,'055002, 51세,2019,9301,4805,4496,106.9,8762,4520,4242,106.6
'31070, 평택시,'055003, 52세,2019,8312,4284,4028,106.4,7951,4066,3885,104.7
'31070, 평택시,'055004, 53세,2019,8176,4391,3785,116,7701,4141,3560,116.3
'31070, 평택시,'055005, 54세,2019,8497,4445,4052,109.7,7970,4163,3807,109.4
'31070, 평택시,'060,55~59세,2019,39520,20824,18696,111.4,37444,19799,17645,112.2
'31070, 평택시,'060001, 55세,2019,7714,4087,3627,112.7,7234,3839,3395,113.1
'31070, 평택시,'060002, 56세,2019,7973,4282,3691,116,7422,4011,3411,117.6
'31070, 평택시,'060003, 57세,2019,7681,4084,3597,113.5,7274,3872,3402,113.8
'31070, 평택시,'060004, 58세,2019,8316,4356,3960,110,8046,4247,3799,111.8
'31070, 평택시,'060005, 59세,2019,7836,4015,3821,105.1,7468,3830,3638,105.3
'31070, 평택시,'065,60~64세,2019,29854,15182,14672,103.5,28291,14445,13846,104.3
'31070, 평택시,'065001, 60세,2019,6992,3594,3398,105.8,6642,3439,3203,107.4
'31070, 평택시,'065002, 61세,2019,6383,3269,3114,105,6030,3105,2925,106.2
'31070, 평택시,'065003, 62세,2019,5724,2956,2768,106.8,5403,2812,2591,108.5
'31070, 평택시,'065004, 63세,2019,5426,2755,2671,103.1,5156,2611,2545,102.6
'31070, 평택시,'065005, 64세,2019,5329,2608,2721,95.8,5060,2478,2582,96
'31070, 평택시,'070,65~69세,2019,18588,8911,9677,92.1,17847,8552,9295,92
'31070, 평택시,'070001, 65세,2019,4455,2143,2312,92.7,4230,2039,2191,93.1
'31070, 평택시,'070002, 66세,2019,3808,1868,1940,96.3,3638,1779,1859,95.7
'31070, 평택시,'070003, 67세,2019,4165,2030,2135,95.1,4033,1964,2069,94.9
'31070, 평택시,'070004, 68세,2019,2919,1356,1563,86.8,2800,1298,1502,86.4
'31070, 평택시,'070005, 69세,2019,3241,1514,1727,87.7,3146,1472,1674,87.9
'31070, 평택시,'075,70~74세,2019,14347,6586,7761,84.9,14053,6442,7611,84.6
'31070, 평택시,'075001, 70세,2019,3134,1449,1685,86,3064,1409,1655,85.1
'31070, 평택시,'075002, 71세,2019,3184,1443,1741,82.9,3099,1409,1690,83.4
'31070, 평택시,'075003, 72세,2019,3189,1483,1706,86.9,3125,1457,1668,87.4
'31070, 평택시,'075004, 73세,2019,2420,1140,1280,89.1,2378,1116,1262,88.4
'31070, 평택시,'075005, 74세,2019,2420,1071,1349,79.4,2387,1051,1336,78.7
'31070, 평택시,'080,75~79세,2019,12231,5083,7148,71.1,12092,5021,7071,71
'31070, 평택시,'080001, 75세,2019,2430,987,1443,68.4,2401,975,1426,68.4
'31070, 평택시,'080002, 76세,2019,2436,1024,1412,72.5,2411,1014,1397,72.6
'31070, 평택시,'080003, 77세,2019,2879,1202,1677,71.7,2851,1189,1662,71.5
'31070, 평택시,'080004, 78세,2019,2381,989,1392,71,2344,971,1373,70.7
'31070, 평택시,'080005, 79세,2019,2105,881,1224,72,2085,872,1213,71.9
'31070, 평택시,'085,80~84세,2019,8775,3205,5570,57.5,8682,3175,5507,57.7
'31070, 평택시,'085001, 80세,2019,2081,783,1298,60.3,2063,779,1284,60.7
'31070, 평택시,'085002, 81세,2019,1954,717,1237,58,1931,706,1225,57.6
'31070, 평택시,'085003, 82세,2019,1784,668,1116,59.9,1762,664,1098,60.5
'31070, 평택시,'085004, 83세,2019,1573,568,1005,56.5,1554,562,992,56.7
'31070, 평택시,'085005, 84세,2019,1383,469,914,51.3,1372,464,908,51.1
'31070, 평택시,'086,85세이상,2019,5390,1546,3844,40.2,5338,1528,3810,40.1
'31070, 평택시,'090,85~89세,2019,3788,1125,2663,42.2,3753,1111,2642,42.1
'31070, 평택시,'090001, 85세,2019,1107,365,742,49.2,1096,364,732,49.7
'31070, 평택시,'090002, 86세,2019,880,278,602,46.2,868,269,599,44.9
'31070, 평택시,'090003, 87세,2019,745,204,541,37.7,739,202,537,37.6
'31070, 평택시,'090004, 88세,2019,568,145,423,34.3,564,143,421,34
'31070, 평택시,'090005, 89세,2019,488,133,355,37.5,486,133,353,37.7
'31070, 평택시,'095,90~94세,2019,1276,329,947,34.7,1264,326,938,34.8
'31070, 평택시,'095001, 90세,2019,420,118,302,39.1,412,116,296,39.2
'31070, 평택시,'095002, 91세,2019,321,82,239,34.3,320,81,239,33.9
'31070, 평택시,'095003, 92세,2019,249,63,186,33.9,248,63,185,34.1
'31070, 평택시,'095004, 93세,2019,163,39,124,31.5,161,39,122,32
'31070, 평택시,'095005, 94세,2019,123,27,96,28.1,123,27,96,28.1
'31070, 평택시,'100,95~99세,2019,284,78,206,37.9,279,77,202,38.1
'31070, 평택시,'100001, 95세,2019,81,22,59,37.3,81,22,59,37.3
'31070, 평택시,'100002, 96세,2019,89,29,60,48.3,87,29,58,50
'31070, 평택시,'100003, 97세,2019,54,15,39,38.5,52,15,37,40.5
'31070, 평택시,'100004, 98세,2019,34,8,26,30.8,34,8,26,30.8
'31070, 평택시,'100005, 99세,2019,26,X,22,18.2,25,X,22,13.6
'31070, 평택시,'101,100세이상,2019,42,14,28,50,42,14,28,50
'31070, 평택시,'102,15세미만,2019,73824,37722,36102,104.5,71727,36726,35001,104.9
'31070, 평택시,'103,15~64세,2019,388017,208913,179104,116.6,357896,190790,167106,114.2
'31070, 평택시,'104,65세이상,2019,59331,25331,34000,74.5,58012,24718,33294,74.2
'31070, 평택시,'126,평균연령,2019,40,39.1,41,,40.2,39.2,41.1,
'31070, 평택시,'127,중위연령,2019,40.4,39.5,41.6,,40.9,40,41.9,
'31080, 동두천시,'000,합계,2019,96541,48387,48154,100.5,91940,45802,46138,99.3
'31080, 동두천시,'005,0~4세,2019,3021,1580,1441,109.6,2882,1495,1387,107.8
'31080, 동두천시,'005001, 0세,2019,464,259,205,126.3,446,250,196,127.6
'31080, 동두천시,'005002, 1세,2019,495,244,251,97.2,481,238,243,97.9
'31080, 동두천시,'005003, 2세,2019,603,310,293,105.8,570,290,280,103.6
'31080, 동두천시,'005004, 3세,2019,706,373,333,112,668,344,324,106.2
'31080, 동두천시,'005005, 4세,2019,753,394,359,109.7,717,373,344,108.4
'31080, 동두천시,'010,5~9세,2019,4076,2110,1966,107.3,3985,2068,1917,107.9
'31080, 동두천시,'010001, 5세,2019,758,400,358,111.7,729,390,339,115
'31080, 동두천시,'010002, 6세,2019,772,403,369,109.2,748,388,360,107.8
'31080, 동두천시,'010003, 7세,2019,841,424,417,101.7,829,416,413,100.7
'31080, 동두천시,'010004, 8세,2019,850,435,415,104.8,837,431,406,106.2
'31080, 동두천시,'010005, 9세,2019,855,448,407,110.1,842,443,399,111
'31080, 동두천시,'015,10~14세,2019,4139,2034,2105,96.6,4090,2011,2079,96.7
'31080, 동두천시,'015001, 10세,2019,841,408,433,94.2,834,402,432,93.1
'31080, 동두천시,'015002, 11세,2019,832,387,445,87,818,384,434,88.5
'31080, 동두천시,'015003, 12세,2019,896,456,440,103.6,885,451,434,103.9
'31080, 동두천시,'015004, 13세,2019,783,391,392,99.7,777,388,389,99.7
'31080, 동두천시,'015005, 14세,2019,787,392,395,99.2,776,386,390,99
'31080, 동두천시,'020,15~19세,2019,5233,2676,2557,104.7,5171,2635,2536,103.9
'31080, 동두천시,'020001, 15세,2019,922,495,427,115.9,912,489,423,115.6
'31080, 동두천시,'020002, 16세,2019,1105,572,533,107.3,1098,568,530,107.2
'31080, 동두천시,'020003, 17세,2019,922,472,450,104.9,915,466,449,103.8
'31080, 동두천시,'020004, 18세,2019,1180,573,607,94.4,1162,562,600,93.7
'31080, 동두천시,'020005, 19세,2019,1104,564,540,104.4,1084,550,534,103
'31080, 동두천시,'025,20~24세,2019,5755,3117,2638,118.2,5372,2879,2493,115.5
'31080, 동두천시,'025001, 20세,2019,1115,601,514,116.9,1083,583,500,116.6
'31080, 동두천시,'025002, 21세,2019,1156,655,501,130.7,1104,615,489,125.8
'31080, 동두천시,'025003, 22세,2019,1114,574,540,106.3,1026,515,511,100.8
'31080, 동두천시,'025004, 23세,2019,1132,614,518,118.5,1032,560,472,118.6
'31080, 동두천시,'025005, 24세,2019,1238,673,565,119.1,1127,606,521,116.3
'31080, 동두천시,'030,25~29세,2019,5897,3224,2673,120.6,5167,2830,2337,121.1
'31080, 동두천시,'030001, 25세,2019,1273,726,547,132.7,1135,640,495,129.3
'31080, 동두천시,'030002, 26세,2019,1209,674,535,126,1067,590,477,123.7
'31080, 동두천시,'030003, 27세,2019,1167,642,525,122.3,1015,564,451,125.1
'31080, 동두천시,'030004, 28세,2019,1158,603,555,108.6,1008,523,485,107.8
'31080, 동두천시,'030005, 29세,2019,1090,579,511,113.3,942,513,429,119.6
'31080, 동두천시,'035,30~34세,2019,5195,2759,2436,113.3,4413,2350,2063,113.9
'31080, 동두천시,'035001, 30세,2019,1006,543,463,117.3,853,459,394,116.5
'31080, 동두천시,'035002, 31세,2019,973,526,447,117.7,824,453,371,122.1
'31080, 동두천시,'035003, 32세,2019,1032,534,498,107.2,884,458,426,107.5
'31080, 동두천시,'035004, 33세,2019,1052,559,493,113.4,903,482,421,114.5
'31080, 동두천시,'035005, 34세,2019,1132,597,535,111.6,949,498,451,110.4
'31080, 동두천시,'040,35~39세,2019,6473,3285,3188,103,5823,2929,2894,101.2
'31080, 동두천시,'040001, 35세,2019,1134,549,585,93.8,972,464,508,91.3
'31080, 동두천시,'040002, 36세,2019,1236,654,582,112.4,1092,576,516,111.6
'31080, 동두천시,'040003, 37세,2019,1327,672,655,102.6,1203,603,600,100.5
'31080, 동두천시,'040004, 38세,2019,1396,706,690,102.3,1279,643,636,101.1
'31080, 동두천시,'040005, 39세,2019,1380,704,676,104.1,1277,643,634,101.4
'31080, 동두천시,'045,40~44세,2019,6785,3578,3207,111.6,6259,3263,2996,108.9
'31080, 동두천시,'045001, 40세,2019,1360,700,660,106.1,1245,639,606,105.4
'31080, 동두천시,'045002, 41세,2019,1232,638,594,107.4,1134,581,553,105.1
'31080, 동두천시,'045003, 42세,2019,1367,730,637,114.6,1253,657,596,110.2
'31080, 동두천시,'045004, 43세,2019,1372,744,628,118.5,1278,686,592,115.9
'31080, 동두천시,'045005, 44세,2019,1454,766,688,111.3,1349,700,649,107.9
'31080, 동두천시,'050,45~49세,2019,8214,4295,3919,109.6,7828,4056,3772,107.5
'31080, 동두천시,'050001, 45세,2019,1514,803,711,112.9,1438,759,679,111.8
'31080, 동두천시,'050002, 46세,2019,1615,823,792,103.9,1528,764,764,100
'31080, 동두천시,'050003, 47세,2019,1709,893,816,109.4,1642,855,787,108.6
'31080, 동두천시,'050004, 48세,2019,1696,880,816,107.8,1622,830,792,104.8
'31080, 동두천시,'050005, 49세,2019,1680,896,784,114.3,1598,848,750,113.1
'31080, 동두천시,'055,50~54세,2019,8126,4388,3738,117.4,7831,4200,3631,115.7
'31080, 동두천시,'055001, 50세,2019,1720,924,796,116.1,1672,895,777,115.2
'31080, 동두천시,'055002, 51세,2019,1736,950,786,120.9,1665,900,765,117.6
'31080, 동두천시,'055003, 52세,2019,1492,800,692,115.6,1442,766,676,113.3
'31080, 동두천시,'055004, 53세,2019,1571,883,688,128.3,1518,848,670,126.6
'31080, 동두천시,'055005, 54세,2019,1607,831,776,107.1,1534,791,743,106.5
'31080, 동두천시,'060,55~59세,2019,7997,4160,3837,108.4,7782,4035,3747,107.7
'31080, 동두천시,'060001, 55세,2019,1452,760,692,109.8,1402,730,672,108.6
'31080, 동두천시,'060002, 56세,2019,1610,873,737,118.5,1543,830,713,116.4
'31080, 동두천시,'060003, 57세,2019,1589,832,757,109.9,1547,812,735,110.5
'31080, 동두천시,'060004, 58세,2019,1680,850,830,102.4,1656,836,820,102
'31080, 동두천시,'060005, 59세,2019,1666,845,821,102.9,1634,827,807,102.5
'31080, 동두천시,'065,60~64세,2019,7159,3593,3566,100.8,7000,3518,3482,101
'31080, 동두천시,'065001, 60세,2019,1585,814,771,105.6,1557,801,756,106
'31080, 동두천시,'065002, 61세,2019,1528,761,767,99.2,1491,748,743,100.7
'31080, 동두천시,'065003, 62세,2019,1421,717,704,101.8,1383,701,682,102.8
'31080, 동두천시,'065004, 63세,2019,1275,629,646,97.4,1248,614,634,96.8
'31080, 동두천시,'065005, 64세,2019,1350,672,678,99.1,1321,654,667,98.1
'31080, 동두천시,'070,65~69세,2019,4824,2296,2528,90.8,4757,2272,2485,91.4
'31080, 동두천시,'070001, 65세,2019,1141,557,584,95.4,1124,551,573,96.2
'31080, 동두천시,'070002, 66세,2019,986,457,529,86.4,965,451,514,87.7
'31080, 동두천시,'070003, 67세,2019,1043,499,544,91.7,1035,498,537,92.7
'31080, 동두천시,'070004, 68세,2019,808,375,433,86.6,793,368,425,86.6
'31080, 동두천시,'070005, 69세,2019,846,408,438,93.2,840,404,436,92.7
'31080, 동두천시,'075,70~74세,2019,4490,1964,2526,77.8,4452,1946,2506,77.7
'31080, 동두천시,'075001, 70세,2019,930,399,531,75.1,916,394,522,75.5
'31080, 동두천시,'075002, 71세,2019,949,406,543,74.8,942,401,541,74.1
'31080, 동두천시,'075003, 72세,2019,1055,474,581,81.6,1046,466,580,80.3
'31080, 동두천시,'075004, 73세,2019,806,352,454,77.5,801,352,449,78.4
'31080, 동두천시,'075005, 74세,2019,750,333,417,79.9,747,333,414,80.4
'31080, 동두천시,'080,75~79세,2019,4246,1702,2544,66.9,4229,1694,2535,66.8
'31080, 동두천시,'080001, 75세,2019,771,297,474,62.7,768,296,472,62.7
'31080, 동두천시,'080002, 76세,2019,818,353,465,75.9,813,352,461,76.4
'31080, 동두천시,'080003, 77세,2019,967,373,594,62.8,965,372,593,62.7
'31080, 동두천시,'080004, 78세,2019,901,364,537,67.8,897,361,536,67.4
'31080, 동두천시,'080005, 79세,2019,789,315,474,66.5,786,313,473,66.2
'31080, 동두천시,'085,80~84세,2019,2945,1088,1857,58.6,2936,1084,1852,58.5
'31080, 동두천시,'085001, 80세,2019,701,260,441,59,700,260,440,59.1
'31080, 동두천시,'085002, 81세,2019,674,261,413,63.2,672,260,412,63.1
'31080, 동두천시,'085003, 82세,2019,592,206,386,53.4,591,206,385,53.5
'31080, 동두천시,'085004, 83세,2019,532,204,328,62.2,528,202,326,62
'31080, 동두천시,'085005, 84세,2019,446,157,289,54.3,445,156,289,54
'31080, 동두천시,'086,85세이상,2019,1966,538,1428,37.7,1963,537,1426,37.7
'31080, 동두천시,'090,85~89세,2019,1318,392,926,42.3,1315,391,924,42.3
'31080, 동두천시,'090001, 85세,2019,359,115,244,47.1,358,115,243,47.3
'31080, 동두천시,'090002, 86세,2019,304,81,223,36.3,304,81,223,36.3
'31080, 동두천시,'090003, 87세,2019,281,90,191,47.1,280,90,190,47.4
'31080, 동두천시,'090004, 88세,2019,194,54,140,38.6,194,54,140,38.6
'31080, 동두천시,'090005, 89세,2019,180,52,128,40.6,179,51,128,39.8
'31080, 동두천시,'095,90~94세,2019,521,123,398,30.9,521,123,398,30.9
'31080, 동두천시,'095001, 90세,2019,158,49,109,45,158,49,109,45
'31080, 동두천시,'095002, 91세,2019,147,31,116,26.7,147,31,116,26.7
'31080, 동두천시,'095003, 92세,2019,83,18,65,27.7,83,18,65,27.7
'31080, 동두천시,'095004, 93세,2019,83,17,66,25.8,83,17,66,25.8
'31080, 동두천시,'095005, 94세,2019,50,8,42,19,50,8,42,19
'31080, 동두천시,'100,95~99세,2019,105,18,87,20.7,105,18,87,20.7
'31080, 동두천시,'100001, 95세,2019,34,X,31,9.7,34,X,31,9.7
'31080, 동두천시,'100002, 96세,2019,30,5,25,20,30,5,25,20
'31080, 동두천시,'100003, 97세,2019,19,5,14,35.7,19,5,14,35.7
'31080, 동두천시,'100004, 98세,2019,10,X,7,42.9,10,X,7,42.9
'31080, 동두천시,'100005, 99세,2019,12,X,10,20,12,X,10,20
'31080, 동두천시,'101,100세이상,2019,22,5,17,29.4,22,5,17,29.4
'31080, 동두천시,'102,15세미만,2019,11236,5724,5512,103.8,10957,5574,5383,103.5
'31080, 동두천시,'103,15~64세,2019,66834,35075,31759,110.4,62646,32695,29951,109.2
'31080, 동두천시,'104,65세이상,2019,18471,7588,10883,69.7,18337,7533,10804,69.7
'31080, 동두천시,'126,평균연령,2019,44.5,43,46,,44.9,43.4,46.4,
'31080, 동두천시,'127,중위연령,2019,46.1,44.8,47.4,,46.9,45.6,48.2,
'31090, 안산시,'000,합계,2019,714650,370739,343911,107.8,635294,325047,310247,104.8
'31090, 안산시,'005,0~4세,2019,23281,11902,11379,104.6,20420,10418,10002,104.2
'31090, 안산시,'005001, 0세,2019,3978,2026,1952,103.8,3496,1772,1724,102.8
'31090, 안산시,'005002, 1세,2019,4219,2185,2034,107.4,3607,1876,1731,108.4
'31090, 안산시,'005003, 2세,2019,4574,2344,2230,105.1,3969,2021,1948,103.7
'31090, 안산시,'005004, 3세,2019,5091,2619,2472,105.9,4471,2300,2171,105.9
'31090, 안산시,'005005, 4세,2019,5419,2728,2691,101.4,4877,2449,2428,100.9
'31090, 안산시,'010,5~9세,2019,27371,13907,13464,103.3,25549,13010,12539,103.8
'31090, 안산시,'010001, 5세,2019,5248,2659,2589,102.7,4767,2425,2342,103.5
'31090, 안산시,'010002, 6세,2019,5178,2638,2540,103.9,4777,2447,2330,105
'31090, 안산시,'010003, 7세,2019,5632,2825,2807,100.6,5264,2657,2607,101.9
'31090, 안산시,'010004, 8세,2019,5738,2905,2833,102.5,5438,2752,2686,102.5
'31090, 안산시,'010005, 9세,2019,5575,2880,2695,106.9,5303,2729,2574,106
'31090, 안산시,'015,10~14세,2019,29724,15308,14416,106.2,28540,14751,13789,107
'31090, 안산시,'015001, 10세,2019,5582,2900,2682,108.1,5296,2766,2530,109.3
'31090, 안산시,'015002, 11세,2019,5986,3109,2877,108.1,5711,2973,2738,108.6
'31090, 안산시,'015003, 12세,2019,6443,3294,3149,104.6,6193,3178,3015,105.4
'31090, 안산시,'015004, 13세,2019,5687,2956,2731,108.2,5488,2860,2628,108.8
'31090, 안산시,'015005, 14세,2019,6026,3049,2977,102.4,5852,2974,2878,103.3
'31090, 안산시,'020,15~19세,2019,39309,20419,18890,108.1,38201,19867,18334,108.4
'31090, 안산시,'020001, 15세,2019,6694,3449,3245,106.3,6509,3358,3151,106.6
'31090, 안산시,'020002, 16세,2019,6942,3589,3353,107,6775,3511,3264,107.6
'31090, 안산시,'020003, 17세,2019,7512,3868,3644,106.1,7329,3785,3544,106.8
'31090, 안산시,'020004, 18세,2019,8722,4501,4221,106.6,8523,4398,4125,106.6
'31090, 안산시,'020005, 19세,2019,9439,5012,4427,113.2,9065,4815,4250,113.3
'31090, 안산시,'025,20~24세,2019,54175,28812,25363,113.6,50061,26249,23812,110.2
'31090, 안산시,'025001, 20세,2019,9753,5208,4545,114.6,9246,4924,4322,113.9
'31090, 안산시,'025002, 21세,2019,10057,5343,4714,113.3,9427,4954,4473,110.8
'31090, 안산시,'025003, 22세,2019,10764,5787,4977,116.3,9943,5276,4667,113
'31090, 안산시,'025004, 23세,2019,11465,6082,5383,113,10501,5452,5049,108
'31090, 안산시,'025005, 24세,2019,12136,6392,5744,111.3,10944,5643,5301,106.5
'31090, 안산시,'030,25~29세,2019,59855,33391,26464,126.2,51759,28072,23687,118.5
'31090, 안산시,'030001, 25세,2019,12319,6772,5547,122.1,11056,5940,5116,116.1
'31090, 안산시,'030002, 26세,2019,12268,6734,5534,121.7,10824,5801,5023,115.5
'31090, 안산시,'030003, 27세,2019,12562,6984,5578,125.2,10965,5915,5050,117.1
'31090, 안산시,'030004, 28세,2019,11570,6583,4987,132,9837,5415,4422,122.5
'31090, 안산시,'030005, 29세,2019,11136,6318,4818,131.1,9077,5001,4076,122.7
'31090, 안산시,'035,30~34세,2019,50375,28600,21775,131.3,39054,21594,17460,123.7
'31090, 안산시,'035001, 30세,2019,10666,6088,4578,133,8502,4734,3768,125.6
'31090, 안산시,'035002, 31세,2019,10219,5823,4396,132.5,7963,4403,3560,123.7
'31090, 안산시,'035003, 32세,2019,9978,5720,4258,134.3,7595,4256,3339,127.5
'31090, 안산시,'035004, 33세,2019,9806,5517,4289,128.6,7533,4145,3388,122.3
'31090, 안산시,'035005, 34세,2019,9706,5452,4254,128.2,7461,4056,3405,119.1
'31090, 안산시,'040,35~39세,2019,54220,29919,24301,123.1,44633,23970,20663,116
'31090, 안산시,'040001, 35세,2019,9889,5538,4351,127.3,7824,4242,3582,118.4
'31090, 안산시,'040002, 36세,2019,10438,5830,4608,126.5,8510,4606,3904,118
'31090, 안산시,'040003, 37세,2019,11301,6332,4969,127.4,9252,5048,4204,120.1
'31090, 안산시,'040004, 38세,2019,11040,6050,4990,121.2,9210,4955,4255,116.5
'31090, 안산시,'040005, 39세,2019,11552,6169,5383,114.6,9837,5119,4718,108.5
'31090, 안산시,'045,40~44세,2019,54561,28691,25870,110.9,46873,24056,22817,105.4
'31090, 안산시,'045001, 40세,2019,11032,5863,5169,113.4,9226,4752,4474,106.2
'31090, 안산시,'045002, 41세,2019,10359,5483,4876,112.4,8795,4537,4258,106.6
'31090, 안산시,'045003, 42세,2019,10682,5634,5048,111.6,9218,4744,4474,106
'31090, 안산시,'045004, 43세,2019,10757,5625,5132,109.6,9307,4771,4536,105.2
'31090, 안산시,'045005, 44세,2019,11731,6086,5645,107.8,10327,5252,5075,103.5
'31090, 안산시,'050,45~49세,2019,69730,35432,34298,103.3,61476,30597,30879,99.1
'31090, 안산시,'050001, 45세,2019,12923,6710,6213,108,11516,5879,5637,104.3
'31090, 안산시,'050002, 46세,2019,13372,6811,6561,103.8,11784,5875,5909,99.4
'31090, 안산시,'050003, 47세,2019,13693,6969,6724,103.6,12052,5958,6094,97.8
'31090, 안산시,'050004, 48세,2019,15012,7555,7457,101.3,13172,6498,6674,97.4
'31090, 안산시,'050005, 49세,2019,14730,7387,7343,100.6,12952,6387,6565,97.3
'31090, 안산시,'055,50~54세,2019,72639,36751,35888,102.4,64810,32418,32392,100.1
'31090, 안산시,'055001, 50세,2019,15301,7582,7719,98.2,13625,6640,6985,95.1
'31090, 안산시,'055002, 51세,2019,15253,7609,7644,99.5,13597,6684,6913,96.7
'31090, 안산시,'055003, 52세,2019,13898,7060,6838,103.2,12524,6261,6263,100
'31090, 안산시,'055004, 53세,2019,13849,7122,6727,105.9,12350,6331,6019,105.2
'31090, 안산시,'055005, 54세,2019,14338,7378,6960,106,12714,6502,6212,104.7
'31090, 안산시,'060,55~59세,2019,65167,34498,30669,112.5,58391,30925,27466,112.6
'31090, 안산시,'060001, 55세,2019,12904,6766,6138,110.2,11348,5925,5423,109.3
'31090, 안산시,'060002, 56세,2019,13405,7164,6241,114.8,11638,6222,5416,114.9
'31090, 안산시,'060003, 57세,2019,13039,6869,6170,111.3,11702,6186,5516,112.1
'31090, 안산시,'060004, 58세,2019,13163,6940,6223,111.5,12289,6478,5811,111.5
'31090, 안산시,'060005, 59세,2019,12656,6759,5897,114.6,11414,6114,5300,115.4
'31090, 안산시,'065,60~64세,2019,44645,23522,21123,111.4,39929,21190,18739,113.1
'31090, 안산시,'065001, 60세,2019,10822,5822,5000,116.4,9797,5294,4503,117.6
'31090, 안산시,'065002, 61세,2019,9718,5205,4513,115.3,8733,4709,4024,117
'31090, 안산시,'065003, 62세,2019,8983,4721,4262,110.8,7945,4202,3743,112.3
'31090, 안산시,'065004, 63세,2019,7705,3976,3729,106.6,6830,3569,3261,109.4
'31090, 안산시,'065005, 64세,2019,7417,3798,3619,104.9,6624,3416,3208,106.5
'31090, 안산시,'070,65~69세,2019,23966,11937,12029,99.2,21513,10805,10708,100.9
'31090, 안산시,'070001, 65세,2019,5998,3008,2990,100.6,5295,2664,2631,101.3
'31090, 안산시,'070002, 66세,2019,4950,2527,2423,104.3,4377,2247,2130,105.5
'31090, 안산시,'070003, 67세,2019,5259,2605,2654,98.2,4816,2417,2399,100.8
'31090, 안산시,'070004, 68세,2019,3741,1858,1883,98.7,3340,1685,1655,101.8
'31090, 안산시,'070005, 69세,2019,4018,1939,2079,93.3,3685,1792,1893,94.7
'31090, 안산시,'075,70~74세,2019,16285,7546,8739,86.3,15466,7240,8226,88
'31090, 안산시,'075001, 70세,2019,3780,1864,1916,97.3,3489,1741,1748,99.6
'31090, 안산시,'075002, 71세,2019,3537,1636,1901,86.1,3377,1583,1794,88.2
'31090, 안산시,'075003, 72세,2019,3573,1655,1918,86.3,3423,1604,1819,88.2
'31090, 안산시,'075004, 73세,2019,2754,1250,1504,83.1,2629,1205,1424,84.6
'31090, 안산시,'075005, 74세,2019,2641,1141,1500,76.1,2548,1107,1441,76.8
'31090, 안산시,'080,75~79세,2019,13218,5287,7931,66.7,12799,5150,7649,67.3
'31090, 안산시,'080001, 75세,2019,2630,1113,1517,73.4,2536,1083,1453,74.5
'31090, 안산시,'080002, 76세,2019,2776,1131,1645,68.8,2696,1105,1591,69.5
'31090, 안산시,'080003, 77세,2019,3014,1210,1804,67.1,2941,1187,1754,67.7
'31090, 안산시,'080004, 78세,2019,2481,939,1542,60.9,2396,912,1484,61.5
'31090, 안산시,'080005, 79세,2019,2317,894,1423,62.8,2230,863,1367,63.1
'31090, 안산시,'085,80~84세,2019,9504,3169,6335,50,9282,3113,6169,50.5
'31090, 안산시,'085001, 80세,2019,2253,835,1418,58.9,2195,818,1377,59.4
'31090, 안산시,'085002, 81세,2019,2055,681,1374,49.6,1989,665,1324,50.2
'31090, 안산시,'085003, 82세,2019,1872,626,1246,50.2,1833,614,1219,50.4
'31090, 안산시,'085004, 83세,2019,1701,537,1164,46.1,1668,532,1136,46.8
'31090, 안산시,'085005, 84세,2019,1623,490,1133,43.2,1597,484,1113,43.5
'31090, 안산시,'086,85세이상,2019,6625,1648,4977,33.1,6538,1622,4916,33
'31090, 안산시,'090,85~89세,2019,4593,1265,3328,38,4525,1245,3280,38
'31090, 안산시,'090001, 85세,2019,1278,362,916,39.5,1257,354,903,39.2
'31090, 안산시,'090002, 86세,2019,1062,310,752,41.2,1047,307,740,41.5
'31090, 안산시,'090003, 87세,2019,948,256,692,37,937,252,685,36.8
'31090, 안산시,'090004, 88세,2019,686,187,499,37.5,673,184,489,37.6
'31090, 안산시,'090005, 89세,2019,619,150,469,32,611,148,463,32
'31090, 안산시,'095,90~94세,2019,1626,312,1314,23.7,1612,308,1304,23.6
'31090, 안산시,'095001, 90세,2019,477,108,369,29.3,470,106,364,29.1
'31090, 안산시,'095002, 91세,2019,412,78,334,23.4,410,77,333,23.1
'31090, 안산시,'095003, 92세,2019,313,47,266,17.7,310,47,263,17.9
'31090, 안산시,'095004, 93세,2019,234,51,183,27.9,233,50,183,27.3
'31090, 안산시,'095005, 94세,2019,190,28,162,17.3,189,28,161,17.4
'31090, 안산시,'100,95~99세,2019,359,66,293,22.5,354,64,290,22.1
'31090, 안산시,'100001, 95세,2019,123,24,99,24.2,121,23,98,23.5
'31090, 안산시,'100002, 96세,2019,100,21,79,26.6,98,20,78,25.6
'31090, 안산시,'100003, 97세,2019,66,8,58,13.8,66,8,58,13.8
'31090, 안산시,'100004, 98세,2019,35,6,29,20.7,35,6,29,20.7
'31090, 안산시,'100005, 99세,2019,35,7,28,25,34,7,27,25.9
'31090, 안산시,'101,100세이상,2019,47,5,42,11.9,47,5,42,11.9
'31090, 안산시,'102,15세미만,2019,80376,41117,39259,104.7,74509,38179,36330,105.1
'31090, 안산시,'103,15~64세,2019,564676,300035,264641,113.4,495187,258938,236249,109.6
'31090, 안산시,'104,65세이상,2019,69598,29587,40011,73.9,65598,27930,37668,74.1
'31090, 안산시,'126,평균연령,2019,40.6,39.8,41.5,,40.7,39.8,41.6,
'31090, 안산시,'127,중위연령,2019,41.8,40.5,43.2,,42.2,41,43.4,
'31091, 상록구,'000,합계,2019,356620,181899,174721,104.1,337575,171951,165624,103.8
'31091, 상록구,'005,0~4세,2019,11385,5847,5538,105.6,10464,5358,5106,104.9
'31091, 상록구,'005001, 0세,2019,1891,943,948,99.5,1737,859,878,97.8
'31091, 상록구,'005002, 1세,2019,2031,1057,974,108.5,1810,946,864,109.5
'31091, 상록구,'005003, 2세,2019,2189,1139,1050,108.5,1987,1023,964,106.1
'31091, 상록구,'005004, 3세,2019,2532,1319,1213,108.7,2356,1220,1136,107.4
'31091, 상록구,'005005, 4세,2019,2742,1389,1353,102.7,2574,1310,1264,103.6
'31091, 상록구,'010,5~9세,2019,13765,7016,6749,104,13285,6772,6513,104
'31091, 상록구,'010001, 5세,2019,2619,1357,1262,107.5,2476,1285,1191,107.9
'31091, 상록구,'010002, 6세,2019,2584,1314,1270,103.5,2474,1258,1216,103.5
'31091, 상록구,'010003, 7세,2019,2812,1438,1374,104.7,2727,1398,1329,105.2
'31091, 상록구,'010004, 8세,2019,2885,1443,1442,100.1,2810,1409,1401,100.6
'31091, 상록구,'010005, 9세,2019,2865,1464,1401,104.5,2798,1422,1376,103.3
'31091, 상록구,'015,10~14세,2019,15089,7739,7350,105.3,14810,7596,7214,105.3
'31091, 상록구,'015001, 10세,2019,2804,1470,1334,110.2,2729,1431,1298,110.2
'31091, 상록구,'015002, 11세,2019,2956,1535,1421,108,2894,1500,1394,107.6
'31091, 상록구,'015003, 12세,2019,3293,1675,1618,103.5,3235,1645,1590,103.5
'31091, 상록구,'015004, 13세,2019,2918,1502,1416,106.1,2874,1483,1391,106.6
'31091, 상록구,'015005, 14세,2019,3118,1557,1561,99.7,3078,1537,1541,99.7
'31091, 상록구,'020,15~19세,2019,20709,10690,10019,106.7,20313,10493,9820,106.9
'31091, 상록구,'020001, 15세,2019,3422,1792,1630,109.9,3384,1773,1611,110.1
'31091, 상록구,'020002, 16세,2019,3504,1789,1715,104.3,3457,1766,1691,104.4
'31091, 상록구,'020003, 17세,2019,3819,1963,1856,105.8,3775,1939,1836,105.6
'31091, 상록구,'020004, 18세,2019,4602,2312,2290,101,4521,2270,2251,100.8
'31091, 상록구,'020005, 19세,2019,5362,2834,2528,112.1,5176,2745,2431,112.9
'31091, 상록구,'025,20~24세,2019,29489,15496,13993,110.7,28182,14805,13377,110.7
'31091, 상록구,'025001, 20세,2019,5428,2826,2602,108.6,5224,2719,2505,108.5
'31091, 상록구,'025002, 21세,2019,5545,2903,2642,109.9,5308,2777,2531,109.7
'31091, 상록구,'025003, 22세,2019,5883,3134,2749,114,5626,2995,2631,113.8
'31091, 상록구,'025004, 23세,2019,6225,3291,2934,112.2,5928,3129,2799,111.8
'31091, 상록구,'025005, 24세,2019,6408,3342,3066,109,6096,3185,2911,109.4
'31091, 상록구,'030,25~29세,2019,29715,16182,13533,119.6,27770,15117,12653,119.5
'31091, 상록구,'030001, 25세,2019,6350,3450,2900,119,6059,3291,2768,118.9
'31091, 상록구,'030002, 26세,2019,6210,3354,2856,117.4,5842,3158,2684,117.7
'31091, 상록구,'030003, 27세,2019,6293,3436,2857,120.3,5914,3228,2686,120.2
'31091, 상록구,'030004, 28세,2019,5623,3064,2559,119.7,5226,2836,2390,118.7
'31091, 상록구,'030005, 29세,2019,5239,2878,2361,121.9,4729,2604,2125,122.5
'31091, 상록구,'035,30~34세,2019,22469,12303,10166,121,19801,10866,8935,121.6
'31091, 상록구,'035001, 30세,2019,4810,2657,2153,123.4,4290,2389,1901,125.7
'31091, 상록구,'035002, 31세,2019,4543,2511,2032,123.6,4049,2244,1805,124.3
'31091, 상록구,'035003, 32세,2019,4395,2412,1983,121.6,3867,2129,1738,122.5
'31091, 상록구,'035004, 33세,2019,4406,2355,2051,114.8,3829,2048,1781,115
'31091, 상록구,'035005, 34세,2019,4315,2368,1947,121.6,3766,2056,1710,120.2
'31091, 상록구,'040,35~39세,2019,25115,13381,11734,114,22845,12145,10700,113.5
'31091, 상록구,'040001, 35세,2019,4515,2437,2078,117.3,4001,2151,1850,116.3
'31091, 상록구,'040002, 36세,2019,4849,2586,2263,114.3,4401,2335,2066,113
'31091, 상록구,'040003, 37세,2019,5235,2846,2389,119.1,4761,2592,2169,119.5
'31091, 상록구,'040004, 38세,2019,5039,2673,2366,113,4612,2450,2162,113.3
'31091, 상록구,'040005, 39세,2019,5477,2839,2638,107.6,5070,2617,2453,106.7
'31091, 상록구,'045,40~44세,2019,26232,13523,12709,106.4,24475,12529,11946,104.9
'31091, 상록구,'045001, 40세,2019,5266,2694,2572,104.7,4836,2448,2388,102.5
'31091, 상록구,'045002, 41세,2019,4899,2585,2314,111.7,4555,2385,2170,109.9
'31091, 상록구,'045003, 42세,2019,5128,2672,2456,108.8,4834,2519,2315,108.8
'31091, 상록구,'045004, 43세,2019,5204,2695,2509,107.4,4867,2505,2362,106.1
'31091, 상록구,'045005, 44세,2019,5735,2877,2858,100.7,5383,2672,2711,98.6
'31091, 상록구,'050,45~49세,2019,34441,17209,17232,99.9,32701,16249,16452,98.8
'31091, 상록구,'050001, 45세,2019,6325,3217,3108,103.5,6000,3030,2970,102
'31091, 상록구,'050002, 46세,2019,6585,3292,3293,100,6241,3112,3129,99.5
'31091, 상록구,'050003, 47세,2019,6819,3448,3371,102.3,6455,3233,3222,100.3
'31091, 상록구,'050004, 48세,2019,7365,3596,3769,95.4,7016,3407,3609,94.4
'31091, 상록구,'050005, 49세,2019,7347,3656,3691,99.1,6989,3467,3522,98.4
'31091, 상록구,'055,50~54세,2019,36286,18115,18171,99.7,34757,17313,17444,99.2
'31091, 상록구,'055001, 50세,2019,7659,3720,3939,94.4,7345,3554,3791,93.7
'31091, 상록구,'055002, 51세,2019,7502,3659,3843,95.2,7202,3494,3708,94.2
'31091, 상록구,'055003, 52세,2019,7070,3560,3510,101.4,6775,3403,3372,100.9
'31091, 상록구,'055004, 53세,2019,6973,3547,3426,103.5,6662,3395,3267,103.9
'31091, 상록구,'055005, 54세,2019,7082,3629,3453,105.1,6773,3467,3306,104.9
'31091, 상록구,'060,55~59세,2019,32256,17022,15234,111.7,30726,16290,14436,112.8
'31091, 상록구,'060001, 55세,2019,6203,3214,2989,107.5,5876,3048,2828,107.8
'31091, 상록구,'060002, 56세,2019,6582,3493,3089,113.1,6188,3307,2881,114.8
'31091, 상록구,'060003, 57세,2019,6426,3415,3011,113.4,6119,3269,2850,114.7
'31091, 상록구,'060004, 58세,2019,6734,3542,3192,111,6524,3438,3086,111.4
'31091, 상록구,'060005, 59세,2019,6311,3358,2953,113.7,6019,3228,2791,115.7
'31091, 상록구,'065,60~64세,2019,22123,11600,10523,110.2,20998,11076,9922,111.6
'31091, 상록구,'065001, 60세,2019,5377,2870,2507,114.5,5145,2751,2394,114.9
'31091, 상록구,'065002, 61세,2019,4786,2574,2212,116.4,4535,2447,2088,117.2
'31091, 상록구,'065003, 62세,2019,4490,2324,2166,107.3,4235,2205,2030,108.6
'31091, 상록구,'065004, 63세,2019,3778,1958,1820,107.6,3587,1884,1703,110.6
'31091, 상록구,'065005, 64세,2019,3692,1874,1818,103.1,3496,1789,1707,104.8
'31091, 상록구,'070,65~69세,2019,12081,5956,6125,97.2,11431,5670,5761,98.4
'31091, 상록구,'070001, 65세,2019,2989,1484,1505,98.6,2808,1395,1413,98.7
'31091, 상록구,'070002, 66세,2019,2477,1243,1234,100.7,2324,1175,1149,102.3
'31091, 상록구,'070003, 67세,2019,2700,1332,1368,97.4,2575,1285,1290,99.6
'31091, 상록구,'070004, 68세,2019,1881,897,984,91.2,1774,847,927,91.4
'31091, 상록구,'070005, 69세,2019,2034,1000,1034,96.7,1950,968,982,98.6
'31091, 상록구,'075,70~74세,2019,8930,4058,4872,83.3,8713,3983,4730,84.2
'31091, 상록구,'075001, 70세,2019,1939,933,1006,92.7,1869,905,964,93.9
'31091, 상록구,'075002, 71세,2019,1959,883,1076,82.1,1915,872,1043,83.6
'31091, 상록구,'075003, 72세,2019,1983,905,1078,84,1934,887,1047,84.7
'31091, 상록구,'075004, 73세,2019,1541,688,853,80.7,1511,676,835,81
'31091, 상록구,'075005, 74세,2019,1508,649,859,75.6,1484,643,841,76.5
'31091, 상록구,'080,75~79세,2019,7541,2982,4559,65.4,7421,2934,4487,65.4
'31091, 상록구,'080001, 75세,2019,1442,601,841,71.5,1412,590,822,71.8
'31091, 상록구,'080002, 76세,2019,1603,638,965,66.1,1576,629,947,66.4
'31091, 상록구,'080003, 77세,2019,1760,697,1063,65.6,1738,686,1052,65.2
'31091, 상록구,'080004, 78세,2019,1410,544,866,62.8,1392,538,854,63
'31091, 상록구,'080005, 79세,2019,1326,502,824,60.9,1303,491,812,60.5
'31091, 상록구,'085,80~84세,2019,5311,1799,3512,51.2,5234,1786,3448,51.8
'31091, 상록구,'085001, 80세,2019,1246,458,788,58.1,1231,455,776,58.6
'31091, 상록구,'085002, 81세,2019,1152,390,762,51.2,1119,383,736,52
'31091, 상록구,'085003, 82세,2019,1085,363,722,50.3,1075,360,715,50.3
'31091, 상록구,'085004, 83세,2019,966,319,647,49.3,953,319,634,50.3
'31091, 상록구,'085005, 84세,2019,862,269,593,45.4,856,269,587,45.8
'31091, 상록구,'086,85세이상,2019,3683,981,2702,36.3,3649,969,2680,36.2
'31091, 상록구,'090,85~89세,2019,2551,762,1789,42.6,2524,754,1770,42.6
'31091, 상록구,'090001, 85세,2019,725,219,506,43.3,719,216,503,42.9
'31091, 상록구,'090002, 86세,2019,576,181,395,45.8,570,180,390,46.2
'31091, 상록구,'090003, 87세,2019,539,159,380,41.8,533,157,376,41.8
'31091, 상록구,'090004, 88세,2019,376,109,267,40.8,372,108,264,40.9
'31091, 상록구,'090005, 89세,2019,335,94,241,39,330,93,237,39.2
'31091, 상록구,'095,90~94세,2019,881,180,701,25.7,875,177,698,25.4
'31091, 상록구,'095001, 90세,2019,259,65,194,33.5,255,63,192,32.8
'31091, 상록구,'095002, 91세,2019,230,51,179,28.5,229,51,178,28.7
'31091, 상록구,'095003, 92세,2019,157,19,138,13.8,157,19,138,13.8
'31091, 상록구,'095004, 93세,2019,136,32,104,30.8,135,31,104,29.8
'31091, 상록구,'095005, 94세,2019,99,13,86,15.1,99,13,86,15.1
'31091, 상록구,'100,95~99세,2019,220,36,184,19.6,219,35,184,19
'31091, 상록구,'100001, 95세,2019,79,13,66,19.7,78,12,66,18.2
'31091, 상록구,'100002, 96세,2019,57,8,49,16.3,57,8,49,16.3
'31091, 상록구,'100003, 97세,2019,42,7,35,20,42,7,35,20
'31091, 상록구,'100004, 98세,2019,19,X,16,18.8,19,X,16,18.8
'31091, 상록구,'100005, 99세,2019,23,5,18,27.8,23,5,18,27.8
'31091, 상록구,'101,100세이상,2019,31,X,28,10.7,31,X,28,10.7
'31091, 상록구,'102,15세미만,2019,40239,20602,19637,104.9,38559,19726,18833,104.7
'31091, 상록구,'103,15~64세,2019,278835,145521,133314,109.2,262568,136883,125685,108.9
'31091, 상록구,'104,65세이상,2019,37546,15776,21770,72.5,36448,15342,21106,72.7
'31091, 상록구,'126,평균연령,2019,40.8,39.9,41.7,,40.9,40,41.8,
'31091, 상록구,'127,중위연령,2019,42.1,40.9,43.4,,42.4,41.2,43.7,
'31092, 단원구,'000,합계,2019,358030,188840,169190,111.6,297719,153096,144623,105.9
'31092, 단원구,'005,0~4세,2019,11896,6055,5841,103.7,9956,5060,4896,103.3
'31092, 단원구,'005001, 0세,2019,2087,1083,1004,107.9,1759,913,846,107.9
'31092, 단원구,'005002, 1세,2019,2188,1128,1060,106.4,1797,930,867,107.3
'31092, 단원구,'005003, 2세,2019,2385,1205,1180,102.1,1982,998,984,101.4
'31092, 단원구,'005004, 3세,2019,2559,1300,1259,103.3,2115,1080,1035,104.3
'31092, 단원구,'005005, 4세,2019,2677,1339,1338,100.1,2303,1139,1164,97.9
'31092, 단원구,'010,5~9세,2019,13606,6891,6715,102.6,12264,6238,6026,103.5
'31092, 단원구,'010001, 5세,2019,2629,1302,1327,98.1,2291,1140,1151,99
'31092, 단원구,'010002, 6세,2019,2594,1324,1270,104.3,2303,1189,1114,106.7
'31092, 단원구,'010003, 7세,2019,2820,1387,1433,96.8,2537,1259,1278,98.5
'31092, 단원구,'010004, 8세,2019,2853,1462,1391,105.1,2628,1343,1285,104.5
'31092, 단원구,'010005, 9세,2019,2710,1416,1294,109.4,2505,1307,1198,109.1
'31092, 단원구,'015,10~14세,2019,14635,7569,7066,107.1,13730,7155,6575,108.8
'31092, 단원구,'015001, 10세,2019,2778,1430,1348,106.1,2567,1335,1232,108.4
'31092, 단원구,'015002, 11세,2019,3030,1574,1456,108.1,2817,1473,1344,109.6
'31092, 단원구,'015003, 12세,2019,3150,1619,1531,105.7,2958,1533,1425,107.6
'31092, 단원구,'015004, 13세,2019,2769,1454,1315,110.6,2614,1377,1237,111.3
'31092, 단원구,'015005, 14세,2019,2908,1492,1416,105.4,2774,1437,1337,107.5
'31092, 단원구,'020,15~19세,2019,18600,9729,8871,109.7,17888,9374,8514,110.1
'31092, 단원구,'020001, 15세,2019,3272,1657,1615,102.6,3125,1585,1540,102.9
'31092, 단원구,'020002, 16세,2019,3438,1800,1638,109.9,3318,1745,1573,110.9
'31092, 단원구,'020003, 17세,2019,3693,1905,1788,106.5,3554,1846,1708,108.1
'31092, 단원구,'020004, 18세,2019,4120,2189,1931,113.4,4002,2128,1874,113.6
'31092, 단원구,'020005, 19세,2019,4077,2178,1899,114.7,3889,2070,1819,113.8
'31092, 단원구,'025,20~24세,2019,24686,13316,11370,117.1,21879,11444,10435,109.7
'31092, 단원구,'025001, 20세,2019,4325,2382,1943,122.6,4022,2205,1817,121.4
'31092, 단원구,'025002, 21세,2019,4512,2440,2072,117.8,4119,2177,1942,112.1
'31092, 단원구,'025003, 22세,2019,4881,2653,2228,119.1,4317,2281,2036,112
'31092, 단원구,'025004, 23세,2019,5240,2791,2449,114,4573,2323,2250,103.2
'31092, 단원구,'025005, 24세,2019,5728,3050,2678,113.9,4848,2458,2390,102.8
'31092, 단원구,'030,25~29세,2019,30140,17209,12931,133.1,23989,12955,11034,117.4
'31092, 단원구,'030001, 25세,2019,5969,3322,2647,125.5,4997,2649,2348,112.8
'31092, 단원구,'030002, 26세,2019,6058,3380,2678,126.2,4982,2643,2339,113
'31092, 단원구,'030003, 27세,2019,6269,3548,2721,130.4,5051,2687,2364,113.7
'31092, 단원구,'030004, 28세,2019,5947,3519,2428,144.9,4611,2579,2032,126.9
'31092, 단원구,'030005, 29세,2019,5897,3440,2457,140,4348,2397,1951,122.9
'31092, 단원구,'035,30~34세,2019,27906,16297,11609,140.4,19253,10728,8525,125.8
'31092, 단원구,'035001, 30세,2019,5856,3431,2425,141.5,4212,2345,1867,125.6
'31092, 단원구,'035002, 31세,2019,5676,3312,2364,140.1,3914,2159,1755,123
'31092, 단원구,'035003, 32세,2019,5583,3308,2275,145.4,3728,2127,1601,132.9
'31092, 단원구,'035004, 33세,2019,5400,3162,2238,141.3,3704,2097,1607,130.5
'31092, 단원구,'035005, 34세,2019,5391,3084,2307,133.7,3695,2000,1695,118
'31092, 단원구,'040,35~39세,2019,29105,16538,12567,131.6,21788,11825,9963,118.7
'31092, 단원구,'040001, 35세,2019,5374,3101,2273,136.4,3823,2091,1732,120.7
'31092, 단원구,'040002, 36세,2019,5589,3244,2345,138.3,4109,2271,1838,123.6
'31092, 단원구,'040003, 37세,2019,6066,3486,2580,135.1,4491,2456,2035,120.7
'31092, 단원구,'040004, 38세,2019,6001,3377,2624,128.7,4598,2505,2093,119.7
'31092, 단원구,'040005, 39세,2019,6075,3330,2745,121.3,4767,2502,2265,110.5
'31092, 단원구,'045,40~44세,2019,28329,15168,13161,115.2,22398,11527,10871,106
'31092, 단원구,'045001, 40세,2019,5766,3169,2597,122,4390,2304,2086,110.5
'31092, 단원구,'045002, 41세,2019,5460,2898,2562,113.1,4240,2152,2088,103.1
'31092, 단원구,'045003, 42세,2019,5554,2962,2592,114.3,4384,2225,2159,103.1
'31092, 단원구,'045004, 43세,2019,5553,2930,2623,111.7,4440,2266,2174,104.2
'31092, 단원구,'045005, 44세,2019,5996,3209,2787,115.1,4944,2580,2364,109.1
'31092, 단원구,'050,45~49세,2019,35289,18223,17066,106.8,28775,14348,14427,99.5
'31092, 단원구,'050001, 45세,2019,6598,3493,3105,112.5,5516,2849,2667,106.8
'31092, 단원구,'050002, 46세,2019,6787,3519,3268,107.7,5543,2763,2780,99.4
'31092, 단원구,'050003, 47세,2019,6874,3521,3353,105,5597,2725,2872,94.9
'31092, 단원구,'050004, 48세,2019,7647,3959,3688,107.3,6156,3091,3065,100.8
'31092, 단원구,'050005, 49세,2019,7383,3731,3652,102.2,5963,2920,3043,96
'31092, 단원구,'055,50~54세,2019,36353,18636,17717,105.2,30053,15105,14948,101.1
'31092, 단원구,'055001, 50세,2019,7642,3862,3780,102.2,6280,3086,3194,96.6
'31092, 단원구,'055002, 51세,2019,7751,3950,3801,103.9,6395,3190,3205,99.5
'31092, 단원구,'055003, 52세,2019,6828,3500,3328,105.2,5749,2858,2891,98.9
'31092, 단원구,'055004, 53세,2019,6876,3575,3301,108.3,5688,2936,2752,106.7
'31092, 단원구,'055005, 54세,2019,7256,3749,3507,106.9,5941,3035,2906,104.4
'31092, 단원구,'060,55~59세,2019,32911,17476,15435,113.2,27665,14635,13030,112.3
'31092, 단원구,'060001, 55세,2019,6701,3552,3149,112.8,5472,2877,2595,110.9
'31092, 단원구,'060002, 56세,2019,6823,3671,3152,116.5,5450,2915,2535,115
'31092, 단원구,'060003, 57세,2019,6613,3454,3159,109.3,5583,2917,2666,109.4
'31092, 단원구,'060004, 58세,2019,6429,3398,3031,112.1,5765,3040,2725,111.6
'31092, 단원구,'060005, 59세,2019,6345,3401,2944,115.5,5395,2886,2509,115
'31092, 단원구,'065,60~64세,2019,22522,11922,10600,112.5,18931,10114,8817,114.7
'31092, 단원구,'065001, 60세,2019,5445,2952,2493,118.4,4652,2543,2109,120.6
'31092, 단원구,'065002, 61세,2019,4932,2631,2301,114.3,4198,2262,1936,116.8
'31092, 단원구,'065003, 62세,2019,4493,2397,2096,114.4,3710,1997,1713,116.6
'31092, 단원구,'065004, 63세,2019,3927,2018,1909,105.7,3243,1685,1558,108.2
'31092, 단원구,'065005, 64세,2019,3725,1924,1801,106.8,3128,1627,1501,108.4
'31092, 단원구,'070,65~69세,2019,11885,5981,5904,101.3,10082,5135,4947,103.8
'31092, 단원구,'070001, 65세,2019,3009,1524,1485,102.6,2487,1269,1218,104.2
'31092, 단원구,'070002, 66세,2019,2473,1284,1189,108,2053,1072,981,109.3
'31092, 단원구,'070003, 67세,2019,2559,1273,1286,99,2241,1132,1109,102.1
'31092, 단원구,'070004, 68세,2019,1860,961,899,106.9,1566,838,728,115.1
'31092, 단원구,'070005, 69세,2019,1984,939,1045,89.9,1735,824,911,90.5
'31092, 단원구,'075,70~74세,2019,7355,3488,3867,90.2,6753,3257,3496,93.2
'31092, 단원구,'075001, 70세,2019,1841,931,910,102.3,1620,836,784,106.6
'31092, 단원구,'075002, 71세,2019,1578,753,825,91.3,1462,711,751,94.7
'31092, 단원구,'075003, 72세,2019,1590,750,840,89.3,1489,717,772,92.9
'31092, 단원구,'075004, 73세,2019,1213,562,651,86.3,1118,529,589,89.8
'31092, 단원구,'075005, 74세,2019,1133,492,641,76.8,1064,464,600,77.3
'31092, 단원구,'080,75~79세,2019,5677,2305,3372,68.4,5378,2216,3162,70.1
'31092, 단원구,'080001, 75세,2019,1188,512,676,75.7,1124,493,631,78.1
'31092, 단원구,'080002, 76세,2019,1173,493,680,72.5,1120,476,644,73.9
'31092, 단원구,'080003, 77세,2019,1254,513,741,69.2,1203,501,702,71.4
'31092, 단원구,'080004, 78세,2019,1071,395,676,58.4,1004,374,630,59.4
'31092, 단원구,'080005, 79세,2019,991,392,599,65.4,927,372,555,67
'31092, 단원구,'085,80~84세,2019,4193,1370,2823,48.5,4048,1327,2721,48.8
'31092, 단원구,'085001, 80세,2019,1007,377,630,59.8,964,363,601,60.4
'31092, 단원구,'085002, 81세,2019,903,291,612,47.5,870,282,588,48
'31092, 단원구,'085003, 82세,2019,787,263,524,50.2,758,254,504,50.4
'31092, 단원구,'085004, 83세,2019,735,218,517,42.2,715,213,502,42.4
'31092, 단원구,'085005, 84세,2019,761,221,540,40.9,741,215,526,40.9
'31092, 단원구,'086,85세이상,2019,2942,667,2275,29.3,2889,653,2236,29.2
'31092, 단원구,'090,85~89세,2019,2042,503,1539,32.7,2001,491,1510,32.5
'31092, 단원구,'090001, 85세,2019,553,143,410,34.9,538,138,400,34.5
'31092, 단원구,'090002, 86세,2019,486,129,357,36.1,477,127,350,36.3
'31092, 단원구,'090003, 87세,2019,409,97,312,31.1,404,95,309,30.7
'31092, 단원구,'090004, 88세,2019,310,78,232,33.6,301,76,225,33.8
'31092, 단원구,'090005, 89세,2019,284,56,228,24.6,281,55,226,24.3
'31092, 단원구,'095,90~94세,2019,745,132,613,21.5,737,131,606,21.6
'31092, 단원구,'095001, 90세,2019,218,43,175,24.6,215,43,172,25
'31092, 단원구,'095002, 91세,2019,182,27,155,17.4,181,26,155,16.8
'31092, 단원구,'095003, 92세,2019,156,28,128,21.9,153,28,125,22.4
'31092, 단원구,'095004, 93세,2019,98,19,79,24.1,98,19,79,24.1
'31092, 단원구,'095005, 94세,2019,91,15,76,19.7,90,15,75,20
'31092, 단원구,'100,95~99세,2019,139,30,109,27.5,135,29,106,27.4
'31092, 단원구,'100001, 95세,2019,44,11,33,33.3,43,11,32,34.4
'31092, 단원구,'100002, 96세,2019,43,13,30,43.3,41,12,29,41.4
'31092, 단원구,'100003, 97세,2019,24,X,23,4.3,24,X,23,4.3
'31092, 단원구,'100004, 98세,2019,16,X,13,23.1,16,X,13,23.1
'31092, 단원구,'100005, 99세,2019,12,X,10,20,11,X,9,22.2
'31092, 단원구,'101,100세이상,2019,16,X,14,14.3,16,X,14,14.3
'31092, 단원구,'102,15세미만,2019,40137,20515,19622,104.6,35950,18453,17497,105.5
'31092, 단원구,'103,15~64세,2019,285841,154514,131327,117.7,232619,122055,110564,110.4
'31092, 단원구,'104,65세이상,2019,32052,13811,18241,75.7,29150,12588,16562,76
'31092, 단원구,'126,평균연령,2019,40.5,39.7,41.3,,40.5,39.7,41.3,
'31092, 단원구,'127,중위연령,2019,41.5,40.3,43,,41.9,40.8,43,
'31100, 고양시,'000,합계,2019,1024645,501941,522704,96,1005549,491852,513697,95.7
'31100, 고양시,'005,0~4세,2019,37009,18832,18177,103.6,36579,18614,17965,103.6
'31100, 고양시,'005001, 0세,2019,5963,2997,2966,101,5891,2962,2929,101.1
'31100, 고양시,'005002, 1세,2019,6649,3374,3275,103,6553,3328,3225,103.2
'31100, 고양시,'005003, 2세,2019,7249,3746,3503,106.9,7151,3692,3459,106.7
'31100, 고양시,'005004, 3세,2019,8316,4196,4120,101.8,8224,4148,4076,101.8
'31100, 고양시,'005005, 4세,2019,8832,4519,4313,104.8,8760,4484,4276,104.9
'31100, 고양시,'010,5~9세,2019,46070,23559,22511,104.7,45780,23412,22368,104.7
'31100, 고양시,'010001, 5세,2019,8628,4411,4217,104.6,8556,4371,4185,104.4
'31100, 고양시,'010002, 6세,2019,8810,4480,4330,103.5,8748,4446,4302,103.3
'31100, 고양시,'010003, 7세,2019,9725,5026,4699,107,9657,4993,4664,107.1
'31100, 고양시,'010004, 8세,2019,9592,4865,4727,102.9,9547,4847,4700,103.1
'31100, 고양시,'010005, 9세,2019,9315,4777,4538,105.3,9272,4755,4517,105.3
'31100, 고양시,'015,10~14세,2019,47198,24114,23084,104.5,47046,24039,23007,104.5
'31100, 고양시,'015001, 10세,2019,9084,4743,4341,109.3,9037,4721,4316,109.4
'31100, 고양시,'015002, 11세,2019,9832,4986,4846,102.9,9804,4970,4834,102.8
'31100, 고양시,'015003, 12세,2019,9772,5062,4710,107.5,9745,5044,4701,107.3
'31100, 고양시,'015004, 13세,2019,9261,4681,4580,102.2,9239,4671,4568,102.3
'31100, 고양시,'015005, 14세,2019,9249,4642,4607,100.8,9221,4633,4588,101
'31100, 고양시,'020,15~19세,2019,53762,27653,26109,105.9,53526,27531,25995,105.9
'31100, 고양시,'020001, 15세,2019,10334,5249,5085,103.2,10300,5236,5064,103.4
'31100, 고양시,'020002, 16세,2019,10201,5280,4921,107.3,10180,5269,4911,107.3
'31100, 고양시,'020003, 17세,2019,10623,5391,5232,103,10595,5380,5215,103.2
'31100, 고양시,'020004, 18세,2019,11486,5891,5595,105.3,11447,5882,5565,105.7
'31100, 고양시,'020005, 19세,2019,11118,5842,5276,110.7,11004,5764,5240,110
'31100, 고양시,'025,20~24세,2019,62954,32977,29977,110,61564,32182,29382,109.5
'31100, 고양시,'025001, 20세,2019,11102,6074,5028,120.8,10955,5994,4961,120.8
'31100, 고양시,'025002, 21세,2019,11968,6565,5403,121.5,11780,6455,5325,121.2
'31100, 고양시,'025003, 22세,2019,12503,6582,5921,111.2,12233,6424,5809,110.6
'31100, 고양시,'025004, 23세,2019,13327,6769,6558,103.2,12984,6582,6402,102.8
'31100, 고양시,'025005, 24세,2019,14054,6987,7067,98.9,13612,6727,6885,97.7
'31100, 고양시,'030,25~29세,2019,72213,36416,35797,101.7,69594,34866,34728,100.4
'31100, 고양시,'030001, 25세,2019,14675,7530,7145,105.4,14187,7237,6950,104.1
'31100, 고양시,'030002, 26세,2019,14955,7525,7430,101.3,14462,7227,7235,99.9
'31100, 고양시,'030003, 27세,2019,15006,7598,7408,102.6,14529,7303,7226,101.1
'31100, 고양시,'030004, 28세,2019,14270,7156,7114,100.6,13720,6855,6865,99.9
'31100, 고양시,'030005, 29세,2019,13307,6607,6700,98.6,12696,6244,6452,96.8
'31100, 고양시,'035,30~34세,2019,62250,31107,31143,99.9,59539,29598,29941,98.9
'31100, 고양시,'035001, 30세,2019,12621,6379,6242,102.2,12077,6067,6010,100.9
'31100, 고양시,'035002, 31세,2019,12339,6128,6211,98.7,11757,5828,5929,98.3
'31100, 고양시,'035003, 32세,2019,12078,6023,6055,99.5,11547,5710,5837,97.8
'31100, 고양시,'035004, 33세,2019,12419,6186,6233,99.2,11847,5866,5981,98.1
'31100, 고양시,'035005, 34세,2019,12793,6391,6402,99.8,12311,6127,6184,99.1
'31100, 고양시,'040,35~39세,2019,76174,37526,38648,97.1,73774,36208,37566,96.4
'31100, 고양시,'040001, 35세,2019,13146,6552,6594,99.4,12643,6270,6373,98.4
'31100, 고양시,'040002, 36세,2019,14830,7382,7448,99.1,14343,7107,7236,98.2
'31100, 고양시,'040003, 37세,2019,15654,7771,7883,98.6,15127,7486,7641,98
'31100, 고양시,'040004, 38세,2019,16275,7920,8355,94.8,15826,7671,8155,94.1
'31100, 고양시,'040005, 39세,2019,16269,7901,8368,94.4,15835,7674,8161,94
'31100, 고양시,'045,40~44세,2019,79305,38516,40789,94.4,77522,37518,40004,93.8
'31100, 고양시,'045001, 40세,2019,16212,7866,8346,94.2,15804,7635,8169,93.5
'31100, 고양시,'045002, 41세,2019,14831,7261,7570,95.9,14462,7050,7412,95.1
'31100, 고양시,'045003, 42세,2019,15806,7607,8199,92.8,15471,7410,8061,91.9
'31100, 고양시,'045004, 43세,2019,15637,7693,7944,96.8,15297,7497,7800,96.1
'31100, 고양시,'045005, 44세,2019,16819,8089,8730,92.7,16488,7926,8562,92.6
'31100, 고양시,'050,45~49세,2019,101101,48848,52253,93.5,99417,47955,51462,93.2
'31100, 고양시,'050001, 45세,2019,18861,9096,9765,93.1,18531,8924,9607,92.9
'31100, 고양시,'050002, 46세,2019,19189,9189,10000,91.9,18861,9011,9850,91.5
'31100, 고양시,'050003, 47세,2019,20540,9892,10648,92.9,20210,9708,10502,92.4
'31100, 고양시,'050004, 48세,2019,21520,10498,11022,95.2,21194,10336,10858,95.2
'31100, 고양시,'050005, 49세,2019,20991,10173,10818,94,20621,9976,10645,93.7
'31100, 고양시,'055,50~54세,2019,96698,47046,49652,94.8,95125,46279,48846,94.7
'31100, 고양시,'055001, 50세,2019,20982,10271,10711,95.9,20646,10112,10534,96
'31100, 고양시,'055002, 51세,2019,20338,9771,10567,92.5,20018,9603,10415,92.2
'31100, 고양시,'055003, 52세,2019,18643,8943,9700,92.2,18352,8815,9537,92.4
'31100, 고양시,'055004, 53세,2019,18043,8970,9073,98.9,17725,8805,8920,98.7
'31100, 고양시,'055005, 54세,2019,18692,9091,9601,94.7,18384,8944,9440,94.7
'31100, 고양시,'060,55~59세,2019,89996,45177,44819,100.8,88479,44493,43986,101.2
'31100, 고양시,'060001, 55세,2019,17588,8646,8942,96.7,17264,8494,8770,96.9
'31100, 고양시,'060002, 56세,2019,18461,9299,9162,101.5,18085,9130,8955,102
'31100, 고양시,'060003, 57세,2019,17723,8889,8834,100.6,17437,8765,8672,101.1
'31100, 고양시,'060004, 58세,2019,18361,9345,9016,103.6,18136,9245,8891,104
'31100, 고양시,'060005, 59세,2019,17863,8998,8865,101.5,17557,8859,8698,101.9
'31100, 고양시,'065,60~64세,2019,67254,34276,32978,103.9,66025,33706,32319,104.3
'31100, 고양시,'065001, 60세,2019,15611,7935,7676,103.4,15355,7819,7536,103.8
'31100, 고양시,'065002, 61세,2019,14152,7255,6897,105.2,13875,7139,6736,106
'31100, 고양시,'065003, 62세,2019,13655,7063,6592,107.1,13387,6947,6440,107.9
'31100, 고양시,'065004, 63세,2019,11966,6128,5838,105,11755,6016,5739,104.8
'31100, 고양시,'065005, 64세,2019,11870,5895,5975,98.7,11653,5785,5868,98.6
'31100, 고양시,'070,65~69세,2019,38496,18696,19800,94.4,37881,18426,19455,94.7
'31100, 고양시,'070001, 65세,2019,9489,4841,4648,104.2,9318,4763,4555,104.6
'31100, 고양시,'070002, 66세,2019,8207,4022,4185,96.1,8058,3958,4100,96.5
'31100, 고양시,'070003, 67세,2019,8547,4204,4343,96.8,8423,4153,4270,97.3
'31100, 고양시,'070004, 68세,2019,5685,2671,3014,88.6,5608,2639,2969,88.9
'31100, 고양시,'070005, 69세,2019,6568,2958,3610,81.9,6474,2913,3561,81.8
'31100, 고양시,'075,70~74세,2019,31558,13862,17696,78.3,31311,13754,17557,78.3
'31100, 고양시,'075001, 70세,2019,6734,3046,3688,82.6,6657,3014,3643,82.7
'31100, 고양시,'075002, 71세,2019,6789,3016,3773,79.9,6742,2994,3748,79.9
'31100, 고양시,'075003, 72세,2019,6969,3049,3920,77.8,6922,3028,3894,77.8
'31100, 고양시,'075004, 73세,2019,5643,2443,3200,76.3,5596,2425,3171,76.5
'31100, 고양시,'075005, 74세,2019,5423,2308,3115,74.1,5394,2293,3101,73.9
'31100, 고양시,'080,75~79세,2019,28139,11451,16688,68.6,28029,11415,16614,68.7
'31100, 고양시,'080001, 75세,2019,5504,2232,3272,68.2,5471,2217,3254,68.1
'31100, 고양시,'080002, 76세,2019,5686,2337,3349,69.8,5667,2329,3338,69.8
'31100, 고양시,'080003, 77세,2019,6442,2666,3776,70.6,6415,2658,3757,70.7
'31100, 고양시,'080004, 78세,2019,5454,2212,3242,68.2,5436,2210,3226,68.5
'31100, 고양시,'080005, 79세,2019,5053,2004,3049,65.7,5040,2001,3039,65.8
'31100, 고양시,'085,80~84세,2019,20479,7677,12802,60,20417,7659,12758,60
'31100, 고양시,'085001, 80세,2019,4921,1889,3032,62.3,4913,1887,3026,62.4
'31100, 고양시,'085002, 81세,2019,4431,1700,2731,62.2,4414,1693,2721,62.2
'31100, 고양시,'085003, 82세,2019,4077,1506,2571,58.6,4065,1501,2564,58.5
'31100, 고양시,'085004, 83세,2019,3674,1380,2294,60.2,3662,1377,2285,60.3
'31100, 고양시,'085005, 84세,2019,3376,1202,2174,55.3,3363,1201,2162,55.6
'31100, 고양시,'086,85세이상,2019,13989,4208,9781,43,13941,4197,9744,43.1
'31100, 고양시,'090,85~89세,2019,9814,3137,6677,47,9782,3131,6651,47.1
'31100, 고양시,'090001, 85세,2019,2702,897,1805,49.7,2691,894,1797,49.7
'31100, 고양시,'090002, 86세,2019,2260,726,1534,47.3,2257,726,1531,47.4
'31100, 고양시,'090003, 87세,2019,1945,641,1304,49.2,1935,640,1295,49.4
'31100, 고양시,'090004, 88세,2019,1528,491,1037,47.3,1524,490,1034,47.4
'31100, 고양시,'090005, 89세,2019,1379,382,997,38.3,1375,381,994,38.3
'31100, 고양시,'095,90~94세,2019,3329,850,2479,34.3,3318,845,2473,34.2
'31100, 고양시,'095001, 90세,2019,1116,315,801,39.3,1110,313,797,39.3
'31100, 고양시,'095002, 91세,2019,833,213,620,34.4,831,211,620,34
'31100, 고양시,'095003, 92세,2019,618,153,465,32.9,617,153,464,33
'31100, 고양시,'095004, 93세,2019,423,93,330,28.2,422,92,330,27.9
'31100, 고양시,'095005, 94세,2019,339,76,263,28.9,338,76,262,29
'31100, 고양시,'100,95~99세,2019,743,203,540,37.6,738,203,535,37.9
'31100, 고양시,'100001, 95세,2019,244,60,184,32.6,244,60,184,32.6
'31100, 고양시,'100002, 96세,2019,217,66,151,43.7,213,66,147,44.9
'31100, 고양시,'100003, 97세,2019,151,40,111,36,150,40,110,36.4
'31100, 고양시,'100004, 98세,2019,73,20,53,37.7,73,20,53,37.7
'31100, 고양시,'100005, 99세,2019,58,17,41,41.5,58,17,41,41.5
'31100, 고양시,'101,100세이상,2019,103,18,85,21.2,103,18,85,21.2
'31100, 고양시,'102,15세미만,2019,130277,66505,63772,104.3,129405,66065,63340,104.3
'31100, 고양시,'103,15~64세,2019,761707,379542,382165,99.3,744565,370336,374229,99
'31100, 고양시,'104,65세이상,2019,132661,55894,76767,72.8,131579,55451,76128,72.8
'31100, 고양시,'126,평균연령,2019,41.8,40.8,42.8,,41.9,40.9,42.8,
'31100, 고양시,'127,중위연령,2019,43.5,42.5,44.4,,43.6,42.6,44.5,
'31101, 덕양구,'000,합계,2019,448571,221937,226634,97.9,441142,218274,222868,97.9
'31101, 덕양구,'005,0~4세,2019,17592,8889,8703,102.1,17460,8817,8643,102
'31101, 덕양구,'005001, 0세,2019,2909,1434,1475,97.2,2885,1423,1462,97.3
'31101, 덕양구,'005002, 1세,2019,3164,1592,1572,101.3,3134,1579,1555,101.5
'31101, 덕양구,'005003, 2세,2019,3435,1832,1603,114.3,3401,1810,1591,113.8
'31101, 덕양구,'005004, 3세,2019,3993,1999,1994,100.3,3964,1981,1983,99.9
'31101, 덕양구,'005005, 4세,2019,4091,2032,2059,98.7,4076,2024,2052,98.6
'31101, 덕양구,'010,5~9세,2019,20482,10511,9971,105.4,20392,10462,9930,105.4
'31101, 덕양구,'010001, 5세,2019,4011,2046,1965,104.1,3984,2029,1955,103.8
'31101, 덕양구,'010002, 6세,2019,3935,2027,1908,106.2,3924,2019,1905,106
'31101, 덕양구,'010003, 7세,2019,4316,2230,2086,106.9,4292,2218,2074,106.9
'31101, 덕양구,'010004, 8세,2019,4293,2194,2099,104.5,4278,2188,2090,104.7
'31101, 덕양구,'010005, 9세,2019,3927,2014,1913,105.3,3914,2008,1906,105.4
'31101, 덕양구,'015,10~14세,2019,18805,9538,9267,102.9,18760,9516,9244,102.9
'31101, 덕양구,'015001, 10세,2019,3836,2006,1830,109.6,3822,1998,1824,109.5
'31101, 덕양구,'015002, 11세,2019,3997,2014,1983,101.6,3989,2009,1980,101.5
'31101, 덕양구,'015003, 12세,2019,3827,1978,1849,107,3819,1973,1846,106.9
'31101, 덕양구,'015004, 13세,2019,3587,1803,1784,101.1,3580,1802,1778,101.3
'31101, 덕양구,'015005, 14세,2019,3558,1737,1821,95.4,3550,1734,1816,95.5
'31101, 덕양구,'020,15~19세,2019,20976,10878,10098,107.7,20871,10821,10050,107.7
'31101, 덕양구,'020001, 15세,2019,3903,2010,1893,106.2,3891,2005,1886,106.3
'31101, 덕양구,'020002, 16세,2019,4009,2062,1947,105.9,3999,2059,1940,106.1
'31101, 덕양구,'020003, 17세,2019,4053,2087,1966,106.2,4043,2084,1959,106.4
'31101, 덕양구,'020004, 18세,2019,4492,2315,2177,106.3,4474,2310,2164,106.7
'31101, 덕양구,'020005, 19세,2019,4519,2404,2115,113.7,4464,2363,2101,112.5
'31101, 덕양구,'025,20~24세,2019,26723,14177,12546,113,26125,13900,12225,113.7
'31101, 덕양구,'025001, 20세,2019,4697,2575,2122,121.3,4628,2541,2087,121.8
'31101, 덕양구,'025002, 21세,2019,4886,2636,2250,117.2,4806,2598,2208,117.7
'31101, 덕양구,'025003, 22세,2019,5365,2921,2444,119.5,5242,2861,2381,120.2
'31101, 덕양구,'025004, 23세,2019,5785,3000,2785,107.7,5630,2933,2697,108.8
'31101, 덕양구,'025005, 24세,2019,5990,3045,2945,103.4,5819,2967,2852,104
'31101, 덕양구,'030,25~29세,2019,31275,16048,15227,105.4,30261,15497,14764,105
'31101, 덕양구,'030001, 25세,2019,6189,3286,2903,113.2,6006,3192,2814,113.4
'31101, 덕양구,'030002, 26세,2019,6447,3353,3094,108.4,6245,3236,3009,107.5
'31101, 덕양구,'030003, 27세,2019,6444,3310,3134,105.6,6258,3196,3062,104.4
'31101, 덕양구,'030004, 28세,2019,6202,3109,3093,100.5,6009,3014,2995,100.6
'31101, 덕양구,'030005, 29세,2019,5993,2990,3003,99.6,5743,2859,2884,99.1
'31101, 덕양구,'035,30~34세,2019,28880,14584,14296,102,27822,14036,13786,101.8
'31101, 덕양구,'035001, 30세,2019,5641,2855,2786,102.5,5431,2738,2693,101.7
'31101, 덕양구,'035002, 31세,2019,5666,2830,2836,99.8,5418,2707,2711,99.9
'31101, 덕양구,'035003, 32세,2019,5660,2861,2799,102.2,5456,2755,2701,102
'31101, 덕양구,'035004, 33세,2019,5825,2980,2845,104.7,5605,2861,2744,104.3
'31101, 덕양구,'035005, 34세,2019,6088,3058,3030,100.9,5912,2975,2937,101.3
'31101, 덕양구,'040,35~39세,2019,35802,18075,17727,102,34920,17648,17272,102.2
'31101, 덕양구,'040001, 35세,2019,6203,3090,3113,99.3,6023,3011,3012,100
'31101, 덕양구,'040002, 36세,2019,7096,3560,3536,100.7,6926,3474,3452,100.6
'31101, 덕양구,'040003, 37세,2019,7344,3746,3598,104.1,7147,3651,3496,104.4
'31101, 덕양구,'040004, 38세,2019,7613,3841,3772,101.8,7459,3766,3693,102
'31101, 덕양구,'040005, 39세,2019,7546,3838,3708,103.5,7365,3746,3619,103.5
'31101, 덕양구,'045,40~44세,2019,34752,17484,17268,101.3,34051,17126,16925,101.2
'31101, 덕양구,'045001, 40세,2019,7269,3595,3674,97.8,7136,3536,3600,98.2
'31101, 덕양구,'045002, 41세,2019,6569,3294,3275,100.6,6424,3216,3208,100.2
'31101, 덕양구,'045003, 42세,2019,6976,3490,3486,100.1,6851,3421,3430,99.7
'31101, 덕양구,'045004, 43세,2019,6719,3504,3215,109,6568,3419,3149,108.6
'31101, 덕양구,'045005, 44세,2019,7219,3601,3618,99.5,7072,3534,3538,99.9
'31101, 덕양구,'050,45~49세,2019,41030,20544,20486,100.3,40359,20210,20149,100.3
'31101, 덕양구,'050001, 45세,2019,7904,3965,3939,100.7,7772,3899,3873,100.7
'31101, 덕양구,'050002, 46세,2019,7798,3918,3880,101,7666,3850,3816,100.9
'31101, 덕양구,'050003, 47세,2019,8294,4161,4133,100.7,8165,4089,4076,100.3
'31101, 덕양구,'050004, 48세,2019,8667,4361,4306,101.3,8533,4304,4229,101.8
'31101, 덕양구,'050005, 49세,2019,8367,4139,4228,97.9,8223,4068,4155,97.9
'31101, 덕양구,'055,50~54세,2019,39954,19523,20431,95.6,39322,19217,20105,95.6
'31101, 덕양구,'055001, 50세,2019,8493,4164,4329,96.2,8367,4117,4250,96.9
'31101, 덕양구,'055002, 51세,2019,8291,3998,4293,93.1,8168,3932,4236,92.8
'31101, 덕양구,'055003, 52세,2019,7657,3689,3968,93,7520,3627,3893,93.2
'31101, 덕양구,'055004, 53세,2019,7605,3819,3786,100.9,7491,3746,3745,100
'31101, 덕양구,'055005, 54세,2019,7908,3853,4055,95,7776,3795,3981,95.3
'31101, 덕양구,'060,55~59세,2019,38920,19605,19315,101.5,38325,19344,18981,101.9
'31101, 덕양구,'060001, 55세,2019,7373,3664,3709,98.8,7257,3617,3640,99.4
'31101, 덕양구,'060002, 56세,2019,7939,4021,3918,102.6,7783,3955,3828,103.3
'31101, 덕양구,'060003, 57세,2019,7614,3832,3782,101.3,7494,3778,3716,101.7
'31101, 덕양구,'060004, 58세,2019,8020,4065,3955,102.8,7933,4030,3903,103.3
'31101, 덕양구,'060005, 59세,2019,7974,4023,3951,101.8,7858,3964,3894,101.8
'31101, 덕양구,'065,60~64세,2019,30719,15414,15305,100.7,30242,15185,15057,100.9
'31101, 덕양구,'065001, 60세,2019,6938,3533,3405,103.8,6846,3489,3357,103.9
'31101, 덕양구,'065002, 61세,2019,6425,3257,3168,102.8,6312,3207,3105,103.3
'31101, 덕양구,'065003, 62세,2019,6208,3141,3067,102.4,6089,3091,2998,103.1
'31101, 덕양구,'065004, 63세,2019,5499,2759,2740,100.7,5435,2723,2712,100.4
'31101, 덕양구,'065005, 64세,2019,5649,2724,2925,93.1,5560,2675,2885,92.7
'31101, 덕양구,'070,65~69세,2019,18713,8990,9723,92.5,18466,8885,9581,92.7
'31101, 덕양구,'070001, 65세,2019,4530,2273,2257,100.7,4474,2249,2225,101.1
'31101, 덕양구,'070002, 66세,2019,3935,1893,2042,92.7,3874,1866,2008,92.9
'31101, 덕양구,'070003, 67세,2019,4211,2081,2130,97.7,4156,2056,2100,97.9
'31101, 덕양구,'070004, 68세,2019,2816,1306,1510,86.5,2782,1294,1488,87
'31101, 덕양구,'070005, 69세,2019,3221,1437,1784,80.5,3180,1420,1760,80.7
'31101, 덕양구,'075,70~74세,2019,15535,6920,8615,80.3,15431,6871,8560,80.3
'31101, 덕양구,'075001, 70세,2019,3329,1517,1812,83.7,3292,1501,1791,83.8
'31101, 덕양구,'075002, 71세,2019,3373,1531,1842,83.1,3354,1519,1835,82.8
'31101, 덕양구,'075003, 72세,2019,3377,1503,1874,80.2,3359,1497,1862,80.4
'31101, 덕양구,'075004, 73세,2019,2781,1238,1543,80.2,2762,1230,1532,80.3
'31101, 덕양구,'075005, 74세,2019,2675,1131,1544,73.3,2664,1124,1540,73
'31101, 덕양구,'080,75~79세,2019,13353,5530,7823,70.7,13314,5521,7793,70.8
'31101, 덕양구,'080001, 75세,2019,2593,1030,1563,65.9,2585,1025,1560,65.7
'31101, 덕양구,'080002, 76세,2019,2732,1128,1604,70.3,2725,1128,1597,70.6
'31101, 덕양구,'080003, 77세,2019,3108,1284,1824,70.4,3097,1282,1815,70.6
'31101, 덕양구,'080004, 78세,2019,2530,1087,1443,75.3,2523,1086,1437,75.6
'31101, 덕양구,'080005, 79세,2019,2390,1001,1389,72.1,2384,1000,1384,72.3
'31101, 덕양구,'085,80~84세,2019,9183,3488,5695,61.2,9160,3484,5676,61.4
'31101, 덕양구,'085001, 80세,2019,2307,897,1410,63.6,2304,897,1407,63.8
'31101, 덕양구,'085002, 81세,2019,2001,777,1224,63.5,1992,774,1218,63.5
'31101, 덕양구,'085003, 82세,2019,1821,681,1140,59.7,1818,680,1138,59.8
'31101, 덕양구,'085004, 83세,2019,1612,597,1015,58.8,1608,597,1011,59.1
'31101, 덕양구,'085005, 84세,2019,1442,536,906,59.2,1438,536,902,59.4
'31101, 덕양구,'086,85세이상,2019,5877,1739,4138,42,5861,1734,4127,42
'31101, 덕양구,'090,85~89세,2019,4141,1310,2831,46.3,4130,1308,2822,46.4
'31101, 덕양구,'090001, 85세,2019,1146,372,774,48.1,1141,371,770,48.2
'31101, 덕양구,'090002, 86세,2019,970,305,665,45.9,969,305,664,45.9
'31101, 덕양구,'090003, 87세,2019,845,272,573,47.5,843,272,571,47.6
'31101, 덕양구,'090004, 88세,2019,624,211,413,51.1,623,211,412,51.2
'31101, 덕양구,'090005, 89세,2019,556,150,406,36.9,554,149,405,36.8
'31101, 덕양구,'095,90~94세,2019,1395,354,1041,34,1391,351,1040,33.8
'31101, 덕양구,'095001, 90세,2019,448,126,322,39.1,446,125,321,38.9
'31101, 덕양구,'095002, 91세,2019,341,90,251,35.9,340,89,251,35.5
'31101, 덕양구,'095003, 92세,2019,283,66,217,30.4,283,66,217,30.4
'31101, 덕양구,'095004, 93세,2019,189,41,148,27.7,188,40,148,27
'31101, 덕양구,'095005, 94세,2019,134,31,103,30.1,134,31,103,30.1
'31101, 덕양구,'100,95~99세,2019,304,74,230,32.2,303,74,229,32.3
'31101, 덕양구,'100001, 95세,2019,104,21,83,25.3,104,21,83,25.3
'31101, 덕양구,'100002, 96세,2019,81,21,60,35,80,21,59,35.6
'31101, 덕양구,'100003, 97세,2019,54,13,41,31.7,54,13,41,31.7
'31101, 덕양구,'100004, 98세,2019,41,10,31,32.3,41,10,31,32.3
'31101, 덕양구,'100005, 99세,2019,24,9,15,60,24,9,15,60
'31101, 덕양구,'101,100세이상,2019,37,X,36,2.8,37,X,36,2.8
'31101, 덕양구,'102,15세미만,2019,56879,28938,27941,103.6,56612,28795,27817,103.5
'31101, 덕양구,'103,15~64세,2019,329031,166332,162699,102.2,322298,162984,159314,102.3
'31101, 덕양구,'104,65세이상,2019,62661,26667,35994,74.1,62232,26495,35737,74.1
'31101, 덕양구,'126,평균연령,2019,42.2,41.2,43.2,,42.2,41.2,43.2,
'31101, 덕양구,'127,중위연령,2019,43.4,42.4,44.5,,43.5,42.5,44.6,
'31103, 일산동구,'000,합계,2019,287041,139807,147234,95,280372,135930,144442,94.1
'31103, 일산동구,'005,0~4세,2019,9275,4798,4477,107.2,9099,4709,4390,107.3
'31103, 일산동구,'005001, 0세,2019,1476,768,708,108.5,1451,754,697,108.2
'31103, 일산동구,'005002, 1세,2019,1675,854,821,104,1637,834,803,103.9
'31103, 일산동구,'005003, 2세,2019,1875,929,946,98.2,1836,908,928,97.8
'31103, 일산동구,'005004, 3세,2019,1966,1030,936,110,1930,1012,918,110.2
'31103, 일산동구,'005005, 4세,2019,2283,1217,1066,114.2,2245,1201,1044,115
'31103, 일산동구,'010,5~9세,2019,11975,6120,5855,104.5,11856,6058,5798,104.5
'31103, 일산동구,'010001, 5세,2019,2231,1124,1107,101.5,2202,1106,1096,100.9
'31103, 일산동구,'010002, 6세,2019,2270,1157,1113,104,2239,1144,1095,104.5
'31103, 일산동구,'010003, 7세,2019,2491,1321,1170,112.9,2466,1308,1158,113
'31103, 일산동구,'010004, 8세,2019,2468,1215,1253,97,2450,1207,1243,97.1
'31103, 일산동구,'010005, 9세,2019,2515,1303,1212,107.5,2499,1293,1206,107.2
'31103, 일산동구,'015,10~14세,2019,13027,6726,6301,106.7,12966,6700,6266,106.9
'31103, 일산동구,'015001, 10세,2019,2459,1308,1151,113.6,2443,1301,1142,113.9
'31103, 일산동구,'015002, 11세,2019,2658,1384,1274,108.6,2646,1380,1266,109
'31103, 일산동구,'015003, 12세,2019,2690,1389,1301,106.8,2680,1382,1298,106.5
'31103, 일산동구,'015004, 13세,2019,2653,1332,1321,100.8,2645,1328,1317,100.8
'31103, 일산동구,'015005, 14세,2019,2567,1313,1254,104.7,2552,1309,1243,105.3
'31103, 일산동구,'020,15~19세,2019,15444,7846,7598,103.3,15368,7804,7564,103.2
'31103, 일산동구,'020001, 15세,2019,2959,1468,1491,98.5,2945,1463,1482,98.7
'31103, 일산동구,'020002, 16세,2019,2907,1507,1400,107.6,2902,1503,1399,107.4
'31103, 일산동구,'020003, 17세,2019,3061,1513,1548,97.7,3050,1509,1541,97.9
'31103, 일산동구,'020004, 18세,2019,3390,1760,1630,108,3378,1758,1620,108.5
'31103, 일산동구,'020005, 19세,2019,3127,1598,1529,104.5,3093,1571,1522,103.2
'31103, 일산동구,'025,20~24세,2019,18260,9406,8854,106.2,17716,9032,8684,104
'31103, 일산동구,'025001, 20세,2019,3140,1718,1422,120.8,3094,1687,1407,119.9
'31103, 일산동구,'025002, 21세,2019,3443,1885,1558,121,3372,1836,1536,119.5
'31103, 일산동구,'025003, 22세,2019,3591,1824,1767,103.2,3491,1754,1737,101
'31103, 일산동구,'025004, 23세,2019,3888,1908,1980,96.4,3744,1812,1932,93.8
'31103, 일산동구,'025005, 24세,2019,4198,2071,2127,97.4,4015,1943,2072,93.8
'31103, 일산동구,'030,25~29세,2019,21871,10898,10973,99.3,20796,10195,10601,96.2
'31103, 일산동구,'030001, 25세,2019,4468,2245,2223,101,4270,2114,2156,98.1
'31103, 일산동구,'030002, 26세,2019,4568,2203,2365,93.2,4351,2062,2289,90.1
'31103, 일산동구,'030003, 27세,2019,4626,2349,2277,103.2,4430,2219,2211,100.4
'31103, 일산동구,'030004, 28세,2019,4250,2132,2118,100.7,4022,1991,2031,98
'31103, 일산동구,'030005, 29세,2019,3959,1969,1990,98.9,3723,1809,1914,94.5
'31103, 일산동구,'035,30~34세,2019,17592,8779,8813,99.6,16592,8160,8432,96.8
'31103, 일산동구,'035001, 30세,2019,3715,1910,1805,105.8,3512,1789,1723,103.8
'31103, 일산동구,'035002, 31세,2019,3574,1774,1800,98.6,3374,1658,1716,96.6
'31103, 일산동구,'035003, 32세,2019,3391,1643,1748,94,3182,1504,1678,89.6
'31103, 일산동구,'035004, 33세,2019,3461,1706,1755,97.2,3255,1583,1672,94.7
'31103, 일산동구,'035005, 34세,2019,3451,1746,1705,102.4,3269,1626,1643,99
'31103, 일산동구,'040,35~39세,2019,20404,9883,10521,93.9,19477,9300,10177,91.4
'31103, 일산동구,'040001, 35세,2019,3513,1790,1723,103.9,3305,1653,1652,100.1
'31103, 일산동구,'040002, 36세,2019,3940,1950,1990,98,3736,1825,1911,95.5
'31103, 일산동구,'040003, 37세,2019,4202,2059,2143,96.1,4007,1932,2075,93.1
'31103, 일산동구,'040004, 38세,2019,4382,2060,2322,88.7,4205,1948,2257,86.3
'31103, 일산동구,'040005, 39세,2019,4367,2024,2343,86.4,4224,1942,2282,85.1
'31103, 일산동구,'045,40~44세,2019,22104,10557,11547,91.4,21479,10174,11305,90
'31103, 일산동구,'045001, 40세,2019,4529,2192,2337,93.8,4365,2087,2278,91.6
'31103, 일산동구,'045002, 41세,2019,4159,2020,2139,94.4,4025,1938,2087,92.9
'31103, 일산동구,'045003, 42세,2019,4356,2027,2329,87,4244,1958,2286,85.7
'31103, 일산동구,'045004, 43세,2019,4451,2146,2305,93.1,4348,2079,2269,91.6
'31103, 일산동구,'045005, 44세,2019,4609,2172,2437,89.1,4497,2112,2385,88.6
'31103, 일산동구,'050,45~49세,2019,29452,13954,15498,90,28907,13655,15252,89.5
'31103, 일산동구,'050001, 45세,2019,5363,2491,2872,86.7,5261,2438,2823,86.4
'31103, 일산동구,'050002, 46세,2019,5518,2534,2984,84.9,5411,2474,2937,84.2
'31103, 일산동구,'050003, 47세,2019,6006,2871,3135,91.6,5892,2808,3084,91.1
'31103, 일산동구,'050004, 48세,2019,6322,3040,3282,92.6,6212,2981,3231,92.3
'31103, 일산동구,'050005, 49세,2019,6243,3018,3225,93.6,6131,2954,3177,93
'31103, 일산동구,'055,50~54세,2019,27911,13545,14366,94.3,27449,13313,14136,94.2
'31103, 일산동구,'055001, 50세,2019,6158,3022,3136,96.4,6043,2960,3083,96
'31103, 일산동구,'055002, 51세,2019,5847,2806,3041,92.3,5763,2765,2998,92.2
'31103, 일산동구,'055003, 52세,2019,5371,2563,2808,91.3,5299,2529,2770,91.3
'31103, 일산동구,'055004, 53세,2019,5218,2565,2653,96.7,5117,2516,2601,96.7
'31103, 일산동구,'055005, 54세,2019,5317,2589,2728,94.9,5227,2543,2684,94.7
'31103, 일산동구,'060,55~59세,2019,25877,12935,12942,99.9,25446,12732,12714,100.1
'31103, 일산동구,'060001, 55세,2019,5156,2503,2653,94.3,5052,2449,2603,94.1
'31103, 일산동구,'060002, 56세,2019,5362,2688,2674,100.5,5259,2638,2621,100.6
'31103, 일산동구,'060003, 57세,2019,5110,2563,2547,100.6,5041,2533,2508,101
'31103, 일산동구,'060004, 58세,2019,5210,2696,2514,107.2,5149,2666,2483,107.4
'31103, 일산동구,'060005, 59세,2019,5039,2485,2554,97.3,4945,2446,2499,97.9
'31103, 일산동구,'065,60~64세,2019,18646,9544,9102,104.9,18317,9402,8915,105.5
'31103, 일산동구,'065001, 60세,2019,4367,2202,2165,101.7,4292,2169,2123,102.2
'31103, 일산동구,'065002, 61세,2019,4001,2063,1938,106.4,3921,2031,1890,107.5
'31103, 일산동구,'065003, 62세,2019,3786,1978,1808,109.4,3733,1958,1775,110.3
'31103, 일산동구,'065004, 63세,2019,3340,1725,1615,106.8,3282,1693,1589,106.5
'31103, 일산동구,'065005, 64세,2019,3152,1576,1576,100,3089,1551,1538,100.8
'31103, 일산동구,'070,65~69세,2019,10188,5128,5060,101.3,10015,5052,4963,101.8
'31103, 일산동구,'070001, 65세,2019,2568,1352,1216,111.2,2513,1322,1191,111
'31103, 일산동구,'070002, 66세,2019,2216,1160,1056,109.8,2178,1146,1032,111
'31103, 일산동구,'070003, 67세,2019,2215,1087,1128,96.4,2179,1080,1099,98.3
'31103, 일산동구,'070004, 68세,2019,1447,704,743,94.8,1425,692,733,94.4
'31103, 일산동구,'070005, 69세,2019,1742,825,917,90,1720,812,908,89.4
'31103, 일산동구,'075,70~74세,2019,7881,3422,4459,76.7,7822,3400,4422,76.9
'31103, 일산동구,'075001, 70세,2019,1690,736,954,77.1,1671,728,943,77.2
'31103, 일산동구,'075002, 71세,2019,1702,736,966,76.2,1693,735,958,76.7
'31103, 일산동구,'075003, 72세,2019,1776,780,996,78.3,1765,775,990,78.3
'31103, 일산동구,'075004, 73세,2019,1407,596,811,73.5,1393,590,803,73.5
'31103, 일산동구,'075005, 74세,2019,1306,574,732,78.4,1300,572,728,78.6
'31103, 일산동구,'080,75~79세,2019,7340,2994,4346,68.9,7304,2979,4325,68.9
'31103, 일산동구,'080001, 75세,2019,1502,621,881,70.5,1491,617,874,70.6
'31103, 일산동구,'080002, 76세,2019,1486,634,852,74.4,1478,628,850,73.9
'31103, 일산동구,'080003, 77세,2019,1627,679,948,71.6,1618,675,943,71.6
'31103, 일산동구,'080004, 78세,2019,1386,535,851,62.9,1381,534,847,63
'31103, 일산동구,'080005, 79세,2019,1339,525,814,64.5,1336,525,811,64.7
'31103, 일산동구,'085,80~84세,2019,5576,2045,3531,57.9,5561,2040,3521,57.9
'31103, 일산동구,'085001, 80세,2019,1264,471,793,59.4,1262,470,792,59.3
'31103, 일산동구,'085002, 81세,2019,1182,463,719,64.4,1179,461,718,64.2
'31103, 일산동구,'085003, 82세,2019,1125,425,700,60.7,1123,424,699,60.7
'31103, 일산동구,'085004, 83세,2019,1023,363,660,55,1019,362,657,55.1
'31103, 일산동구,'085005, 84세,2019,982,323,659,49,978,323,655,49.3
'31103, 일산동구,'086,85세이상,2019,4218,1227,2991,41,4202,1225,2977,41.1
'31103, 일산동구,'090,85~89세,2019,2892,894,1998,44.7,2880,892,1988,44.9
'31103, 일산동구,'090001, 85세,2019,792,256,536,47.8,788,255,533,47.8
'31103, 일산동구,'090002, 86세,2019,661,220,441,49.9,661,220,441,49.9
'31103, 일산동구,'090003, 87세,2019,578,177,401,44.1,573,176,397,44.3
'31103, 일산동구,'090004, 88세,2019,449,140,309,45.3,448,140,308,45.5
'31103, 일산동구,'090005, 89세,2019,412,101,311,32.5,410,101,309,32.7
'31103, 일산동구,'095,90~94세,2019,1048,261,787,33.2,1046,261,785,33.2
'31103, 일산동구,'095001, 90세,2019,349,93,256,36.3,349,93,256,36.3
'31103, 일산동구,'095002, 91세,2019,272,70,202,34.7,272,70,202,34.7
'31103, 일산동구,'095003, 92세,2019,175,47,128,36.7,174,47,127,37
'31103, 일산동구,'095004, 93세,2019,127,26,101,25.7,127,26,101,25.7
'31103, 일산동구,'095005, 94세,2019,125,25,100,25,124,25,99,25.3
'31103, 일산동구,'100,95~99세,2019,242,64,178,36,240,64,176,36.4
'31103, 일산동구,'100001, 95세,2019,78,18,60,30,78,18,60,30
'31103, 일산동구,'100002, 96세,2019,86,27,59,45.8,85,27,58,46.6
'31103, 일산동구,'100003, 97세,2019,52,13,39,33.3,51,13,38,34.2
'31103, 일산동구,'100004, 98세,2019,13,X,9,44.4,13,X,9,44.4
'31103, 일산동구,'100005, 99세,2019,13,X,11,18.2,13,X,11,18.2
'31103, 일산동구,'101,100세이상,2019,36,8,28,28.6,36,8,28,28.6
'31103, 일산동구,'102,15세미만,2019,34277,17644,16633,106.1,33921,17467,16454,106.2
'31103, 일산동구,'103,15~64세,2019,217561,107347,110214,97.4,211547,103767,107780,96.3
'31103, 일산동구,'104,65세이상,2019,35203,14816,20387,72.7,34904,14696,20208,72.7
'31103, 일산동구,'126,평균연령,2019,41.9,40.9,42.8,,41.9,41,42.9,
'31103, 일산동구,'127,중위연령,2019,43.6,42.6,44.5,,43.8,43,44.6,
'31104, 일산서구,'000,합계,2019,289033,140197,148836,94.2,284035,137648,146387,94
'31104, 일산서구,'005,0~4세,2019,10142,5145,4997,103,10020,5088,4932,103.2
'31104, 일산서구,'005001, 0세,2019,1578,795,783,101.5,1555,785,770,101.9
'31104, 일산서구,'005002, 1세,2019,1810,928,882,105.2,1782,915,867,105.5
'31104, 일산서구,'005003, 2세,2019,1939,985,954,103.2,1914,974,940,103.6
'31104, 일산서구,'005004, 3세,2019,2357,1167,1190,98.1,2330,1155,1175,98.3
'31104, 일산서구,'005005, 4세,2019,2458,1270,1188,106.9,2439,1259,1180,106.7
'31104, 일산서구,'010,5~9세,2019,13613,6928,6685,103.6,13532,6892,6640,103.8
'31104, 일산서구,'010001, 5세,2019,2386,1241,1145,108.4,2370,1236,1134,109
'31104, 일산서구,'010002, 6세,2019,2605,1296,1309,99,2585,1283,1302,98.5
'31104, 일산서구,'010003, 7세,2019,2918,1475,1443,102.2,2899,1467,1432,102.4
'31104, 일산서구,'010004, 8세,2019,2831,1456,1375,105.9,2819,1452,1367,106.2
'31104, 일산서구,'010005, 9세,2019,2873,1460,1413,103.3,2859,1454,1405,103.5
'31104, 일산서구,'015,10~14세,2019,15366,7850,7516,104.4,15320,7823,7497,104.3
'31104, 일산서구,'015001, 10세,2019,2789,1429,1360,105.1,2772,1422,1350,105.3
'31104, 일산서구,'015002, 11세,2019,3177,1588,1589,99.9,3169,1581,1588,99.6
'31104, 일산서구,'015003, 12세,2019,3255,1695,1560,108.7,3246,1689,1557,108.5
'31104, 일산서구,'015004, 13세,2019,3021,1546,1475,104.8,3014,1541,1473,104.6
'31104, 일산서구,'015005, 14세,2019,3124,1592,1532,103.9,3119,1590,1529,104
'31104, 일산서구,'020,15~19세,2019,17342,8929,8413,106.1,17287,8906,8381,106.3
'31104, 일산서구,'020001, 15세,2019,3472,1771,1701,104.1,3464,1768,1696,104.2
'31104, 일산서구,'020002, 16세,2019,3285,1711,1574,108.7,3279,1707,1572,108.6
'31104, 일산서구,'020003, 17세,2019,3509,1791,1718,104.2,3502,1787,1715,104.2
'31104, 일산서구,'020004, 18세,2019,3604,1816,1788,101.6,3595,1814,1781,101.9
'31104, 일산서구,'020005, 19세,2019,3472,1840,1632,112.7,3447,1830,1617,113.2
'31104, 일산서구,'025,20~24세,2019,17971,9394,8577,109.5,17723,9250,8473,109.2
'31104, 일산서구,'025001, 20세,2019,3265,1781,1484,120,3233,1766,1467,120.4
'31104, 일산서구,'025002, 21세,2019,3639,2044,1595,128.2,3602,2021,1581,127.8
'31104, 일산서구,'025003, 22세,2019,3547,1837,1710,107.4,3500,1809,1691,107
'31104, 일산서구,'025004, 23세,2019,3654,1861,1793,103.8,3610,1837,1773,103.6
'31104, 일산서구,'025005, 24세,2019,3866,1871,1995,93.8,3778,1817,1961,92.7
'31104, 일산서구,'030,25~29세,2019,19067,9470,9597,98.7,18537,9174,9363,98
'31104, 일산서구,'030001, 25세,2019,4018,1999,2019,99,3911,1931,1980,97.5
'31104, 일산서구,'030002, 26세,2019,3940,1969,1971,99.9,3866,1929,1937,99.6
'31104, 일산서구,'030003, 27세,2019,3936,1939,1997,97.1,3841,1888,1953,96.7
'31104, 일산서구,'030004, 28세,2019,3818,1915,1903,100.6,3689,1850,1839,100.6
'31104, 일산서구,'030005, 29세,2019,3355,1648,1707,96.5,3230,1576,1654,95.3
'31104, 일산서구,'035,30~34세,2019,15778,7744,8034,96.4,15125,7402,7723,95.8
'31104, 일산서구,'035001, 30세,2019,3265,1614,1651,97.8,3134,1540,1594,96.6
'31104, 일산서구,'035002, 31세,2019,3099,1524,1575,96.8,2965,1463,1502,97.4
'31104, 일산서구,'035003, 32세,2019,3027,1519,1508,100.7,2909,1451,1458,99.5
'31104, 일산서구,'035004, 33세,2019,3133,1500,1633,91.9,2987,1422,1565,90.9
'31104, 일산서구,'035005, 34세,2019,3254,1587,1667,95.2,3130,1526,1604,95.1
'31104, 일산서구,'040,35~39세,2019,19968,9568,10400,92,19377,9260,10117,91.5
'31104, 일산서구,'040001, 35세,2019,3430,1672,1758,95.1,3315,1606,1709,94
'31104, 일산서구,'040002, 36세,2019,3794,1872,1922,97.4,3681,1808,1873,96.5
'31104, 일산서구,'040003, 37세,2019,4108,1966,2142,91.8,3973,1903,2070,91.9
'31104, 일산서구,'040004, 38세,2019,4280,2019,2261,89.3,4162,1957,2205,88.8
'31104, 일산서구,'040005, 39세,2019,4356,2039,2317,88,4246,1986,2260,87.9
'31104, 일산서구,'045,40~44세,2019,22449,10475,11974,87.5,21992,10218,11774,86.8
'31104, 일산서구,'045001, 40세,2019,4414,2079,2335,89,4303,2012,2291,87.8
'31104, 일산서구,'045002, 41세,2019,4103,1947,2156,90.3,4013,1896,2117,89.6
'31104, 일산서구,'045003, 42세,2019,4474,2090,2384,87.7,4376,2031,2345,86.6
'31104, 일산서구,'045004, 43세,2019,4467,2043,2424,84.3,4381,1999,2382,83.9
'31104, 일산서구,'045005, 44세,2019,4991,2316,2675,86.6,4919,2280,2639,86.4
'31104, 일산서구,'050,45~49세,2019,30619,14350,16269,88.2,30151,14090,16061,87.7
'31104, 일산서구,'050001, 45세,2019,5594,2640,2954,89.4,5498,2587,2911,88.9
'31104, 일산서구,'050002, 46세,2019,5873,2737,3136,87.3,5784,2687,3097,86.8
'31104, 일산서구,'050003, 47세,2019,6240,2860,3380,84.6,6153,2811,3342,84.1
'31104, 일산서구,'050004, 48세,2019,6531,3097,3434,90.2,6449,3051,3398,89.8
'31104, 일산서구,'050005, 49세,2019,6381,3016,3365,89.6,6267,2954,3313,89.2
'31104, 일산서구,'055,50~54세,2019,28833,13978,14855,94.1,28354,13749,14605,94.1
'31104, 일산서구,'055001, 50세,2019,6331,3085,3246,95,6236,3035,3201,94.8
'31104, 일산서구,'055002, 51세,2019,6200,2967,3233,91.8,6087,2906,3181,91.4
'31104, 일산서구,'055003, 52세,2019,5615,2691,2924,92,5533,2659,2874,92.5
'31104, 일산서구,'055004, 53세,2019,5220,2586,2634,98.2,5117,2543,2574,98.8
'31104, 일산서구,'055005, 54세,2019,5467,2649,2818,94,5381,2606,2775,93.9
'31104, 일산서구,'060,55~59세,2019,25199,12637,12562,100.6,24708,12417,12291,101
'31104, 일산서구,'060001, 55세,2019,5059,2479,2580,96.1,4955,2428,2527,96.1
'31104, 일산서구,'060002, 56세,2019,5160,2590,2570,100.8,5043,2537,2506,101.2
'31104, 일산서구,'060003, 57세,2019,4999,2494,2505,99.6,4902,2454,2448,100.2
'31104, 일산서구,'060004, 58세,2019,5131,2584,2547,101.5,5054,2549,2505,101.8
'31104, 일산서구,'060005, 59세,2019,4850,2490,2360,105.5,4754,2449,2305,106.2
'31104, 일산서구,'065,60~64세,2019,17889,9318,8571,108.7,17466,9119,8347,109.2
'31104, 일산서구,'065001, 60세,2019,4306,2200,2106,104.5,4217,2161,2056,105.1
'31104, 일산서구,'065002, 61세,2019,3726,1935,1791,108,3642,1901,1741,109.2
'31104, 일산서구,'065003, 62세,2019,3661,1944,1717,113.2,3565,1898,1667,113.9
'31104, 일산서구,'065004, 63세,2019,3127,1644,1483,110.9,3038,1600,1438,111.3
'31104, 일산서구,'065005, 64세,2019,3069,1595,1474,108.2,3004,1559,1445,107.9
'31104, 일산서구,'070,65~69세,2019,9595,4578,5017,91.2,9400,4489,4911,91.4
'31104, 일산서구,'070001, 65세,2019,2391,1216,1175,103.5,2331,1192,1139,104.7
'31104, 일산서구,'070002, 66세,2019,2056,969,1087,89.1,2006,946,1060,89.2
'31104, 일산서구,'070003, 67세,2019,2121,1036,1085,95.5,2088,1017,1071,95
'31104, 일산서구,'070004, 68세,2019,1422,661,761,86.9,1401,653,748,87.3
'31104, 일산서구,'070005, 69세,2019,1605,696,909,76.6,1574,681,893,76.3
'31104, 일산서구,'075,70~74세,2019,8142,3520,4622,76.2,8058,3483,4575,76.1
'31104, 일산서구,'075001, 70세,2019,1715,793,922,86,1694,785,909,86.4
'31104, 일산서구,'075002, 71세,2019,1714,749,965,77.6,1695,740,955,77.5
'31104, 일산서구,'075003, 72세,2019,1816,766,1050,73,1798,756,1042,72.6
'31104, 일산서구,'075004, 73세,2019,1455,609,846,72,1441,605,836,72.4
'31104, 일산서구,'075005, 74세,2019,1442,603,839,71.9,1430,597,833,71.7
'31104, 일산서구,'080,75~79세,2019,7446,2927,4519,64.8,7411,2915,4496,64.8
'31104, 일산서구,'080001, 75세,2019,1409,581,828,70.2,1395,575,820,70.1
'31104, 일산서구,'080002, 76세,2019,1468,575,893,64.4,1464,573,891,64.3
'31104, 일산서구,'080003, 77세,2019,1707,703,1004,70,1700,701,999,70.2
'31104, 일산서구,'080004, 78세,2019,1538,590,948,62.2,1532,590,942,62.6
'31104, 일산서구,'080005, 79세,2019,1324,478,846,56.5,1320,476,844,56.4
'31104, 일산서구,'085,80~84세,2019,5720,2144,3576,60,5696,2135,3561,60
'31104, 일산서구,'085001, 80세,2019,1350,521,829,62.8,1347,520,827,62.9
'31104, 일산서구,'085002, 81세,2019,1248,460,788,58.4,1243,458,785,58.3
'31104, 일산서구,'085003, 82세,2019,1131,400,731,54.7,1124,397,727,54.6
'31104, 일산서구,'085004, 83세,2019,1039,420,619,67.9,1035,418,617,67.7
'31104, 일산서구,'085005, 84세,2019,952,343,609,56.3,947,342,605,56.5
'31104, 일산서구,'086,85세이상,2019,3894,1242,2652,46.8,3878,1238,2640,46.9
'31104, 일산서구,'090,85~89세,2019,2781,933,1848,50.5,2772,931,1841,50.6
'31104, 일산서구,'090001, 85세,2019,764,269,495,54.3,762,268,494,54.3
'31104, 일산서구,'090002, 86세,2019,629,201,428,47,627,201,426,47.2
'31104, 일산서구,'090003, 87세,2019,522,192,330,58.2,519,192,327,58.7
'31104, 일산서구,'090004, 88세,2019,455,140,315,44.4,453,139,314,44.3
'31104, 일산서구,'090005, 89세,2019,411,131,280,46.8,411,131,280,46.8
'31104, 일산서구,'095,90~94세,2019,886,235,651,36.1,881,233,648,36
'31104, 일산서구,'095001, 90세,2019,319,96,223,43,315,95,220,43.2
'31104, 일산서구,'095002, 91세,2019,220,53,167,31.7,219,52,167,31.1
'31104, 일산서구,'095003, 92세,2019,160,40,120,33.3,160,40,120,33.3
'31104, 일산서구,'095004, 93세,2019,107,26,81,32.1,107,26,81,32.1
'31104, 일산서구,'095005, 94세,2019,80,20,60,33.3,80,20,60,33.3
'31104, 일산서구,'100,95~99세,2019,197,65,132,49.2,195,65,130,50
'31104, 일산서구,'100001, 95세,2019,62,21,41,51.2,62,21,41,51.2
'31104, 일산서구,'100002, 96세,2019,50,18,32,56.3,48,18,30,60
'31104, 일산서구,'100003, 97세,2019,45,14,31,45.2,45,14,31,45.2
'31104, 일산서구,'100004, 98세,2019,19,6,13,46.2,19,6,13,46.2
'31104, 일산서구,'100005, 99세,2019,21,6,15,40,21,6,15,40
'31104, 일산서구,'101,100세이상,2019,30,9,21,42.9,30,9,21,42.9
'31104, 일산서구,'102,15세미만,2019,39121,19923,19198,103.8,38872,19803,19069,103.8
'31104, 일산서구,'103,15~64세,2019,215115,105863,109252,96.9,210720,103585,107135,96.7
'31104, 일산서구,'104,65세이상,2019,34797,14411,20386,70.7,34443,14260,20183,70.7
'31104, 일산서구,'126,평균연령,2019,41.3,40.3,42.2,,41.3,40.3,42.2,
'31104, 일산서구,'127,중위연령,2019,43.5,42.5,44.3,,43.5,42.6,44.4,
'31110, 과천시,'000,합계,2019,53830,26584,27246,97.6,53413,26355,27058,97.4
'31110, 과천시,'005,0~4세,2019,1856,1015,841,120.7,1848,1008,840,120
'31110, 과천시,'005001, 0세,2019,283,161,122,132,282,160,122,131.1
'31110, 과천시,'005002, 1세,2019,350,206,144,143.1,349,205,144,142.4
'31110, 과천시,'005003, 2세,2019,369,206,163,126.4,366,204,162,125.9
'31110, 과천시,'005004, 3세,2019,435,232,203,114.3,434,231,203,113.8
'31110, 과천시,'005005, 4세,2019,419,210,209,100.5,417,208,209,99.5
'31110, 과천시,'010,5~9세,2019,2412,1255,1157,108.5,2408,1251,1157,108.1
'31110, 과천시,'010001, 5세,2019,454,239,215,111.2,454,239,215,111.2
'31110, 과천시,'010002, 6세,2019,455,237,218,108.7,454,236,218,108.3
'31110, 과천시,'010003, 7세,2019,518,265,253,104.7,517,264,253,104.3
'31110, 과천시,'010004, 8세,2019,494,258,236,109.3,493,257,236,108.9
'31110, 과천시,'010005, 9세,2019,491,256,235,108.9,490,255,235,108.5
'31110, 과천시,'015,10~14세,2019,2674,1389,1285,108.1,2671,1386,1285,107.9
'31110, 과천시,'015001, 10세,2019,501,245,256,95.7,500,244,256,95.3
'31110, 과천시,'015002, 11세,2019,537,283,254,111.4,537,283,254,111.4
'31110, 과천시,'015003, 12세,2019,554,291,263,110.6,553,290,263,110.3
'31110, 과천시,'015004, 13세,2019,542,286,256,111.7,541,285,256,111.3
'31110, 과천시,'015005, 14세,2019,540,284,256,110.9,540,284,256,110.9
'31110, 과천시,'020,15~19세,2019,3062,1596,1466,108.9,3058,1594,1464,108.9
'31110, 과천시,'020001, 15세,2019,608,332,276,120.3,607,332,275,120.7
'31110, 과천시,'020002, 16세,2019,569,288,281,102.5,569,288,281,102.5
'31110, 과천시,'020003, 17세,2019,605,299,306,97.7,605,299,306,97.7
'31110, 과천시,'020004, 18세,2019,667,349,318,109.7,667,349,318,109.7
'31110, 과천시,'020005, 19세,2019,613,328,285,115.1,610,326,284,114.8
'31110, 과천시,'025,20~24세,2019,3366,1828,1538,118.9,3333,1807,1526,118.4
'31110, 과천시,'025001, 20세,2019,621,345,276,125,616,341,275,124
'31110, 과천시,'025002, 21세,2019,665,351,314,111.8,660,349,311,112.2
'31110, 과천시,'025003, 22세,2019,707,416,291,143,697,409,288,142
'31110, 과천시,'025004, 23세,2019,690,364,326,111.7,684,360,324,111.1
'31110, 과천시,'025005, 24세,2019,683,352,331,106.3,676,348,328,106.1
'31110, 과천시,'030,25~29세,2019,3588,1868,1720,108.6,3541,1847,1694,109
'31110, 과천시,'030001, 25세,2019,707,367,340,107.9,700,363,337,107.7
'31110, 과천시,'030002, 26세,2019,754,372,382,97.4,742,367,375,97.9
'31110, 과천시,'030003, 27세,2019,684,353,331,106.6,674,348,326,106.7
'31110, 과천시,'030004, 28세,2019,733,389,344,113.1,724,386,338,114.2
'31110, 과천시,'030005, 29세,2019,710,387,323,119.8,701,383,318,120.4
'31110, 과천시,'035,30~34세,2019,3365,1736,1629,106.6,3309,1702,1607,105.9
'31110, 과천시,'035001, 30세,2019,673,367,306,119.9,663,363,300,121
'31110, 과천시,'035002, 31세,2019,666,347,319,108.8,650,335,315,106.3
'31110, 과천시,'035003, 32세,2019,700,341,359,95,689,335,354,94.6
'31110, 과천시,'035004, 33세,2019,660,340,320,106.3,650,335,315,106.3
'31110, 과천시,'035005, 34세,2019,666,341,325,104.9,657,334,323,103.4
'31110, 과천시,'040,35~39세,2019,3709,1907,1802,105.8,3670,1878,1792,104.8
'31110, 과천시,'040001, 35세,2019,713,371,342,108.5,703,365,338,108
'31110, 과천시,'040002, 36세,2019,743,380,363,104.7,734,371,363,102.2
'31110, 과천시,'040003, 37세,2019,734,381,353,107.9,726,375,351,106.8
'31110, 과천시,'040004, 38세,2019,771,403,368,109.5,766,400,366,109.3
'31110, 과천시,'040005, 39세,2019,748,372,376,98.9,741,367,374,98.1
'31110, 과천시,'045,40~44세,2019,3623,1701,1922,88.5,3586,1677,1909,87.8
'31110, 과천시,'045001, 40세,2019,751,380,371,102.4,745,375,370,101.4
'31110, 과천시,'045002, 41세,2019,664,313,351,89.2,655,307,348,88.2
'31110, 과천시,'045003, 42세,2019,666,298,368,81,659,293,366,80.1
'31110, 과천시,'045004, 43세,2019,770,357,413,86.4,765,354,411,86.1
'31110, 과천시,'045005, 44세,2019,772,353,419,84.2,762,348,414,84.1
'31110, 과천시,'050,45~49세,2019,5066,2420,2646,91.5,5030,2399,2631,91.2
'31110, 과천시,'050001, 45세,2019,897,437,460,95,892,434,458,94.8
'31110, 과천시,'050002, 46세,2019,978,479,499,96,966,471,495,95.2
'31110, 과천시,'050003, 47세,2019,983,469,514,91.2,976,467,509,91.7
'31110, 과천시,'050004, 48세,2019,1128,546,582,93.8,1121,541,580,93.3
'31110, 과천시,'050005, 49세,2019,1080,489,591,82.7,1075,486,589,82.5
'31110, 과천시,'055,50~54세,2019,5051,2425,2626,92.3,5006,2404,2602,92.4
'31110, 과천시,'055001, 50세,2019,1057,506,551,91.8,1049,502,547,91.8
'31110, 과천시,'055002, 51세,2019,1064,495,569,87,1057,490,567,86.4
'31110, 과천시,'055003, 52세,2019,970,453,517,87.6,956,448,508,88.2
'31110, 과천시,'055004, 53세,2019,980,499,481,103.7,971,494,477,103.6
'31110, 과천시,'055005, 54세,2019,980,472,508,92.9,973,470,503,93.4
'31110, 과천시,'060,55~59세,2019,4728,2322,2406,96.5,4695,2311,2384,96.9
'31110, 과천시,'060001, 55세,2019,891,449,442,101.6,887,448,439,102.1
'31110, 과천시,'060002, 56세,2019,995,512,483,106,986,509,477,106.7
'31110, 과천시,'060003, 57세,2019,905,445,460,96.7,900,443,457,96.9
'31110, 과천시,'060004, 58세,2019,990,489,501,97.6,985,487,498,97.8
'31110, 과천시,'060005, 59세,2019,947,427,520,82.1,937,424,513,82.7
'31110, 과천시,'065,60~64세,2019,3791,1909,1882,101.4,3760,1896,1864,101.7
'31110, 과천시,'065001, 60세,2019,834,408,426,95.8,827,406,421,96.4
'31110, 과천시,'065002, 61세,2019,814,417,397,105,804,410,394,104.1
'31110, 과천시,'065003, 62세,2019,774,389,385,101,771,389,382,101.8
'31110, 과천시,'065004, 63세,2019,696,352,344,102.3,690,349,341,102.3
'31110, 과천시,'065005, 64세,2019,673,343,330,103.9,668,342,326,104.9
'31110, 과천시,'070,65~69세,2019,2361,1134,1227,92.4,2350,1128,1222,92.3
'31110, 과천시,'070001, 65세,2019,589,288,301,95.7,585,286,299,95.7
'31110, 과천시,'070002, 66세,2019,504,245,259,94.6,502,244,258,94.6
'31110, 과천시,'070003, 67세,2019,475,223,252,88.5,473,221,252,87.7
'31110, 과천시,'070004, 68세,2019,362,171,191,89.5,361,171,190,90
'31110, 과천시,'070005, 69세,2019,431,207,224,92.4,429,206,223,92.4
'31110, 과천시,'075,70~74세,2019,1769,809,960,84.3,1753,803,950,84.5
'31110, 과천시,'075001, 70세,2019,396,180,216,83.3,390,177,213,83.1
'31110, 과천시,'075002, 71세,2019,387,184,203,90.6,382,182,200,91
'31110, 과천시,'075003, 72세,2019,386,166,220,75.5,383,166,217,76.5
'31110, 과천시,'075004, 73세,2019,320,142,178,79.8,319,142,177,80.2
'31110, 과천시,'075005, 74세,2019,280,137,143,95.8,279,136,143,95.1
'31110, 과천시,'080,75~79세,2019,1509,618,891,69.4,1502,616,886,69.5
'31110, 과천시,'080001, 75세,2019,311,114,197,57.9,309,112,197,56.9
'31110, 과천시,'080002, 76세,2019,318,142,176,80.7,318,142,176,80.7
'31110, 과천시,'080003, 77세,2019,343,143,200,71.5,340,143,197,72.6
'31110, 과천시,'080004, 78세,2019,275,107,168,63.7,273,107,166,64.5
'31110, 과천시,'080005, 79세,2019,262,112,150,74.7,262,112,150,74.7
'31110, 과천시,'085,80~84세,2019,1073,415,658,63.1,1072,414,658,62.9
'31110, 과천시,'085001, 80세,2019,253,100,153,65.4,253,100,153,65.4
'31110, 과천시,'085002, 81세,2019,222,96,126,76.2,221,95,126,75.4
'31110, 과천시,'085003, 82세,2019,210,73,137,53.3,210,73,137,53.3
'31110, 과천시,'085004, 83세,2019,191,70,121,57.9,191,70,121,57.9
'31110, 과천시,'085005, 84세,2019,197,76,121,62.8,197,76,121,62.8
'31110, 과천시,'086,85세이상,2019,827,237,590,40.2,821,234,587,39.9
'31110, 과천시,'090,85~89세,2019,536,165,371,44.5,532,164,368,44.6
'31110, 과천시,'090001, 85세,2019,148,51,97,52.6,146,51,95,53.7
'31110, 과천시,'090002, 86세,2019,118,36,82,43.9,118,36,82,43.9
'31110, 과천시,'090003, 87세,2019,101,33,68,48.5,100,32,68,47.1
'31110, 과천시,'090004, 88세,2019,85,22,63,34.9,85,22,63,34.9
'31110, 과천시,'090005, 89세,2019,84,23,61,37.7,83,23,60,38.3
'31110, 과천시,'095,90~94세,2019,230,57,173,32.9,230,57,173,32.9
'31110, 과천시,'095001, 90세,2019,69,23,46,50,69,23,46,50
'31110, 과천시,'095002, 91세,2019,67,15,52,28.8,67,15,52,28.8
'31110, 과천시,'095003, 92세,2019,36,5,31,16.1,36,5,31,16.1
'31110, 과천시,'095004, 93세,2019,28,7,21,33.3,28,7,21,33.3
'31110, 과천시,'095005, 94세,2019,30,7,23,30.4,30,7,23,30.4
'31110, 과천시,'100,95~99세,2019,51,12,39,30.8,49,10,39,25.6
'31110, 과천시,'100001, 95세,2019,16,X,12,33.3,15,X,12,25
'31110, 과천시,'100002, 96세,2019,17,X,15,13.3,17,X,15,13.3
'31110, 과천시,'100003, 97세,2019,13,5,8,62.5,12,X,8,50
'31110, 과천시,'100004, 98세,2019,X,X,X,33.3,X,X,X,33.3
'31110, 과천시,'100005, 99세,2019,X,X,X,0,X,X,X,0
'31110, 과천시,'101,100세이상,2019,10,X,7,42.9,10,X,7,42.9
'31110, 과천시,'102,15세미만,2019,6942,3659,3283,111.5,6927,3645,3282,111.1
'31110, 과천시,'103,15~64세,2019,39349,19712,19637,100.4,38988,19515,19473,100.2
'31110, 과천시,'104,65세이상,2019,7539,3213,4326,74.3,7498,3195,4303,74.3
'31110, 과천시,'126,평균연령,2019,42.1,40.7,43.5,,42.1,40.7,43.5,
'31110, 과천시,'127,중위연령,2019,44,42,45.6,,44.1,42.1,45.6,
'31120, 구리시,'000,합계,2019,192270,95221,97049,98.1,190207,94208,95999,98.1
'31120, 구리시,'005,0~4세,2019,7381,3803,3578,106.3,7335,3784,3551,106.6
'31120, 구리시,'005001, 0세,2019,1212,615,597,103,1206,614,592,103.7
'31120, 구리시,'005002, 1세,2019,1347,694,653,106.3,1336,689,647,106.5
'31120, 구리시,'005003, 2세,2019,1457,774,683,113.3,1449,772,677,114
'31120, 구리시,'005004, 3세,2019,1624,826,798,103.5,1613,820,793,103.4
'31120, 구리시,'005005, 4세,2019,1741,894,847,105.5,1731,889,842,105.6
'31120, 구리시,'010,5~9세,2019,8797,4559,4238,107.6,8772,4552,4220,107.9
'31120, 구리시,'010001, 5세,2019,1765,936,829,112.9,1760,934,826,113.1
'31120, 구리시,'010002, 6세,2019,1747,926,821,112.8,1744,925,819,112.9
'31120, 구리시,'010003, 7세,2019,1833,938,895,104.8,1826,936,890,105.2
'31120, 구리시,'010004, 8세,2019,1772,907,865,104.9,1767,906,861,105.2
'31120, 구리시,'010005, 9세,2019,1680,852,828,102.9,1675,851,824,103.3
'31120, 구리시,'015,10~14세,2019,8436,4455,3981,111.9,8422,4452,3970,112.1
'31120, 구리시,'015001, 10세,2019,1639,847,792,106.9,1636,846,790,107.1
'31120, 구리시,'015002, 11세,2019,1685,867,818,106,1684,866,818,105.9
'31120, 구리시,'015003, 12세,2019,1778,922,856,107.7,1776,922,854,108
'31120, 구리시,'015004, 13세,2019,1711,929,782,118.8,1706,928,778,119.3
'31120, 구리시,'015005, 14세,2019,1623,890,733,121.4,1620,890,730,121.9
'31120, 구리시,'020,15~19세,2019,9534,4820,4714,102.2,9508,4805,4703,102.2
'31120, 구리시,'020001, 15세,2019,1785,891,894,99.7,1782,888,894,99.3
'31120, 구리시,'020002, 16세,2019,1768,876,892,98.2,1766,874,892,98
'31120, 구리시,'020003, 17세,2019,1867,949,918,103.4,1861,946,915,103.4
'31120, 구리시,'020004, 18세,2019,2038,1037,1001,103.6,2034,1035,999,103.6
'31120, 구리시,'020005, 19세,2019,2076,1067,1009,105.7,2065,1062,1003,105.9
'31120, 구리시,'025,20~24세,2019,12189,6317,5872,107.6,12025,6222,5803,107.2
'31120, 구리시,'025001, 20세,2019,2075,1089,986,110.4,2062,1080,982,110
'31120, 구리시,'025002, 21세,2019,2372,1275,1097,116.2,2345,1258,1087,115.7
'31120, 구리시,'025003, 22세,2019,2440,1264,1176,107.5,2400,1243,1157,107.4
'31120, 구리시,'025004, 23세,2019,2589,1306,1283,101.8,2555,1286,1269,101.3
'31120, 구리시,'025005, 24세,2019,2713,1383,1330,104,2663,1355,1308,103.6
'31120, 구리시,'030,25~29세,2019,13353,6791,6562,103.5,13059,6631,6428,103.2
'31120, 구리시,'030001, 25세,2019,2806,1462,1344,108.8,2770,1438,1332,108
'31120, 구리시,'030002, 26세,2019,2845,1452,1393,104.2,2779,1416,1363,103.9
'31120, 구리시,'030003, 27세,2019,2778,1445,1333,108.4,2708,1410,1298,108.6
'31120, 구리시,'030004, 28세,2019,2507,1251,1256,99.6,2442,1219,1223,99.7
'31120, 구리시,'030005, 29세,2019,2417,1181,1236,95.6,2360,1148,1212,94.7
'31120, 구리시,'035,30~34세,2019,11614,5877,5737,102.4,11321,5721,5600,102.2
'31120, 구리시,'035001, 30세,2019,2272,1150,1122,102.5,2209,1119,1090,102.7
'31120, 구리시,'035002, 31세,2019,2233,1173,1060,110.7,2157,1138,1019,111.7
'31120, 구리시,'035003, 32세,2019,2283,1154,1129,102.2,2236,1121,1115,100.5
'31120, 구리시,'035004, 33세,2019,2327,1161,1166,99.6,2272,1134,1138,99.6
'31120, 구리시,'035005, 34세,2019,2499,1239,1260,98.3,2447,1209,1238,97.7
'31120, 구리시,'040,35~39세,2019,15465,7819,7646,102.3,15223,7682,7541,101.9
'31120, 구리시,'040001, 35세,2019,2579,1288,1291,99.8,2524,1255,1269,98.9
'31120, 구리시,'040002, 36세,2019,2964,1497,1467,102,2905,1469,1436,102.3
'31120, 구리시,'040003, 37세,2019,3274,1633,1641,99.5,3230,1603,1627,98.5
'31120, 구리시,'040004, 38세,2019,3280,1685,1595,105.6,3246,1670,1576,106
'31120, 구리시,'040005, 39세,2019,3368,1716,1652,103.9,3318,1685,1633,103.2
'31120, 구리시,'045,40~44세,2019,14920,7490,7430,100.8,14736,7412,7324,101.2
'31120, 구리시,'045001, 40세,2019,3173,1595,1578,101.1,3140,1583,1557,101.7
'31120, 구리시,'045002, 41세,2019,2817,1425,1392,102.4,2782,1407,1375,102.3
'31120, 구리시,'045003, 42세,2019,2945,1501,1444,103.9,2906,1484,1422,104.4
'31120, 구리시,'045004, 43세,2019,2917,1478,1439,102.7,2878,1460,1418,103
'31120, 구리시,'045005, 44세,2019,3068,1491,1577,94.5,3030,1478,1552,95.2
'31120, 구리시,'050,45~49세,2019,17599,8605,8994,95.7,17405,8504,8901,95.5
'31120, 구리시,'050001, 45세,2019,3302,1622,1680,96.5,3272,1607,1665,96.5
'31120, 구리시,'050002, 46세,2019,3415,1669,1746,95.6,3367,1648,1719,95.9
'31120, 구리시,'050003, 47세,2019,3518,1759,1759,100,3472,1730,1742,99.3
'31120, 구리시,'050004, 48세,2019,3702,1755,1947,90.1,3672,1744,1928,90.5
'31120, 구리시,'050005, 49세,2019,3662,1800,1862,96.7,3622,1775,1847,96.1
'31120, 구리시,'055,50~54세,2019,17800,8544,9256,92.3,17616,8461,9155,92.4
'31120, 구리시,'055001, 50세,2019,3772,1782,1990,89.5,3737,1766,1971,89.6
'31120, 구리시,'055002, 51세,2019,3816,1770,2046,86.5,3775,1754,2021,86.8
'31120, 구리시,'055003, 52세,2019,3322,1591,1731,91.9,3293,1582,1711,92.5
'31120, 구리시,'055004, 53세,2019,3419,1654,1765,93.7,3377,1634,1743,93.7
'31120, 구리시,'055005, 54세,2019,3471,1747,1724,101.3,3434,1725,1709,100.9
'31120, 구리시,'060,55~59세,2019,17266,8603,8663,99.3,17088,8541,8547,99.9
'31120, 구리시,'060001, 55세,2019,3212,1592,1620,98.3,3177,1580,1597,98.9
'31120, 구리시,'060002, 56세,2019,3407,1738,1669,104.1,3366,1725,1641,105.1
'31120, 구리시,'060003, 57세,2019,3487,1803,1684,107.1,3448,1790,1658,108
'31120, 구리시,'060004, 58세,2019,3654,1758,1896,92.7,3628,1748,1880,93
'31120, 구리시,'060005, 59세,2019,3506,1712,1794,95.4,3469,1698,1771,95.9
'31120, 구리시,'065,60~64세,2019,13420,6776,6644,102,13309,6726,6583,102.2
'31120, 구리시,'065001, 60세,2019,3034,1591,1443,110.3,3009,1583,1426,111
'31120, 구리시,'065002, 61세,2019,2839,1427,1412,101.1,2809,1415,1394,101.5
'31120, 구리시,'065003, 62세,2019,2693,1342,1351,99.3,2669,1325,1344,98.6
'31120, 구리시,'065004, 63세,2019,2403,1210,1193,101.4,2390,1204,1186,101.5
'31120, 구리시,'065005, 64세,2019,2451,1206,1245,96.9,2432,1199,1233,97.2
'31120, 구리시,'070,65~69세,2019,8301,4077,4224,96.5,8239,4050,4189,96.7
'31120, 구리시,'070001, 65세,2019,1993,996,997,99.9,1978,994,984,101
'31120, 구리시,'070002, 66세,2019,1728,848,880,96.4,1715,840,875,96
'31120, 구리시,'070003, 67세,2019,1950,945,1005,94,1935,939,996,94.3
'31120, 구리시,'070004, 68세,2019,1252,624,628,99.4,1242,620,622,99.7
'31120, 구리시,'070005, 69세,2019,1378,664,714,93,1369,657,712,92.3
'31120, 구리시,'075,70~74세,2019,6227,2857,3370,84.8,6202,2846,3356,84.8
'31120, 구리시,'075001, 70세,2019,1322,627,695,90.2,1317,624,693,90
'31120, 구리시,'075002, 71세,2019,1385,642,743,86.4,1382,641,741,86.5
'31120, 구리시,'075003, 72세,2019,1400,632,768,82.3,1392,628,764,82.2
'31120, 구리시,'075004, 73세,2019,1088,487,601,81,1083,485,598,81.1
'31120, 구리시,'075005, 74세,2019,1032,469,563,83.3,1028,468,560,83.6
'31120, 구리시,'080,75~79세,2019,4942,2106,2836,74.3,4930,2102,2828,74.3
'31120, 구리시,'080001, 75세,2019,1027,446,581,76.8,1023,445,578,77
'31120, 구리시,'080002, 76세,2019,1039,441,598,73.7,1036,439,597,73.5
'31120, 구리시,'080003, 77세,2019,1149,507,642,79,1147,506,641,78.9
'31120, 구리시,'080004, 78세,2019,910,387,523,74,907,387,520,74.4
'31120, 구리시,'080005, 79세,2019,817,325,492,66.1,817,325,492,66.1
'31120, 구리시,'085,80~84세,2019,3058,1162,1896,61.3,3056,1161,1895,61.3
'31120, 구리시,'085001, 80세,2019,795,335,460,72.8,794,334,460,72.6
'31120, 구리시,'085002, 81세,2019,688,271,417,65,687,271,416,65.1
'31120, 구리시,'085003, 82세,2019,596,226,370,61.1,596,226,370,61.1
'31120, 구리시,'085004, 83세,2019,489,171,318,53.8,489,171,318,53.8
'31120, 구리시,'085005, 84세,2019,490,159,331,48,490,159,331,48
'31120, 구리시,'086,85세이상,2019,1968,560,1408,39.8,1961,556,1405,39.6
'31120, 구리시,'090,85~89세,2019,1426,441,985,44.8,1421,438,983,44.6
'31120, 구리시,'090001, 85세,2019,405,137,268,51.1,405,137,268,51.1
'31120, 구리시,'090002, 86세,2019,321,109,212,51.4,320,108,212,50.9
'31120, 구리시,'090003, 87세,2019,273,72,201,35.8,272,71,201,35.3
'31120, 구리시,'090004, 88세,2019,206,64,142,45.1,204,63,141,44.7
'31120, 구리시,'090005, 89세,2019,221,59,162,36.4,220,59,161,36.6
'31120, 구리시,'095,90~94세,2019,429,97,332,29.2,428,97,331,29.3
'31120, 구리시,'095001, 90세,2019,127,39,88,44.3,127,39,88,44.3
'31120, 구리시,'095002, 91세,2019,101,20,81,24.7,101,20,81,24.7
'31120, 구리시,'095003, 92세,2019,89,14,75,18.7,88,14,74,18.9
'31120, 구리시,'095004, 93세,2019,64,12,52,23.1,64,12,52,23.1
'31120, 구리시,'095005, 94세,2019,48,12,36,33.3,48,12,36,33.3
'31120, 구리시,'100,95~99세,2019,98,20,78,25.6,97,19,78,24.4
'31120, 구리시,'100001, 95세,2019,30,9,21,42.9,30,9,21,42.9
'31120, 구리시,'100002, 96세,2019,26,X,24,8.3,26,X,24,8.3
'31120, 구리시,'100003, 97세,2019,20,5,15,33.3,19,X,15,26.7
'31120, 구리시,'100004, 98세,2019,9,X,6,50,9,X,6,50
'31120, 구리시,'100005, 99세,2019,13,X,12,8.3,13,X,12,8.3
'31120, 구리시,'101,100세이상,2019,15,X,13,15.4,15,X,13,15.4
'31120, 구리시,'102,15세미만,2019,24614,12817,11797,108.6,24529,12788,11741,108.9
'31120, 구리시,'103,15~64세,2019,143160,71642,71518,100.2,141290,70705,70585,100.2
'31120, 구리시,'104,65세이상,2019,24496,10762,13734,78.4,24388,10715,13673,78.4
'31120, 구리시,'126,평균연령,2019,41.7,40.8,42.6,,41.7,40.8,42.6,
'31120, 구리시,'127,중위연령,2019,43.1,42.1,44.2,,43.2,42.2,44.3,
'31130, 남양주시,'000,합계,2019,681077,339886,341191,99.6,670201,333319,336882,98.9
'31130, 남양주시,'005,0~4세,2019,28381,14617,13764,106.2,28286,14566,13720,106.2
'31130, 남양주시,'005001, 0세,2019,4166,2213,1953,113.3,4149,2201,1948,113
'31130, 남양주시,'005002, 1세,2019,4957,2591,2366,109.5,4941,2583,2358,109.5
'31130, 남양주시,'005003, 2세,2019,5558,2826,2732,103.4,5540,2817,2723,103.5
'31130, 남양주시,'005004, 3세,2019,6627,3428,3199,107.2,6601,3414,3187,107.1
'31130, 남양주시,'005005, 4세,2019,7073,3559,3514,101.3,7055,3551,3504,101.3
'31130, 남양주시,'010,5~9세,2019,38307,19735,18572,106.3,38244,19709,18535,106.3
'31130, 남양주시,'010001, 5세,2019,7107,3663,3444,106.4,7092,3656,3436,106.4
'31130, 남양주시,'010002, 6세,2019,7371,3759,3612,104.1,7356,3752,3604,104.1
'31130, 남양주시,'010003, 7세,2019,8198,4233,3965,106.8,8184,4227,3957,106.8
'31130, 남양주시,'010004, 8세,2019,7974,4089,3885,105.3,7962,4086,3876,105.4
'31130, 남양주시,'010005, 9세,2019,7657,3991,3666,108.9,7650,3988,3662,108.9
'31130, 남양주시,'015,10~14세,2019,36928,18933,17995,105.2,36871,18907,17964,105.2
'31130, 남양주시,'015001, 10세,2019,7529,3808,3721,102.3,7517,3803,3714,102.4
'31130, 남양주시,'015002, 11세,2019,7787,4041,3746,107.9,7777,4036,3741,107.9
'31130, 남양주시,'015003, 12세,2019,7839,4030,3809,105.8,7827,4025,3802,105.9
'31130, 남양주시,'015004, 13세,2019,7017,3599,3418,105.3,7006,3593,3413,105.3
'31130, 남양주시,'015005, 14세,2019,6756,3455,3301,104.7,6744,3450,3294,104.7
'31130, 남양주시,'020,15~19세,2019,36126,18659,17467,106.8,35994,18592,17402,106.8
'31130, 남양주시,'020001, 15세,2019,7269,3734,3535,105.6,7255,3725,3530,105.5
'31130, 남양주시,'020002, 16세,2019,6805,3459,3346,103.4,6791,3451,3340,103.3
'31130, 남양주시,'020003, 17세,2019,7026,3634,3392,107.1,7013,3628,3385,107.2
'31130, 남양주시,'020004, 18세,2019,7663,3896,3767,103.4,7636,3883,3753,103.5
'31130, 남양주시,'020005, 19세,2019,7363,3936,3427,114.9,7299,3905,3394,115.1
'31130, 남양주시,'025,20~24세,2019,39067,20671,18396,112.4,37737,19811,17926,110.5
'31130, 남양주시,'025001, 20세,2019,7386,3948,3438,114.8,7225,3860,3365,114.7
'31130, 남양주시,'025002, 21세,2019,7646,4158,3488,119.2,7437,4031,3406,118.3
'31130, 남양주시,'025003, 22세,2019,7856,4136,3720,111.2,7580,3960,3620,109.4
'31130, 남양주시,'025004, 23세,2019,7983,4124,3859,106.9,7678,3906,3772,103.6
'31130, 남양주시,'025005, 24세,2019,8196,4305,3891,110.6,7817,4054,3763,107.7
'31130, 남양주시,'030,25~29세,2019,38864,20444,18420,111,36801,19015,17786,106.9
'31130, 남양주시,'030001, 25세,2019,8106,4269,3837,111.3,7720,4017,3703,108.5
'31130, 남양주시,'030002, 26세,2019,8031,4230,3801,111.3,7630,3946,3684,107.1
'31130, 남양주시,'030003, 27세,2019,8127,4291,3836,111.9,7697,3981,3716,107.1
'31130, 남양주시,'030004, 28세,2019,7500,3902,3598,108.4,7072,3610,3462,104.3
'31130, 남양주시,'030005, 29세,2019,7100,3752,3348,112.1,6682,3461,3221,107.5
'31130, 남양주시,'035,30~34세,2019,36336,18358,17978,102.1,34351,17026,17325,98.3
'31130, 남양주시,'035001, 30세,2019,6827,3555,3272,108.6,6398,3263,3135,104.1
'31130, 남양주시,'035002, 31세,2019,6988,3665,3323,110.3,6539,3339,3200,104.3
'31130, 남양주시,'035003, 32세,2019,6897,3458,3439,100.6,6521,3209,3312,96.9
'31130, 남양주시,'035004, 33세,2019,7514,3709,3805,97.5,7155,3493,3662,95.4
'31130, 남양주시,'035005, 34세,2019,8110,3971,4139,95.9,7738,3722,4016,92.7
'31130, 남양주시,'040,35~39세,2019,55827,27410,28417,96.5,54326,26489,27837,95.2
'31130, 남양주시,'040001, 35세,2019,8838,4335,4503,96.3,8490,4122,4368,94.4
'31130, 남양주시,'040002, 36세,2019,10154,5000,5154,97,9842,4813,5029,95.7
'31130, 남양주시,'040003, 37세,2019,11701,5684,6017,94.5,11368,5476,5892,92.9
'31130, 남양주시,'040004, 38세,2019,12258,6089,6169,98.7,12001,5931,6070,97.7
'31130, 남양주시,'040005, 39세,2019,12876,6302,6574,95.9,12625,6147,6478,94.9
'31130, 남양주시,'045,40~44세,2019,59562,29744,29818,99.8,58573,29176,29397,99.2
'31130, 남양주시,'045001, 40세,2019,12469,6170,6299,98,12198,6000,6198,96.8
'31130, 남양주시,'045002, 41세,2019,11493,5700,5793,98.4,11303,5595,5708,98
'31130, 남양주시,'045003, 42세,2019,11819,5912,5907,100.1,11630,5810,5820,99.8
'31130, 남양주시,'045004, 43세,2019,11561,5788,5773,100.3,11369,5679,5690,99.8
'31130, 남양주시,'045005, 44세,2019,12220,6174,6046,102.1,12073,6092,5981,101.9
'31130, 남양주시,'050,45~49세,2019,65232,33426,31806,105.1,64463,33000,31463,104.9
'31130, 남양주시,'050001, 45세,2019,13131,6680,6451,103.5,12975,6597,6378,103.4
'31130, 남양주시,'050002, 46세,2019,12972,6637,6335,104.8,12814,6542,6272,104.3
'31130, 남양주시,'050003, 47세,2019,13058,6733,6325,106.5,12915,6649,6266,106.1
'31130, 남양주시,'050004, 48세,2019,13468,6857,6611,103.7,13321,6776,6545,103.5
'31130, 남양주시,'050005, 49세,2019,12603,6519,6084,107.1,12438,6436,6002,107.2
'31130, 남양주시,'055,50~54세,2019,57412,29014,28398,102.2,56763,28680,28083,102.1
'31130, 남양주시,'055001, 50세,2019,12536,6332,6204,102.1,12397,6244,6153,101.5
'31130, 남양주시,'055002, 51세,2019,12148,6041,6107,98.9,12008,5973,6035,99
'31130, 남양주시,'055003, 52세,2019,11093,5549,5544,100.1,10969,5489,5480,100.2
'31130, 남양주시,'055004, 53세,2019,10817,5615,5202,107.9,10693,5551,5142,108
'31130, 남양주시,'055005, 54세,2019,10818,5477,5341,102.5,10696,5423,5273,102.8
'31130, 남양주시,'060,55~59세,2019,53118,27003,26115,103.4,52629,26793,25836,103.7
'31130, 남양주시,'060001, 55세,2019,10375,5332,5043,105.7,10275,5288,4987,106
'31130, 남양주시,'060002, 56세,2019,10545,5450,5095,107,10410,5383,5027,107.1
'31130, 남양주시,'060003, 57세,2019,10442,5391,5051,106.7,10327,5343,4984,107.2
'31130, 남양주시,'060004, 58세,2019,10882,5413,5469,99,10815,5397,5418,99.6
'31130, 남양주시,'060005, 59세,2019,10874,5417,5457,99.3,10802,5382,5420,99.3
'31130, 남양주시,'065,60~64세,2019,44284,21706,22578,96.1,43912,21551,22361,96.4
'31130, 남양주시,'065001, 60세,2019,9651,4779,4872,98.1,9579,4752,4827,98.4
'31130, 남양주시,'065002, 61세,2019,9219,4594,4625,99.3,9140,4565,4575,99.8
'31130, 남양주시,'065003, 62세,2019,9013,4404,4609,95.6,8919,4361,4558,95.7
'31130, 남양주시,'065004, 63세,2019,8059,3966,4093,96.9,7979,3928,4051,97
'31130, 남양주시,'065005, 64세,2019,8342,3963,4379,90.5,8295,3945,4350,90.7
'31130, 남양주시,'070,65~69세,2019,29598,14030,15568,90.1,29373,13934,15439,90.3
'31130, 남양주시,'070001, 65세,2019,7035,3389,3646,93,6969,3359,3610,93
'31130, 남양주시,'070002, 66세,2019,5989,2851,3138,90.9,5942,2829,3113,90.9
'31130, 남양주시,'070003, 67세,2019,6842,3244,3598,90.2,6804,3229,3575,90.3
'31130, 남양주시,'070004, 68세,2019,4589,2160,2429,88.9,4555,2148,2407,89.2
'31130, 남양주시,'070005, 69세,2019,5143,2386,2757,86.5,5103,2369,2734,86.6
'31130, 남양주시,'075,70~74세,2019,23576,11064,12512,88.4,23508,11033,12475,88.4
'31130, 남양주시,'075001, 70세,2019,5205,2475,2730,90.7,5184,2464,2720,90.6
'31130, 남양주시,'075002, 71세,2019,5209,2454,2755,89.1,5190,2447,2743,89.2
'31130, 남양주시,'075003, 72세,2019,5172,2474,2698,91.7,5158,2469,2689,91.8
'31130, 남양주시,'075004, 73세,2019,4050,1837,2213,83,4039,1829,2210,82.8
'31130, 남양주시,'075005, 74세,2019,3940,1824,2116,86.2,3937,1824,2113,86.3
'31130, 남양주시,'080,75~79세,2019,18713,8267,10446,79.1,18667,8244,10423,79.1
'31130, 남양주시,'080001, 75세,2019,3865,1726,2139,80.7,3854,1721,2133,80.7
'31130, 남양주시,'080002, 76세,2019,3826,1690,2136,79.1,3817,1688,2129,79.3
'31130, 남양주시,'080003, 77세,2019,4409,1997,2412,82.8,4401,1992,2409,82.7
'31130, 남양주시,'080004, 78세,2019,3452,1506,1946,77.4,3443,1498,1945,77
'31130, 남양주시,'080005, 79세,2019,3161,1348,1813,74.4,3152,1345,1807,74.4
'31130, 남양주시,'085,80~84세,2019,11768,4594,7174,64,11745,4588,7157,64.1
'31130, 남양주시,'085001, 80세,2019,3055,1264,1791,70.6,3048,1261,1787,70.6
'31130, 남양주시,'085002, 81세,2019,2473,1004,1469,68.3,2467,1004,1463,68.6
'31130, 남양주시,'085003, 82세,2019,2319,905,1414,64,2312,903,1409,64.1
'31130, 남양주시,'085004, 83세,2019,2052,750,1302,57.6,2050,750,1300,57.7
'31130, 남양주시,'085005, 84세,2019,1869,671,1198,56,1868,670,1198,55.9
'31130, 남양주시,'086,85세이상,2019,7978,2211,5767,38.3,7958,2205,5753,38.3
'31130, 남양주시,'090,85~89세,2019,5420,1631,3789,43,5408,1629,3779,43.1
'31130, 남양주시,'090001, 85세,2019,1490,504,986,51.1,1486,502,984,51
'31130, 남양주시,'090002, 86세,2019,1265,377,888,42.5,1263,377,886,42.6
'31130, 남양주시,'090003, 87세,2019,1068,345,723,47.7,1067,345,722,47.8
'31130, 남양주시,'090004, 88세,2019,834,230,604,38.1,829,230,599,38.4
'31130, 남양주시,'090005, 89세,2019,763,175,588,29.8,763,175,588,29.8
'31130, 남양주시,'095,90~94세,2019,2005,448,1557,28.8,2000,446,1554,28.7
'31130, 남양주시,'095001, 90세,2019,649,174,475,36.6,649,174,475,36.6
'31130, 남양주시,'095002, 91세,2019,509,121,388,31.2,507,120,387,31
'31130, 남양주시,'095003, 92세,2019,357,62,295,21,357,62,295,21
'31130, 남양주시,'095004, 93세,2019,286,56,230,24.3,284,55,229,24
'31130, 남양주시,'095005, 94세,2019,204,35,169,20.7,203,35,168,20.8
'31130, 남양주시,'100,95~99세,2019,476,112,364,30.8,473,110,363,30.3
'31130, 남양주시,'100001, 95세,2019,135,37,98,37.8,134,36,98,36.7
'31130, 남양주시,'100002, 96세,2019,145,36,109,33,145,36,109,33
'31130, 남양주시,'100003, 97세,2019,105,24,81,29.6,104,23,81,28.4
'31130, 남양주시,'100004, 98세,2019,59,11,48,22.9,59,11,48,22.9
'31130, 남양주시,'100005, 99세,2019,32,X,28,14.3,31,X,27,14.8
'31130, 남양주시,'101,100세이상,2019,77,20,57,35.1,77,20,57,35.1
'31130, 남양주시,'102,15세미만,2019,103616,53285,50331,105.9,103401,53182,50219,105.9
'31130, 남양주시,'103,15~64세,2019,485828,246435,239393,102.9,475549,240133,235416,102
'31130, 남양주시,'104,65세이상,2019,91633,40166,51467,78,91251,40004,51247,78.1
'31130, 남양주시,'126,평균연령,2019,41.1,40.2,42,,41.1,40.2,42,
'31130, 남양주시,'127,중위연령,2019,42.6,41.9,43.3,,42.8,42.2,43.4,
'31140, 오산시,'000,합계,2019,233998,120893,113105,106.9,218910,112986,105924,106.7
'31140, 오산시,'005,0~4세,2019,11606,5975,5631,106.1,10974,5640,5334,105.7
'31140, 오산시,'005001, 0세,2019,1862,960,902,106.4,1709,887,822,107.9
'31140, 오산시,'005002, 1세,2019,2072,1092,980,111.4,1950,1028,922,111.5
'31140, 오산시,'005003, 2세,2019,2266,1178,1088,108.3,2133,1111,1022,108.7
'31140, 오산시,'005004, 3세,2019,2618,1299,1319,98.5,2503,1233,1270,97.1
'31140, 오산시,'005005, 4세,2019,2788,1446,1342,107.7,2679,1381,1298,106.4
'31140, 오산시,'010,5~9세,2019,14248,7308,6940,105.3,13941,7140,6801,105
'31140, 오산시,'010001, 5세,2019,2734,1373,1361,100.9,2637,1326,1311,101.1
'31140, 오산시,'010002, 6세,2019,2775,1464,1311,111.7,2721,1433,1288,111.3
'31140, 오산시,'010003, 7세,2019,3089,1582,1507,105,3023,1540,1483,103.8
'31140, 오산시,'010004, 8세,2019,2869,1478,1391,106.3,2822,1452,1370,106
'31140, 오산시,'010005, 9세,2019,2781,1411,1370,103,2738,1389,1349,103
'31140, 오산시,'015,10~14세,2019,12465,6412,6053,105.9,12341,6341,6000,105.7
'31140, 오산시,'015001, 10세,2019,2600,1339,1261,106.2,2563,1320,1243,106.2
'31140, 오산시,'015002, 11세,2019,2684,1414,1270,111.3,2656,1396,1260,110.8
'31140, 오산시,'015003, 12세,2019,2649,1353,1296,104.4,2631,1342,1289,104.1
'31140, 오산시,'015004, 13세,2019,2330,1176,1154,101.9,2306,1165,1141,102.1
'31140, 오산시,'015005, 14세,2019,2202,1130,1072,105.4,2185,1118,1067,104.8
'31140, 오산시,'020,15~19세,2019,11918,6111,5807,105.2,11718,6016,5702,105.5
'31140, 오산시,'020001, 15세,2019,2327,1206,1121,107.6,2305,1196,1109,107.8
'31140, 오산시,'020002, 16세,2019,2314,1178,1136,103.7,2303,1175,1128,104.2
'31140, 오산시,'020003, 17세,2019,2246,1118,1128,99.1,2225,1107,1118,99
'31140, 오산시,'020004, 18세,2019,2509,1286,1223,105.2,2446,1254,1192,105.2
'31140, 오산시,'020005, 19세,2019,2522,1323,1199,110.3,2439,1284,1155,111.2
'31140, 오산시,'025,20~24세,2019,13646,7165,6481,110.6,13085,6871,6214,110.6
'31140, 오산시,'025001, 20세,2019,2488,1345,1143,117.7,2407,1298,1109,117
'31140, 오산시,'025002, 21세,2019,2634,1404,1230,114.1,2536,1353,1183,114.4
'31140, 오산시,'025003, 22세,2019,2661,1368,1293,105.8,2554,1322,1232,107.3
'31140, 오산시,'025004, 23세,2019,2809,1465,1344,109,2692,1402,1290,108.7
'31140, 오산시,'025005, 24세,2019,3054,1583,1471,107.6,2896,1496,1400,106.9
'31140, 오산시,'030,25~29세,2019,16791,9298,7493,124.1,15476,8621,6855,125.8
'31140, 오산시,'030001, 25세,2019,3075,1698,1377,123.3,2911,1624,1287,126.2
'31140, 오산시,'030002, 26세,2019,3290,1809,1481,122.1,3064,1691,1373,123.2
'31140, 오산시,'030003, 27세,2019,3577,1990,1587,125.4,3342,1872,1470,127.3
'31140, 오산시,'030004, 28세,2019,3477,1912,1565,122.2,3153,1742,1411,123.5
'31140, 오산시,'030005, 29세,2019,3372,1889,1483,127.4,3006,1692,1314,128.8
'31140, 오산시,'035,30~34세,2019,18626,9963,8663,115,16258,8722,7536,115.7
'31140, 오산시,'035001, 30세,2019,3376,1865,1511,123.4,2982,1669,1313,127.1
'31140, 오산시,'035002, 31세,2019,3590,1911,1679,113.8,3101,1650,1451,113.7
'31140, 오산시,'035003, 32세,2019,3717,1939,1778,109.1,3197,1678,1519,110.5
'31140, 오산시,'035004, 33세,2019,3885,2083,1802,115.6,3356,1808,1548,116.8
'31140, 오산시,'035005, 34세,2019,4058,2165,1893,114.4,3622,1917,1705,112.4
'31140, 오산시,'040,35~39세,2019,24644,13159,11485,114.6,22736,12086,10650,113.5
'31140, 오산시,'040001, 35세,2019,4225,2224,2001,111.1,3787,1988,1799,110.5
'31140, 오산시,'040002, 36세,2019,4656,2464,2192,112.4,4279,2265,2014,112.5
'31140, 오산시,'040003, 37세,2019,5423,2960,2463,120.2,4984,2686,2298,116.9
'31140, 오산시,'040004, 38세,2019,5112,2790,2322,120.2,4813,2619,2194,119.4
'31140, 오산시,'040005, 39세,2019,5228,2721,2507,108.5,4873,2528,2345,107.8
'31140, 오산시,'045,40~44세,2019,21955,11763,10192,115.4,20609,10986,9623,114.2
'31140, 오산시,'045001, 40세,2019,4839,2577,2262,113.9,4485,2364,2121,111.5
'31140, 오산시,'045002, 41세,2019,4328,2336,1992,117.3,4059,2179,1880,115.9
'31140, 오산시,'045003, 42세,2019,4350,2326,2024,114.9,4123,2202,1921,114.6
'31140, 오산시,'045004, 43세,2019,4162,2245,1917,117.1,3903,2091,1812,115.4
'31140, 오산시,'045005, 44세,2019,4276,2279,1997,114.1,4039,2150,1889,113.8
'31140, 오산시,'050,45~49세,2019,21358,11253,10105,111.4,19854,10424,9430,110.5
'31140, 오산시,'050001, 45세,2019,4517,2401,2116,113.5,4253,2257,1996,113.1
'31140, 오산시,'050002, 46세,2019,4338,2267,2071,109.5,4053,2104,1949,108
'31140, 오산시,'050003, 47세,2019,4216,2242,1974,113.6,3914,2058,1856,110.9
'31140, 오산시,'050004, 48세,2019,4260,2200,2060,106.8,3933,2033,1900,107
'31140, 오산시,'050005, 49세,2019,4027,2143,1884,113.7,3701,1972,1729,114.1
'31140, 오산시,'055,50~54세,2019,18299,9480,8819,107.5,16786,8667,8119,106.7
'31140, 오산시,'055001, 50세,2019,4124,2206,1918,115,3771,1996,1775,112.5
'31140, 오산시,'055002, 51세,2019,4026,2036,1990,102.3,3707,1868,1839,101.6
'31140, 오산시,'055003, 52세,2019,3417,1729,1688,102.4,3159,1589,1570,101.2
'31140, 오산시,'055004, 53세,2019,3290,1714,1576,108.8,3007,1574,1433,109.8
'31140, 오산시,'055005, 54세,2019,3442,1795,1647,109,3142,1640,1502,109.2
'31140, 오산시,'060,55~59세,2019,15755,8104,7651,105.9,14380,7430,6950,106.9
'31140, 오산시,'060001, 55세,2019,3060,1609,1451,110.9,2753,1430,1323,108.1
'31140, 오산시,'060002, 56세,2019,3123,1589,1534,103.6,2771,1428,1343,106.3
'31140, 오산시,'060003, 57세,2019,3138,1640,1498,109.5,2869,1513,1356,111.6
'31140, 오산시,'060004, 58세,2019,3260,1641,1619,101.4,3088,1574,1514,104
'31140, 오산시,'060005, 59세,2019,3174,1625,1549,104.9,2899,1485,1414,105
'31140, 오산시,'065,60~64세,2019,11867,5869,5998,97.8,10752,5337,5415,98.6
'31140, 오산시,'065001, 60세,2019,2755,1398,1357,103,2533,1287,1246,103.3
'31140, 오산시,'065002, 61세,2019,2528,1234,1294,95.4,2262,1112,1150,96.7
'31140, 오산시,'065003, 62세,2019,2340,1142,1198,95.3,2095,1027,1068,96.2
'31140, 오산시,'065004, 63세,2019,2113,1036,1077,96.2,1921,941,980,96
'31140, 오산시,'065005, 64세,2019,2131,1059,1072,98.8,1941,970,971,99.9
'31140, 오산시,'070,65~69세,2019,7185,3465,3720,93.1,6658,3230,3428,94.2
'31140, 오산시,'070001, 65세,2019,1759,866,893,97,1607,801,806,99.4
'31140, 오산시,'070002, 66세,2019,1459,703,756,93,1344,642,702,91.5
'31140, 오산시,'070003, 67세,2019,1641,803,838,95.8,1532,756,776,97.4
'31140, 오산시,'070004, 68세,2019,1157,543,614,88.4,1072,505,567,89.1
'31140, 오산시,'070005, 69세,2019,1169,550,619,88.9,1103,526,577,91.2
'31140, 오산시,'075,70~74세,2019,5261,2436,2825,86.2,5099,2373,2726,87.1
'31140, 오산시,'075001, 70세,2019,1202,557,645,86.4,1152,537,615,87.3
'31140, 오산시,'075002, 71세,2019,1158,564,594,94.9,1125,551,574,96
'31140, 오산시,'075003, 72세,2019,1120,519,601,86.4,1085,507,578,87.7
'31140, 오산시,'075004, 73세,2019,910,421,489,86.1,884,408,476,85.7
'31140, 오산시,'075005, 74세,2019,871,375,496,75.6,853,370,483,76.6
'31140, 오산시,'080,75~79세,2019,4154,1702,2452,69.4,4077,1684,2393,70.4
'31140, 오산시,'080001, 75세,2019,889,362,527,68.7,870,355,515,68.9
'31140, 오산시,'080002, 76세,2019,842,330,512,64.5,827,329,498,66.1
'31140, 오산시,'080003, 77세,2019,986,423,563,75.1,970,419,551,76
'31140, 오산시,'080004, 78세,2019,751,312,439,71.1,736,309,427,72.4
'31140, 오산시,'080005, 79세,2019,686,275,411,66.9,674,272,402,67.7
'31140, 오산시,'085,80~84세,2019,2667,1000,1667,60,2631,990,1641,60.3
'31140, 오산시,'085001, 80세,2019,642,261,381,68.5,632,257,375,68.5
'31140, 오산시,'085002, 81세,2019,637,235,402,58.5,630,233,397,58.7
'31140, 오산시,'085003, 82세,2019,479,168,311,54,472,166,306,54.2
'31140, 오산시,'085004, 83세,2019,503,193,310,62.3,495,192,303,63.4
'31140, 오산시,'085005, 84세,2019,406,143,263,54.4,402,142,260,54.6
'31140, 오산시,'086,85세이상,2019,1553,430,1123,38.3,1535,428,1107,38.7
'31140, 오산시,'090,85~89세,2019,1097,334,763,43.8,1082,332,750,44.3
'31140, 오산시,'090001, 85세,2019,334,129,205,62.9,329,128,201,63.7
'31140, 오산시,'090002, 86세,2019,236,74,162,45.7,232,73,159,45.9
'31140, 오산시,'090003, 87세,2019,208,62,146,42.5,207,62,145,42.8
'31140, 오산시,'090004, 88세,2019,164,40,124,32.3,162,40,122,32.8
'31140, 오산시,'090005, 89세,2019,155,29,126,23,152,29,123,23.6
'31140, 오산시,'095,90~94세,2019,366,78,288,27.1,364,78,286,27.3
'31140, 오산시,'095001, 90세,2019,94,24,70,34.3,93,24,69,34.8
'31140, 오산시,'095002, 91세,2019,102,22,80,27.5,101,22,79,27.8
'31140, 오산시,'095003, 92세,2019,77,13,64,20.3,77,13,64,20.3
'31140, 오산시,'095004, 93세,2019,46,5,41,12.2,46,5,41,12.2
'31140, 오산시,'095005, 94세,2019,47,14,33,42.4,47,14,33,42.4
'31140, 오산시,'100,95~99세,2019,73,12,61,19.7,72,12,60,20
'31140, 오산시,'100001, 95세,2019,25,5,20,25,25,5,20,25
'31140, 오산시,'100002, 96세,2019,22,X,19,15.8,22,X,19,15.8
'31140, 오산시,'100003, 97세,2019,12,X,10,20,12,X,10,20
'31140, 오산시,'100004, 98세,2019,8,X,7,14.3,8,X,7,14.3
'31140, 오산시,'100005, 99세,2019,6,X,5,20,5,X,X,25
'31140, 오산시,'101,100세이상,2019,17,6,11,54.5,17,6,11,54.5
'31140, 오산시,'102,15세미만,2019,38319,19695,18624,105.8,37256,19121,18135,105.4
'31140, 오산시,'103,15~64세,2019,174859,92165,82694,111.5,161654,85160,76494,111.3
'31140, 오산시,'104,65세이상,2019,20820,9033,11787,76.6,20000,8705,11295,77.1
'31140, 오산시,'126,평균연령,2019,38,37.4,38.7,,37.8,37.2,38.5,
'31140, 오산시,'127,중위연령,2019,38.7,38.2,39.2,,38.5,38.1,39.1,
'31150, 시흥시,'000,합계,2019,508749,269625,239124,112.8,458466,239821,218645,109.7
'31150, 시흥시,'005,0~4세,2019,23169,11840,11329,104.5,21519,10962,10557,103.8
'31150, 시흥시,'005001, 0세,2019,3895,1971,1924,102.4,3545,1783,1762,101.2
'31150, 시흥시,'005002, 1세,2019,4125,2107,2018,104.4,3771,1907,1864,102.3
'31150, 시흥시,'005003, 2세,2019,4556,2306,2250,102.5,4221,2143,2078,103.1
'31150, 시흥시,'005004, 3세,2019,5162,2606,2556,102,4820,2421,2399,100.9
'31150, 시흥시,'005005, 4세,2019,5431,2850,2581,110.4,5162,2708,2454,110.4
'31150, 시흥시,'010,5~9세,2019,25491,13101,12390,105.7,24516,12582,11934,105.4
'31150, 시흥시,'010001, 5세,2019,4922,2522,2400,105.1,4683,2394,2289,104.6
'31150, 시흥시,'010002, 6세,2019,5058,2593,2465,105.2,4838,2486,2352,105.7
'31150, 시흥시,'010003, 7세,2019,5384,2787,2597,107.3,5174,2673,2501,106.9
'31150, 시흥시,'010004, 8세,2019,5186,2685,2501,107.4,5026,2592,2434,106.5
'31150, 시흥시,'010005, 9세,2019,4941,2514,2427,103.6,4795,2437,2358,103.4
'31150, 시흥시,'015,10~14세,2019,23747,12059,11688,103.2,23271,11810,11461,103
'31150, 시흥시,'015001, 10세,2019,4856,2513,2343,107.3,4734,2450,2284,107.3
'31150, 시흥시,'015002, 11세,2019,5016,2591,2425,106.8,4909,2532,2377,106.5
'31150, 시흥시,'015003, 12세,2019,4951,2466,2485,99.2,4853,2414,2439,99
'31150, 시흥시,'015004, 13세,2019,4541,2275,2266,100.4,4460,2234,2226,100.4
'31150, 시흥시,'015005, 14세,2019,4383,2214,2169,102.1,4315,2180,2135,102.1
'31150, 시흥시,'020,15~19세,2019,25632,13694,11938,114.7,25260,13509,11751,115
'31150, 시흥시,'020001, 15세,2019,4613,2418,2195,110.2,4562,2392,2170,110.2
'31150, 시흥시,'020002, 16세,2019,4739,2438,2301,106,4683,2418,2265,106.8
'31150, 시흥시,'020003, 17세,2019,4793,2525,2268,111.3,4741,2496,2245,111.2
'31150, 시흥시,'020004, 18세,2019,5476,2923,2553,114.5,5400,2879,2521,114.2
'31150, 시흥시,'020005, 19세,2019,6011,3390,2621,129.3,5874,3324,2550,130.4
'31150, 시흥시,'025,20~24세,2019,33090,18453,14637,126.1,30724,16893,13831,122.1
'31150, 시흥시,'025001, 20세,2019,5695,3152,2543,123.9,5469,3038,2431,125
'31150, 시흥시,'025002, 21세,2019,6256,3435,2821,121.8,5916,3225,2691,119.8
'31150, 시흥시,'025003, 22세,2019,6605,3650,2955,123.5,6172,3360,2812,119.5
'31150, 시흥시,'025004, 23세,2019,7163,3988,3175,125.6,6573,3590,2983,120.3
'31150, 시흥시,'025005, 24세,2019,7371,4228,3143,134.5,6594,3680,2914,126.3
'31150, 시흥시,'030,25~29세,2019,38078,21760,16318,133.3,32027,17693,14334,123.4
'31150, 시흥시,'030001, 25세,2019,7480,4277,3203,133.5,6529,3599,2930,122.8
'31150, 시흥시,'030002, 26세,2019,7667,4458,3209,138.9,6635,3728,2907,128.2
'31150, 시흥시,'030003, 27세,2019,7855,4466,3389,131.8,6661,3683,2978,123.7
'31150, 시흥시,'030004, 28세,2019,7554,4298,3256,132,6240,3432,2808,122.2
'31150, 시흥시,'030005, 29세,2019,7522,4261,3261,130.7,5962,3251,2711,119.9
'31150, 시흥시,'035,30~34세,2019,38982,21766,17216,126.4,30150,16207,13943,116.2
'31150, 시흥시,'035001, 30세,2019,7606,4357,3249,134.1,5899,3228,2671,120.9
'31150, 시흥시,'035002, 31세,2019,7423,4151,3272,126.9,5684,3069,2615,117.4
'31150, 시흥시,'035003, 32세,2019,7731,4267,3464,123.2,5903,3137,2766,113.4
'31150, 시흥시,'035004, 33세,2019,8144,4487,3657,122.7,6258,3327,2931,113.5
'31150, 시흥시,'035005, 34세,2019,8078,4504,3574,126,6406,3446,2960,116.4
'31150, 시흥시,'040,35~39세,2019,48299,26538,21761,122,41390,22132,19258,114.9
'31150, 시흥시,'040001, 35세,2019,8513,4694,3819,122.9,6934,3687,3247,113.6
'31150, 시흥시,'040002, 36세,2019,9324,5025,4299,116.9,7858,4099,3759,109
'31150, 시흥시,'040003, 37세,2019,10233,5656,4577,123.6,8751,4737,4014,118
'31150, 시흥시,'040004, 38세,2019,10094,5561,4533,122.7,8846,4748,4098,115.9
'31150, 시흥시,'040005, 39세,2019,10135,5602,4533,123.6,9001,4861,4140,117.4
'31150, 시흥시,'045,40~44세,2019,44464,24604,19860,123.9,39666,21488,18178,118.2
'31150, 시흥시,'045001, 40세,2019,9384,5184,4200,123.4,8250,4440,3810,116.5
'31150, 시흥시,'045002, 41세,2019,8799,4838,3961,122.1,7756,4146,3610,114.8
'31150, 시흥시,'045003, 42세,2019,8676,4859,3817,127.3,7832,4304,3528,122
'31150, 시흥시,'045004, 43세,2019,8695,4836,3859,125.3,7744,4232,3512,120.5
'31150, 시흥시,'045005, 44세,2019,8910,4887,4023,121.5,8084,4366,3718,117.4
'31150, 시흥시,'050,45~49세,2019,48683,25842,22841,113.1,43813,22969,20844,110.2
'31150, 시흥시,'050001, 45세,2019,9512,5236,4276,122.5,8723,4775,3948,120.9
'31150, 시흥시,'050002, 46세,2019,9514,5106,4408,115.8,8588,4542,4046,112.3
'31150, 시흥시,'050003, 47세,2019,9614,5067,4547,111.4,8575,4467,4108,108.7
'31150, 시흥시,'050004, 48세,2019,10195,5353,4842,110.6,9077,4673,4404,106.1
'31150, 시흥시,'050005, 49세,2019,9848,5080,4768,106.5,8850,4512,4338,104
'31150, 시흥시,'055,50~54세,2019,47346,24639,22707,108.5,43179,22337,20842,107.2
'31150, 시흥시,'055001, 50세,2019,10224,5311,4913,108.1,9323,4818,4505,106.9
'31150, 시흥시,'055002, 51세,2019,10045,5137,4908,104.7,9121,4610,4511,102.2
'31150, 시흥시,'055003, 52세,2019,9231,4738,4493,105.5,8499,4339,4160,104.3
'31150, 시흥시,'055004, 53세,2019,8764,4702,4062,115.8,8012,4281,3731,114.7
'31150, 시흥시,'055005, 54세,2019,9082,4751,4331,109.7,8224,4289,3935,109
'31150, 시흥시,'060,55~59세,2019,41028,22213,18815,118.1,37388,20397,16991,120
'31150, 시흥시,'060001, 55세,2019,8352,4479,3873,115.6,7483,4020,3463,116.1
'31150, 시흥시,'060002, 56세,2019,8563,4652,3911,118.9,7595,4154,3441,120.7
'31150, 시흥시,'060003, 57세,2019,8252,4458,3794,117.5,7552,4121,3431,120.1
'31150, 시흥시,'060004, 58세,2019,8043,4381,3662,119.6,7620,4172,3448,121
'31150, 시흥시,'060005, 59세,2019,7818,4243,3575,118.7,7138,3930,3208,122.5
'31150, 시흥시,'065,60~64세,2019,27875,14669,13206,111.1,24978,13334,11644,114.5
'31150, 시흥시,'065001, 60세,2019,6726,3663,3063,119.6,6166,3387,2779,121.9
'31150, 시흥시,'065002, 61세,2019,6080,3225,2855,113,5442,2925,2517,116.2
'31150, 시흥시,'065003, 62세,2019,5696,2994,2702,110.8,5068,2714,2354,115.3
'31150, 시흥시,'065004, 63세,2019,4708,2402,2306,104.2,4163,2158,2005,107.6
'31150, 시흥시,'065005, 64세,2019,4665,2385,2280,104.6,4139,2150,1989,108.1
'31150, 시흥시,'070,65~69세,2019,14894,7576,7318,103.5,13408,6900,6508,106
'31150, 시흥시,'070001, 65세,2019,3784,1967,1817,108.3,3332,1759,1573,111.8
'31150, 시흥시,'070002, 66세,2019,3161,1647,1514,108.8,2809,1477,1332,110.9
'31150, 시흥시,'070003, 67세,2019,3344,1698,1646,103.2,3061,1562,1499,104.2
'31150, 시흥시,'070004, 68세,2019,2219,1070,1149,93.1,2001,988,1013,97.5
'31150, 시흥시,'070005, 69세,2019,2386,1194,1192,100.2,2205,1114,1091,102.1
'31150, 시흥시,'075,70~74세,2019,10157,4695,5462,86,9716,4529,5187,87.3
'31150, 시흥시,'075001, 70세,2019,2364,1139,1225,93,2227,1088,1139,95.5
'31150, 시흥시,'075002, 71세,2019,2253,1097,1156,94.9,2156,1053,1103,95.5
'31150, 시흥시,'075003, 72세,2019,2211,1016,1195,85,2126,987,1139,86.7
'31150, 시흥시,'075004, 73세,2019,1687,724,963,75.2,1619,696,923,75.4
'31150, 시흥시,'075005, 74세,2019,1642,719,923,77.9,1588,705,883,79.8
'31150, 시흥시,'080,75~79세,2019,8151,3320,4831,68.7,7970,3263,4707,69.3
'31150, 시흥시,'080001, 75세,2019,1622,713,909,78.4,1588,697,891,78.2
'31150, 시흥시,'080002, 76세,2019,1653,704,949,74.2,1617,695,922,75.4
'31150, 시흥시,'080003, 77세,2019,1932,791,1141,69.3,1901,782,1119,69.9
'31150, 시흥시,'080004, 78세,2019,1563,614,949,64.7,1520,600,920,65.2
'31150, 시흥시,'080005, 79세,2019,1381,498,883,56.4,1344,489,855,57.2
'31150, 시흥시,'085,80~84세,2019,5675,1914,3761,50.9,5568,1886,3682,51.2
'31150, 시흥시,'085001, 80세,2019,1410,485,925,52.4,1379,480,899,53.4
'31150, 시흥시,'085002, 81세,2019,1321,475,846,56.1,1296,467,829,56.3
'31150, 시흥시,'085003, 82세,2019,1088,377,711,53,1066,372,694,53.6
'31150, 시흥시,'085004, 83세,2019,979,310,669,46.3,959,304,655,46.4
'31150, 시흥시,'085005, 84세,2019,877,267,610,43.8,868,263,605,43.5
'31150, 시흥시,'086,85세이상,2019,3988,942,3046,30.9,3923,930,2993,31.1
'31150, 시흥시,'090,85~89세,2019,2704,695,2009,34.6,2654,685,1969,34.8
'31150, 시흥시,'090001, 85세,2019,758,227,531,42.7,743,224,519,43.2
'31150, 시흥시,'090002, 86세,2019,621,173,448,38.6,601,171,430,39.8
'31150, 시흥시,'090003, 87세,2019,554,128,426,30,552,128,424,30.2
'31150, 시흥시,'090004, 88세,2019,400,102,298,34.2,393,99,294,33.7
'31150, 시흥시,'090005, 89세,2019,371,65,306,21.2,365,63,302,20.9
'31150, 시흥시,'095,90~94세,2019,1020,202,818,24.7,1009,201,808,24.9
'31150, 시흥시,'095001, 90세,2019,309,65,244,26.6,307,65,242,26.9
'31150, 시흥시,'095002, 91세,2019,262,53,209,25.4,260,53,207,25.6
'31150, 시흥시,'095003, 92세,2019,223,35,188,18.6,220,34,186,18.3
'31150, 시흥시,'095004, 93세,2019,122,22,100,22,120,22,98,22.4
'31150, 시흥시,'095005, 94세,2019,104,27,77,35.1,102,27,75,36
'31150, 시흥시,'100,95~99세,2019,224,40,184,21.7,220,39,181,21.5
'31150, 시흥시,'100001, 95세,2019,60,7,53,13.2,59,7,52,13.5
'31150, 시흥시,'100002, 96세,2019,69,11,58,19,68,11,57,19.3
'31150, 시흥시,'100003, 97세,2019,50,14,36,38.9,50,14,36,38.9
'31150, 시흥시,'100004, 98세,2019,27,X,23,17.4,26,X,23,13
'31150, 시흥시,'100005, 99세,2019,18,X,14,28.6,17,X,13,30.8
'31150, 시흥시,'101,100세이상,2019,40,5,35,14.3,40,5,35,14.3
'31150, 시흥시,'102,15세미만,2019,72407,37000,35407,104.5,69306,35354,33952,104.1
'31150, 시흥시,'103,15~64세,2019,393477,214178,179299,119.5,348575,186959,161616,115.7
'31150, 시흥시,'104,65세이상,2019,42865,18447,24418,75.5,40585,17508,23077,75.9
'31150, 시흥시,'126,평균연령,2019,39,38.4,39.7,,38.9,38.3,39.6,
'31150, 시흥시,'127,중위연령,2019,39.8,39.2,40.5,,40,39.6,40.6,
'31160, 군포시,'000,합계,2019,275154,136614,138540,98.6,264719,131183,133536,98.2
'31160, 군포시,'005,0~4세,2019,10420,5304,5116,103.7,10098,5150,4948,104.1
'31160, 군포시,'005001, 0세,2019,1932,967,965,100.2,1857,938,919,102.1
'31160, 군포시,'005002, 1세,2019,1821,965,856,112.7,1755,931,824,113
'31160, 군포시,'005003, 2세,2019,2041,1027,1014,101.3,1972,991,981,101
'31160, 군포시,'005004, 3세,2019,2332,1184,1148,103.1,2264,1150,1114,103.2
'31160, 군포시,'005005, 4세,2019,2294,1161,1133,102.5,2250,1140,1110,102.7
'31160, 군포시,'010,5~9세,2019,12299,6356,5943,106.9,12136,6265,5871,106.7
'31160, 군포시,'010001, 5세,2019,2336,1197,1139,105.1,2300,1174,1126,104.3
'31160, 군포시,'010002, 6세,2019,2382,1215,1167,104.1,2348,1198,1150,104.2
'31160, 군포시,'010003, 7세,2019,2507,1282,1225,104.7,2473,1264,1209,104.5
'31160, 군포시,'010004, 8세,2019,2610,1358,1252,108.5,2575,1340,1235,108.5
'31160, 군포시,'010005, 9세,2019,2464,1304,1160,112.4,2440,1289,1151,112
'31160, 군포시,'015,10~14세,2019,12356,6349,6007,105.7,12284,6316,5968,105.8
'31160, 군포시,'015001, 10세,2019,2363,1205,1158,104.1,2342,1199,1143,104.9
'31160, 군포시,'015002, 11세,2019,2619,1343,1276,105.3,2601,1331,1270,104.8
'31160, 군포시,'015003, 12세,2019,2578,1335,1243,107.4,2567,1331,1236,107.7
'31160, 군포시,'015004, 13세,2019,2398,1229,1169,105.1,2386,1224,1162,105.3
'31160, 군포시,'015005, 14세,2019,2398,1237,1161,106.5,2388,1231,1157,106.4
'31160, 군포시,'020,15~19세,2019,14136,7260,6876,105.6,14057,7222,6835,105.7
'31160, 군포시,'020001, 15세,2019,2634,1332,1302,102.3,2624,1330,1294,102.8
'31160, 군포시,'020002, 16세,2019,2632,1360,1272,106.9,2620,1355,1265,107.1
'31160, 군포시,'020003, 17세,2019,2757,1415,1342,105.4,2743,1409,1334,105.6
'31160, 군포시,'020004, 18세,2019,3003,1500,1503,99.8,2985,1489,1496,99.5
'31160, 군포시,'020005, 19세,2019,3110,1653,1457,113.5,3085,1639,1446,113.3
'31160, 군포시,'025,20~24세,2019,16743,8815,7928,111.2,16288,8580,7708,111.3
'31160, 군포시,'025001, 20세,2019,3021,1644,1377,119.4,2964,1615,1349,119.7
'31160, 군포시,'025002, 21세,2019,3294,1788,1506,118.7,3225,1753,1472,119.1
'31160, 군포시,'025003, 22세,2019,3322,1721,1601,107.5,3238,1678,1560,107.6
'31160, 군포시,'025004, 23세,2019,3466,1798,1668,107.8,3355,1735,1620,107.1
'31160, 군포시,'025005, 24세,2019,3640,1864,1776,105,3506,1799,1707,105.4
'31160, 군포시,'030,25~29세,2019,19818,10302,9516,108.3,18837,9781,9056,108
'31160, 군포시,'030001, 25세,2019,3843,2010,1833,109.7,3694,1936,1758,110.1
'31160, 군포시,'030002, 26세,2019,3939,2041,1898,107.5,3779,1951,1828,106.7
'31160, 군포시,'030003, 27세,2019,4121,2145,1976,108.6,3930,2052,1878,109.3
'31160, 군포시,'030004, 28세,2019,4075,2104,1971,106.7,3847,1977,1870,105.7
'31160, 군포시,'030005, 29세,2019,3840,2002,1838,108.9,3587,1865,1722,108.3
'31160, 군포시,'035,30~34세,2019,19192,10031,9161,109.5,17799,9277,8522,108.9
'31160, 군포시,'035001, 30세,2019,3857,2012,1845,109.1,3595,1874,1721,108.9
'31160, 군포시,'035002, 31세,2019,3753,1929,1824,105.8,3499,1796,1703,105.5
'31160, 군포시,'035003, 32세,2019,3828,2028,1800,112.7,3517,1856,1661,111.7
'31160, 군포시,'035004, 33세,2019,3898,2016,1882,107.1,3598,1861,1737,107.1
'31160, 군포시,'035005, 34세,2019,3856,2046,1810,113,3590,1890,1700,111.2
'31160, 군포시,'040,35~39세,2019,21699,11188,10511,106.4,20603,10565,10038,105.3
'31160, 군포시,'040001, 35세,2019,4017,2104,1913,110,3775,1962,1813,108.2
'31160, 군포시,'040002, 36세,2019,4223,2259,1964,115,3974,2118,1856,114.1
'31160, 군포시,'040003, 37세,2019,4471,2236,2235,100,4241,2101,2140,98.2
'31160, 군포시,'040004, 38세,2019,4467,2303,2164,106.4,4284,2202,2082,105.8
'31160, 군포시,'040005, 39세,2019,4521,2286,2235,102.3,4329,2182,2147,101.6
'31160, 군포시,'045,40~44세,2019,20773,10315,10458,98.6,19880,9821,10059,97.6
'31160, 군포시,'045001, 40세,2019,4343,2175,2168,100.3,4125,2052,2073,99
'31160, 군포시,'045002, 41세,2019,3938,1980,1958,101.1,3760,1881,1879,100.1
'31160, 군포시,'045003, 42세,2019,4178,2056,2122,96.9,4002,1952,2050,95.2
'31160, 군포시,'045004, 43세,2019,4080,2029,2051,98.9,3927,1946,1981,98.2
'31160, 군포시,'045005, 44세,2019,4234,2075,2159,96.1,4066,1990,2076,95.9
'31160, 군포시,'050,45~49세,2019,25289,12361,12928,95.6,24175,11773,12402,94.9
'31160, 군포시,'050001, 45세,2019,4769,2293,2476,92.6,4595,2205,2390,92.3
'31160, 군포시,'050002, 46세,2019,5043,2495,2548,97.9,4821,2369,2452,96.6
'31160, 군포시,'050003, 47세,2019,4916,2448,2468,99.2,4723,2339,2384,98.1
'31160, 군포시,'050004, 48세,2019,5311,2541,2770,91.7,5055,2413,2642,91.3
'31160, 군포시,'050005, 49세,2019,5250,2584,2666,96.9,4981,2447,2534,96.6
'31160, 군포시,'055,50~54세,2019,24605,11974,12631,94.8,23439,11383,12056,94.4
'31160, 군포시,'055001, 50세,2019,5229,2564,2665,96.2,4984,2436,2548,95.6
'31160, 군포시,'055002, 51세,2019,5174,2460,2714,90.6,4973,2343,2630,89.1
'31160, 군포시,'055003, 52세,2019,4597,2166,2431,89.1,4383,2069,2314,89.4
'31160, 군포시,'055004, 53세,2019,4735,2407,2328,103.4,4498,2291,2207,103.8
'31160, 군포시,'055005, 54세,2019,4870,2377,2493,95.3,4601,2244,2357,95.2
'31160, 군포시,'060,55~59세,2019,24635,12065,12570,96,23464,11479,11985,95.8
'31160, 군포시,'060001, 55세,2019,4555,2204,2351,93.7,4293,2084,2209,94.3
'31160, 군포시,'060002, 56세,2019,4880,2416,2464,98.1,4542,2240,2302,97.3
'31160, 군포시,'060003, 57세,2019,4898,2416,2482,97.3,4672,2302,2370,97.1
'31160, 군포시,'060004, 58세,2019,5140,2474,2666,92.8,5013,2412,2601,92.7
'31160, 군포시,'060005, 59세,2019,5162,2555,2607,98,4944,2441,2503,97.5
'31160, 군포시,'065,60~64세,2019,19335,9561,9774,97.8,18466,9121,9345,97.6
'31160, 군포시,'065001, 60세,2019,4463,2209,2254,98,4280,2122,2158,98.3
'31160, 군포시,'065002, 61세,2019,4281,2109,2172,97.1,4076,2004,2072,96.7
'31160, 군포시,'065003, 62세,2019,3866,1930,1936,99.7,3691,1849,1842,100.4
'31160, 군포시,'065004, 63세,2019,3377,1701,1676,101.5,3231,1622,1609,100.8
'31160, 군포시,'065005, 64세,2019,3348,1612,1736,92.9,3188,1524,1664,91.6
'31160, 군포시,'070,65~69세,2019,10991,5487,5504,99.7,10606,5302,5304,100
'31160, 군포시,'070001, 65세,2019,2747,1392,1355,102.7,2625,1334,1291,103.3
'31160, 군포시,'070002, 66세,2019,2329,1164,1165,99.9,2237,1119,1118,100.1
'31160, 군포시,'070003, 67세,2019,2430,1201,1229,97.7,2351,1166,1185,98.4
'31160, 군포시,'070004, 68세,2019,1684,844,840,100.5,1623,813,810,100.4
'31160, 군포시,'070005, 69세,2019,1801,886,915,96.8,1770,870,900,96.7
'31160, 군포시,'075,70~74세,2019,8042,3750,4292,87.4,7907,3698,4209,87.9
'31160, 군포시,'075001, 70세,2019,1788,894,894,100,1743,876,867,101
'31160, 군포시,'075002, 71세,2019,1717,842,875,96.2,1688,830,858,96.7
'31160, 군포시,'075003, 72세,2019,1857,833,1024,81.3,1826,822,1004,81.9
'31160, 군포시,'075004, 73세,2019,1412,613,799,76.7,1398,609,789,77.2
'31160, 군포시,'075005, 74세,2019,1268,568,700,81.1,1252,561,691,81.2
'31160, 군포시,'080,75~79세,2019,6479,2686,3793,70.8,6412,2668,3744,71.3
'31160, 군포시,'080001, 75세,2019,1308,554,754,73.5,1296,552,744,74.2
'31160, 군포시,'080002, 76세,2019,1292,554,738,75.1,1278,551,727,75.8
'31160, 군포시,'080003, 77세,2019,1531,639,892,71.6,1519,635,884,71.8
'31160, 군포시,'080004, 78세,2019,1255,530,725,73.1,1242,524,718,73
'31160, 군포시,'080005, 79세,2019,1093,409,684,59.8,1077,406,671,60.5
'31160, 군포시,'085,80~84세,2019,4709,1721,2988,57.6,4666,1708,2958,57.7
'31160, 군포시,'085001, 80세,2019,1054,404,650,62.2,1047,404,643,62.8
'31160, 군포시,'085002, 81세,2019,1091,400,691,57.9,1077,393,684,57.5
'31160, 군포시,'085003, 82세,2019,950,361,589,61.3,940,358,582,61.5
'31160, 군포시,'085004, 83세,2019,813,277,536,51.7,806,276,530,52.1
'31160, 군포시,'085005, 84세,2019,801,279,522,53.4,796,277,519,53.4
'31160, 군포시,'086,85세이상,2019,3633,1089,2544,42.8,3602,1074,2528,42.5
'31160, 군포시,'090,85~89세,2019,2482,790,1692,46.7,2461,781,1680,46.5
'31160, 군포시,'090001, 85세,2019,720,239,481,49.7,707,233,474,49.2
'31160, 군포시,'090002, 86세,2019,563,197,366,53.8,561,196,365,53.7
'31160, 군포시,'090003, 87세,2019,498,155,343,45.2,494,153,341,44.9
'31160, 군포시,'090004, 88세,2019,349,99,250,39.6,347,99,248,39.9
'31160, 군포시,'090005, 89세,2019,352,100,252,39.7,352,100,252,39.7
'31160, 군포시,'095,90~94세,2019,903,241,662,36.4,894,236,658,35.9
'31160, 군포시,'095001, 90세,2019,278,83,195,42.6,274,80,194,41.2
'31160, 군포시,'095002, 91세,2019,241,64,177,36.2,239,63,176,35.8
'31160, 군포시,'095003, 92세,2019,171,46,125,36.8,170,46,124,37.1
'31160, 군포시,'095004, 93세,2019,116,31,85,36.5,116,31,85,36.5
'31160, 군포시,'095005, 94세,2019,97,17,80,21.3,95,16,79,20.3
'31160, 군포시,'100,95~99세,2019,220,50,170,29.4,219,49,170,28.8
'31160, 군포시,'100001, 95세,2019,69,19,50,38,68,18,50,36
'31160, 군포시,'100002, 96세,2019,61,11,50,22,61,11,50,22
'31160, 군포시,'100003, 97세,2019,35,6,29,20.7,35,6,29,20.7
'31160, 군포시,'100004, 98세,2019,38,9,29,31,38,9,29,31
'31160, 군포시,'100005, 99세,2019,17,5,12,41.7,17,5,12,41.7
'31160, 군포시,'101,100세이상,2019,28,8,20,40,28,8,20,40
'31160, 군포시,'102,15세미만,2019,35075,18009,17066,105.5,34518,17731,16787,105.6
'31160, 군포시,'103,15~64세,2019,206225,103872,102353,101.5,197008,99002,98006,101
'31160, 군포시,'104,65세이상,2019,33854,14733,19121,77.1,33193,14450,18743,77.1
'31160, 군포시,'126,평균연령,2019,41.5,40.5,42.5,,41.4,40.4,42.5,
'31160, 군포시,'127,중위연령,2019,42.6,41.3,44,,42.6,41.2,43.9,
'31170, 의왕시,'000,합계,2019,155826,77677,78149,99.4,154005,76719,77286,99.3
'31170, 의왕시,'005,0~4세,2019,5848,3049,2799,108.9,5814,3028,2786,108.7
'31170, 의왕시,'005001, 0세,2019,946,514,432,119,943,512,431,118.8
'31170, 의왕시,'005002, 1세,2019,1014,537,477,112.6,1011,536,475,112.8
'31170, 의왕시,'005003, 2세,2019,1137,598,539,110.9,1130,593,537,110.4
'31170, 의왕시,'005004, 3세,2019,1348,671,677,99.1,1335,663,672,98.7
'31170, 의왕시,'005005, 4세,2019,1403,729,674,108.2,1395,724,671,107.9
'31170, 의왕시,'010,5~9세,2019,6813,3495,3318,105.3,6792,3487,3305,105.5
'31170, 의왕시,'010001, 5세,2019,1348,703,645,109,1343,701,642,109.2
'31170, 의왕시,'010002, 6세,2019,1357,657,700,93.9,1353,656,697,94.1
'31170, 의왕시,'010003, 7세,2019,1438,758,680,111.5,1433,756,677,111.7
'31170, 의왕시,'010004, 8세,2019,1361,708,653,108.4,1358,707,651,108.6
'31170, 의왕시,'010005, 9세,2019,1309,669,640,104.5,1305,667,638,104.5
'31170, 의왕시,'015,10~14세,2019,6517,3364,3153,106.7,6507,3359,3148,106.7
'31170, 의왕시,'015001, 10세,2019,1356,700,656,106.7,1353,699,654,106.9
'31170, 의왕시,'015002, 11세,2019,1370,722,648,111.4,1367,720,647,111.3
'31170, 의왕시,'015003, 12세,2019,1318,671,647,103.7,1315,669,646,103.6
'31170, 의왕시,'015004, 13세,2019,1246,656,590,111.2,1245,656,589,111.4
'31170, 의왕시,'015005, 14세,2019,1227,615,612,100.5,1227,615,612,100.5
'31170, 의왕시,'020,15~19세,2019,8427,4195,4232,99.1,8409,4185,4224,99.1
'31170, 의왕시,'020001, 15세,2019,1361,670,691,97,1359,670,689,97.2
'31170, 의왕시,'020002, 16세,2019,1595,820,775,105.8,1594,820,774,105.9
'31170, 의왕시,'020003, 17세,2019,1615,777,838,92.7,1615,777,838,92.7
'31170, 의왕시,'020004, 18세,2019,1951,964,987,97.7,1948,963,985,97.8
'31170, 의왕시,'020005, 19세,2019,1905,964,941,102.4,1893,955,938,101.8
'31170, 의왕시,'025,20~24세,2019,10416,5485,4931,111.2,10258,5406,4852,111.4
'31170, 의왕시,'025001, 20세,2019,1917,997,920,108.4,1909,991,918,108
'31170, 의왕시,'025002, 21세,2019,2010,1044,966,108.1,1976,1028,948,108.4
'31170, 의왕시,'025003, 22세,2019,2062,1082,980,110.4,2033,1067,966,110.5
'31170, 의왕시,'025004, 23세,2019,2208,1184,1024,115.6,2159,1165,994,117.2
'31170, 의왕시,'025005, 24세,2019,2219,1178,1041,113.2,2181,1155,1026,112.6
'31170, 의왕시,'030,25~29세,2019,10958,5905,5053,116.9,10679,5759,4920,117.1
'31170, 의왕시,'030001, 25세,2019,2231,1190,1041,114.3,2174,1163,1011,115
'31170, 의왕시,'030002, 26세,2019,2279,1258,1021,123.2,2221,1219,1002,121.7
'31170, 의왕시,'030003, 27세,2019,2222,1216,1006,120.9,2166,1187,979,121.2
'31170, 의왕시,'030004, 28세,2019,2189,1171,1018,115,2138,1148,990,116
'31170, 의왕시,'030005, 29세,2019,2037,1070,967,110.7,1980,1042,938,111.1
'31170, 의왕시,'035,30~34세,2019,9706,5081,4625,109.9,9449,4948,4501,109.9
'31170, 의왕시,'035001, 30세,2019,1966,1036,930,111.4,1920,1015,905,112.2
'31170, 의왕시,'035002, 31세,2019,1896,980,916,107,1837,943,894,105.5
'31170, 의왕시,'035003, 32세,2019,1933,1019,914,111.5,1876,990,886,111.7
'31170, 의왕시,'035004, 33세,2019,1882,961,921,104.3,1833,937,896,104.6
'31170, 의왕시,'035005, 34세,2019,2029,1085,944,114.9,1983,1063,920,115.5
'31170, 의왕시,'040,35~39세,2019,11414,5862,5552,105.6,11153,5705,5448,104.7
'31170, 의왕시,'040001, 35세,2019,2025,1058,967,109.4,1968,1025,943,108.7
'31170, 의왕시,'040002, 36세,2019,2242,1116,1126,99.1,2192,1084,1108,97.8
'31170, 의왕시,'040003, 37세,2019,2379,1261,1118,112.8,2318,1223,1095,111.7
'31170, 의왕시,'040004, 38세,2019,2412,1232,1180,104.4,2362,1204,1158,104
'31170, 의왕시,'040005, 39세,2019,2356,1195,1161,102.9,2313,1169,1144,102.2
'31170, 의왕시,'045,40~44세,2019,10853,5539,5314,104.2,10680,5450,5230,104.2
'31170, 의왕시,'045001, 40세,2019,2237,1157,1080,107.1,2187,1131,1056,107.1
'31170, 의왕시,'045002, 41세,2019,2007,1030,977,105.4,1970,1016,954,106.5
'31170, 의왕시,'045003, 42세,2019,2196,1111,1085,102.4,2160,1091,1069,102.1
'31170, 의왕시,'045004, 43세,2019,2207,1139,1068,106.6,2179,1119,1060,105.6
'31170, 의왕시,'045005, 44세,2019,2206,1102,1104,99.8,2184,1093,1091,100.2
'31170, 의왕시,'050,45~49세,2019,13348,6408,6940,92.3,13185,6317,6868,92
'31170, 의왕시,'050001, 45세,2019,2417,1199,1218,98.4,2389,1180,1209,97.6
'31170, 의왕시,'050002, 46세,2019,2617,1274,1343,94.9,2583,1261,1322,95.4
'31170, 의왕시,'050003, 47세,2019,2660,1303,1357,96,2625,1282,1343,95.5
'31170, 의왕시,'050004, 48세,2019,2832,1327,1505,88.2,2802,1309,1493,87.7
'31170, 의왕시,'050005, 49세,2019,2822,1305,1517,86,2786,1285,1501,85.6
'31170, 의왕시,'055,50~54세,2019,14277,6964,7313,95.2,14125,6881,7244,95
'31170, 의왕시,'055001, 50세,2019,2940,1409,1531,92,2899,1384,1515,91.4
'31170, 의왕시,'055002, 51세,2019,3073,1480,1593,92.9,3043,1464,1579,92.7
'31170, 의왕시,'055003, 52세,2019,2748,1297,1451,89.4,2728,1288,1440,89.4
'31170, 의왕시,'055004, 53세,2019,2635,1324,1311,101,2604,1307,1297,100.8
'31170, 의왕시,'055005, 54세,2019,2881,1454,1427,101.9,2851,1438,1413,101.8
'31170, 의왕시,'060,55~59세,2019,14712,7112,7600,93.6,14607,7065,7542,93.7
'31170, 의왕시,'060001, 55세,2019,2694,1308,1386,94.4,2667,1291,1376,93.8
'31170, 의왕시,'060002, 56세,2019,2873,1419,1454,97.6,2855,1408,1447,97.3
'31170, 의왕시,'060003, 57세,2019,2885,1350,1535,87.9,2863,1344,1519,88.5
'31170, 의왕시,'060004, 58세,2019,3191,1532,1659,92.3,3174,1527,1647,92.7
'31170, 의왕시,'060005, 59세,2019,3069,1503,1566,96,3048,1495,1553,96.3
'31170, 의왕시,'065,60~64세,2019,12181,6111,6070,100.7,12094,6066,6028,100.6
'31170, 의왕시,'065001, 60세,2019,2750,1363,1387,98.3,2735,1357,1378,98.5
'31170, 의왕시,'065002, 61세,2019,2600,1298,1302,99.7,2577,1283,1294,99.1
'31170, 의왕시,'065003, 62세,2019,2447,1258,1189,105.8,2425,1248,1177,106
'31170, 의왕시,'065004, 63세,2019,2142,1066,1076,99.1,2124,1057,1067,99.1
'31170, 의왕시,'065005, 64세,2019,2242,1126,1116,100.9,2233,1121,1112,100.8
'31170, 의왕시,'070,65~69세,2019,6920,3539,3381,104.7,6863,3513,3350,104.9
'31170, 의왕시,'070001, 65세,2019,1752,895,857,104.4,1735,888,847,104.8
'31170, 의왕시,'070002, 66세,2019,1499,743,756,98.3,1489,739,750,98.5
'31170, 의왕시,'070003, 67세,2019,1539,810,729,111.1,1527,805,722,111.5
'31170, 의왕시,'070004, 68세,2019,1052,555,497,111.7,1041,549,492,111.6
'31170, 의왕시,'070005, 69세,2019,1078,536,542,98.9,1071,532,539,98.7
'31170, 의왕시,'075,70~74세,2019,4920,2365,2555,92.6,4893,2354,2539,92.7
'31170, 의왕시,'075001, 70세,2019,1203,578,625,92.5,1197,573,624,91.8
'31170, 의왕시,'075002, 71세,2019,1098,521,577,90.3,1094,520,574,90.6
'31170, 의왕시,'075003, 72세,2019,1031,503,528,95.3,1024,503,521,96.5
'31170, 의왕시,'075004, 73세,2019,821,398,423,94.1,817,396,421,94.1
'31170, 의왕시,'075005, 74세,2019,767,365,402,90.8,761,362,399,90.7
'31170, 의왕시,'080,75~79세,2019,3814,1669,2145,77.8,3805,1665,2140,77.8
'31170, 의왕시,'080001, 75세,2019,792,374,418,89.5,791,373,418,89.2
'31170, 의왕시,'080002, 76세,2019,765,333,432,77.1,763,331,432,76.6
'31170, 의왕시,'080003, 77세,2019,914,408,506,80.6,912,408,504,81
'31170, 의왕시,'080004, 78세,2019,695,296,399,74.2,693,296,397,74.6
'31170, 의왕시,'080005, 79세,2019,648,258,390,66.2,646,257,389,66.1
'31170, 의왕시,'085,80~84세,2019,2651,979,1672,58.6,2644,976,1668,58.5
'31170, 의왕시,'085001, 80세,2019,630,258,372,69.4,627,256,371,69
'31170, 의왕시,'085002, 81세,2019,584,244,340,71.8,582,243,339,71.7
'31170, 의왕시,'085003, 82세,2019,542,192,350,54.9,541,192,349,55
'31170, 의왕시,'085004, 83세,2019,456,148,308,48.1,455,148,307,48.2
'31170, 의왕시,'085005, 84세,2019,439,137,302,45.4,439,137,302,45.4
'31170, 의왕시,'086,85세이상,2019,2051,555,1496,37.1,2048,555,1493,37.2
'31170, 의왕시,'090,85~89세,2019,1416,408,1008,40.5,1415,408,1007,40.5
'31170, 의왕시,'090001, 85세,2019,393,109,284,38.4,393,109,284,38.4
'31170, 의왕시,'090002, 86세,2019,334,102,232,44,334,102,232,44
'31170, 의왕시,'090003, 87세,2019,263,79,184,42.9,263,79,184,42.9
'31170, 의왕시,'090004, 88세,2019,234,70,164,42.7,234,70,164,42.7
'31170, 의왕시,'090005, 89세,2019,192,48,144,33.3,191,48,143,33.6
'31170, 의왕시,'095,90~94세,2019,499,114,385,29.6,498,114,384,29.7
'31170, 의왕시,'095001, 90세,2019,161,44,117,37.6,161,44,117,37.6
'31170, 의왕시,'095002, 91세,2019,129,27,102,26.5,129,27,102,26.5
'31170, 의왕시,'095003, 92세,2019,96,23,73,31.5,96,23,73,31.5
'31170, 의왕시,'095004, 93세,2019,66,15,51,29.4,65,15,50,30
'31170, 의왕시,'095005, 94세,2019,47,5,42,11.9,47,5,42,11.9
'31170, 의왕시,'100,95~99세,2019,120,31,89,34.8,119,31,88,35.2
'31170, 의왕시,'100001, 95세,2019,35,13,22,59.1,35,13,22,59.1
'31170, 의왕시,'100002, 96세,2019,40,9,31,29,40,9,31,29
'31170, 의왕시,'100003, 97세,2019,21,5,16,31.3,20,5,15,33.3
'31170, 의왕시,'100004, 98세,2019,14,X,14,0,14,X,14,0
'31170, 의왕시,'100005, 99세,2019,10,X,6,66.7,10,X,6,66.7
'31170, 의왕시,'101,100세이상,2019,16,X,14,14.3,16,X,14,14.3
'31170, 의왕시,'102,15세미만,2019,19178,9908,9270,106.9,19113,9874,9239,106.9
'31170, 의왕시,'103,15~64세,2019,116292,58662,57630,101.8,114639,57782,56857,101.6
'31170, 의왕시,'104,65세이상,2019,20356,9107,11249,81,20253,9063,11190,81
'31170, 의왕시,'126,평균연령,2019,42,41,43,,42,41,43,
'31170, 의왕시,'127,중위연령,2019,43.6,42.2,45.1,,43.7,42.3,45.2,
'31180, 하남시,'000,합계,2019,260544,130979,129565,101.1,256981,128909,128072,100.7
'31180, 하남시,'005,0~4세,2019,13605,7012,6593,106.4,13577,6995,6582,106.3
'31180, 하남시,'005001, 0세,2019,2096,1098,998,110,2092,1098,994,110.5
'31180, 하남시,'005002, 1세,2019,2448,1257,1191,105.5,2442,1252,1190,105.2
'31180, 하남시,'005003, 2세,2019,2689,1395,1294,107.8,2685,1392,1293,107.7
'31180, 하남시,'005004, 3세,2019,3158,1628,1530,106.4,3150,1623,1527,106.3
'31180, 하남시,'005005, 4세,2019,3214,1634,1580,103.4,3208,1630,1578,103.3
'31180, 하남시,'010,5~9세,2019,15290,7794,7496,104,15260,7780,7480,104
'31180, 하남시,'010001, 5세,2019,3143,1594,1549,102.9,3137,1592,1545,103
'31180, 하남시,'010002, 6세,2019,3160,1603,1557,103,3157,1602,1555,103
'31180, 하남시,'010003, 7세,2019,3176,1671,1505,111,3168,1668,1500,111.2
'31180, 하남시,'010004, 8세,2019,2972,1455,1517,95.9,2961,1447,1514,95.6
'31180, 하남시,'010005, 9세,2019,2839,1471,1368,107.5,2837,1471,1366,107.7
'31180, 하남시,'015,10~14세,2019,11721,6029,5692,105.9,11704,6020,5684,105.9
'31180, 하남시,'015001, 10세,2019,2526,1294,1232,105,2520,1292,1228,105.2
'31180, 하남시,'015002, 11세,2019,2577,1286,1291,99.6,2574,1285,1289,99.7
'31180, 하남시,'015003, 12세,2019,2528,1320,1208,109.3,2525,1319,1206,109.4
'31180, 하남시,'015004, 13세,2019,2083,1079,1004,107.5,2079,1075,1004,107.1
'31180, 하남시,'015005, 14세,2019,2007,1050,957,109.7,2006,1049,957,109.6
'31180, 하남시,'020,15~19세,2019,10280,5247,5033,104.3,10254,5231,5023,104.1
'31180, 하남시,'020001, 15세,2019,2084,1054,1030,102.3,2080,1050,1030,101.9
'31180, 하남시,'020002, 16세,2019,2054,1040,1014,102.6,2051,1039,1012,102.7
'31180, 하남시,'020003, 17세,2019,1975,988,987,100.1,1974,987,987,100
'31180, 하남시,'020004, 18세,2019,2179,1125,1054,106.7,2172,1120,1052,106.5
'31180, 하남시,'020005, 19세,2019,1988,1040,948,109.7,1977,1035,942,109.9
'31180, 하남시,'025,20~24세,2019,12629,6643,5986,111,12326,6459,5867,110.1
'31180, 하남시,'025001, 20세,2019,2140,1135,1005,112.9,2103,1117,986,113.3
'31180, 하남시,'025002, 21세,2019,2355,1311,1044,125.6,2315,1282,1033,124.1
'31180, 하남시,'025003, 22세,2019,2572,1407,1165,120.8,2507,1368,1139,120.1
'31180, 하남시,'025004, 23세,2019,2657,1312,1345,97.5,2581,1263,1318,95.8
'31180, 하남시,'025005, 24세,2019,2905,1478,1427,103.6,2820,1429,1391,102.7
'31180, 하남시,'030,25~29세,2019,16831,8718,8113,107.5,16257,8333,7924,105.2
'31180, 하남시,'030001, 25세,2019,3069,1558,1511,103.1,2967,1490,1477,100.9
'31180, 하남시,'030002, 26세,2019,3256,1722,1534,112.3,3149,1648,1501,109.8
'31180, 하남시,'030003, 27세,2019,3586,1867,1719,108.6,3469,1781,1688,105.5
'31180, 하남시,'030004, 28세,2019,3436,1783,1653,107.9,3321,1711,1610,106.3
'31180, 하남시,'030005, 29세,2019,3484,1788,1696,105.4,3351,1703,1648,103.3
'31180, 하남시,'035,30~34세,2019,18862,9521,9341,101.9,18229,9101,9128,99.7
'31180, 하남시,'035001, 30세,2019,3524,1824,1700,107.3,3382,1727,1655,104.4
'31180, 하남시,'035002, 31세,2019,3445,1696,1749,97,3335,1626,1709,95.1
'31180, 하남시,'035003, 32세,2019,3766,1903,1863,102.1,3622,1804,1818,99.2
'31180, 하남시,'035004, 33세,2019,4008,2044,1964,104.1,3873,1954,1919,101.8
'31180, 하남시,'035005, 34세,2019,4119,2054,2065,99.5,4017,1990,2027,98.2
'31180, 하남시,'040,35~39세,2019,26749,13570,13179,103,26239,13253,12986,102.1
'31180, 하남시,'040001, 35세,2019,4466,2278,2188,104.1,4358,2203,2155,102.2
'31180, 하남시,'040002, 36세,2019,5151,2612,2539,102.9,5039,2542,2497,101.8
'31180, 하남시,'040003, 37세,2019,5527,2809,2718,103.3,5432,2756,2676,103
'31180, 하남시,'040004, 38세,2019,5886,2944,2942,100.1,5788,2884,2904,99.3
'31180, 하남시,'040005, 39세,2019,5719,2927,2792,104.8,5622,2868,2754,104.1
'31180, 하남시,'045,40~44세,2019,23357,12233,11124,110,23016,12050,10966,109.9
'31180, 하남시,'045001, 40세,2019,5406,2773,2633,105.3,5307,2720,2587,105.1
'31180, 하남시,'045002, 41세,2019,4626,2432,2194,110.8,4555,2396,2159,111
'31180, 하남시,'045003, 42세,2019,4740,2494,2246,111,4676,2457,2219,110.7
'31180, 하남시,'045004, 43세,2019,4338,2307,2031,113.6,4285,2275,2010,113.2
'31180, 하남시,'045005, 44세,2019,4247,2227,2020,110.2,4193,2202,1991,110.6
'31180, 하남시,'050,45~49세,2019,21529,11299,10230,110.4,21255,11155,10100,110.4
'31180, 하남시,'050001, 45세,2019,4551,2408,2143,112.4,4498,2378,2120,112.2
'31180, 하남시,'050002, 46세,2019,4192,2213,1979,111.8,4145,2188,1957,111.8
'31180, 하남시,'050003, 47세,2019,4342,2313,2029,114,4277,2277,2000,113.9
'31180, 하남시,'050004, 48세,2019,4418,2310,2108,109.6,4370,2286,2084,109.7
'31180, 하남시,'050005, 49세,2019,4026,2055,1971,104.3,3965,2026,1939,104.5
'31180, 하남시,'055,50~54세,2019,19242,9546,9696,98.5,18988,9423,9565,98.5
'31180, 하남시,'055001, 50세,2019,4079,2062,2017,102.2,4024,2036,1988,102.4
'31180, 하남시,'055002, 51세,2019,4025,1952,2073,94.2,3979,1925,2054,93.7
'31180, 하남시,'055003, 52세,2019,3738,1854,1884,98.4,3695,1836,1859,98.8
'31180, 하남시,'055004, 53세,2019,3652,1824,1828,99.8,3593,1799,1794,100.3
'31180, 하남시,'055005, 54세,2019,3748,1854,1894,97.9,3697,1827,1870,97.7
'31180, 하남시,'060,55~59세,2019,19993,9603,10390,92.4,19761,9498,10263,92.5
'31180, 하남시,'060001, 55세,2019,3554,1759,1795,98,3497,1734,1763,98.4
'31180, 하남시,'060002, 56세,2019,3769,1786,1983,90.1,3717,1763,1954,90.2
'31180, 하남시,'060003, 57세,2019,3907,1905,2002,95.2,3861,1885,1976,95.4
'31180, 하남시,'060004, 58세,2019,4375,2077,2298,90.4,4341,2060,2281,90.3
'31180, 하남시,'060005, 59세,2019,4388,2076,2312,89.8,4345,2056,2289,89.8
'31180, 하남시,'065,60~64세,2019,18283,8828,9455,93.4,18114,8757,9357,93.6
'31180, 하남시,'065001, 60세,2019,3949,1891,2058,91.9,3916,1878,2038,92.1
'31180, 하남시,'065002, 61세,2019,3764,1841,1923,95.7,3726,1827,1899,96.2
'31180, 하남시,'065003, 62세,2019,3735,1829,1906,96,3705,1812,1893,95.7
'31180, 하남시,'065004, 63세,2019,3369,1608,1761,91.3,3333,1591,1742,91.3
'31180, 하남시,'065005, 64세,2019,3466,1659,1807,91.8,3434,1649,1785,92.4
'31180, 하남시,'070,65~69세,2019,12246,6035,6211,97.2,12144,5988,6156,97.3
'31180, 하남시,'070001, 65세,2019,2980,1448,1532,94.5,2941,1429,1512,94.5
'31180, 하남시,'070002, 66세,2019,2599,1269,1330,95.4,2576,1258,1318,95.4
'31180, 하남시,'070003, 67세,2019,2789,1392,1397,99.6,2772,1386,1386,100
'31180, 하남시,'070004, 68세,2019,1865,909,956,95.1,1854,905,949,95.4
'31180, 하남시,'070005, 69세,2019,2013,1017,996,102.1,2001,1010,991,101.9
'31180, 하남시,'075,70~74세,2019,8695,4491,4204,106.8,8659,4472,4187,106.8
'31180, 하남시,'075001, 70세,2019,2099,1088,1011,107.6,2094,1084,1010,107.3
'31180, 하남시,'075002, 71세,2019,2017,1044,973,107.3,2006,1037,969,107
'31180, 하남시,'075003, 72세,2019,1900,981,919,106.7,1893,978,915,106.9
'31180, 하남시,'075004, 73세,2019,1396,702,694,101.2,1388,699,689,101.5
'31180, 하남시,'075005, 74세,2019,1283,676,607,111.4,1278,674,604,111.6
'31180, 하남시,'080,75~79세,2019,5481,2551,2930,87.1,5465,2545,2920,87.2
'31180, 하남시,'080001, 75세,2019,1269,640,629,101.7,1267,638,629,101.4
'31180, 하남시,'080002, 76세,2019,1130,556,574,96.9,1126,555,571,97.2
'31180, 하남시,'080003, 77세,2019,1236,536,700,76.6,1229,533,696,76.6
'31180, 하남시,'080004, 78세,2019,990,447,543,82.3,989,447,542,82.5
'31180, 하남시,'080005, 79세,2019,856,372,484,76.9,854,372,482,77.2
'31180, 하남시,'085,80~84세,2019,3314,1262,2052,61.5,3304,1259,2045,61.6
'31180, 하남시,'085001, 80세,2019,844,339,505,67.1,844,339,505,67.1
'31180, 하남시,'085002, 81세,2019,732,308,424,72.6,731,307,424,72.4
'31180, 하남시,'085003, 82세,2019,606,238,368,64.7,601,237,364,65.1
'31180, 하남시,'085004, 83세,2019,608,217,391,55.5,607,216,391,55.2
'31180, 하남시,'085005, 84세,2019,524,160,364,44,521,160,361,44.3
'31180, 하남시,'086,85세이상,2019,2437,597,1840,32.4,2429,590,1839,32.1
'31180, 하남시,'090,85~89세,2019,1599,419,1180,35.5,1593,414,1179,35.1
'31180, 하남시,'090001, 85세,2019,415,110,305,36.1,413,108,305,35.4
'31180, 하남시,'090002, 86세,2019,367,112,255,43.9,367,112,255,43.9
'31180, 하남시,'090003, 87세,2019,328,75,253,29.6,327,74,253,29.2
'31180, 하남시,'090004, 88세,2019,257,68,189,36,257,68,189,36
'31180, 하남시,'090005, 89세,2019,232,54,178,30.3,229,52,177,29.4
'31180, 하남시,'095,90~94세,2019,648,137,511,26.8,647,136,511,26.6
'31180, 하남시,'095001, 90세,2019,194,43,151,28.5,193,42,151,27.8
'31180, 하남시,'095002, 91세,2019,172,38,134,28.4,172,38,134,28.4
'31180, 하남시,'095003, 92세,2019,128,24,104,23.1,128,24,104,23.1
'31180, 하남시,'095004, 93세,2019,76,16,60,26.7,76,16,60,26.7
'31180, 하남시,'095005, 94세,2019,78,16,62,25.8,78,16,62,25.8
'31180, 하남시,'100,95~99세,2019,172,39,133,29.3,171,38,133,28.6
'31180, 하남시,'100001, 95세,2019,44,13,31,41.9,44,13,31,41.9
'31180, 하남시,'100002, 96세,2019,56,13,43,30.2,55,12,43,27.9
'31180, 하남시,'100003, 97세,2019,32,X,28,14.3,32,X,28,14.3
'31180, 하남시,'100004, 98세,2019,17,X,14,21.4,17,X,14,21.4
'31180, 하남시,'100005, 99세,2019,23,6,17,35.3,23,6,17,35.3
'31180, 하남시,'101,100세이상,2019,18,X,16,12.5,18,X,16,12.5
'31180, 하남시,'102,15세미만,2019,40616,20835,19781,105.3,40541,20795,19746,105.3
'31180, 하남시,'103,15~64세,2019,187755,95208,92547,102.9,184439,93260,91179,102.3
'31180, 하남시,'104,65세이상,2019,32173,14936,17237,86.7,32001,14854,17147,86.6
'31180, 하남시,'126,평균연령,2019,40.4,39.7,41.1,,40.4,39.7,41.1,
'31180, 하남시,'127,중위연령,2019,40.8,40.3,41.3,,40.9,40.5,41.4,
'31190, 용인시,'000,합계,2019,1052529,525139,527390,99.6,1024132,508761,515371,98.7
'31190, 용인시,'005,0~4세,2019,45079,23116,21963,105.2,44350,22755,21595,105.4
'31190, 용인시,'005001, 0세,2019,6916,3543,3373,105,6830,3498,3332,105
'31190, 용인시,'005002, 1세,2019,7896,3986,3910,101.9,7791,3933,3858,101.9
'31190, 용인시,'005003, 2세,2019,8928,4653,4275,108.8,8761,4566,4195,108.8
'31190, 용인시,'005004, 3세,2019,10293,5270,5023,104.9,10083,5168,4915,105.1
'31190, 용인시,'005005, 4세,2019,11046,5664,5382,105.2,10885,5590,5295,105.6
'31190, 용인시,'010,5~9세,2019,58542,29953,28589,104.8,58110,29746,28364,104.9
'31190, 용인시,'010001, 5세,2019,11127,5688,5439,104.6,11003,5631,5372,104.8
'31190, 용인시,'010002, 6세,2019,11295,5755,5540,103.9,11194,5707,5487,104
'31190, 용인시,'010003, 7세,2019,12352,6307,6045,104.3,12268,6265,6003,104.4
'31190, 용인시,'010004, 8세,2019,12041,6183,5858,105.5,11977,6151,5826,105.6
'31190, 용인시,'010005, 9세,2019,11727,6020,5707,105.5,11668,5992,5676,105.6
'31190, 용인시,'015,10~14세,2019,57826,29674,28152,105.4,57612,29567,28045,105.4
'31190, 용인시,'015001, 10세,2019,11433,5878,5555,105.8,11375,5848,5527,105.8
'31190, 용인시,'015002, 11세,2019,12118,6157,5961,103.3,12065,6134,5931,103.4
'31190, 용인시,'015003, 12세,2019,12380,6310,6070,104,12342,6288,6054,103.9
'31190, 용인시,'015004, 13세,2019,11113,5759,5354,107.6,11083,5743,5340,107.5
'31190, 용인시,'015005, 14세,2019,10782,5570,5212,106.9,10747,5554,5193,107
'31190, 용인시,'020,15~19세,2019,61252,31519,29733,106,60489,31128,29361,106
'31190, 용인시,'020001, 15세,2019,11163,5688,5475,103.9,11128,5667,5461,103.8
'31190, 용인시,'020002, 16세,2019,10539,5372,5167,104,10499,5350,5149,103.9
'31190, 용인시,'020003, 17세,2019,10513,5430,5083,106.8,10459,5396,5063,106.6
'31190, 용인시,'020004, 18세,2019,12666,6512,6154,105.8,12505,6436,6069,106
'31190, 용인시,'020005, 19세,2019,16371,8517,7854,108.4,15898,8279,7619,108.7
'31190, 용인시,'025,20~24세,2019,71706,37329,34377,108.6,67620,35017,32603,107.4
'31190, 용인시,'025001, 20세,2019,14433,7239,7194,100.6,13712,6902,6810,101.4
'31190, 용인시,'025002, 21세,2019,14158,7253,6905,105,13410,6858,6552,104.7
'31190, 용인시,'025003, 22세,2019,14488,7579,6909,109.7,13651,7086,6565,107.9
'31190, 용인시,'025004, 23세,2019,14532,7628,6904,110.5,13638,7092,6546,108.3
'31190, 용인시,'025005, 24세,2019,14095,7630,6465,118,13209,7079,6130,115.5
'31190, 용인시,'030,25~29세,2019,67302,35682,31620,112.8,62951,32834,30117,109
'31190, 용인시,'030001, 25세,2019,14229,7668,6561,116.9,13337,7072,6265,112.9
'31190, 용인시,'030002, 26세,2019,14099,7421,6678,111.1,13237,6851,6386,107.3
'31190, 용인시,'030003, 27세,2019,13765,7337,6428,114.1,12923,6788,6135,110.6
'31190, 용인시,'030004, 28세,2019,13054,6934,6120,113.3,12199,6383,5816,109.7
'31190, 용인시,'030005, 29세,2019,12155,6322,5833,108.4,11255,5740,5515,104.1
'31190, 용인시,'035,30~34세,2019,62820,32126,30694,104.7,58685,29459,29226,100.8
'31190, 용인시,'035001, 30세,2019,11996,6293,5703,110.3,11072,5681,5391,105.4
'31190, 용인시,'035002, 31세,2019,12185,6335,5850,108.3,11315,5761,5554,103.7
'31190, 용인시,'035003, 32세,2019,12215,6095,6120,99.6,11388,5581,5807,96.1
'31190, 용인시,'035004, 33세,2019,12803,6527,6276,104,12024,6040,5984,100.9
'31190, 용인시,'035005, 34세,2019,13621,6876,6745,101.9,12886,6396,6490,98.6
'31190, 용인시,'040,35~39세,2019,88206,43780,44426,98.5,85080,41800,43280,96.6
'31190, 용인시,'040001, 35세,2019,14462,7166,7296,98.2,13790,6725,7065,95.2
'31190, 용인시,'040002, 36세,2019,16676,8269,8407,98.4,16002,7845,8157,96.2
'31190, 용인시,'040003, 37세,2019,18399,9107,9292,98,17725,8682,9043,96
'31190, 용인시,'040004, 38세,2019,19011,9553,9458,101,18432,9180,9252,99.2
'31190, 용인시,'040005, 39세,2019,19658,9685,9973,97.1,19131,9368,9763,96
'31190, 용인시,'045,40~44세,2019,92183,45394,46789,97,90036,44130,45906,96.1
'31190, 용인시,'045001, 40세,2019,18990,9300,9690,96,18475,8992,9483,94.8
'31190, 용인시,'045002, 41세,2019,17349,8488,8861,95.8,16927,8231,8696,94.7
'31190, 용인시,'045003, 42세,2019,18651,9139,9512,96.1,18202,8870,9332,95
'31190, 용인시,'045004, 43세,2019,18222,9091,9131,99.6,17820,8853,8967,98.7
'31190, 용인시,'045005, 44세,2019,18971,9376,9595,97.7,18612,9184,9428,97.4
'31190, 용인시,'050,45~49세,2019,102228,51395,50833,101.1,100054,50165,49889,100.6
'31190, 용인시,'050001, 45세,2019,20629,10351,10278,100.7,20252,10142,10110,100.3
'31190, 용인시,'050002, 46세,2019,20161,10068,10093,99.8,19713,9808,9905,99
'31190, 용인시,'050003, 47세,2019,20261,10237,10024,102.1,19809,9965,9844,101.2
'31190, 용인시,'050004, 48세,2019,21154,10690,10464,102.2,20701,10447,10254,101.9
'31190, 용인시,'050005, 49세,2019,20023,10049,9974,100.8,19579,9803,9776,100.3
'31190, 용인시,'055,50~54세,2019,84906,43039,41867,102.8,83004,42061,40943,102.7
'31190, 용인시,'055001, 50세,2019,19254,9667,9587,100.8,18854,9460,9394,100.7
'31190, 용인시,'055002, 51세,2019,18480,9285,9195,101,18088,9060,9028,100.4
'31190, 용인시,'055003, 52세,2019,16411,8249,8162,101.1,16061,8094,7967,101.6
'31190, 용인시,'055004, 53세,2019,15157,7755,7402,104.8,14790,7572,7218,104.9
'31190, 용인시,'055005, 54세,2019,15604,8083,7521,107.5,15211,7875,7336,107.3
'31190, 용인시,'060,55~59세,2019,70876,36126,34750,104,69065,35266,33799,104.3
'31190, 용인시,'060001, 55세,2019,14085,7276,6809,106.9,13716,7098,6618,107.3
'31190, 용인시,'060002, 56세,2019,14589,7558,7031,107.5,14108,7326,6782,108
'31190, 용인시,'060003, 57세,2019,13796,7052,6744,104.6,13441,6882,6559,104.9
'31190, 용인시,'060004, 58세,2019,14532,7325,7207,101.6,14266,7206,7060,102.1
'31190, 용인시,'060005, 59세,2019,13874,6915,6959,99.4,13534,6754,6780,99.6
'31190, 용인시,'065,60~64세,2019,56825,27499,29326,93.8,55493,26842,28651,93.7
'31190, 용인시,'065001, 60세,2019,12558,6312,6246,101.1,12286,6176,6110,101.1
'31190, 용인시,'065002, 61세,2019,11666,5740,5926,96.9,11349,5580,5769,96.7
'31190, 용인시,'065003, 62세,2019,11285,5342,5943,89.9,11014,5223,5791,90.2
'31190, 용인시,'065004, 63세,2019,10396,4961,5435,91.3,10141,4827,5314,90.8
'31190, 용인시,'065005, 64세,2019,10920,5144,5776,89.1,10703,5036,5667,88.9
'31190, 용인시,'070,65~69세,2019,40995,18657,22338,83.5,40285,18326,21959,83.5
'31190, 용인시,'070001, 65세,2019,9309,4258,5051,84.3,9110,4157,4953,83.9
'31190, 용인시,'070002, 66세,2019,8574,3894,4680,83.2,8414,3827,4587,83.4
'31190, 용인시,'070003, 67세,2019,9280,4261,5019,84.9,9137,4194,4943,84.8
'31190, 용인시,'070004, 68세,2019,6402,2876,3526,81.6,6295,2819,3476,81.1
'31190, 용인시,'070005, 69세,2019,7430,3368,4062,82.9,7329,3329,4000,83.2
'31190, 용인시,'075,70~74세,2019,35154,15947,19207,83,34902,15839,19063,83.1
'31190, 용인시,'075001, 70세,2019,7462,3418,4044,84.5,7377,3382,3995,84.7
'31190, 용인시,'075002, 71세,2019,7601,3471,4130,84,7544,3448,4096,84.2
'31190, 용인시,'075003, 72세,2019,7839,3469,4370,79.4,7788,3442,4346,79.2
'31190, 용인시,'075004, 73세,2019,6376,2878,3498,82.3,6347,2869,3478,82.5
'31190, 용인시,'075005, 74세,2019,5876,2711,3165,85.7,5846,2698,3148,85.7
'31190, 용인시,'080,75~79세,2019,27469,12815,14654,87.5,27358,12783,14575,87.7
'31190, 용인시,'080001, 75세,2019,5661,2614,3047,85.8,5630,2602,3028,85.9
'31190, 용인시,'080002, 76세,2019,5625,2606,3019,86.3,5608,2604,3004,86.7
'31190, 용인시,'080003, 77세,2019,6336,2958,3378,87.6,6305,2951,3354,88
'31190, 용인시,'080004, 78세,2019,5323,2536,2787,91,5307,2529,2778,91
'31190, 용인시,'080005, 79세,2019,4524,2101,2423,86.7,4508,2097,2411,87
'31190, 용인시,'085,80~84세,2019,17073,7331,9742,75.3,17009,7302,9707,75.2
'31190, 용인시,'085001, 80세,2019,4295,1917,2378,80.6,4281,1909,2372,80.5
'31190, 용인시,'085002, 81세,2019,3749,1688,2061,81.9,3734,1678,2056,81.6
'31190, 용인시,'085003, 82세,2019,3442,1487,1955,76.1,3434,1484,1950,76.1
'31190, 용인시,'085004, 83세,2019,2882,1152,1730,66.6,2869,1146,1723,66.5
'31190, 용인시,'085005, 84세,2019,2705,1087,1618,67.2,2691,1085,1606,67.6
'31190, 용인시,'086,85세이상,2019,12087,3757,8330,45.1,12029,3741,8288,45.1
'31190, 용인시,'090,85~89세,2019,8157,2804,5353,52.4,8123,2792,5331,52.4
'31190, 용인시,'090001, 85세,2019,2279,861,1418,60.7,2271,859,1412,60.8
'31190, 용인시,'090002, 86세,2019,1862,662,1200,55.2,1852,658,1194,55.1
'31190, 용인시,'090003, 87세,2019,1639,571,1068,53.5,1634,570,1064,53.6
'31190, 용인시,'090004, 88세,2019,1236,364,872,41.7,1230,361,869,41.5
'31190, 용인시,'090005, 89세,2019,1141,346,795,43.5,1136,344,792,43.4
'31190, 용인시,'095,90~94세,2019,3101,773,2328,33.2,3082,771,2311,33.4
'31190, 용인시,'095001, 90세,2019,1015,270,745,36.2,1008,269,739,36.4
'31190, 용인시,'095002, 91세,2019,733,187,546,34.2,726,187,539,34.7
'31190, 용인시,'095003, 92세,2019,574,147,427,34.4,573,147,426,34.5
'31190, 용인시,'095004, 93세,2019,448,103,345,29.9,445,102,343,29.7
'31190, 용인시,'095005, 94세,2019,331,66,265,24.9,330,66,264,25
'31190, 용인시,'100,95~99세,2019,741,167,574,29.1,737,166,571,29.1
'31190, 용인시,'100001, 95세,2019,226,50,176,28.4,224,50,174,28.7
'31190, 용인시,'100002, 96세,2019,192,53,139,38.1,191,52,139,37.4
'31190, 용인시,'100003, 97세,2019,146,27,119,22.7,146,27,119,22.7
'31190, 용인시,'100004, 98세,2019,102,25,77,32.5,101,25,76,32.9
'31190, 용인시,'100005, 99세,2019,75,12,63,19,75,12,63,19
'31190, 용인시,'101,100세이상,2019,88,13,75,17.3,87,12,75,16
'31190, 용인시,'102,15세미만,2019,161447,82743,78704,105.1,160072,82068,78004,105.2
'31190, 용인시,'103,15~64세,2019,758304,383889,374415,102.5,732477,368702,363775,101.4
'31190, 용인시,'104,65세이상,2019,132778,58507,74271,78.8,131583,57991,73592,78.8
'31190, 용인시,'126,평균연령,2019,39.9,39,40.7,,39.9,39.1,40.8,
'31190, 용인시,'127,중위연령,2019,40.7,39.9,41.5,,40.9,40.2,41.6,
'31191, 처인구,'000,합계,2019,266647,138547,128100,108.2,252024,129137,122887,105.1
'31191, 처인구,'005,0~4세,2019,10021,5137,4884,105.2,9835,5049,4786,105.5
'31191, 처인구,'005001, 0세,2019,1586,811,775,104.6,1558,799,759,105.3
'31191, 처인구,'005002, 1세,2019,1781,901,880,102.4,1746,885,861,102.8
'31191, 처인구,'005003, 2세,2019,2017,1054,963,109.4,1968,1024,944,108.5
'31191, 처인구,'005004, 3세,2019,2280,1157,1123,103,2241,1143,1098,104.1
'31191, 처인구,'005005, 4세,2019,2357,1214,1143,106.2,2322,1198,1124,106.6
'31191, 처인구,'010,5~9세,2019,12283,6285,5998,104.8,12173,6227,5946,104.7
'31191, 처인구,'010001, 5세,2019,2319,1217,1102,110.4,2288,1201,1087,110.5
'31191, 처인구,'010002, 6세,2019,2376,1223,1153,106.1,2351,1214,1137,106.8
'31191, 처인구,'010003, 7세,2019,2647,1307,1340,97.5,2626,1295,1331,97.3
'31191, 처인구,'010004, 8세,2019,2550,1323,1227,107.8,2538,1315,1223,107.5
'31191, 처인구,'010005, 9세,2019,2391,1215,1176,103.3,2370,1202,1168,102.9
'31191, 처인구,'015,10~14세,2019,11813,6137,5676,108.1,11747,6109,5638,108.4
'31191, 처인구,'015001, 10세,2019,2391,1243,1148,108.3,2373,1235,1138,108.5
'31191, 처인구,'015002, 11세,2019,2460,1229,1231,99.8,2440,1222,1218,100.3
'31191, 처인구,'015003, 12세,2019,2519,1290,1229,105,2508,1284,1224,104.9
'31191, 처인구,'015004, 13세,2019,2252,1230,1022,120.4,2246,1225,1021,120
'31191, 처인구,'015005, 14세,2019,2191,1145,1046,109.5,2180,1143,1037,110.2
'31191, 처인구,'020,15~19세,2019,16783,8819,7964,110.7,16439,8636,7803,110.7
'31191, 처인구,'020001, 15세,2019,2310,1225,1085,112.9,2298,1218,1080,112.8
'31191, 처인구,'020002, 16세,2019,2483,1238,1245,99.4,2468,1230,1238,99.4
'31191, 처인구,'020003, 17세,2019,2594,1322,1272,103.9,2580,1311,1269,103.3
'31191, 처인구,'020004, 18세,2019,3517,1826,1691,108,3450,1783,1667,107
'31191, 처인구,'020005, 19세,2019,5879,3208,2671,120.1,5643,3094,2549,121.4
'31191, 처인구,'025,20~24세,2019,21119,11509,9610,119.8,19265,10277,8988,114.3
'31191, 처인구,'025001, 20세,2019,4355,2254,2101,107.3,4050,2078,1972,105.4
'31191, 처인구,'025002, 21세,2019,4128,2095,2033,103,3801,1909,1892,100.9
'31191, 처인구,'025003, 22세,2019,4280,2328,1952,119.3,3897,2068,1829,113.1
'31191, 처인구,'025004, 23세,2019,4305,2417,1888,128,3912,2130,1782,119.5
'31191, 처인구,'025005, 24세,2019,4051,2415,1636,147.6,3605,2092,1513,138.3
'31191, 처인구,'030,25~29세,2019,19017,11126,7891,141,16374,9211,7163,128.6
'31191, 처인구,'030001, 25세,2019,4121,2419,1702,142.1,3596,2032,1564,129.9
'31191, 처인구,'030002, 26세,2019,3936,2294,1642,139.7,3426,1916,1510,126.9
'31191, 처인구,'030003, 27세,2019,3937,2309,1628,141.8,3416,1931,1485,130
'31191, 처인구,'030004, 28세,2019,3640,2143,1497,143.2,3126,1772,1354,130.9
'31191, 처인구,'030005, 29세,2019,3383,1961,1422,137.9,2810,1560,1250,124.8
'31191, 처인구,'035,30~34세,2019,16919,9669,7250,133.4,14396,7877,6519,120.8
'31191, 처인구,'035001, 30세,2019,3397,2030,1367,148.5,2810,1589,1221,130.1
'31191, 처인구,'035002, 31세,2019,3268,1873,1395,134.3,2730,1479,1251,118.2
'31191, 처인구,'035003, 32세,2019,3299,1835,1464,125.3,2809,1506,1303,115.6
'31191, 처인구,'035004, 33세,2019,3410,1907,1503,126.9,2963,1607,1356,118.5
'31191, 처인구,'035005, 34세,2019,3545,2024,1521,133.1,3084,1696,1388,122.2
'31191, 처인구,'040,35~39세,2019,21520,11529,9991,115.4,19711,10250,9461,108.3
'31191, 처인구,'040001, 35세,2019,3687,1995,1692,117.9,3274,1697,1577,107.6
'31191, 처인구,'040002, 36세,2019,4229,2258,1971,114.6,3838,1980,1858,106.6
'31191, 처인구,'040003, 37세,2019,4495,2387,2108,113.2,4106,2119,1987,106.6
'31191, 처인구,'040004, 38세,2019,4520,2442,2078,117.5,4188,2203,1985,111
'31191, 처인구,'040005, 39세,2019,4589,2447,2142,114.2,4305,2251,2054,109.6
'31191, 처인구,'045,40~44세,2019,20799,11106,9693,114.6,19623,10360,9263,111.8
'31191, 처인구,'045001, 40세,2019,4490,2414,2076,116.3,4195,2222,1973,112.6
'31191, 처인구,'045002, 41세,2019,3931,2089,1842,113.4,3696,1933,1763,109.6
'31191, 처인구,'045003, 42세,2019,4087,2161,1926,112.2,3842,2002,1840,108.8
'31191, 처인구,'045004, 43세,2019,4104,2210,1894,116.7,3888,2079,1809,114.9
'31191, 처인구,'045005, 44세,2019,4187,2232,1955,114.2,4002,2124,1878,113.1
'31191, 처인구,'050,45~49세,2019,22694,11887,10807,110,21620,11252,10368,108.5
'31191, 처인구,'050001, 45세,2019,4546,2463,2083,118.2,4351,2341,2010,116.5
'31191, 처인구,'050002, 46세,2019,4488,2339,2149,108.8,4273,2212,2061,107.3
'31191, 처인구,'050003, 47세,2019,4529,2402,2127,112.9,4293,2257,2036,110.9
'31191, 처인구,'050004, 48세,2019,4660,2398,2262,106,4452,2276,2176,104.6
'31191, 처인구,'050005, 49세,2019,4471,2285,2186,104.5,4251,2166,2085,103.9
'31191, 처인구,'055,50~54세,2019,21737,11103,10634,104.4,20837,10615,10222,103.8
'31191, 처인구,'055001, 50세,2019,4633,2325,2308,100.7,4440,2218,2222,99.8
'31191, 처인구,'055002, 51세,2019,4563,2372,2191,108.3,4369,2257,2112,106.9
'31191, 처인구,'055003, 52세,2019,4061,2025,2036,99.5,3909,1961,1948,100.7
'31191, 처인구,'055004, 53세,2019,4121,2151,1970,109.2,3955,2063,1892,109
'31191, 처인구,'055005, 54세,2019,4359,2230,2129,104.7,4164,2116,2048,103.3
'31191, 처인구,'060,55~59세,2019,20650,10685,9965,107.2,19862,10280,9582,107.3
'31191, 처인구,'060001, 55세,2019,3761,1989,1772,112.2,3605,1904,1701,111.9
'31191, 처인구,'060002, 56세,2019,4083,2147,1936,110.9,3862,2029,1833,110.7
'31191, 처인구,'060003, 57세,2019,4024,2024,2000,101.2,3872,1957,1915,102.2
'31191, 처인구,'060004, 58세,2019,4530,2338,2192,106.7,4425,2289,2136,107.2
'31191, 처인구,'060005, 59세,2019,4252,2187,2065,105.9,4098,2101,1997,105.2
'31191, 처인구,'065,60~64세,2019,16832,8459,8373,101,16242,8145,8097,100.6
'31191, 처인구,'065001, 60세,2019,3776,1970,1806,109.1,3663,1915,1748,109.6
'31191, 처인구,'065002, 61세,2019,3480,1774,1706,104,3338,1692,1646,102.8
'31191, 처인구,'065003, 62세,2019,3313,1585,1728,91.7,3199,1533,1666,92
'31191, 처인구,'065004, 63세,2019,3114,1566,1548,101.2,2993,1496,1497,99.9
'31191, 처인구,'065005, 64세,2019,3149,1564,1585,98.7,3049,1509,1540,98
'31191, 처인구,'070,65~69세,2019,11312,5441,5871,92.7,10954,5267,5687,92.6
'31191, 처인구,'070001, 65세,2019,2623,1246,1377,90.5,2530,1200,1330,90.2
'31191, 처인구,'070002, 66세,2019,2370,1145,1225,93.5,2295,1117,1178,94.8
'31191, 처인구,'070003, 67세,2019,2661,1309,1352,96.8,2584,1268,1316,96.4
'31191, 처인구,'070004, 68세,2019,1751,824,927,88.9,1690,791,899,88
'31191, 처인구,'070005, 69세,2019,1907,917,990,92.6,1855,891,964,92.4
'31191, 처인구,'075,70~74세,2019,8429,4026,4403,91.4,8316,3978,4338,91.7
'31191, 처인구,'075001, 70세,2019,1850,917,933,98.3,1809,897,912,98.4
'31191, 처인구,'075002, 71세,2019,1856,893,963,92.7,1832,886,946,93.7
'31191, 처인구,'075003, 72세,2019,1821,852,969,87.9,1799,840,959,87.6
'31191, 처인구,'075004, 73세,2019,1490,713,777,91.8,1474,709,765,92.7
'31191, 처인구,'075005, 74세,2019,1412,651,761,85.5,1402,646,756,85.4
'31191, 처인구,'080,75~79세,2019,6706,2895,3811,76,6662,2886,3776,76.4
'31191, 처인구,'080001, 75세,2019,1400,644,756,85.2,1389,640,749,85.4
'31191, 처인구,'080002, 76세,2019,1381,596,785,75.9,1376,596,780,76.4
'31191, 처인구,'080003, 77세,2019,1507,633,874,72.4,1493,632,861,73.4
'31191, 처인구,'080004, 78세,2019,1291,552,739,74.7,1284,549,735,74.7
'31191, 처인구,'080005, 79세,2019,1127,470,657,71.5,1120,469,651,72
'31191, 처인구,'085,80~84세,2019,4625,1793,2832,63.3,4596,1781,2815,63.3
'31191, 처인구,'085001, 80세,2019,1121,443,678,65.3,1115,440,675,65.2
'31191, 처인구,'085002, 81세,2019,997,386,611,63.2,994,385,609,63.2
'31191, 처인구,'085003, 82세,2019,924,385,539,71.4,919,383,536,71.5
'31191, 처인구,'085004, 83세,2019,788,293,495,59.2,780,289,491,58.9
'31191, 처인구,'085005, 84세,2019,795,286,509,56.2,788,284,504,56.3
'31191, 처인구,'086,85세이상,2019,3388,941,2447,38.5,3372,937,2435,38.5
'31191, 처인구,'090,85~89세,2019,2342,710,1632,43.5,2330,706,1624,43.5
'31191, 처인구,'090001, 85세,2019,681,241,440,54.8,678,240,438,54.8
'31191, 처인구,'090002, 86세,2019,530,168,362,46.4,528,168,360,46.7
'31191, 처인구,'090003, 87세,2019,449,129,320,40.3,449,129,320,40.3
'31191, 처인구,'090004, 88세,2019,353,97,256,37.9,350,96,254,37.8
'31191, 처인구,'090005, 89세,2019,329,75,254,29.5,325,73,252,29
'31191, 처인구,'095,90~94세,2019,845,186,659,28.2,841,186,655,28.4
'31191, 처인구,'095001, 90세,2019,271,61,210,29,270,61,209,29.2
'31191, 처인구,'095002, 91세,2019,192,37,155,23.9,189,37,152,24.3
'31191, 처인구,'095003, 92세,2019,163,42,121,34.7,163,42,121,34.7
'31191, 처인구,'095004, 93세,2019,124,25,99,25.3,124,25,99,25.3
'31191, 처인구,'095005, 94세,2019,95,21,74,28.4,95,21,74,28.4
'31191, 처인구,'100,95~99세,2019,178,43,135,31.9,178,43,135,31.9
'31191, 처인구,'100001, 95세,2019,54,12,42,28.6,54,12,42,28.6
'31191, 처인구,'100002, 96세,2019,55,17,38,44.7,55,17,38,44.7
'31191, 처인구,'100003, 97세,2019,31,X,27,14.8,31,X,27,14.8
'31191, 처인구,'100004, 98세,2019,22,5,17,29.4,22,5,17,29.4
'31191, 처인구,'100005, 99세,2019,16,5,11,45.5,16,5,11,45.5
'31191, 처인구,'101,100세이상,2019,23,X,21,9.5,23,X,21,9.5
'31191, 처인구,'102,15세미만,2019,34117,17559,16558,106,33755,17385,16370,106.2
'31191, 처인구,'103,15~64세,2019,198070,105892,92178,114.9,184369,96903,87466,110.8
'31191, 처인구,'104,65세이상,2019,34460,15096,19364,78,33900,14849,19051,77.9
'31191, 처인구,'126,평균연령,2019,40.6,39.6,41.8,,40.8,39.8,41.9,
'31191, 처인구,'127,중위연령,2019,40.9,39.6,42.5,,41.5,40.4,42.8,
'31192, 기흥구,'000,합계,2019,434075,214565,219510,97.7,424982,209966,215016,97.7
'31192, 기흥구,'005,0~4세,2019,19500,10094,9406,107.3,19270,9977,9293,107.4
'31192, 기흥구,'005001, 0세,2019,2935,1514,1421,106.5,2902,1493,1409,106
'31192, 기흥구,'005002, 1세,2019,3391,1741,1650,105.5,3353,1722,1631,105.6
'31192, 기흥구,'005003, 2세,2019,3818,2006,1812,110.7,3770,1985,1785,111.2
'31192, 기흥구,'005004, 3세,2019,4502,2331,2171,107.4,4438,2298,2140,107.4
'31192, 기흥구,'005005, 4세,2019,4854,2502,2352,106.4,4807,2479,2328,106.5
'31192, 기흥구,'010,5~9세,2019,25667,13143,12524,104.9,25522,13077,12445,105.1
'31192, 기흥구,'010001, 5세,2019,4888,2482,2406,103.2,4848,2466,2382,103.5
'31192, 기흥구,'010002, 6세,2019,4900,2483,2417,102.7,4872,2468,2404,102.7
'31192, 기흥구,'010003, 7세,2019,5466,2827,2639,107.1,5434,2811,2623,107.2
'31192, 기흥구,'010004, 8세,2019,5226,2687,2539,105.8,5197,2672,2525,105.8
'31192, 기흥구,'010005, 9세,2019,5187,2664,2523,105.6,5171,2660,2511,105.9
'31192, 기흥구,'015,10~14세,2019,24860,12772,12088,105.7,24789,12732,12057,105.6
'31192, 기흥구,'015001, 10세,2019,4861,2496,2365,105.5,4840,2482,2358,105.3
'31192, 기흥구,'015002, 11세,2019,5260,2669,2591,103,5247,2663,2584,103.1
'31192, 기흥구,'015003, 12세,2019,5445,2791,2654,105.2,5429,2781,2648,105
'31192, 기흥구,'015004, 13세,2019,4687,2439,2248,108.5,4676,2434,2242,108.6
'31192, 기흥구,'015005, 14세,2019,4607,2377,2230,106.6,4597,2372,2225,106.6
'31192, 기흥구,'020,15~19세,2019,24256,12396,11860,104.5,23957,12263,11694,104.9
'31192, 기흥구,'020001, 15세,2019,4684,2370,2314,102.4,4676,2365,2311,102.3
'31192, 기흥구,'020002, 16세,2019,4164,2134,2030,105.1,4153,2128,2025,105.1
'31192, 기흥구,'020003, 17세,2019,4082,2097,1985,105.6,4058,2086,1972,105.8
'31192, 기흥구,'020004, 18세,2019,5082,2615,2467,106,5003,2589,2414,107.2
'31192, 기흥구,'020005, 19세,2019,6244,3180,3064,103.8,6067,3095,2972,104.1
'31192, 기흥구,'025,20~24세,2019,29975,15194,14781,102.8,28148,14346,13802,103.9
'31192, 기흥구,'025001, 20세,2019,6207,2974,3233,92,5845,2845,3000,94.8
'31192, 기흥구,'025002, 21세,2019,5882,2920,2962,98.6,5533,2760,2773,99.5
'31192, 기흥구,'025003, 22세,2019,5978,3049,2929,104.1,5601,2857,2744,104.1
'31192, 기흥구,'025004, 23세,2019,6088,3156,2932,107.6,5677,2951,2726,108.3
'31192, 기흥구,'025005, 24세,2019,5820,3095,2725,113.6,5492,2933,2559,114.6
'31192, 기흥구,'030,25~29세,2019,27331,14037,13294,105.6,26147,13381,12766,104.8
'31192, 기흥구,'030001, 25세,2019,5710,2993,2717,110.2,5450,2846,2604,109.3
'31192, 기흥구,'030002, 26세,2019,5842,2934,2908,100.9,5585,2790,2795,99.8
'31192, 기흥구,'030003, 27세,2019,5519,2858,2661,107.4,5297,2735,2562,106.8
'31192, 기흥구,'030004, 28세,2019,5305,2757,2548,108.2,5065,2628,2437,107.8
'31192, 기흥구,'030005, 29세,2019,4955,2495,2460,101.4,4750,2382,2368,100.6
'31192, 기흥구,'035,30~34세,2019,25373,12669,12704,99.7,24308,12101,12207,99.1
'31192, 기흥구,'035001, 30세,2019,4810,2435,2375,102.5,4585,2319,2266,102.3
'31192, 기흥구,'035002, 31세,2019,4911,2516,2395,105.1,4689,2395,2294,104.4
'31192, 기흥구,'035003, 32세,2019,4919,2358,2561,92.1,4699,2239,2460,91
'31192, 기흥구,'035004, 33세,2019,5194,2619,2575,101.7,4979,2504,2475,101.2
'31192, 기흥구,'035005, 34세,2019,5539,2741,2798,98,5356,2644,2712,97.5
'31192, 기흥구,'040,35~39세,2019,37277,18185,19092,95.2,36468,17764,18704,95
'31192, 기흥구,'040001, 35세,2019,5968,2903,3065,94.7,5807,2823,2984,94.6
'31192, 기흥구,'040002, 36세,2019,6901,3363,3538,95.1,6722,3273,3449,94.9
'31192, 기흥구,'040003, 37세,2019,7815,3788,4027,94.1,7649,3695,3954,93.4
'31192, 기흥구,'040004, 38세,2019,8094,3967,4127,96.1,7946,3891,4055,96
'31192, 기흥구,'040005, 39세,2019,8499,4164,4335,96.1,8344,4082,4262,95.8
'31192, 기흥구,'045,40~44세,2019,38974,19050,19924,95.6,38379,18740,19639,95.4
'31192, 기흥구,'045001, 40세,2019,8028,3921,4107,95.5,7892,3847,4045,95.1
'31192, 기흥구,'045002, 41세,2019,7400,3572,3828,93.3,7286,3513,3773,93.1
'31192, 기흥구,'045003, 42세,2019,7908,3853,4055,95,7774,3781,3993,94.7
'31192, 기흥구,'045004, 43세,2019,7589,3773,3816,98.9,7482,3714,3768,98.6
'31192, 기흥구,'045005, 44세,2019,8049,3931,4118,95.5,7945,3885,4060,95.7
'31192, 기흥구,'050,45~49세,2019,43339,21711,21628,100.4,42629,21321,21308,100.1
'31192, 기흥구,'050001, 45세,2019,8758,4354,4404,98.9,8653,4300,4353,98.8
'31192, 기흥구,'050002, 46세,2019,8705,4326,4379,98.8,8559,4240,4319,98.2
'31192, 기흥구,'050003, 47세,2019,8499,4273,4226,101.1,8345,4183,4162,100.5
'31192, 기흥구,'050004, 48세,2019,8889,4489,4400,102,8729,4410,4319,102.1
'31192, 기흥구,'050005, 49세,2019,8488,4269,4219,101.2,8343,4188,4155,100.8
'31192, 기흥구,'055,50~54세,2019,34570,17513,17057,102.7,33950,17187,16763,102.5
'31192, 기흥구,'055001, 50세,2019,7799,3947,3852,102.5,7686,3885,3801,102.2
'31192, 기흥구,'055002, 51세,2019,7632,3758,3874,97,7505,3682,3823,96.3
'31192, 기흥구,'055003, 52세,2019,6853,3469,3384,102.5,6729,3411,3318,102.8
'31192, 기흥구,'055004, 53세,2019,6057,3080,2977,103.5,5930,3013,2917,103.3
'31192, 기흥구,'055005, 54세,2019,6229,3259,2970,109.7,6100,3196,2904,110.1
'31192, 기흥구,'060,55~59세,2019,27635,13927,13708,101.6,26992,13631,13361,102
'31192, 기흥구,'060001, 55세,2019,5544,2853,2691,106,5413,2796,2617,106.8
'31192, 기흥구,'060002, 56세,2019,5773,2959,2814,105.2,5612,2882,2730,105.6
'31192, 기흥구,'060003, 57세,2019,5431,2755,2676,103,5294,2686,2608,103
'31192, 기흥구,'060004, 58세,2019,5581,2778,2803,99.1,5488,2734,2754,99.3
'31192, 기흥구,'060005, 59세,2019,5306,2582,2724,94.8,5185,2533,2652,95.5
'31192, 기흥구,'065,60~64세,2019,22315,10642,11673,91.2,21841,10408,11433,91
'31192, 기흥구,'065001, 60세,2019,4978,2458,2520,97.5,4874,2404,2470,97.3
'31192, 기흥구,'065002, 61세,2019,4554,2169,2385,90.9,4443,2119,2324,91.2
'31192, 기흥구,'065003, 62세,2019,4425,2067,2358,87.7,4334,2021,2313,87.4
'31192, 기흥구,'065004, 63세,2019,4099,1968,2131,92.4,4008,1921,2087,92
'31192, 기흥구,'065005, 64세,2019,4259,1980,2279,86.9,4182,1943,2239,86.8
'31192, 기흥구,'070,65~69세,2019,16147,7280,8867,82.1,15914,7170,8744,82
'31192, 기흥구,'070001, 65세,2019,3680,1679,2001,83.9,3611,1644,1967,83.6
'31192, 기흥구,'070002, 66세,2019,3354,1506,1848,81.5,3299,1477,1822,81.1
'31192, 기흥구,'070003, 67세,2019,3618,1631,1987,82.1,3580,1612,1968,81.9
'31192, 기흥구,'070004, 68세,2019,2571,1145,1426,80.3,2536,1128,1408,80.1
'31192, 기흥구,'070005, 69세,2019,2924,1319,1605,82.2,2888,1309,1579,82.9
'31192, 기흥구,'075,70~74세,2019,14124,6339,7785,81.4,14026,6290,7736,81.3
'31192, 기흥구,'075001, 70세,2019,2941,1299,1642,79.1,2910,1285,1625,79.1
'31192, 기흥구,'075002, 71세,2019,3051,1381,1670,82.7,3027,1369,1658,82.6
'31192, 기흥구,'075003, 72세,2019,3200,1415,1785,79.3,3181,1403,1778,78.9
'31192, 기흥구,'075004, 73세,2019,2621,1176,1445,81.4,2611,1173,1438,81.6
'31192, 기흥구,'075005, 74세,2019,2311,1068,1243,85.9,2297,1060,1237,85.7
'31192, 기흥구,'080,75~79세,2019,10975,5131,5844,87.8,10929,5112,5817,87.9
'31192, 기흥구,'080001, 75세,2019,2223,1018,1205,84.5,2212,1013,1199,84.5
'31192, 기흥구,'080002, 76세,2019,2249,1030,1219,84.5,2241,1028,1213,84.7
'31192, 기흥구,'080003, 77세,2019,2528,1204,1324,90.9,2514,1198,1316,91
'31192, 기흥구,'080004, 78세,2019,2150,1039,1111,93.5,2143,1036,1107,93.6
'31192, 기흥구,'080005, 79세,2019,1825,840,985,85.3,1819,837,982,85.2
'31192, 기흥구,'085,80~84세,2019,6786,2906,3880,74.9,6766,2897,3869,74.9
'31192, 기흥구,'085001, 80세,2019,1730,750,980,76.5,1724,747,977,76.5
'31192, 기흥구,'085002, 81세,2019,1503,687,816,84.2,1497,684,813,84.1
'31192, 기흥구,'085003, 82세,2019,1350,572,778,73.5,1348,571,777,73.5
'31192, 기흥구,'085004, 83세,2019,1170,475,695,68.3,1167,473,694,68.2
'31192, 기흥구,'085005, 84세,2019,1033,422,611,69.1,1030,422,608,69.4
'31192, 기흥구,'086,85세이상,2019,4971,1576,3395,46.4,4947,1569,3378,46.4
'31192, 기흥구,'090,85~89세,2019,3280,1171,2109,55.5,3266,1167,2099,55.6
'31192, 기흥구,'090001, 85세,2019,904,336,568,59.2,901,335,566,59.2
'31192, 기흥구,'090002, 86세,2019,743,273,470,58.1,738,271,467,58
'31192, 기흥구,'090003, 87세,2019,674,251,423,59.3,670,251,419,59.9
'31192, 기흥구,'090004, 88세,2019,486,153,333,45.9,484,152,332,45.8
'31192, 기흥구,'090005, 89세,2019,473,158,315,50.2,473,158,315,50.2
'31192, 기흥구,'095,90~94세,2019,1326,329,997,33,1319,328,991,33.1
'31192, 기흥구,'095001, 90세,2019,437,123,314,39.2,434,122,312,39.1
'31192, 기흥구,'095002, 91세,2019,302,78,224,34.8,299,78,221,35.3
'31192, 기흥구,'095003, 92세,2019,261,68,193,35.2,261,68,193,35.2
'31192, 기흥구,'095004, 93세,2019,190,37,153,24.2,190,37,153,24.2
'31192, 기흥구,'095005, 94세,2019,136,23,113,20.4,135,23,112,20.5
'31192, 기흥구,'100,95~99세,2019,326,67,259,25.9,324,66,258,25.6
'31192, 기흥구,'100001, 95세,2019,100,16,84,19,99,16,83,19.3
'31192, 기흥구,'100002, 96세,2019,79,23,56,41.1,78,22,56,39.3
'31192, 기흥구,'100003, 97세,2019,68,13,55,23.6,68,13,55,23.6
'31192, 기흥구,'100004, 98세,2019,41,9,32,28.1,41,9,32,28.1
'31192, 기흥구,'100005, 99세,2019,38,6,32,18.8,38,6,32,18.8
'31192, 기흥구,'101,100세이상,2019,39,9,30,30,38,8,30,26.7
'31192, 기흥구,'102,15세미만,2019,70027,36009,34018,105.9,69581,35786,33795,105.9
'31192, 기흥구,'103,15~64세,2019,311045,155324,155721,99.7,302819,151142,151677,99.6
'31192, 기흥구,'104,65세이상,2019,53003,23232,29771,78,52582,23038,29544,78
'31192, 기흥구,'126,평균연령,2019,39.4,38.6,40.2,,39.5,38.6,40.3,
'31192, 기흥구,'127,중위연령,2019,40.3,39.7,41,,40.5,39.8,41.1,
'31193, 수지구,'000,합계,2019,351807,172027,179780,95.7,347126,169658,177468,95.6
'31193, 수지구,'005,0~4세,2019,15558,7885,7673,102.8,15245,7729,7516,102.8
'31193, 수지구,'005001, 0세,2019,2395,1218,1177,103.5,2370,1206,1164,103.6
'31193, 수지구,'005002, 1세,2019,2724,1344,1380,97.4,2692,1326,1366,97.1
'31193, 수지구,'005003, 2세,2019,3093,1593,1500,106.2,3023,1557,1466,106.2
'31193, 수지구,'005004, 3세,2019,3511,1782,1729,103.1,3404,1727,1677,103
'31193, 수지구,'005005, 4세,2019,3835,1948,1887,103.2,3756,1913,1843,103.8
'31193, 수지구,'010,5~9세,2019,20592,10525,10067,104.5,20415,10442,9973,104.7
'31193, 수지구,'010001, 5세,2019,3920,1989,1931,103,3867,1964,1903,103.2
'31193, 수지구,'010002, 6세,2019,4019,2049,1970,104,3971,2025,1946,104.1
'31193, 수지구,'010003, 7세,2019,4239,2173,2066,105.2,4208,2159,2049,105.4
'31193, 수지구,'010004, 8세,2019,4265,2173,2092,103.9,4242,2164,2078,104.1
'31193, 수지구,'010005, 9세,2019,4149,2141,2008,106.6,4127,2130,1997,106.7
'31193, 수지구,'015,10~14세,2019,21153,10765,10388,103.6,21076,10726,10350,103.6
'31193, 수지구,'015001, 10세,2019,4181,2139,2042,104.8,4162,2131,2031,104.9
'31193, 수지구,'015002, 11세,2019,4398,2259,2139,105.6,4378,2249,2129,105.6
'31193, 수지구,'015003, 12세,2019,4416,2229,2187,101.9,4405,2223,2182,101.9
'31193, 수지구,'015004, 13세,2019,4174,2090,2084,100.3,4161,2084,2077,100.3
'31193, 수지구,'015005, 14세,2019,3984,2048,1936,105.8,3970,2039,1931,105.6
'31193, 수지구,'020,15~19세,2019,20213,10304,9909,104,20093,10229,9864,103.7
'31193, 수지구,'020001, 15세,2019,4169,2093,2076,100.8,4154,2084,2070,100.7
'31193, 수지구,'020002, 16세,2019,3892,2000,1892,105.7,3878,1992,1886,105.6
'31193, 수지구,'020003, 17세,2019,3837,2011,1826,110.1,3821,1999,1822,109.7
'31193, 수지구,'020004, 18세,2019,4067,2071,1996,103.8,4052,2064,1988,103.8
'31193, 수지구,'020005, 19세,2019,4248,2129,2119,100.5,4188,2090,2098,99.6
'31193, 수지구,'025,20~24세,2019,20612,10626,9986,106.4,20207,10394,9813,105.9
'31193, 수지구,'025001, 20세,2019,3871,2011,1860,108.1,3817,1979,1838,107.7
'31193, 수지구,'025002, 21세,2019,4148,2238,1910,117.2,4076,2189,1887,116
'31193, 수지구,'025003, 22세,2019,4230,2202,2028,108.6,4153,2161,1992,108.5
'31193, 수지구,'025004, 23세,2019,4139,2055,2084,98.6,4049,2011,2038,98.7
'31193, 수지구,'025005, 24세,2019,4224,2120,2104,100.8,4112,2054,2058,99.8
'31193, 수지구,'030,25~29세,2019,20954,10519,10435,100.8,20430,10242,10188,100.5
'31193, 수지구,'030001, 25세,2019,4398,2256,2142,105.3,4291,2194,2097,104.6
'31193, 수지구,'030002, 26세,2019,4321,2193,2128,103.1,4226,2145,2081,103.1
'31193, 수지구,'030003, 27세,2019,4309,2170,2139,101.4,4210,2122,2088,101.6
'31193, 수지구,'030004, 28세,2019,4109,2034,2075,98,4008,1983,2025,97.9
'31193, 수지구,'030005, 29세,2019,3817,1866,1951,95.6,3695,1798,1897,94.8
'31193, 수지구,'035,30~34세,2019,20528,9788,10740,91.1,19981,9481,10500,90.3
'31193, 수지구,'035001, 30세,2019,3789,1828,1961,93.2,3677,1773,1904,93.1
'31193, 수지구,'035002, 31세,2019,4006,1946,2060,94.5,3896,1887,2009,93.9
'31193, 수지구,'035003, 32세,2019,3997,1902,2095,90.8,3880,1836,2044,89.8
'31193, 수지구,'035004, 33세,2019,4199,2001,2198,91,4082,1929,2153,89.6
'31193, 수지구,'035005, 34세,2019,4537,2111,2426,87,4446,2056,2390,86
'31193, 수지구,'040,35~39세,2019,29409,14066,15343,91.7,28901,13786,15115,91.2
'31193, 수지구,'040001, 35세,2019,4807,2268,2539,89.3,4709,2205,2504,88.1
'31193, 수지구,'040002, 36세,2019,5546,2648,2898,91.4,5442,2592,2850,90.9
'31193, 수지구,'040003, 37세,2019,6089,2932,3157,92.9,5970,2868,3102,92.5
'31193, 수지구,'040004, 38세,2019,6397,3144,3253,96.6,6298,3086,3212,96.1
'31193, 수지구,'040005, 39세,2019,6570,3074,3496,87.9,6482,3035,3447,88
'31193, 수지구,'045,40~44세,2019,32410,15238,17172,88.7,32034,15030,17004,88.4
'31193, 수지구,'045001, 40세,2019,6472,2965,3507,84.5,6388,2923,3465,84.4
'31193, 수지구,'045002, 41세,2019,6018,2827,3191,88.6,5945,2785,3160,88.1
'31193, 수지구,'045003, 42세,2019,6656,3125,3531,88.5,6586,3087,3499,88.2
'31193, 수지구,'045004, 43세,2019,6529,3108,3421,90.9,6450,3060,3390,90.3
'31193, 수지구,'045005, 44세,2019,6735,3213,3522,91.2,6665,3175,3490,91
'31193, 수지구,'050,45~49세,2019,36195,17797,18398,96.7,35805,17592,18213,96.6
'31193, 수지구,'050001, 45세,2019,7325,3534,3791,93.2,7248,3501,3747,93.4
'31193, 수지구,'050002, 46세,2019,6968,3403,3565,95.5,6881,3356,3525,95.2
'31193, 수지구,'050003, 47세,2019,7233,3562,3671,97,7171,3525,3646,96.7
'31193, 수지구,'050004, 48세,2019,7605,3803,3802,100,7520,3761,3759,100.1
'31193, 수지구,'050005, 49세,2019,7064,3495,3569,97.9,6985,3449,3536,97.5
'31193, 수지구,'055,50~54세,2019,28599,14423,14176,101.7,28217,14259,13958,102.2
'31193, 수지구,'055001, 50세,2019,6822,3395,3427,99.1,6728,3357,3371,99.6
'31193, 수지구,'055002, 51세,2019,6285,3155,3130,100.8,6214,3121,3093,100.9
'31193, 수지구,'055003, 52세,2019,5497,2755,2742,100.5,5423,2722,2701,100.8
'31193, 수지구,'055004, 53세,2019,4979,2524,2455,102.8,4905,2496,2409,103.6
'31193, 수지구,'055005, 54세,2019,5016,2594,2422,107.1,4947,2563,2384,107.5
'31193, 수지구,'060,55~59세,2019,22591,11514,11077,103.9,22211,11355,10856,104.6
'31193, 수지구,'060001, 55세,2019,4780,2434,2346,103.8,4698,2398,2300,104.3
'31193, 수지구,'060002, 56세,2019,4733,2452,2281,107.5,4634,2415,2219,108.8
'31193, 수지구,'060003, 57세,2019,4341,2273,2068,109.9,4275,2239,2036,110
'31193, 수지구,'060004, 58세,2019,4421,2209,2212,99.9,4353,2183,2170,100.6
'31193, 수지구,'060005, 59세,2019,4316,2146,2170,98.9,4251,2120,2131,99.5
'31193, 수지구,'065,60~64세,2019,17678,8398,9280,90.5,17410,8289,9121,90.9
'31193, 수지구,'065001, 60세,2019,3804,1884,1920,98.1,3749,1857,1892,98.2
'31193, 수지구,'065002, 61세,2019,3632,1797,1835,97.9,3568,1769,1799,98.3
'31193, 수지구,'065003, 62세,2019,3547,1690,1857,91,3481,1669,1812,92.1
'31193, 수지구,'065004, 63세,2019,3183,1427,1756,81.3,3140,1410,1730,81.5
'31193, 수지구,'065005, 64세,2019,3512,1600,1912,83.7,3472,1584,1888,83.9
'31193, 수지구,'070,65~69세,2019,13536,5936,7600,78.1,13417,5889,7528,78.2
'31193, 수지구,'070001, 65세,2019,3006,1333,1673,79.7,2969,1313,1656,79.3
'31193, 수지구,'070002, 66세,2019,2850,1243,1607,77.3,2820,1233,1587,77.7
'31193, 수지구,'070003, 67세,2019,3001,1321,1680,78.6,2973,1314,1659,79.2
'31193, 수지구,'070004, 68세,2019,2080,907,1173,77.3,2069,900,1169,77
'31193, 수지구,'070005, 69세,2019,2599,1132,1467,77.2,2586,1129,1457,77.5
'31193, 수지구,'075,70~74세,2019,12601,5582,7019,79.5,12560,5571,6989,79.7
'31193, 수지구,'075001, 70세,2019,2671,1202,1469,81.8,2658,1200,1458,82.3
'31193, 수지구,'075002, 71세,2019,2694,1197,1497,80,2685,1193,1492,80
'31193, 수지구,'075003, 72세,2019,2818,1202,1616,74.4,2808,1199,1609,74.5
'31193, 수지구,'075004, 73세,2019,2265,989,1276,77.5,2262,987,1275,77.4
'31193, 수지구,'075005, 74세,2019,2153,992,1161,85.4,2147,992,1155,85.9
'31193, 수지구,'080,75~79세,2019,9788,4789,4999,95.8,9767,4785,4982,96
'31193, 수지구,'080001, 75세,2019,2038,952,1086,87.7,2029,949,1080,87.9
'31193, 수지구,'080002, 76세,2019,1995,980,1015,96.6,1991,980,1011,96.9
'31193, 수지구,'080003, 77세,2019,2301,1121,1180,95,2298,1121,1177,95.2
'31193, 수지구,'080004, 78세,2019,1882,945,937,100.9,1880,944,936,100.9
'31193, 수지구,'080005, 79세,2019,1572,791,781,101.3,1569,791,778,101.7
'31193, 수지구,'085,80~84세,2019,5662,2632,3030,86.9,5647,2624,3023,86.8
'31193, 수지구,'085001, 80세,2019,1444,724,720,100.6,1442,722,720,100.3
'31193, 수지구,'085002, 81세,2019,1249,615,634,97,1243,609,634,96.1
'31193, 수지구,'085003, 82세,2019,1168,530,638,83.1,1167,530,637,83.2
'31193, 수지구,'085004, 83세,2019,924,384,540,71.1,922,384,538,71.4
'31193, 수지구,'085005, 84세,2019,877,379,498,76.1,873,379,494,76.7
'31193, 수지구,'086,85세이상,2019,3728,1240,2488,49.8,3710,1235,2475,49.9
'31193, 수지구,'090,85~89세,2019,2535,923,1612,57.3,2527,919,1608,57.2
'31193, 수지구,'090001, 85세,2019,694,284,410,69.3,692,284,408,69.6
'31193, 수지구,'090002, 86세,2019,589,221,368,60.1,586,219,367,59.7
'31193, 수지구,'090003, 87세,2019,516,191,325,58.8,515,190,325,58.5
'31193, 수지구,'090004, 88세,2019,397,114,283,40.3,396,113,283,39.9
'31193, 수지구,'090005, 89세,2019,339,113,226,50,338,113,225,50.2
'31193, 수지구,'095,90~94세,2019,930,258,672,38.4,922,257,665,38.6
'31193, 수지구,'095001, 90세,2019,307,86,221,38.9,304,86,218,39.4
'31193, 수지구,'095002, 91세,2019,239,72,167,43.1,238,72,166,43.4
'31193, 수지구,'095003, 92세,2019,150,37,113,32.7,149,37,112,33
'31193, 수지구,'095004, 93세,2019,134,41,93,44.1,131,40,91,44
'31193, 수지구,'095005, 94세,2019,100,22,78,28.2,100,22,78,28.2
'31193, 수지구,'100,95~99세,2019,237,57,180,31.7,235,57,178,32
'31193, 수지구,'100001, 95세,2019,72,22,50,44,71,22,49,44.9
'31193, 수지구,'100002, 96세,2019,58,13,45,28.9,58,13,45,28.9
'31193, 수지구,'100003, 97세,2019,47,10,37,27,47,10,37,27
'31193, 수지구,'100004, 98세,2019,39,11,28,39.3,38,11,27,40.7
'31193, 수지구,'100005, 99세,2019,21,X,20,5,21,X,20,5
'31193, 수지구,'101,100세이상,2019,26,X,24,8.3,26,X,24,8.3
'31193, 수지구,'102,15세미만,2019,57303,29175,28128,103.7,56736,28897,27839,103.8
'31193, 수지구,'103,15~64세,2019,249189,122673,126516,97,245289,120657,124632,96.8
'31193, 수지구,'104,65세이상,2019,45315,20179,25136,80.3,45101,20104,24997,80.4
'31193, 수지구,'126,평균연령,2019,39.8,39.1,40.5,,39.8,39.1,40.5,
'31193, 수지구,'127,중위연령,2019,41.1,40.5,41.6,,41.1,40.6,41.6,
'31200, 파주시,'000,합계,2019,454328,233834,220494,106.1,437840,222198,215642,103
'31200, 파주시,'005,0~4세,2019,20056,10278,9778,105.1,19873,10176,9697,104.9
'31200, 파주시,'005001, 0세,2019,3209,1662,1547,107.4,3174,1643,1531,107.3
'31200, 파주시,'005002, 1세,2019,3497,1788,1709,104.6,3463,1771,1692,104.7
'31200, 파주시,'005003, 2세,2019,3949,1990,1959,101.6,3912,1971,1941,101.5
'31200, 파주시,'005004, 3세,2019,4545,2370,2175,109,4494,2341,2153,108.7
'31200, 파주시,'005005, 4세,2019,4856,2468,2388,103.4,4830,2450,2380,102.9
'31200, 파주시,'010,5~9세,2019,25025,12727,12298,103.5,24936,12672,12264,103.3
'31200, 파주시,'010001, 5세,2019,4876,2508,2368,105.9,4851,2492,2359,105.6
'31200, 파주시,'010002, 6세,2019,4787,2419,2368,102.2,4768,2406,2362,101.9
'31200, 파주시,'010003, 7세,2019,5243,2703,2540,106.4,5227,2695,2532,106.4
'31200, 파주시,'010004, 8세,2019,5098,2607,2491,104.7,5084,2599,2485,104.6
'31200, 파주시,'010005, 9세,2019,5021,2490,2531,98.4,5006,2480,2526,98.2
'31200, 파주시,'015,10~14세,2019,23345,12038,11307,106.5,23261,11984,11277,106.3
'31200, 파주시,'015001, 10세,2019,4686,2448,2238,109.4,4667,2436,2231,109.2
'31200, 파주시,'015002, 11세,2019,4983,2583,2400,107.6,4966,2572,2394,107.4
'31200, 파주시,'015003, 12세,2019,4968,2538,2430,104.4,4954,2530,2424,104.4
'31200, 파주시,'015004, 13세,2019,4441,2260,2181,103.6,4422,2248,2174,103.4
'31200, 파주시,'015005, 14세,2019,4267,2209,2058,107.3,4252,2198,2054,107
'31200, 파주시,'020,15~19세,2019,23252,12093,11159,108.4,23120,12011,11109,108.1
'31200, 파주시,'020001, 15세,2019,4530,2341,2189,106.9,4520,2338,2182,107.1
'31200, 파주시,'020002, 16세,2019,4755,2468,2287,107.9,4739,2457,2282,107.7
'31200, 파주시,'020003, 17세,2019,4686,2453,2233,109.9,4669,2442,2227,109.7
'31200, 파주시,'020004, 18세,2019,4951,2541,2410,105.4,4928,2528,2400,105.3
'31200, 파주시,'020005, 19세,2019,4330,2290,2040,112.3,4264,2246,2018,111.3
'31200, 파주시,'025,20~24세,2019,25405,14017,11388,123.1,23707,12658,11049,114.6
'31200, 파주시,'025001, 20세,2019,4646,2473,2173,113.8,4538,2394,2144,111.7
'31200, 파주시,'025002, 21세,2019,4894,2729,2165,126.1,4685,2568,2117,121.3
'31200, 파주시,'025003, 22세,2019,4917,2714,2203,123.2,4609,2471,2138,115.6
'31200, 파주시,'025004, 23세,2019,5162,2887,2275,126.9,4693,2502,2191,114.2
'31200, 파주시,'025005, 24세,2019,5786,3214,2572,125,5182,2723,2459,110.7
'31200, 파주시,'030,25~29세,2019,32724,18170,14554,124.8,29293,15461,13832,111.8
'31200, 파주시,'030001, 25세,2019,6339,3524,2815,125.2,5695,2975,2720,109.4
'31200, 파주시,'030002, 26세,2019,6643,3613,3030,119.2,5937,3054,2883,105.9
'31200, 파주시,'030003, 27세,2019,6824,3800,3024,125.7,6130,3244,2886,112.4
'31200, 파주시,'030004, 28세,2019,6594,3649,2945,123.9,5901,3121,2780,112.3
'31200, 파주시,'030005, 29세,2019,6324,3584,2740,130.8,5630,3067,2563,119.7
'31200, 파주시,'035,30~34세,2019,33047,18832,14215,132.5,29922,16542,13380,123.6
'31200, 파주시,'035001, 30세,2019,6244,3586,2658,134.9,5568,3087,2481,124.4
'31200, 파주시,'035002, 31세,2019,6442,3629,2813,129,5813,3165,2648,119.5
'31200, 파주시,'035003, 32세,2019,6660,3792,2868,132.2,6000,3312,2688,123.2
'31200, 파주시,'035004, 33세,2019,6769,3884,2885,134.6,6174,3454,2720,127
'31200, 파주시,'035005, 34세,2019,6932,3941,2991,131.8,6367,3524,2843,124
'31200, 파주시,'040,35~39세,2019,39560,21439,18121,118.3,37024,19572,17452,112.1
'31200, 파주시,'040001, 35세,2019,6937,3787,3150,120.2,6342,3356,2986,112.4
'31200, 파주시,'040002, 36세,2019,7726,4222,3504,120.5,7184,3824,3360,113.8
'31200, 파주시,'040003, 37세,2019,8253,4501,3752,120,7737,4116,3621,113.7
'31200, 파주시,'040004, 38세,2019,8200,4408,3792,116.2,7729,4044,3685,109.7
'31200, 파주시,'040005, 39세,2019,8444,4521,3923,115.2,8032,4232,3800,111.4
'31200, 파주시,'045,40~44세,2019,36785,18943,17842,106.2,35234,17858,17376,102.8
'31200, 파주시,'045001, 40세,2019,7770,4013,3757,106.8,7389,3751,3638,103.1
'31200, 파주시,'045002, 41세,2019,7107,3698,3409,108.5,6768,3440,3328,103.4
'31200, 파주시,'045003, 42세,2019,7401,3832,3569,107.4,7097,3620,3477,104.1
'31200, 파주시,'045004, 43세,2019,7224,3727,3497,106.6,6937,3530,3407,103.6
'31200, 파주시,'045005, 44세,2019,7283,3673,3610,101.7,7043,3517,3526,99.7
'31200, 파주시,'050,45~49세,2019,41226,21535,19691,109.4,40038,20773,19265,107.8
'31200, 파주시,'050001, 45세,2019,8018,4107,3911,105,7791,3966,3825,103.7
'31200, 파주시,'050002, 46세,2019,8164,4201,3963,106,7938,4052,3886,104.3
'31200, 파주시,'050003, 47세,2019,8290,4378,3912,111.9,8046,4213,3833,109.9
'31200, 파주시,'050004, 48세,2019,8677,4547,4130,110.1,8434,4401,4033,109.1
'31200, 파주시,'050005, 49세,2019,8077,4302,3775,114,7829,4141,3688,112.3
'31200, 파주시,'055,50~54세,2019,35587,18627,16960,109.8,34629,18090,16539,109.4
'31200, 파주시,'055001, 50세,2019,7700,4014,3686,108.9,7484,3901,3583,108.9
'31200, 파주시,'055002, 51세,2019,7699,4040,3659,110.4,7483,3918,3565,109.9
'31200, 파주시,'055003, 52세,2019,6798,3520,3278,107.4,6623,3421,3202,106.8
'31200, 파주시,'055004, 53세,2019,6678,3563,3115,114.4,6510,3471,3039,114.2
'31200, 파주시,'055005, 54세,2019,6712,3490,3222,108.3,6529,3379,3150,107.3
'31200, 파주시,'060,55~59세,2019,32433,16715,15718,106.3,31753,16378,15375,106.5
'31200, 파주시,'060001, 55세,2019,6162,3184,2978,106.9,5996,3097,2899,106.8
'31200, 파주시,'060002, 56세,2019,6552,3415,3137,108.9,6369,3325,3044,109.2
'31200, 파주시,'060003, 57세,2019,6516,3413,3103,110,6374,3348,3026,110.6
'31200, 파주시,'060004, 58세,2019,6837,3464,3373,102.7,6758,3422,3336,102.6
'31200, 파주시,'060005, 59세,2019,6366,3239,3127,103.6,6256,3186,3070,103.8
'31200, 파주시,'065,60~64세,2019,26608,13252,13356,99.2,26192,13034,13158,99.1
'31200, 파주시,'065001, 60세,2019,5883,2940,2943,99.9,5789,2891,2898,99.8
'31200, 파주시,'065002, 61세,2019,5661,2871,2790,102.9,5557,2821,2736,103.1
'31200, 파주시,'065003, 62세,2019,5422,2730,2692,101.4,5335,2679,2656,100.9
'31200, 파주시,'065004, 63세,2019,4760,2343,2417,96.9,4696,2308,2388,96.6
'31200, 파주시,'065005, 64세,2019,4882,2368,2514,94.2,4815,2335,2480,94.2
'31200, 파주시,'070,65~69세,2019,16776,7979,8797,90.7,16568,7880,8688,90.7
'31200, 파주시,'070001, 65세,2019,3975,1950,2025,96.3,3922,1925,1997,96.4
'31200, 파주시,'070002, 66세,2019,3549,1732,1817,95.3,3507,1714,1793,95.6
'31200, 파주시,'070003, 67세,2019,3771,1809,1962,92.2,3722,1784,1938,92.1
'31200, 파주시,'070004, 68세,2019,2525,1148,1377,83.4,2496,1131,1365,82.9
'31200, 파주시,'070005, 69세,2019,2956,1340,1616,82.9,2921,1326,1595,83.1
'31200, 파주시,'075,70~74세,2019,14641,6647,7994,83.1,14543,6603,7940,83.2
'31200, 파주시,'075001, 70세,2019,3154,1446,1708,84.7,3130,1437,1693,84.9
'31200, 파주시,'075002, 71세,2019,3144,1432,1712,83.6,3119,1418,1701,83.4
'31200, 파주시,'075003, 72세,2019,3196,1471,1725,85.3,3174,1463,1711,85.5
'31200, 파주시,'075004, 73세,2019,2593,1187,1406,84.4,2580,1181,1399,84.4
'31200, 파주시,'075005, 74세,2019,2554,1111,1443,77,2540,1104,1436,76.9
'31200, 파주시,'080,75~79세,2019,12891,5392,7499,71.9,12839,5375,7464,72
'31200, 파주시,'080001, 75세,2019,2500,1046,1454,71.9,2491,1042,1449,71.9
'31200, 파주시,'080002, 76세,2019,2620,1075,1545,69.6,2607,1072,1535,69.8
'31200, 파주시,'080003, 77세,2019,2986,1310,1676,78.2,2974,1304,1670,78.1
'31200, 파주시,'080004, 78세,2019,2499,1036,1463,70.8,2488,1033,1455,71
'31200, 파주시,'080005, 79세,2019,2286,925,1361,68,2279,924,1355,68.2
'31200, 파주시,'085,80~84세,2019,8846,3399,5447,62.4,8813,3388,5425,62.5
'31200, 파주시,'085001, 80세,2019,2148,865,1283,67.4,2140,863,1277,67.6
'31200, 파주시,'085002, 81세,2019,2006,736,1270,58,1996,733,1263,58
'31200, 파주시,'085003, 82세,2019,1701,696,1005,69.3,1695,694,1001,69.3
'31200, 파주시,'085004, 83세,2019,1565,594,971,61.2,1560,593,967,61.3
'31200, 파주시,'085005, 84세,2019,1426,508,918,55.3,1422,505,917,55.1
'31200, 파주시,'086,85세이상,2019,6121,1751,4370,40.1,6095,1743,4352,40.1
'31200, 파주시,'090,85~89세,2019,4180,1324,2856,46.4,4163,1317,2846,46.3
'31200, 파주시,'090001, 85세,2019,1135,397,738,53.8,1127,395,732,54
'31200, 파주시,'090002, 86세,2019,982,307,675,45.5,979,306,673,45.5
'31200, 파주시,'090003, 87세,2019,849,268,581,46.1,847,267,580,46
'31200, 파주시,'090004, 88세,2019,639,184,455,40.4,636,182,454,40.1
'31200, 파주시,'090005, 89세,2019,575,168,407,41.3,574,167,407,41
'31200, 파주시,'095,90~94세,2019,1551,336,1215,27.7,1546,336,1210,27.8
'31200, 파주시,'095001, 90세,2019,482,123,359,34.3,480,123,357,34.5
'31200, 파주시,'095002, 91세,2019,385,94,291,32.3,385,94,291,32.3
'31200, 파주시,'095003, 92세,2019,315,55,260,21.2,315,55,260,21.2
'31200, 파주시,'095004, 93세,2019,212,42,170,24.7,212,42,170,24.7
'31200, 파주시,'095005, 94세,2019,157,22,135,16.3,154,22,132,16.7
'31200, 파주시,'100,95~99세,2019,339,78,261,29.9,335,77,258,29.8
'31200, 파주시,'100001, 95세,2019,115,20,95,21.1,114,20,94,21.3
'31200, 파주시,'100002, 96세,2019,100,26,74,35.1,98,26,72,36.1
'31200, 파주시,'100003, 97세,2019,59,13,46,28.3,58,12,46,26.1
'31200, 파주시,'100004, 98세,2019,36,10,26,38.5,36,10,26,38.5
'31200, 파주시,'100005, 99세,2019,29,9,20,45,29,9,20,45
'31200, 파주시,'101,100세이상,2019,51,13,38,34.2,51,13,38,34.2
'31200, 파주시,'102,15세미만,2019,68426,35043,33383,105,68070,34832,33238,104.8
'31200, 파주시,'103,15~64세,2019,326627,173623,153004,113.5,310912,162377,148535,109.3
'31200, 파주시,'104,65세이상,2019,59275,25168,34107,73.8,58858,24989,33869,73.8
'31200, 파주시,'126,평균연령,2019,40.4,39.3,41.6,,40.5,39.5,41.6,
'31200, 파주시,'127,중위연령,2019,40.6,39.4,42.1,,41.1,40,42.2,
'31210, 이천시,'000,합계,2019,222995,115769,107226,108,211978,109094,102884,106
'31210, 이천시,'005,0~4세,2019,9058,4678,4380,106.8,8955,4628,4327,107
'31210, 이천시,'005001, 0세,2019,1396,729,667,109.3,1383,724,659,109.9
'31210, 이천시,'005002, 1세,2019,1617,824,793,103.9,1596,813,783,103.8
'31210, 이천시,'005003, 2세,2019,1847,966,881,109.6,1821,953,868,109.8
'31210, 이천시,'005004, 3세,2019,2024,1063,961,110.6,2001,1051,950,110.6
'31210, 이천시,'005005, 4세,2019,2174,1096,1078,101.7,2154,1087,1067,101.9
'31210, 이천시,'010,5~9세,2019,10914,5651,5263,107.4,10834,5606,5228,107.2
'31210, 이천시,'010001, 5세,2019,2088,1097,991,110.7,2067,1084,983,110.3
'31210, 이천시,'010002, 6세,2019,2128,1082,1046,103.4,2107,1072,1035,103.6
'31210, 이천시,'010003, 7세,2019,2300,1168,1132,103.2,2282,1157,1125,102.8
'31210, 이천시,'010004, 8세,2019,2245,1167,1078,108.3,2232,1161,1071,108.4
'31210, 이천시,'010005, 9세,2019,2153,1137,1016,111.9,2146,1132,1014,111.6
'31210, 이천시,'015,10~14세,2019,10490,5427,5063,107.2,10456,5409,5047,107.2
'31210, 이천시,'015001, 10세,2019,2023,1043,980,106.4,2013,1039,974,106.7
'31210, 이천시,'015002, 11세,2019,2184,1123,1061,105.8,2180,1119,1061,105.5
'31210, 이천시,'015003, 12세,2019,2210,1121,1089,102.9,2208,1120,1088,102.9
'31210, 이천시,'015004, 13세,2019,2075,1099,976,112.6,2065,1092,973,112.2
'31210, 이천시,'015005, 14세,2019,1998,1041,957,108.8,1990,1039,951,109.3
'31210, 이천시,'020,15~19세,2019,13254,6901,6353,108.6,13154,6837,6317,108.2
'31210, 이천시,'020001, 15세,2019,2122,1089,1033,105.4,2116,1085,1031,105.2
'31210, 이천시,'020002, 16세,2019,2060,1052,1008,104.4,2053,1047,1006,104.1
'31210, 이천시,'020003, 17세,2019,2301,1205,1096,109.9,2288,1197,1091,109.7
'31210, 이천시,'020004, 18세,2019,2733,1395,1338,104.3,2705,1376,1329,103.5
'31210, 이천시,'020005, 19세,2019,4038,2160,1878,115,3992,2132,1860,114.6
'31210, 이천시,'025,20~24세,2019,13994,7647,6347,120.5,12771,6862,5909,116.1
'31210, 이천시,'025001, 20세,2019,2797,1537,1260,122,2707,1464,1243,117.8
'31210, 이천시,'025002, 21세,2019,2575,1412,1163,121.4,2442,1332,1110,120
'31210, 이천시,'025003, 22세,2019,2601,1385,1216,113.9,2368,1251,1117,112
'31210, 이천시,'025004, 23세,2019,2919,1560,1359,114.8,2565,1337,1228,108.9
'31210, 이천시,'025005, 24세,2019,3102,1753,1349,129.9,2689,1478,1211,122
'31210, 이천시,'030,25~29세,2019,18229,10639,7590,140.2,15635,9011,6624,136
'31210, 이천시,'030001, 25세,2019,3399,1924,1475,130.4,2962,1649,1313,125.6
'31210, 이천시,'030002, 26세,2019,3808,2222,1586,140.1,3270,1887,1383,136.4
'31210, 이천시,'030003, 27세,2019,3979,2353,1626,144.7,3428,2010,1418,141.7
'31210, 이천시,'030004, 28세,2019,3477,2051,1426,143.8,2958,1722,1236,139.3
'31210, 이천시,'030005, 29세,2019,3566,2089,1477,141.4,3017,1743,1274,136.8
'31210, 이천시,'035,30~34세,2019,16376,8838,7538,117.2,14250,7448,6802,109.5
'31210, 이천시,'035001, 30세,2019,3487,1974,1513,130.5,3018,1675,1343,124.7
'31210, 이천시,'035002, 31세,2019,3295,1779,1516,117.3,2798,1464,1334,109.7
'31210, 이천시,'035003, 32세,2019,3245,1781,1464,121.7,2808,1481,1327,111.6
'31210, 이천시,'035004, 33세,2019,3140,1659,1481,112,2746,1393,1353,103
'31210, 이천시,'035005, 34세,2019,3209,1645,1564,105.2,2880,1435,1445,99.3
'31210, 이천시,'040,35~39세,2019,17739,9728,8011,121.4,16367,8913,7454,119.6
'31210, 이천시,'040001, 35세,2019,3257,1794,1463,122.6,2957,1597,1360,117.4
'31210, 이천시,'040002, 36세,2019,3442,1863,1579,118,3142,1686,1456,115.8
'31210, 이천시,'040003, 37세,2019,3819,2136,1683,126.9,3546,1975,1571,125.7
'31210, 이천시,'040004, 38세,2019,3568,1978,1590,124.4,3309,1827,1482,123.3
'31210, 이천시,'040005, 39세,2019,3653,1957,1696,115.4,3413,1828,1585,115.3
'31210, 이천시,'045,40~44세,2019,17094,8679,8415,103.1,16186,8136,8050,101.1
'31210, 이천시,'045001, 40세,2019,3530,1822,1708,106.7,3311,1694,1617,104.8
'31210, 이천시,'045002, 41세,2019,3490,1799,1691,106.4,3280,1671,1609,103.9
'31210, 이천시,'045003, 42세,2019,3363,1652,1711,96.6,3198,1550,1648,94.1
'31210, 이천시,'045004, 43세,2019,3435,1710,1725,99.1,3259,1600,1659,96.4
'31210, 이천시,'045005, 44세,2019,3276,1696,1580,107.3,3138,1621,1517,106.9
'31210, 이천시,'050,45~49세,2019,18247,9661,8586,112.5,17486,9245,8241,112.2
'31210, 이천시,'050001, 45세,2019,3705,1943,1762,110.3,3537,1852,1685,109.9
'31210, 이천시,'050002, 46세,2019,3564,1842,1722,107,3414,1767,1647,107.3
'31210, 이천시,'050003, 47세,2019,3524,1892,1632,115.9,3382,1806,1576,114.6
'31210, 이천시,'050004, 48세,2019,3700,1969,1731,113.7,3547,1888,1659,113.8
'31210, 이천시,'050005, 49세,2019,3754,2015,1739,115.9,3606,1932,1674,115.4
'31210, 이천시,'055,50~54세,2019,17676,9089,8587,105.8,17028,8725,8303,105.1
'31210, 이천시,'055001, 50세,2019,3776,1926,1850,104.1,3627,1845,1782,103.5
'31210, 이천시,'055002, 51세,2019,3697,1876,1821,103,3566,1799,1767,101.8
'31210, 이천시,'055003, 52세,2019,3346,1704,1642,103.8,3224,1638,1586,103.3
'31210, 이천시,'055004, 53세,2019,3400,1792,1608,111.4,3276,1722,1554,110.8
'31210, 이천시,'055005, 54세,2019,3457,1791,1666,107.5,3335,1721,1614,106.6
'31210, 이천시,'060,55~59세,2019,17318,8987,8331,107.9,16781,8697,8084,107.6
'31210, 이천시,'060001, 55세,2019,3207,1656,1551,106.8,3078,1589,1489,106.7
'31210, 이천시,'060002, 56세,2019,3229,1693,1536,110.2,3081,1603,1478,108.5
'31210, 이천시,'060003, 57세,2019,3373,1780,1593,111.7,3282,1736,1546,112.3
'31210, 이천시,'060004, 58세,2019,3952,2068,1884,109.8,3888,2035,1853,109.8
'31210, 이천시,'060005, 59세,2019,3557,1790,1767,101.3,3452,1734,1718,100.9
'31210, 이천시,'065,60~64세,2019,14044,7299,6745,108.2,13733,7139,6594,108.3
'31210, 이천시,'065001, 60세,2019,3179,1639,1540,106.4,3116,1609,1507,106.8
'31210, 이천시,'065002, 61세,2019,3035,1611,1424,113.1,2968,1577,1391,113.4
'31210, 이천시,'065003, 62세,2019,2775,1427,1348,105.9,2701,1385,1316,105.2
'31210, 이천시,'065004, 63세,2019,2505,1340,1165,115,2451,1315,1136,115.8
'31210, 이천시,'065005, 64세,2019,2550,1282,1268,101.1,2497,1253,1244,100.7
'31210, 이천시,'070,65~69세,2019,8925,4394,4531,97,8789,4323,4466,96.8
'31210, 이천시,'070001, 65세,2019,2070,1055,1015,103.9,2034,1031,1003,102.8
'31210, 이천시,'070002, 66세,2019,1813,906,907,99.9,1787,896,891,100.6
'31210, 이천시,'070003, 67세,2019,2232,1120,1112,100.7,2207,1109,1098,101
'31210, 이천시,'070004, 68세,2019,1353,632,721,87.7,1320,616,704,87.5
'31210, 이천시,'070005, 69세,2019,1457,681,776,87.8,1441,671,770,87.1
'31210, 이천시,'075,70~74세,2019,6745,3264,3481,93.8,6694,3240,3454,93.8
'31210, 이천시,'075001, 70세,2019,1500,737,763,96.6,1485,730,755,96.7
'31210, 이천시,'075002, 71세,2019,1456,711,745,95.4,1444,705,739,95.4
'31210, 이천시,'075003, 72세,2019,1469,701,768,91.3,1462,698,764,91.4
'31210, 이천시,'075004, 73세,2019,1201,606,595,101.8,1191,601,590,101.9
'31210, 이천시,'075005, 74세,2019,1119,509,610,83.4,1112,506,606,83.5
'31210, 이천시,'080,75~79세,2019,5785,2479,3306,75,5765,2471,3294,75
'31210, 이천시,'080001, 75세,2019,1088,493,595,82.9,1084,490,594,82.5
'31210, 이천시,'080002, 76세,2019,1169,506,663,76.3,1167,506,661,76.6
'31210, 이천시,'080003, 77세,2019,1362,564,798,70.7,1356,562,794,70.8
'31210, 이천시,'080004, 78세,2019,1127,472,655,72.1,1124,471,653,72.1
'31210, 이천시,'080005, 79세,2019,1039,444,595,74.6,1034,442,592,74.7
'31210, 이천시,'085,80~84세,2019,4191,1585,2606,60.8,4187,1584,2603,60.9
'31210, 이천시,'085001, 80세,2019,976,391,585,66.8,975,391,584,67
'31210, 이천시,'085002, 81세,2019,925,373,552,67.6,924,373,551,67.7
'31210, 이천시,'085003, 82세,2019,850,311,539,57.7,850,311,539,57.7
'31210, 이천시,'085004, 83세,2019,722,271,451,60.1,722,271,451,60.1
'31210, 이천시,'085005, 84세,2019,718,239,479,49.9,716,238,478,49.8
'31210, 이천시,'086,85세이상,2019,2916,823,2093,39.3,2907,820,2087,39.3
'31210, 이천시,'090,85~89세,2019,2024,624,1400,44.6,2017,621,1396,44.5
'31210, 이천시,'090001, 85세,2019,603,204,399,51.1,601,203,398,51
'31210, 이천시,'090002, 86세,2019,483,151,332,45.5,482,150,332,45.2
'31210, 이천시,'090003, 87세,2019,391,115,276,41.7,390,115,275,41.8
'31210, 이천시,'090004, 88세,2019,290,80,210,38.1,289,79,210,37.6
'31210, 이천시,'090005, 89세,2019,257,74,183,40.4,255,74,181,40.9
'31210, 이천시,'095,90~94세,2019,720,166,554,30,718,166,552,30.1
'31210, 이천시,'095001, 90세,2019,234,62,172,36,234,62,172,36
'31210, 이천시,'095002, 91세,2019,168,35,133,26.3,168,35,133,26.3
'31210, 이천시,'095003, 92세,2019,134,29,105,27.6,133,29,104,27.9
'31210, 이천시,'095004, 93세,2019,94,19,75,25.3,93,19,74,25.7
'31210, 이천시,'095005, 94세,2019,90,21,69,30.4,90,21,69,30.4
'31210, 이천시,'100,95~99세,2019,153,28,125,22.4,153,28,125,22.4
'31210, 이천시,'100001, 95세,2019,52,10,42,23.8,52,10,42,23.8
'31210, 이천시,'100002, 96세,2019,44,8,36,22.2,44,8,36,22.2
'31210, 이천시,'100003, 97세,2019,25,X,21,19,25,X,21,19
'31210, 이천시,'100004, 98세,2019,20,5,15,33.3,20,5,15,33.3
'31210, 이천시,'100005, 99세,2019,12,X,11,9.1,12,X,11,9.1
'31210, 이천시,'101,100세이상,2019,19,5,14,35.7,19,5,14,35.7
'31210, 이천시,'102,15세미만,2019,30462,15756,14706,107.1,30245,15643,14602,107.1
'31210, 이천시,'103,15~64세,2019,163971,87468,76503,114.3,153391,81013,72378,111.9
'31210, 이천시,'104,65세이상,2019,28562,12545,16017,78.3,28342,12438,15904,78.2
'31210, 이천시,'126,평균연령,2019,40.5,39.5,41.6,,40.7,39.7,41.7,
'31210, 이천시,'127,중위연령,2019,40.4,39.2,41.8,,41.1,39.9,42.3,
'31220, 안성시,'000,합계,2019,202284,105953,96331,110,184506,94517,89989,105
'31220, 안성시,'005,0~4세,2019,6698,3437,3261,105.4,6347,3262,3085,105.7
'31220, 안성시,'005001, 0세,2019,1069,571,498,114.7,1008,541,467,115.8
'31220, 안성시,'005002, 1세,2019,1182,598,584,102.4,1108,558,550,101.5
'31220, 안성시,'005003, 2세,2019,1329,655,674,97.2,1251,625,626,99.8
'31220, 안성시,'005004, 3세,2019,1494,764,730,104.7,1433,732,701,104.4
'31220, 안성시,'005005, 4세,2019,1624,849,775,109.5,1547,806,741,108.8
'31220, 안성시,'010,5~9세,2019,8722,4475,4247,105.4,8451,4347,4104,105.9
'31220, 안성시,'010001, 5세,2019,1590,794,796,99.7,1516,765,751,101.9
'31220, 안성시,'010002, 6세,2019,1700,899,801,112.2,1639,874,765,114.2
'31220, 안성시,'010003, 7세,2019,1823,910,913,99.7,1760,879,881,99.8
'31220, 안성시,'010004, 8세,2019,1860,969,891,108.8,1822,948,874,108.5
'31220, 안성시,'010005, 9세,2019,1749,903,846,106.7,1714,881,833,105.8
'31220, 안성시,'015,10~14세,2019,8724,4475,4249,105.3,8538,4384,4154,105.5
'31220, 안성시,'015001, 10세,2019,1772,914,858,106.5,1729,888,841,105.6
'31220, 안성시,'015002, 11세,2019,1847,933,914,102.1,1812,919,893,102.9
'31220, 안성시,'015003, 12세,2019,1825,937,888,105.5,1777,910,867,105
'31220, 안성시,'015004, 13세,2019,1635,839,796,105.4,1610,827,783,105.6
'31220, 안성시,'015005, 14세,2019,1645,852,793,107.4,1610,840,770,109.1
'31220, 안성시,'020,15~19세,2019,11838,6089,5749,105.9,11507,5931,5576,106.4
'31220, 안성시,'020001, 15세,2019,1726,894,832,107.5,1702,883,819,107.8
'31220, 안성시,'020002, 16세,2019,1929,1002,927,108.1,1910,996,914,109
'31220, 안성시,'020003, 17세,2019,2023,1081,942,114.8,1997,1067,930,114.7
'31220, 안성시,'020004, 18세,2019,2580,1345,1235,108.9,2502,1312,1190,110.3
'31220, 안성시,'020005, 19세,2019,3580,1767,1813,97.5,3396,1673,1723,97.1
'31220, 안성시,'025,20~24세,2019,15198,8118,7080,114.7,13296,6823,6473,105.4
'31220, 안성시,'025001, 20세,2019,3139,1543,1596,96.7,2913,1405,1508,93.2
'31220, 안성시,'025002, 21세,2019,3006,1480,1526,97,2698,1296,1402,92.4
'31220, 안성시,'025003, 22세,2019,2996,1557,1439,108.2,2610,1284,1326,96.8
'31220, 안성시,'025004, 23세,2019,3062,1767,1295,136.4,2601,1445,1156,125
'31220, 안성시,'025005, 24세,2019,2995,1771,1224,144.7,2474,1393,1081,128.9
'31220, 안성시,'030,25~29세,2019,13779,8400,5379,156.2,10751,6242,4509,138.4
'31220, 안성시,'030001, 25세,2019,2877,1766,1111,159,2373,1391,982,141.6
'31220, 안성시,'030002, 26세,2019,2923,1793,1130,158.7,2281,1336,945,141.4
'31220, 안성시,'030003, 27세,2019,2793,1725,1068,161.5,2153,1264,889,142.2
'31220, 안성시,'030004, 28세,2019,2606,1543,1063,145.2,2014,1127,887,127.1
'31220, 안성시,'030005, 29세,2019,2580,1573,1007,156.2,1930,1124,806,139.5
'31220, 안성시,'035,30~34세,2019,13024,7648,5376,142.3,9933,5460,4473,122.1
'31220, 안성시,'035001, 30세,2019,2605,1556,1049,148.3,1973,1084,889,121.9
'31220, 안성시,'035002, 31세,2019,2516,1464,1052,139.2,1896,1040,856,121.5
'31220, 안성시,'035003, 32세,2019,2594,1519,1075,141.3,1949,1062,887,119.7
'31220, 안성시,'035004, 33세,2019,2592,1507,1085,138.9,1992,1082,910,118.9
'31220, 안성시,'035005, 34세,2019,2717,1602,1115,143.7,2123,1192,931,128
'31220, 안성시,'040,35~39세,2019,16010,9008,7002,128.6,13527,7315,6212,117.8
'31220, 안성시,'040001, 35세,2019,2810,1665,1145,145.4,2260,1283,977,131.3
'31220, 안성시,'040002, 36세,2019,3050,1672,1378,121.3,2542,1336,1206,110.8
'31220, 안성시,'040003, 37세,2019,3274,1832,1442,127,2773,1491,1282,116.3
'31220, 안성시,'040004, 38세,2019,3382,1907,1475,129.3,2904,1570,1334,117.7
'31220, 안성시,'040005, 39세,2019,3494,1932,1562,123.7,3048,1635,1413,115.7
'31220, 안성시,'045,40~44세,2019,15323,8413,6910,121.8,13576,7250,6326,114.6
'31220, 안성시,'045001, 40세,2019,3283,1817,1466,123.9,2873,1525,1348,113.1
'31220, 안성시,'045002, 41세,2019,3059,1693,1366,123.9,2683,1455,1228,118.5
'31220, 안성시,'045003, 42세,2019,3059,1671,1388,120.4,2722,1445,1277,113.2
'31220, 안성시,'045004, 43세,2019,2940,1625,1315,123.6,2590,1388,1202,115.5
'31220, 안성시,'045005, 44세,2019,2982,1607,1375,116.9,2708,1437,1271,113.1
'31220, 안성시,'050,45~49세,2019,16664,8948,7716,116,15285,8134,7151,113.7
'31220, 안성시,'050001, 45세,2019,3256,1746,1510,115.6,2981,1581,1400,112.9
'31220, 안성시,'050002, 46세,2019,3333,1768,1565,113,3077,1615,1462,110.5
'31220, 안성시,'050003, 47세,2019,3235,1775,1460,121.6,2947,1600,1347,118.8
'31220, 안성시,'050004, 48세,2019,3491,1870,1621,115.4,3214,1708,1506,113.4
'31220, 안성시,'050005, 49세,2019,3349,1789,1560,114.7,3066,1630,1436,113.5
'31220, 안성시,'055,50~54세,2019,16028,8544,7484,114.2,14959,7959,7000,113.7
'31220, 안성시,'055001, 50세,2019,3531,1917,1614,118.8,3285,1777,1508,117.8
'31220, 안성시,'055002, 51세,2019,3359,1772,1587,111.7,3105,1628,1477,110.2
'31220, 안성시,'055003, 52세,2019,3024,1560,1464,106.6,2839,1454,1385,105
'31220, 안성시,'055004, 53세,2019,3031,1645,1386,118.7,2845,1557,1288,120.9
'31220, 안성시,'055005, 54세,2019,3083,1650,1433,115.1,2885,1543,1342,115
'31220, 안성시,'060,55~59세,2019,15752,8213,7539,108.9,14889,7759,7130,108.8
'31220, 안성시,'060001, 55세,2019,2872,1489,1383,107.7,2672,1393,1279,108.9
'31220, 안성시,'060002, 56세,2019,3094,1627,1467,110.9,2876,1510,1366,110.5
'31220, 안성시,'060003, 57세,2019,2953,1565,1388,112.8,2771,1469,1302,112.8
'31220, 안성시,'060004, 58세,2019,3473,1819,1654,110,3352,1754,1598,109.8
'31220, 안성시,'060005, 59세,2019,3360,1713,1647,104,3218,1633,1585,103
'31220, 안성시,'065,60~64세,2019,13624,6894,6730,102.4,13026,6572,6454,101.8
'31220, 안성시,'065001, 60세,2019,3081,1583,1498,105.7,2929,1499,1430,104.8
'31220, 안성시,'065002, 61세,2019,2864,1452,1412,102.8,2743,1395,1348,103.5
'31220, 안성시,'065003, 62세,2019,2678,1371,1307,104.9,2531,1287,1244,103.5
'31220, 안성시,'065004, 63세,2019,2497,1231,1266,97.2,2394,1178,1216,96.9
'31220, 안성시,'065005, 64세,2019,2504,1257,1247,100.8,2429,1213,1216,99.8
'31220, 안성시,'070,65~69세,2019,9352,4653,4699,99,9053,4523,4530,99.8
'31220, 안성시,'070001, 65세,2019,2159,1094,1065,102.7,2095,1067,1028,103.8
'31220, 안성시,'070002, 66세,2019,1940,960,980,98,1848,918,930,98.7
'31220, 안성시,'070003, 67세,2019,2210,1117,1093,102.2,2157,1097,1060,103.5
'31220, 안성시,'070004, 68세,2019,1456,707,749,94.4,1412,684,728,94
'31220, 안성시,'070005, 69세,2019,1587,775,812,95.4,1541,757,784,96.6
'31220, 안성시,'075,70~74세,2019,7083,3371,3712,90.8,6985,3319,3666,90.5
'31220, 안성시,'075001, 70세,2019,1461,708,753,94,1431,694,737,94.2
'31220, 안성시,'075002, 71세,2019,1512,731,781,93.6,1493,721,772,93.4
'31220, 안성시,'075003, 72세,2019,1663,782,881,88.8,1643,769,874,88
'31220, 안성시,'075004, 73세,2019,1221,596,625,95.4,1206,589,617,95.5
'31220, 안성시,'075005, 74세,2019,1226,554,672,82.4,1212,546,666,82
'31220, 안성시,'080,75~79세,2019,6127,2573,3554,72.4,6094,2560,3534,72.4
'31220, 안성시,'080001, 75세,2019,1195,539,656,82.2,1189,536,653,82.1
'31220, 안성시,'080002, 76세,2019,1192,507,685,74,1186,504,682,73.9
'31220, 안성시,'080003, 77세,2019,1410,562,848,66.3,1405,561,844,66.5
'31220, 안성시,'080004, 78세,2019,1181,514,667,77.1,1173,510,663,76.9
'31220, 안성시,'080005, 79세,2019,1149,451,698,64.6,1141,449,692,64.9
'31220, 안성시,'085,80~84세,2019,4800,1784,3016,59.2,4771,1774,2997,59.2
'31220, 안성시,'085001, 80세,2019,1143,453,690,65.7,1133,450,683,65.9
'31220, 안성시,'085002, 81세,2019,995,363,632,57.4,986,359,627,57.3
'31220, 안성시,'085003, 82세,2019,1020,388,632,61.4,1016,386,630,61.3
'31220, 안성시,'085004, 83세,2019,888,335,553,60.6,886,334,552,60.5
'31220, 안성시,'085005, 84세,2019,754,245,509,48.1,750,245,505,48.5
'31220, 안성시,'086,85세이상,2019,3538,910,2628,34.6,3518,903,2615,34.5
'31220, 안성시,'090,85~89세,2019,2494,721,1773,40.7,2480,716,1764,40.6
'31220, 안성시,'090001, 85세,2019,714,236,478,49.4,710,234,476,49.2
'31220, 안성시,'090002, 86세,2019,570,169,401,42.1,565,168,397,42.3
'31220, 안성시,'090003, 87세,2019,487,132,355,37.2,487,132,355,37.2
'31220, 안성시,'090004, 88세,2019,397,109,288,37.8,394,108,286,37.8
'31220, 안성시,'090005, 89세,2019,326,75,251,29.9,324,74,250,29.6
'31220, 안성시,'095,90~94세,2019,797,136,661,20.6,793,134,659,20.3
'31220, 안성시,'095001, 90세,2019,242,45,197,22.8,241,45,196,23
'31220, 안성시,'095002, 91세,2019,198,35,163,21.5,197,34,163,20.9
'31220, 안성시,'095003, 92세,2019,138,20,118,16.9,136,19,117,16.2
'31220, 안성시,'095004, 93세,2019,133,20,113,17.7,133,20,113,17.7
'31220, 안성시,'095005, 94세,2019,86,16,70,22.9,86,16,70,22.9
'31220, 안성시,'100,95~99세,2019,221,48,173,27.7,219,48,171,28.1
'31220, 안성시,'100001, 95세,2019,82,20,62,32.3,82,20,62,32.3
'31220, 안성시,'100002, 96세,2019,60,12,48,25,58,12,46,26.1
'31220, 안성시,'100003, 97세,2019,41,9,32,28.1,41,9,32,28.1
'31220, 안성시,'100004, 98세,2019,23,5,18,27.8,23,5,18,27.8
'31220, 안성시,'100005, 99세,2019,15,X,13,15.4,15,X,13,15.4
'31220, 안성시,'101,100세이상,2019,26,5,21,23.8,26,5,21,23.8
'31220, 안성시,'102,15세미만,2019,24144,12387,11757,105.4,23336,11993,11343,105.7
'31220, 안성시,'103,15~64세,2019,147240,80275,66965,119.9,130749,69445,61304,113.3
'31220, 안성시,'104,65세이상,2019,30900,13291,17609,75.5,30421,13079,17342,75.4
'31220, 안성시,'126,평균연령,2019,42.1,40.8,43.5,,42.6,41.4,43.9,
'31220, 안성시,'127,중위연령,2019,42.3,40.7,44.2,,43.6,42.4,45.1,
'31230, 김포시,'000,합계,2019,442910,229269,213641,107.3,414839,207712,207127,100.3
'31230, 김포시,'005,0~4세,2019,23584,12095,11489,105.3,23249,11929,11320,105.4
'31230, 김포시,'005001, 0세,2019,3525,1856,1669,111.2,3463,1826,1637,111.5
'31230, 김포시,'005002, 1세,2019,4144,2075,2069,100.3,4081,2042,2039,100.1
'31230, 김포시,'005003, 2세,2019,4654,2407,2247,107.1,4587,2375,2212,107.4
'31230, 김포시,'005004, 3세,2019,5468,2793,2675,104.4,5381,2745,2636,104.1
'31230, 김포시,'005005, 4세,2019,5793,2964,2829,104.8,5737,2941,2796,105.2
'31230, 김포시,'010,5~9세,2019,28110,14369,13741,104.6,27902,14254,13648,104.4
'31230, 김포시,'010001, 5세,2019,5587,2866,2721,105.3,5540,2841,2699,105.3
'31230, 김포시,'010002, 6세,2019,5476,2786,2690,103.6,5435,2763,2672,103.4
'31230, 김포시,'010003, 7세,2019,6106,3032,3074,98.6,6059,3009,3050,98.7
'31230, 김포시,'010004, 8세,2019,5690,2953,2737,107.9,5646,2927,2719,107.6
'31230, 김포시,'010005, 9세,2019,5251,2732,2519,108.5,5222,2714,2508,108.2
'31230, 김포시,'015,10~14세,2019,22807,11520,11287,102.1,22678,11450,11228,102
'31230, 김포시,'015001, 10세,2019,4908,2503,2405,104.1,4883,2489,2394,104
'31230, 김포시,'015002, 11세,2019,4967,2511,2456,102.2,4934,2490,2444,101.9
'31230, 김포시,'015003, 12세,2019,4696,2332,2364,98.6,4669,2318,2351,98.6
'31230, 김포시,'015004, 13세,2019,4285,2218,2067,107.3,4264,2207,2057,107.3
'31230, 김포시,'015005, 14세,2019,3951,1956,1995,98,3928,1946,1982,98.2
'31230, 김포시,'020,15~19세,2019,19496,9977,9519,104.8,19283,9850,9433,104.4
'31230, 김포시,'020001, 15세,2019,4066,2080,1986,104.7,4045,2065,1980,104.3
'31230, 김포시,'020002, 16세,2019,4060,2059,2001,102.9,4043,2049,1994,102.8
'31230, 김포시,'020003, 17세,2019,4072,2050,2022,101.4,4039,2034,2005,101.4
'31230, 김포시,'020004, 18세,2019,3962,2013,1949,103.3,3917,1985,1932,102.7
'31230, 김포시,'020005, 19세,2019,3336,1775,1561,113.7,3239,1717,1522,112.8
'31230, 김포시,'025,20~24세,2019,21143,12116,9027,134.2,18589,9981,8608,116
'31230, 김포시,'025001, 20세,2019,3601,2081,1520,136.9,3420,1944,1476,131.7
'31230, 김포시,'025002, 21세,2019,3979,2380,1599,148.8,3647,2102,1545,136.1
'31230, 김포시,'025003, 22세,2019,4092,2372,1720,137.9,3617,1977,1640,120.5
'31230, 김포시,'025004, 23세,2019,4519,2542,1977,128.6,3807,1943,1864,104.2
'31230, 김포시,'025005, 24세,2019,4952,2741,2211,124,4098,2015,2083,96.7
'31230, 김포시,'030,25~29세,2019,28860,16939,11921,142.1,22645,11566,11079,104.4
'31230, 김포시,'030001, 25세,2019,5410,3163,2247,140.8,4357,2236,2121,105.4
'31230, 김포시,'030002, 26세,2019,5773,3404,2369,143.7,4556,2355,2201,107
'31230, 김포시,'030003, 27세,2019,5924,3528,2396,147.2,4636,2395,2241,106.9
'31230, 김포시,'030004, 28세,2019,5860,3370,2490,135.3,4622,2314,2308,100.3
'31230, 김포시,'030005, 29세,2019,5893,3474,2419,143.6,4474,2266,2208,102.6
'31230, 김포시,'035,30~34세,2019,32243,17575,14668,119.8,26421,12718,13703,92.8
'31230, 김포시,'035001, 30세,2019,5920,3428,2492,137.6,4630,2327,2303,101
'31230, 김포시,'035002, 31세,2019,5875,3223,2652,121.5,4701,2231,2470,90.3
'31230, 김포시,'035003, 32세,2019,6369,3391,2978,113.9,5222,2444,2778,88
'31230, 김포시,'035004, 33세,2019,6781,3677,3104,118.5,5630,2735,2895,94.5
'31230, 김포시,'035005, 34세,2019,7298,3856,3442,112,6238,2981,3257,91.5
'31230, 김포시,'040,35~39세,2019,46225,24137,22088,109.3,42174,20888,21286,98.1
'31230, 김포시,'040001, 35세,2019,7701,4032,3669,109.9,6773,3275,3498,93.6
'31230, 김포시,'040002, 36세,2019,8893,4596,4297,107,8036,3899,4137,94.2
'31230, 김포시,'040003, 37세,2019,9758,5124,4634,110.6,8921,4452,4469,99.6
'31230, 김포시,'040004, 38세,2019,9832,5123,4709,108.8,9115,4557,4558,100
'31230, 김포시,'040005, 39세,2019,10041,5262,4779,110.1,9329,4705,4624,101.8
'31230, 김포시,'045,40~44세,2019,42188,22413,19775,113.3,39818,20612,19206,107.3
'31230, 김포시,'045001, 40세,2019,9395,4896,4499,108.8,8792,4433,4359,101.7
'31230, 김포시,'045002, 41세,2019,8513,4575,3938,116.2,7993,4175,3818,109.4
'31230, 김포시,'045003, 42세,2019,8435,4433,4002,110.8,7958,4069,3889,104.6
'31230, 김포시,'045004, 43세,2019,7920,4266,3654,116.7,7499,3944,3555,110.9
'31230, 김포시,'045005, 44세,2019,7925,4243,3682,115.2,7576,3991,3585,111.3
'31230, 김포시,'050,45~49세,2019,38418,20440,17978,113.7,36638,19255,17383,110.8
'31230, 김포시,'050001, 45세,2019,8192,4386,3806,115.2,7845,4146,3699,112.1
'31230, 김포시,'050002, 46세,2019,7788,4221,3567,118.3,7427,3975,3452,115.2
'31230, 김포시,'050003, 47세,2019,7751,4149,3602,115.2,7383,3905,3478,112.3
'31230, 김포시,'050004, 48세,2019,7505,3955,3550,111.4,7179,3745,3434,109.1
'31230, 김포시,'050005, 49세,2019,7182,3729,3453,108,6804,3484,3320,104.9
'31230, 김포시,'055,50~54세,2019,32436,16548,15888,104.2,30879,15589,15290,102
'31230, 김포시,'055001, 50세,2019,7081,3625,3456,104.9,6754,3435,3319,103.5
'31230, 김포시,'055002, 51세,2019,6816,3524,3292,107,6469,3296,3173,103.9
'31230, 김포시,'055003, 52세,2019,6259,3180,3079,103.3,5981,3014,2967,101.6
'31230, 김포시,'055004, 53세,2019,6133,3161,2972,106.4,5838,2972,2866,103.7
'31230, 김포시,'055005, 54세,2019,6147,3058,3089,99,5837,2872,2965,96.9
'31230, 김포시,'060,55~59세,2019,30629,15757,14872,106,29345,15030,14315,105
'31230, 김포시,'060001, 55세,2019,5814,3005,2809,107,5520,2843,2677,106.2
'31230, 김포시,'060002, 56세,2019,6142,3175,2967,107,5806,2987,2819,106
'31230, 김포시,'060003, 57세,2019,6153,3203,2950,108.6,5885,3043,2842,107.1
'31230, 김포시,'060004, 58세,2019,6209,3151,3058,103,6056,3062,2994,102.3
'31230, 김포시,'060005, 59세,2019,6311,3223,3088,104.4,6078,3095,2983,103.8
'31230, 김포시,'065,60~64세,2019,25965,12681,13284,95.5,25140,12233,12907,94.8
'31230, 김포시,'065001, 60세,2019,5742,2878,2864,100.5,5532,2761,2771,99.6
'31230, 김포시,'065002, 61세,2019,5404,2657,2747,96.7,5240,2569,2671,96.2
'31230, 김포시,'065003, 62세,2019,5337,2613,2724,95.9,5157,2516,2641,95.3
'31230, 김포시,'065004, 63세,2019,4658,2229,2429,91.8,4512,2153,2359,91.3
'31230, 김포시,'065005, 64세,2019,4824,2304,2520,91.4,4699,2234,2465,90.6
'31230, 김포시,'070,65~69세,2019,17088,8150,8938,91.2,16683,7946,8737,90.9
'31230, 김포시,'070001, 65세,2019,4046,1960,2086,94,3926,1892,2034,93
'31230, 김포시,'070002, 66세,2019,3631,1713,1918,89.3,3527,1654,1873,88.3
'31230, 김포시,'070003, 67세,2019,3846,1865,1981,94.1,3782,1831,1951,93.8
'31230, 김포시,'070004, 68세,2019,2587,1228,1359,90.4,2528,1206,1322,91.2
'31230, 김포시,'070005, 69세,2019,2978,1384,1594,86.8,2920,1363,1557,87.5
'31230, 김포시,'075,70~74세,2019,13531,6527,7004,93.2,13369,6452,6917,93.3
'31230, 김포시,'075001, 70세,2019,3154,1527,1627,93.9,3098,1503,1595,94.2
'31230, 김포시,'075002, 71세,2019,2979,1462,1517,96.4,2937,1440,1497,96.2
'31230, 김포시,'075003, 72세,2019,2875,1388,1487,93.3,2849,1371,1478,92.8
'31230, 김포시,'075004, 73세,2019,2319,1121,1198,93.6,2297,1113,1184,94
'31230, 김포시,'075005, 74세,2019,2204,1029,1175,87.6,2188,1025,1163,88.1
'31230, 김포시,'080,75~79세,2019,9832,4324,5508,78.5,9751,4291,5460,78.6
'31230, 김포시,'080001, 75세,2019,1984,893,1091,81.9,1971,884,1087,81.3
'31230, 김포시,'080002, 76세,2019,2082,947,1135,83.4,2064,942,1122,84
'31230, 김포시,'080003, 77세,2019,2320,980,1340,73.1,2303,971,1332,72.9
'31230, 김포시,'080004, 78세,2019,1837,803,1034,77.7,1821,800,1021,78.4
'31230, 김포시,'080005, 79세,2019,1609,701,908,77.2,1592,694,898,77.3
'31230, 김포시,'085,80~84세,2019,6244,2486,3758,66.2,6192,2467,3725,66.2
'31230, 김포시,'085001, 80세,2019,1538,633,905,69.9,1523,632,891,70.9
'31230, 김포시,'085002, 81세,2019,1381,575,806,71.3,1371,569,802,70.9
'31230, 김포시,'085003, 82세,2019,1236,478,758,63.1,1229,476,753,63.2
'31230, 김포시,'085004, 83세,2019,1068,427,641,66.6,1057,424,633,67
'31230, 김포시,'085005, 84세,2019,1021,373,648,57.6,1012,366,646,56.7
'31230, 김포시,'086,85세이상,2019,4111,1215,2896,42,4083,1201,2882,41.7
'31230, 김포시,'090,85~89세,2019,2867,898,1969,45.6,2850,890,1960,45.4
'31230, 김포시,'090001, 85세,2019,813,278,535,52,809,275,534,51.5
'31230, 김포시,'090002, 86세,2019,636,203,433,46.9,631,203,428,47.4
'31230, 김포시,'090003, 87세,2019,587,187,400,46.8,584,185,399,46.4
'31230, 김포시,'090004, 88세,2019,464,144,320,45,460,141,319,44.2
'31230, 김포시,'090005, 89세,2019,367,86,281,30.6,366,86,280,30.7
'31230, 김포시,'095,90~94세,2019,999,263,736,35.7,989,258,731,35.3
'31230, 김포시,'095001, 90세,2019,324,88,236,37.3,322,88,234,37.6
'31230, 김포시,'095002, 91세,2019,239,62,177,35,236,60,176,34.1
'31230, 김포시,'095003, 92세,2019,208,54,154,35.1,207,53,154,34.4
'31230, 김포시,'095004, 93세,2019,123,27,96,28.1,120,25,95,26.3
'31230, 김포시,'095005, 94세,2019,105,32,73,43.8,104,32,72,44.4
'31230, 김포시,'100,95~99세,2019,222,50,172,29.1,221,49,172,28.5
'31230, 김포시,'100001, 95세,2019,66,11,55,20,66,11,55,20
'31230, 김포시,'100002, 96세,2019,69,19,50,38,69,19,50,38
'31230, 김포시,'100003, 97세,2019,42,8,34,23.5,42,8,34,23.5
'31230, 김포시,'100004, 98세,2019,26,8,18,44.4,25,7,18,38.9
'31230, 김포시,'100005, 99세,2019,19,X,15,26.7,19,X,15,26.7
'31230, 김포시,'101,100세이상,2019,23,X,19,21.1,23,X,19,21.1
'31230, 김포시,'102,15세미만,2019,74501,37984,36517,104,73829,37633,36196,104
'31230, 김포시,'103,15~64세,2019,317603,168583,149020,113.1,290932,147722,143210,103.2
'31230, 김포시,'104,65세이상,2019,50806,22702,28104,80.8,50078,22357,27721,80.7
'31230, 김포시,'126,평균연령,2019,39.3,38.5,40.2,,39.5,38.9,40.2,
'31230, 김포시,'127,중위연령,2019,39.9,39.2,40.7,,40.5,40.3,40.7,
'31240, 화성시,'000,합계,2019,838635,444058,394577,112.5,781512,403808,377704,106.9
'31240, 화성시,'005,0~4세,2019,48850,25084,23766,105.5,47903,24609,23294,105.6
'31240, 화성시,'005001, 0세,2019,7924,4134,3790,109.1,7737,4038,3699,109.2
'31240, 화성시,'005002, 1세,2019,8941,4575,4366,104.8,8758,4480,4278,104.7
'31240, 화성시,'005003, 2세,2019,9745,4997,4748,105.2,9544,4901,4643,105.6
'31240, 화성시,'005004, 3세,2019,10909,5577,5332,104.6,10701,5474,5227,104.7
'31240, 화성시,'005005, 4세,2019,11331,5801,5530,104.9,11163,5716,5447,104.9
'31240, 화성시,'010,5~9세,2019,56597,28886,27711,104.2,56014,28587,27427,104.2
'31240, 화성시,'010001, 5세,2019,11178,5627,5551,101.4,11024,5548,5476,101.3
'31240, 화성시,'010002, 6세,2019,11114,5722,5392,106.1,10967,5643,5324,106
'31240, 화성시,'010003, 7세,2019,11979,6093,5886,103.5,11874,6039,5835,103.5
'31240, 화성시,'010004, 8세,2019,11512,5882,5630,104.5,11410,5829,5581,104.4
'31240, 화성시,'010005, 9세,2019,10814,5562,5252,105.9,10739,5528,5211,106.1
'31240, 화성시,'015,10~14세,2019,48304,24533,23771,103.2,47965,24366,23599,103.3
'31240, 화성시,'015001, 10세,2019,10334,5248,5086,103.2,10268,5212,5056,103.1
'31240, 화성시,'015002, 11세,2019,10544,5383,5161,104.3,10451,5335,5116,104.3
'31240, 화성시,'015003, 12세,2019,10138,5118,5020,102,10063,5084,4979,102.1
'31240, 화성시,'015004, 13세,2019,9053,4610,4443,103.8,8993,4582,4411,103.9
'31240, 화성시,'015005, 14세,2019,8235,4174,4061,102.8,8190,4153,4037,102.9
'31240, 화성시,'020,15~19세,2019,41307,21007,20300,103.5,40702,20672,20030,103.2
'31240, 화성시,'020001, 15세,2019,8533,4330,4203,103,8474,4304,4170,103.2
'31240, 화성시,'020002, 16세,2019,8130,4151,3979,104.3,8083,4122,3961,104.1
'31240, 화성시,'020003, 17세,2019,7942,4013,3929,102.1,7885,3977,3908,101.8
'31240, 화성시,'020004, 18세,2019,8424,4317,4107,105.1,8310,4264,4046,105.4
'31240, 화성시,'020005, 19세,2019,8278,4196,4082,102.8,7950,4005,3945,101.5
'31240, 화성시,'025,20~24세,2019,45341,25528,19813,128.8,39608,21193,18415,115.1
'31240, 화성시,'025001, 20세,2019,8205,4429,3776,117.3,7688,4099,3589,114.2
'31240, 화성시,'025002, 21세,2019,8467,4693,3774,124.4,7654,4127,3527,117
'31240, 화성시,'025003, 22세,2019,9051,5135,3916,131.1,7947,4308,3639,118.4
'31240, 화성시,'025004, 23세,2019,9377,5312,4065,130.7,7914,4153,3761,110.4
'31240, 화성시,'025005, 24세,2019,10241,5959,4282,139.2,8405,4506,3899,115.6
'31240, 화성시,'030,25~29세,2019,61020,36232,24788,146.2,49667,27364,22303,122.7
'31240, 화성시,'030001, 25세,2019,10869,6375,4494,141.9,8915,4829,4086,118.2
'31240, 화성시,'030002, 26세,2019,11964,7151,4813,148.6,9853,5496,4357,126.1
'31240, 화성시,'030003, 27세,2019,12575,7625,4950,154,10185,5758,4427,130.1
'31240, 화성시,'030004, 28세,2019,12589,7471,5118,146,10299,5676,4623,122.8
'31240, 화성시,'030005, 29세,2019,13023,7610,5413,140.6,10415,5605,4810,116.5
'31240, 화성시,'035,30~34세,2019,72409,40402,32007,126.2,60781,31575,29206,108.1
'31240, 화성시,'035001, 30세,2019,13585,7748,5837,132.7,11193,5898,5295,111.4
'31240, 화성시,'035002, 31세,2019,14072,7933,6139,129.2,11597,6027,5570,108.2
'31240, 화성시,'035003, 32세,2019,14486,8088,6398,126.4,12080,6300,5780,109
'31240, 화성시,'035004, 33세,2019,14968,8198,6770,121.1,12695,6479,6216,104.2
'31240, 화성시,'035005, 34세,2019,15298,8435,6863,122.9,13216,6871,6345,108.3
'31240, 화성시,'040,35~39세,2019,93373,50201,43172,116.3,84890,43909,40981,107.1
'31240, 화성시,'040001, 35세,2019,16248,8924,7324,121.8,14230,7413,6817,108.7
'31240, 화성시,'040002, 36세,2019,17945,9555,8390,113.9,16124,8160,7964,102.5
'31240, 화성시,'040003, 37세,2019,19699,10518,9181,114.6,17966,9252,8714,106.2
'31240, 화성시,'040004, 38세,2019,19730,10611,9119,116.4,18250,9539,8711,109.5
'31240, 화성시,'040005, 39세,2019,19751,10593,9158,115.7,18320,9545,8775,108.8
'31240, 화성시,'045,40~44세,2019,82864,44892,37972,118.2,77689,41286,36403,113.4
'31240, 화성시,'045001, 40세,2019,18390,9941,8449,117.7,17121,9059,8062,112.4
'31240, 화성시,'045002, 41세,2019,16635,9062,7573,119.7,15464,8241,7223,114.1
'31240, 화성시,'045003, 42세,2019,16776,9053,7723,117.2,15795,8344,7451,112
'31240, 화성시,'045004, 43세,2019,15559,8473,7086,119.6,14641,7842,6799,115.3
'31240, 화성시,'045005, 44세,2019,15504,8363,7141,117.1,14668,7800,6868,113.6
'31240, 화성시,'050,45~49세,2019,74479,40421,34058,118.7,70389,37822,32567,116.1
'31240, 화성시,'050001, 45세,2019,15794,8420,7374,114.2,14986,7876,7110,110.8
'31240, 화성시,'050002, 46세,2019,15374,8300,7074,117.3,14571,7776,6795,114.4
'31240, 화성시,'050003, 47세,2019,14535,7999,6536,122.4,13702,7471,6231,119.9
'31240, 화성시,'050004, 48세,2019,14792,8111,6681,121.4,13980,7607,6373,119.4
'31240, 화성시,'050005, 49세,2019,13984,7591,6393,118.7,13150,7092,6058,117.1
'31240, 화성시,'055,50~54세,2019,59037,31676,27361,115.8,55881,29849,26032,114.7
'31240, 화성시,'055001, 50세,2019,13580,7253,6327,114.6,12888,6826,6062,112.6
'31240, 화성시,'055002, 51세,2019,12768,6786,5982,113.4,12079,6401,5678,112.7
'31240, 화성시,'055003, 52세,2019,11106,5838,5268,110.8,10557,5527,5030,109.9
'31240, 화성시,'055004, 53세,2019,10574,5781,4793,120.6,9965,5434,4531,119.9
'31240, 화성시,'055005, 54세,2019,11009,6018,4991,120.6,10392,5661,4731,119.7
'31240, 화성시,'060,55~59세,2019,50059,26465,23594,112.2,47561,25101,22460,111.8
'31240, 화성시,'060001, 55세,2019,9809,5230,4579,114.2,9231,4905,4326,113.4
'31240, 화성시,'060002, 56세,2019,10015,5382,4633,116.2,9377,5024,4353,115.4
'31240, 화성시,'060003, 57세,2019,9835,5236,4599,113.9,9313,4945,4368,113.2
'31240, 화성시,'060004, 58세,2019,10582,5526,5056,109.3,10248,5359,4889,109.6
'31240, 화성시,'060005, 59세,2019,9818,5091,4727,107.7,9392,4868,4524,107.6
'31240, 화성시,'065,60~64세,2019,37394,18891,18503,102.1,35967,18127,17840,101.6
'31240, 화성시,'065001, 60세,2019,8666,4481,4185,107.1,8330,4291,4039,106.2
'31240, 화성시,'065002, 61세,2019,7898,4038,3860,104.6,7571,3853,3718,103.6
'31240, 화성시,'065003, 62세,2019,7260,3566,3694,96.5,6956,3416,3540,96.5
'31240, 화성시,'065004, 63세,2019,6847,3464,3383,102.4,6611,3339,3272,102
'31240, 화성시,'065005, 64세,2019,6723,3342,3381,98.8,6499,3228,3271,98.7
'31240, 화성시,'070,65~69세,2019,23325,11428,11897,96.1,22654,11095,11559,96
'31240, 화성시,'070001, 65세,2019,5566,2732,2834,96.4,5373,2638,2735,96.5
'31240, 화성시,'070002, 66세,2019,4965,2523,2442,103.3,4807,2442,2365,103.3
'31240, 화성시,'070003, 67세,2019,5449,2633,2816,93.5,5331,2585,2746,94.1
'31240, 화성시,'070004, 68세,2019,3433,1687,1746,96.6,3313,1619,1694,95.6
'31240, 화성시,'070005, 69세,2019,3912,1853,2059,90,3830,1811,2019,89.7
'31240, 화성시,'075,70~74세,2019,16810,8140,8670,93.9,16595,8040,8555,94
'31240, 화성시,'075001, 70세,2019,3879,1873,2006,93.4,3815,1840,1975,93.2
'31240, 화성시,'075002, 71세,2019,3687,1781,1906,93.4,3640,1761,1879,93.7
'31240, 화성시,'075003, 72세,2019,3665,1778,1887,94.2,3618,1758,1860,94.5
'31240, 화성시,'075004, 73세,2019,2893,1420,1473,96.4,2871,1410,1461,96.5
'31240, 화성시,'075005, 74세,2019,2686,1288,1398,92.1,2651,1271,1380,92.1
'31240, 화성시,'080,75~79세,2019,12599,5369,7230,74.3,12494,5341,7153,74.7
'31240, 화성시,'080001, 75세,2019,2613,1156,1457,79.3,2592,1152,1440,80
'31240, 화성시,'080002, 76세,2019,2552,1088,1464,74.3,2526,1082,1444,74.9
'31240, 화성시,'080003, 77세,2019,2886,1227,1659,74,2865,1222,1643,74.4
'31240, 화성시,'080004, 78세,2019,2458,1039,1419,73.2,2440,1030,1410,73
'31240, 화성시,'080005, 79세,2019,2090,859,1231,69.8,2071,855,1216,70.3
'31240, 화성시,'085,80~84세,2019,8795,3296,5499,59.9,8723,3275,5448,60.1
'31240, 화성시,'085001, 80세,2019,2090,822,1268,64.8,2077,819,1258,65.1
'31240, 화성시,'085002, 81세,2019,1949,771,1178,65.4,1928,766,1162,65.9
'31240, 화성시,'085003, 82세,2019,1799,689,1110,62.1,1784,683,1101,62
'31240, 화성시,'085004, 83세,2019,1576,582,994,58.6,1560,579,981,59
'31240, 화성시,'085005, 84세,2019,1381,432,949,45.5,1374,428,946,45.2
'31240, 화성시,'086,85세이상,2019,6072,1607,4465,36,6029,1597,4432,36
'31240, 화성시,'090,85~89세,2019,4309,1231,3078,40,4282,1226,3056,40.1
'31240, 화성시,'090001, 85세,2019,1217,406,811,50.1,1208,404,804,50.2
'31240, 화성시,'090002, 86세,2019,1009,295,714,41.3,1004,292,712,41
'31240, 화성시,'090003, 87세,2019,908,249,659,37.8,903,249,654,38.1
'31240, 화성시,'090004, 88세,2019,603,153,450,34,598,153,445,34.4
'31240, 화성시,'090005, 89세,2019,572,128,444,28.8,569,128,441,29
'31240, 화성시,'095,90~94세,2019,1400,299,1101,27.2,1391,297,1094,27.1
'31240, 화성시,'095001, 90세,2019,427,104,323,32.2,422,102,320,31.9
'31240, 화성시,'095002, 91세,2019,360,74,286,25.9,359,74,285,26
'31240, 화성시,'095003, 92세,2019,273,49,224,21.9,273,49,224,21.9
'31240, 화성시,'095004, 93세,2019,175,44,131,33.6,174,44,130,33.8
'31240, 화성시,'095005, 94세,2019,165,28,137,20.4,163,28,135,20.7
'31240, 화성시,'100,95~99세,2019,324,69,255,27.1,318,66,252,26.2
'31240, 화성시,'100001, 95세,2019,97,24,73,32.9,95,23,72,31.9
'31240, 화성시,'100002, 96세,2019,108,25,83,30.1,106,24,82,29.3
'31240, 화성시,'100003, 97세,2019,52,12,40,30,51,12,39,30.8
'31240, 화성시,'100004, 98세,2019,39,6,33,18.2,39,6,33,18.2
'31240, 화성시,'100005, 99세,2019,28,X,26,7.7,27,X,26,3.8
'31240, 화성시,'101,100세이상,2019,39,8,31,25.8,38,8,30,26.7
'31240, 화성시,'102,15세미만,2019,153751,78503,75248,104.3,151882,77562,74320,104.4
'31240, 화성시,'103,15~64세,2019,617283,335715,281568,119.2,563135,296898,266237,111.5
'31240, 화성시,'104,65세이상,2019,67601,29840,37761,79,66495,29348,37147,79
'31240, 화성시,'126,평균연령,2019,36.8,36.3,37.3,,36.8,36.4,37.3,
'31240, 화성시,'127,중위연령,2019,37.6,37.2,38,,38,37.9,38.1,
'31250, 광주시,'000,합계,2019,375238,194288,180950,107.4,356432,181623,174809,103.9
'31250, 광주시,'005,0~4세,2019,17627,9008,8619,104.5,17394,8893,8501,104.6
'31250, 광주시,'005001, 0세,2019,2848,1468,1380,106.4,2814,1449,1365,106.2
'31250, 광주시,'005002, 1세,2019,3280,1656,1624,102,3231,1634,1597,102.3
'31250, 광주시,'005003, 2세,2019,3484,1728,1756,98.4,3431,1699,1732,98.1
'31250, 광주시,'005004, 3세,2019,4008,2081,1927,108,3961,2057,1904,108
'31250, 광주시,'005005, 4세,2019,4007,2075,1932,107.4,3957,2054,1903,107.9
'31250, 광주시,'010,5~9세,2019,18493,9540,8953,106.6,18288,9438,8850,106.6
'31250, 광주시,'010001, 5세,2019,3873,2028,1845,109.9,3824,2005,1819,110.2
'31250, 광주시,'010002, 6세,2019,3602,1810,1792,101,3557,1789,1768,101.2
'31250, 광주시,'010003, 7세,2019,3905,2045,1860,109.9,3864,2020,1844,109.5
'31250, 광주시,'010004, 8세,2019,3759,1949,1810,107.7,3720,1931,1789,107.9
'31250, 광주시,'010005, 9세,2019,3354,1708,1646,103.8,3323,1693,1630,103.9
'31250, 광주시,'015,10~14세,2019,15712,7940,7772,102.2,15605,7880,7725,102
'31250, 광주시,'015001, 10세,2019,3154,1612,1542,104.5,3126,1598,1528,104.6
'31250, 광주시,'015002, 11세,2019,3312,1673,1639,102.1,3288,1658,1630,101.7
'31250, 광주시,'015003, 12세,2019,3298,1639,1659,98.8,3276,1625,1651,98.4
'31250, 광주시,'015004, 13세,2019,3080,1571,1509,104.1,3067,1567,1500,104.5
'31250, 광주시,'015005, 14세,2019,2868,1445,1423,101.5,2848,1432,1416,101.1
'31250, 광주시,'020,15~19세,2019,17135,8610,8525,101,16958,8509,8449,100.7
'31250, 광주시,'020001, 15세,2019,3114,1597,1517,105.3,3093,1583,1510,104.8
'31250, 광주시,'020002, 16세,2019,2964,1422,1542,92.2,2951,1417,1534,92.4
'31250, 광주시,'020003, 17세,2019,3202,1621,1581,102.5,3183,1608,1575,102.1
'31250, 광주시,'020004, 18세,2019,3532,1750,1782,98.2,3510,1740,1770,98.3
'31250, 광주시,'020005, 19세,2019,4323,2220,2103,105.6,4221,2161,2060,104.9
'31250, 광주시,'025,20~24세,2019,21296,11862,9434,125.7,19171,10328,8843,116.8
'31250, 광주시,'025001, 20세,2019,3801,2127,1674,127.1,3610,1999,1611,124.1
'31250, 광주시,'025002, 21세,2019,4146,2307,1839,125.4,3820,2092,1728,121.1
'31250, 광주시,'025003, 22세,2019,4235,2347,1888,124.3,3804,2038,1766,115.4
'31250, 광주시,'025004, 23세,2019,4498,2521,1977,127.5,3954,2126,1828,116.3
'31250, 광주시,'025005, 24세,2019,4616,2560,2056,124.5,3983,2073,1910,108.5
'31250, 광주시,'030,25~29세,2019,25089,13982,11107,125.9,21540,11304,10236,110.4
'31250, 광주시,'030001, 25세,2019,4805,2695,2110,127.7,4169,2202,1967,111.9
'31250, 광주시,'030002, 26세,2019,4925,2797,2128,131.4,4220,2249,1971,114.1
'31250, 광주시,'030003, 27세,2019,5309,2904,2405,120.7,4585,2361,2224,106.2
'31250, 광주시,'030004, 28세,2019,5060,2804,2256,124.3,4347,2277,2070,110
'31250, 광주시,'030005, 29세,2019,4990,2782,2208,126,4219,2215,2004,110.5
'31250, 광주시,'035,30~34세,2019,27261,14863,12398,119.9,23765,12317,11448,107.6
'31250, 광주시,'035001, 30세,2019,5105,2838,2267,125.2,4380,2301,2079,110.7
'31250, 광주시,'035002, 31세,2019,5145,2776,2369,117.2,4409,2258,2151,105
'31250, 광주시,'035003, 32세,2019,5340,2900,2440,118.9,4631,2372,2259,105
'31250, 광주시,'035004, 33세,2019,5568,3053,2515,121.4,4929,2581,2348,109.9
'31250, 광주시,'035005, 34세,2019,6103,3296,2807,117.4,5416,2805,2611,107.4
'31250, 광주시,'040,35~39세,2019,36692,19803,16889,117.3,33943,17831,16112,110.7
'31250, 광주시,'040001, 35세,2019,6265,3354,2911,115.2,5666,2919,2747,106.3
'31250, 광주시,'040002, 36세,2019,7142,3889,3253,119.6,6572,3467,3105,111.7
'31250, 광주시,'040003, 37세,2019,7773,4157,3616,115,7208,3762,3446,109.2
'31250, 광주시,'040004, 38세,2019,7691,4237,3454,122.7,7152,3850,3302,116.6
'31250, 광주시,'040005, 39세,2019,7821,4166,3655,114,7345,3833,3512,109.1
'31250, 광주시,'045,40~44세,2019,31381,16945,14436,117.4,29660,15789,13871,113.8
'31250, 광주시,'045001, 40세,2019,6874,3737,3137,119.1,6436,3438,2998,114.7
'31250, 광주시,'045002, 41세,2019,6111,3226,2885,111.8,5744,2986,2758,108.3
'31250, 광주시,'045003, 42세,2019,6125,3375,2750,122.7,5799,3150,2649,118.9
'31250, 광주시,'045004, 43세,2019,6070,3290,2780,118.3,5765,3077,2688,114.5
'31250, 광주시,'045005, 44세,2019,6201,3317,2884,115,5916,3138,2778,113
'31250, 광주시,'050,45~49세,2019,32563,17232,15331,112.4,31289,16475,14814,111.2
'31250, 광주시,'050001, 45세,2019,6443,3428,3015,113.7,6182,3262,2920,111.7
'31250, 광주시,'050002, 46세,2019,6395,3337,3058,109.1,6133,3187,2946,108.2
'31250, 광주시,'050003, 47세,2019,6499,3513,2986,117.6,6246,3372,2874,117.3
'31250, 광주시,'050004, 48세,2019,6796,3538,3258,108.6,6548,3389,3159,107.3
'31250, 광주시,'050005, 49세,2019,6430,3416,3014,113.3,6180,3265,2915,112
'31250, 광주시,'055,50~54세,2019,30639,15532,15107,102.8,29561,14943,14618,102.2
'31250, 광주시,'055001, 50세,2019,6570,3413,3157,108.1,6326,3275,3051,107.3
'31250, 광주시,'055002, 51세,2019,6500,3300,3200,103.1,6284,3180,3104,102.4
'31250, 광주시,'055003, 52세,2019,5826,2867,2959,96.9,5613,2746,2867,95.8
'31250, 광주시,'055004, 53세,2019,5709,2900,2809,103.2,5519,2800,2719,103
'31250, 광주시,'055005, 54세,2019,6034,3052,2982,102.3,5819,2942,2877,102.3
'31250, 광주시,'060,55~59세,2019,29939,14999,14940,100.4,29059,14544,14515,100.2
'31250, 광주시,'060001, 55세,2019,5527,2779,2748,101.1,5320,2675,2645,101.1
'31250, 광주시,'060002, 56세,2019,5760,2969,2791,106.4,5532,2850,2682,106.3
'31250, 광주시,'060003, 57세,2019,6043,3028,3015,100.4,5866,2939,2927,100.4
'31250, 광주시,'060004, 58세,2019,6300,3098,3202,96.8,6186,3043,3143,96.8
'31250, 광주시,'060005, 59세,2019,6309,3125,3184,98.1,6155,3037,3118,97.4
'31250, 광주시,'065,60~64세,2019,26087,13034,13053,99.9,25427,12695,12732,99.7
'31250, 광주시,'065001, 60세,2019,5724,2823,2901,97.3,5589,2746,2843,96.6
'31250, 광주시,'065002, 61세,2019,5540,2767,2773,99.8,5371,2687,2684,100.1
'31250, 광주시,'065003, 62세,2019,5280,2668,2612,102.1,5138,2589,2549,101.6
'31250, 광주시,'065004, 63세,2019,4672,2348,2324,101,4561,2297,2264,101.5
'31250, 광주시,'065005, 64세,2019,4871,2428,2443,99.4,4768,2376,2392,99.3
'31250, 광주시,'070,65~69세,2019,16463,8225,8238,99.8,16134,8063,8071,99.9
'31250, 광주시,'070001, 65세,2019,4008,2012,1996,100.8,3929,1971,1958,100.7
'31250, 광주시,'070002, 66세,2019,3415,1717,1698,101.1,3333,1675,1658,101
'31250, 광주시,'070003, 67세,2019,3760,1908,1852,103,3687,1875,1812,103.5
'31250, 광주시,'070004, 68세,2019,2565,1255,1310,95.8,2514,1234,1280,96.4
'31250, 광주시,'070005, 69세,2019,2715,1333,1382,96.5,2671,1308,1363,96
'31250, 광주시,'075,70~74세,2019,11785,5837,5948,98.1,11663,5777,5886,98.1
'31250, 광주시,'075001, 70세,2019,2740,1339,1401,95.6,2703,1317,1386,95
'31250, 광주시,'075002, 71세,2019,2584,1301,1283,101.4,2555,1288,1267,101.7
'31250, 광주시,'075003, 72세,2019,2643,1325,1318,100.5,2615,1311,1304,100.5
'31250, 광주시,'075004, 73세,2019,1970,949,1021,92.9,1949,941,1008,93.4
'31250, 광주시,'075005, 74세,2019,1848,923,925,99.8,1841,920,921,99.9
'31250, 광주시,'080,75~79세,2019,8468,3906,4562,85.6,8415,3883,4532,85.7
'31250, 광주시,'080001, 75세,2019,1780,856,924,92.6,1768,854,914,93.4
'31250, 광주시,'080002, 76세,2019,1727,837,890,94,1717,829,888,93.4
'31250, 광주시,'080003, 77세,2019,1993,925,1068,86.6,1983,921,1062,86.7
'31250, 광주시,'080004, 78세,2019,1568,697,871,80,1560,695,865,80.3
'31250, 광주시,'080005, 79세,2019,1400,591,809,73.1,1387,584,803,72.7
'31250, 광주시,'085,80~84세,2019,5100,2019,3081,65.5,5074,2010,3064,65.6
'31250, 광주시,'085001, 80세,2019,1260,538,722,74.5,1255,536,719,74.5
'31250, 광주시,'085002, 81세,2019,1126,459,667,68.8,1114,455,659,69
'31250, 광주시,'085003, 82세,2019,988,401,587,68.3,985,399,586,68.1
'31250, 광주시,'085004, 83세,2019,884,345,539,64,880,345,535,64.5
'31250, 광주시,'085005, 84세,2019,842,276,566,48.8,840,275,565,48.7
'31250, 광주시,'086,85세이상,2019,3508,951,2557,37.2,3486,944,2542,37.1
'31250, 광주시,'090,85~89세,2019,2373,720,1653,43.6,2357,715,1642,43.5
'31250, 광주시,'090001, 85세,2019,665,232,433,53.6,659,230,429,53.6
'31250, 광주시,'090002, 86세,2019,571,183,388,47.2,568,182,386,47.2
'31250, 광주시,'090003, 87세,2019,463,134,329,40.7,459,133,326,40.8
'31250, 광주시,'090004, 88세,2019,324,85,239,35.6,322,85,237,35.9
'31250, 광주시,'090005, 89세,2019,350,86,264,32.6,349,85,264,32.2
'31250, 광주시,'095,90~94세,2019,887,183,704,26,882,182,700,26
'31250, 광주시,'095001, 90세,2019,280,77,203,37.9,277,76,201,37.8
'31250, 광주시,'095002, 91세,2019,214,39,175,22.3,214,39,175,22.3
'31250, 광주시,'095003, 92세,2019,179,29,150,19.3,178,29,149,19.5
'31250, 광주시,'095004, 93세,2019,124,24,100,24,123,24,99,24.2
'31250, 광주시,'095005, 94세,2019,90,14,76,18.4,90,14,76,18.4
'31250, 광주시,'100,95~99세,2019,216,47,169,27.8,215,46,169,27.2
'31250, 광주시,'100001, 95세,2019,66,14,52,26.9,66,14,52,26.9
'31250, 광주시,'100002, 96세,2019,65,18,47,38.3,64,17,47,36.2
'31250, 광주시,'100003, 97세,2019,46,X,42,9.5,46,X,42,9.5
'31250, 광주시,'100004, 98세,2019,20,7,13,53.8,20,7,13,53.8
'31250, 광주시,'100005, 99세,2019,19,X,15,26.7,19,X,15,26.7
'31250, 광주시,'101,100세이상,2019,32,X,31,3.2,32,X,31,3.2
'31250, 광주시,'102,15세미만,2019,51832,26488,25344,104.5,51287,26211,25076,104.5
'31250, 광주시,'103,15~64세,2019,278082,146862,131220,111.9,260373,134735,125638,107.2
'31250, 광주시,'104,65세이상,2019,45324,20938,24386,85.9,44772,20677,24095,85.8
'31250, 광주시,'126,평균연령,2019,40.8,40.1,41.6,,41,40.4,41.7,
'31250, 광주시,'127,중위연령,2019,41.2,40.4,42.3,,41.9,41.3,42.6,
'31260, 양주시,'000,합계,2019,224684,115541,109143,105.9,213908,107708,106200,101.4
'31260, 양주시,'005,0~4세,2019,8617,4423,4194,105.5,8490,4362,4128,105.7
'31260, 양주시,'005001, 0세,2019,1352,702,650,108,1327,689,638,108
'31260, 양주시,'005002, 1세,2019,1518,764,754,101.3,1488,749,739,101.4
'31260, 양주시,'005003, 2세,2019,1751,889,862,103.1,1726,882,844,104.5
'31260, 양주시,'005004, 3세,2019,1914,984,930,105.8,1890,974,916,106.3
'31260, 양주시,'005005, 4세,2019,2082,1084,998,108.6,2059,1068,991,107.8
'31260, 양주시,'010,5~9세,2019,11133,5648,5485,103,11048,5595,5453,102.6
'31260, 양주시,'010001, 5세,2019,2021,1039,982,105.8,2000,1026,974,105.3
'31260, 양주시,'010002, 6세,2019,2127,1069,1058,101,2114,1063,1051,101.1
'31260, 양주시,'010003, 7세,2019,2443,1249,1194,104.6,2429,1238,1191,103.9
'31260, 양주시,'010004, 8세,2019,2305,1166,1139,102.4,2286,1155,1131,102.1
'31260, 양주시,'010005, 9세,2019,2237,1125,1112,101.2,2219,1113,1106,100.6
'31260, 양주시,'015,10~14세,2019,11221,5796,5425,106.8,11173,5766,5407,106.6
'31260, 양주시,'015001, 10세,2019,2199,1130,1069,105.7,2190,1126,1064,105.8
'31260, 양주시,'015002, 11세,2019,2300,1192,1108,107.6,2290,1184,1106,107.1
'31260, 양주시,'015003, 12세,2019,2368,1202,1166,103.1,2354,1194,1160,102.9
'31260, 양주시,'015004, 13세,2019,2199,1123,1076,104.4,2191,1119,1072,104.4
'31260, 양주시,'015005, 14세,2019,2155,1149,1006,114.2,2148,1143,1005,113.7
'31260, 양주시,'020,15~19세,2019,11514,5871,5643,104,11384,5789,5595,103.5
'31260, 양주시,'020001, 15세,2019,2289,1172,1117,104.9,2286,1171,1115,105
'31260, 양주시,'020002, 16세,2019,2252,1089,1163,93.6,2241,1083,1158,93.5
'31260, 양주시,'020003, 17세,2019,2309,1206,1103,109.3,2289,1190,1099,108.3
'31260, 양주시,'020004, 18세,2019,2398,1225,1173,104.4,2367,1209,1158,104.4
'31260, 양주시,'020005, 19세,2019,2266,1179,1087,108.5,2201,1136,1065,106.7
'31260, 양주시,'025,20~24세,2019,13078,7281,5797,125.6,11881,6340,5541,114.4
'31260, 양주시,'025001, 20세,2019,2422,1348,1074,125.5,2329,1280,1049,122
'31260, 양주시,'025002, 21세,2019,2495,1380,1115,123.8,2327,1247,1080,115.5
'31260, 양주시,'025003, 22세,2019,2643,1437,1206,119.2,2380,1235,1145,107.9
'31260, 양주시,'025004, 23세,2019,2687,1524,1163,131,2378,1273,1105,115.2
'31260, 양주시,'025005, 24세,2019,2831,1592,1239,128.5,2467,1305,1162,112.3
'31260, 양주시,'030,25~29세,2019,14412,8283,6129,135.1,12152,6487,5665,114.5
'31260, 양주시,'030001, 25세,2019,2817,1601,1216,131.7,2423,1289,1134,113.7
'31260, 양주시,'030002, 26세,2019,2881,1631,1250,130.5,2466,1303,1163,112
'31260, 양주시,'030003, 27세,2019,2949,1692,1257,134.6,2483,1312,1171,112
'31260, 양주시,'030004, 28세,2019,2966,1714,1252,136.9,2486,1347,1139,118.3
'31260, 양주시,'030005, 29세,2019,2799,1645,1154,142.5,2294,1236,1058,116.8
'31260, 양주시,'035,30~34세,2019,13154,7414,5740,129.2,11036,5762,5274,109.3
'31260, 양주시,'035001, 30세,2019,2571,1477,1094,135,2095,1110,985,112.7
'31260, 양주시,'035002, 31세,2019,2633,1539,1094,140.7,2150,1156,994,116.3
'31260, 양주시,'035003, 32세,2019,2626,1493,1133,131.8,2193,1139,1054,108.1
'31260, 양주시,'035004, 33세,2019,2640,1444,1196,120.7,2286,1179,1107,106.5
'31260, 양주시,'035005, 34세,2019,2684,1461,1223,119.5,2312,1178,1134,103.9
'31260, 양주시,'040,35~39세,2019,17094,9057,8037,112.7,15566,7919,7647,103.6
'31260, 양주시,'040001, 35세,2019,2887,1558,1329,117.2,2534,1283,1251,102.6
'31260, 양주시,'040002, 36세,2019,3244,1799,1445,124.5,2918,1565,1353,115.7
'31260, 양주시,'040003, 37세,2019,3477,1806,1671,108.1,3180,1589,1591,99.9
'31260, 양주시,'040004, 38세,2019,3630,1875,1755,106.8,3362,1681,1681,100
'31260, 양주시,'040005, 39세,2019,3856,2019,1837,109.9,3572,1801,1771,101.7
'31260, 양주시,'045,40~44세,2019,17875,9201,8674,106.1,16867,8511,8356,101.9
'31260, 양주시,'045001, 40세,2019,3536,1809,1727,104.7,3287,1637,1650,99.2
'31260, 양주시,'045002, 41세,2019,3431,1766,1665,106.1,3224,1621,1603,101.1
'31260, 양주시,'045003, 42세,2019,3459,1764,1695,104.1,3260,1631,1629,100.1
'31260, 양주시,'045004, 43세,2019,3618,1863,1755,106.2,3420,1730,1690,102.4
'31260, 양주시,'045005, 44세,2019,3831,1999,1832,109.1,3676,1892,1784,106.1
'31260, 양주시,'050,45~49세,2019,20839,10925,9914,110.2,20065,10415,9650,107.9
'31260, 양주시,'050001, 45세,2019,4136,2134,2002,106.6,3963,2018,1945,103.8
'31260, 양주시,'050002, 46세,2019,4302,2261,2041,110.8,4146,2168,1978,109.6
'31260, 양주시,'050003, 47세,2019,4129,2216,1913,115.8,3975,2114,1861,113.6
'31260, 양주시,'050004, 48세,2019,4242,2230,2012,110.8,4107,2142,1965,109
'31260, 양주시,'050005, 49세,2019,4030,2084,1946,107.1,3874,1973,1901,103.8
'31260, 양주시,'055,50~54세,2019,18735,9816,8919,110.1,18132,9421,8711,108.2
'31260, 양주시,'055001, 50세,2019,4087,2096,1991,105.3,3929,1988,1941,102.4
'31260, 양주시,'055002, 51세,2019,3919,2051,1868,109.8,3792,1966,1826,107.7
'31260, 양주시,'055003, 52세,2019,3556,1888,1668,113.2,3440,1809,1631,110.9
'31260, 양주시,'055004, 53세,2019,3586,1873,1713,109.3,3478,1805,1673,107.9
'31260, 양주시,'055005, 54세,2019,3587,1908,1679,113.6,3493,1853,1640,113
'31260, 양주시,'060,55~59세,2019,17639,9185,8454,108.6,17256,8954,8302,107.9
'31260, 양주시,'060001, 55세,2019,3277,1778,1499,118.6,3191,1722,1469,117.2
'31260, 양주시,'060002, 56세,2019,3495,1817,1678,108.3,3398,1761,1637,107.6
'31260, 양주시,'060003, 57세,2019,3464,1835,1629,112.6,3401,1803,1598,112.8
'31260, 양주시,'060004, 58세,2019,3673,1862,1811,102.8,3615,1826,1789,102.1
'31260, 양주시,'060005, 59세,2019,3730,1893,1837,103,3651,1842,1809,101.8
'31260, 양주시,'065,60~64세,2019,15497,7794,7703,101.2,15240,7660,7580,101.1
'31260, 양주시,'065001, 60세,2019,3319,1709,1610,106.1,3260,1677,1583,105.9
'31260, 양주시,'065002, 61세,2019,3158,1601,1557,102.8,3101,1566,1535,102
'31260, 양주시,'065003, 62세,2019,3223,1604,1619,99.1,3174,1581,1593,99.2
'31260, 양주시,'065004, 63세,2019,2846,1442,1404,102.7,2799,1422,1377,103.3
'31260, 양주시,'065005, 64세,2019,2951,1438,1513,95,2906,1414,1492,94.8
'31260, 양주시,'070,65~69세,2019,10040,4843,5197,93.2,9918,4784,5134,93.2
'31260, 양주시,'070001, 65세,2019,2473,1242,1231,100.9,2436,1228,1208,101.7
'31260, 양주시,'070002, 66세,2019,2088,996,1092,91.2,2058,981,1077,91.1
'31260, 양주시,'070003, 67세,2019,2220,1062,1158,91.7,2198,1048,1150,91.1
'31260, 양주시,'070004, 68세,2019,1525,734,791,92.8,1509,725,784,92.5
'31260, 양주시,'070005, 69세,2019,1734,809,925,87.5,1717,802,915,87.7
'31260, 양주시,'075,70~74세,2019,8614,4110,4504,91.3,8536,4075,4461,91.3
'31260, 양주시,'075001, 70세,2019,1844,862,982,87.8,1816,845,971,87
'31260, 양주시,'075002, 71세,2019,1855,896,959,93.4,1844,896,948,94.5
'31260, 양주시,'075003, 72세,2019,1930,933,997,93.6,1913,925,988,93.6
'31260, 양주시,'075004, 73세,2019,1481,700,781,89.6,1469,695,774,89.8
'31260, 양주시,'075005, 74세,2019,1504,719,785,91.6,1494,714,780,91.5
'31260, 양주시,'080,75~79세,2019,6981,3065,3916,78.3,6955,3050,3905,78.1
'31260, 양주시,'080001, 75세,2019,1440,638,802,79.6,1435,635,800,79.4
'31260, 양주시,'080002, 76세,2019,1426,652,774,84.2,1421,649,772,84.1
'31260, 양주시,'080003, 77세,2019,1661,731,930,78.6,1655,728,927,78.5
'31260, 양주시,'080004, 78세,2019,1329,553,776,71.3,1323,548,775,70.7
'31260, 양주시,'080005, 79세,2019,1125,491,634,77.4,1121,490,631,77.7
'31260, 양주시,'085,80~84세,2019,4754,1861,2893,64.3,4731,1852,2879,64.3
'31260, 양주시,'085001, 80세,2019,1128,459,669,68.6,1120,454,666,68.2
'31260, 양주시,'085002, 81세,2019,1052,418,634,65.9,1047,417,630,66.2
'31260, 양주시,'085003, 82세,2019,960,389,571,68.1,954,387,567,68.3
'31260, 양주시,'085004, 83세,2019,813,308,505,61,810,307,503,61
'31260, 양주시,'085005, 84세,2019,801,287,514,55.8,800,287,513,55.9
'31260, 양주시,'086,85세이상,2019,3487,968,2519,38.4,3478,966,2512,38.5
'31260, 양주시,'090,85~89세,2019,2314,710,1604,44.3,2308,709,1599,44.3
'31260, 양주시,'090001, 85세,2019,633,215,418,51.4,630,215,415,51.8
'31260, 양주시,'090002, 86세,2019,539,172,367,46.9,536,171,365,46.8
'31260, 양주시,'090003, 87세,2019,467,157,310,50.6,467,157,310,50.6
'31260, 양주시,'090004, 88세,2019,360,92,268,34.3,360,92,268,34.3
'31260, 양주시,'090005, 89세,2019,315,74,241,30.7,315,74,241,30.7
'31260, 양주시,'095,90~94세,2019,887,206,681,30.2,886,206,680,30.3
'31260, 양주시,'095001, 90세,2019,276,62,214,29,276,62,214,29
'31260, 양주시,'095002, 91세,2019,237,62,175,35.4,237,62,175,35.4
'31260, 양주시,'095003, 92세,2019,161,37,124,29.8,160,37,123,30.1
'31260, 양주시,'095004, 93세,2019,117,22,95,23.2,117,22,95,23.2
'31260, 양주시,'095005, 94세,2019,96,23,73,31.5,96,23,73,31.5
'31260, 양주시,'100,95~99세,2019,249,48,201,23.9,247,47,200,23.5
'31260, 양주시,'100001, 95세,2019,88,21,67,31.3,86,20,66,30.3
'31260, 양주시,'100002, 96세,2019,62,12,50,24,62,12,50,24
'31260, 양주시,'100003, 97세,2019,46,10,36,27.8,46,10,36,27.8
'31260, 양주시,'100004, 98세,2019,35,X,31,12.9,35,X,31,12.9
'31260, 양주시,'100005, 99세,2019,18,X,17,5.9,18,X,17,5.9
'31260, 양주시,'101,100세이상,2019,37,X,33,12.1,37,X,33,12.1
'31260, 양주시,'102,15세미만,2019,30971,15867,15104,105.1,30711,15723,14988,104.9
'31260, 양주시,'103,15~64세,2019,159837,84827,75010,113.1,149579,77258,72321,106.8
'31260, 양주시,'104,65세이상,2019,33876,14847,19029,78,33618,14727,18891,78
'31260, 양주시,'126,평균연령,2019,42.1,41.1,43.3,,42.5,41.5,43.4,
'31260, 양주시,'127,중위연령,2019,43.5,42.2,44.7,,44.3,43.5,45,
'31270, 포천시,'000,합계,2019,159871,87476,72395,120.8,140938,73405,67533,108.7
'31270, 포천시,'005,0~4세,2019,4170,2166,2004,108.1,4074,2127,1947,109.2
'31270, 포천시,'005001, 0세,2019,627,320,307,104.2,616,314,302,104
'31270, 포천시,'005002, 1세,2019,772,384,388,99,747,372,375,99.2
'31270, 포천시,'005003, 2세,2019,839,450,389,115.7,823,446,377,118.3
'31270, 포천시,'005004, 3세,2019,945,506,439,115.3,920,494,426,116
'31270, 포천시,'005005, 4세,2019,987,506,481,105.2,968,501,467,107.3
'31270, 포천시,'010,5~9세,2019,5221,2706,2515,107.6,5141,2664,2477,107.5
'31270, 포천시,'010001, 5세,2019,936,477,459,103.9,923,468,455,102.9
'31270, 포천시,'010002, 6세,2019,989,510,479,106.5,970,500,470,106.4
'31270, 포천시,'010003, 7세,2019,1126,566,560,101.1,1110,560,550,101.8
'31270, 포천시,'010004, 8세,2019,1089,597,492,121.3,1071,586,485,120.8
'31270, 포천시,'010005, 9세,2019,1081,556,525,105.9,1067,550,517,106.4
'31270, 포천시,'015,10~14세,2019,5650,2966,2684,110.5,5604,2946,2658,110.8
'31270, 포천시,'015001, 10세,2019,1097,555,542,102.4,1084,550,534,103
'31270, 포천시,'015002, 11세,2019,1146,604,542,111.4,1136,600,536,111.9
'31270, 포천시,'015003, 12세,2019,1177,647,530,122.1,1172,644,528,122
'31270, 포천시,'015004, 13세,2019,1137,581,556,104.5,1128,577,551,104.7
'31270, 포천시,'015005, 14세,2019,1093,579,514,112.6,1084,575,509,113
'31270, 포천시,'020,15~19세,2019,7198,3781,3417,110.7,6937,3632,3305,109.9
'31270, 포천시,'020001, 15세,2019,1123,591,532,111.1,1112,585,527,111
'31270, 포천시,'020002, 16세,2019,1345,675,670,100.7,1329,667,662,100.8
'31270, 포천시,'020003, 17세,2019,1390,758,632,119.9,1369,742,627,118.3
'31270, 포천시,'020004, 18세,2019,1587,844,743,113.6,1527,813,714,113.9
'31270, 포천시,'020005, 19세,2019,1753,913,840,108.7,1600,825,775,106.5
'31270, 포천시,'025,20~24세,2019,11664,6963,4701,148.1,9081,4984,4097,121.6
'31270, 포천시,'025001, 20세,2019,2064,1122,942,119.1,1829,962,867,111
'31270, 포천시,'025002, 21세,2019,2211,1289,922,139.8,1858,1041,817,127.4
'31270, 포천시,'025003, 22세,2019,2320,1343,977,137.5,1765,926,839,110.4
'31270, 포천시,'025004, 23세,2019,2487,1547,940,164.6,1822,1021,801,127.5
'31270, 포천시,'025005, 24세,2019,2582,1662,920,180.7,1807,1034,773,133.8
'31270, 포천시,'030,25~29세,2019,12969,8498,4471,190.1,8490,4938,3552,139
'31270, 포천시,'030001, 25세,2019,2597,1672,925,180.8,1805,1044,761,137.2
'31270, 포천시,'030002, 26세,2019,2632,1737,895,194.1,1740,1030,710,145.1
'31270, 포천시,'030003, 27세,2019,2655,1753,902,194.3,1747,1034,713,145
'31270, 포천시,'030004, 28세,2019,2606,1753,853,205.5,1656,976,680,143.5
'31270, 포천시,'030005, 29세,2019,2479,1583,896,176.7,1542,854,688,124.1
'31270, 포천시,'035,30~34세,2019,10687,6889,3798,181.4,6744,3749,2995,125.2
'31270, 포천시,'035001, 30세,2019,2257,1476,781,189,1385,773,612,126.3
'31270, 포천시,'035002, 31세,2019,2229,1436,793,181.1,1420,792,628,126.1
'31270, 포천시,'035003, 32세,2019,2101,1371,730,187.8,1285,724,561,129.1
'31270, 포천시,'035004, 33세,2019,2093,1353,740,182.8,1335,763,572,133.4
'31270, 포천시,'035005, 34세,2019,2007,1253,754,166.2,1319,697,622,112.1
'31270, 포천시,'040,35~39세,2019,10218,6139,4079,150.5,7667,4182,3485,120
'31270, 포천시,'040001, 35세,2019,1941,1219,722,168.8,1329,749,580,129.1
'31270, 포천시,'040002, 36세,2019,2024,1222,802,152.4,1482,804,678,118.6
'31270, 포천시,'040003, 37세,2019,2068,1253,815,153.7,1534,845,689,122.6
'31270, 포천시,'040004, 38세,2019,2069,1215,854,142.3,1624,871,753,115.7
'31270, 포천시,'040005, 39세,2019,2116,1230,886,138.8,1698,913,785,116.3
'31270, 포천시,'045,40~44세,2019,10319,5731,4588,124.9,8618,4501,4117,109.3
'31270, 포천시,'045001, 40세,2019,2066,1173,893,131.4,1630,847,783,108.2
'31270, 포천시,'045002, 41세,2019,2004,1104,900,122.7,1649,845,804,105.1
'31270, 포천시,'045003, 42세,2019,2035,1131,904,125.1,1733,917,816,112.4
'31270, 포천시,'045004, 43세,2019,2045,1146,899,127.5,1720,906,814,111.3
'31270, 포천시,'045005, 44세,2019,2169,1177,992,118.6,1886,986,900,109.6
'31270, 포천시,'050,45~49세,2019,12706,6964,5742,121.3,11551,6194,5357,115.6
'31270, 포천시,'050001, 45세,2019,2427,1337,1090,122.7,2172,1160,1012,114.6
'31270, 포천시,'050002, 46세,2019,2428,1303,1125,115.8,2202,1154,1048,110.1
'31270, 포천시,'050003, 47세,2019,2576,1435,1141,125.8,2315,1253,1062,118
'31270, 포천시,'050004, 48세,2019,2746,1519,1227,123.8,2535,1378,1157,119.1
'31270, 포천시,'050005, 49세,2019,2529,1370,1159,118.2,2327,1249,1078,115.9
'31270, 포천시,'055,50~54세,2019,14209,7696,6513,118.2,13375,7201,6174,116.6
'31270, 포천시,'055001, 50세,2019,2724,1464,1260,116.2,2567,1365,1202,113.6
'31270, 포천시,'055002, 51세,2019,2974,1596,1378,115.8,2774,1479,1295,114.2
'31270, 포천시,'055003, 52세,2019,2663,1414,1249,113.2,2503,1321,1182,111.8
'31270, 포천시,'055004, 53세,2019,2864,1584,1280,123.8,2701,1485,1216,122.1
'31270, 포천시,'055005, 54세,2019,2984,1638,1346,121.7,2830,1551,1279,121.3
'31270, 포천시,'060,55~59세,2019,14975,8162,6813,119.8,14364,7788,6576,118.4
'31270, 포천시,'060001, 55세,2019,2710,1496,1214,123.2,2567,1396,1171,119.2
'31270, 포천시,'060002, 56세,2019,2957,1641,1316,124.7,2794,1547,1247,124.1
'31270, 포천시,'060003, 57세,2019,2865,1547,1318,117.4,2748,1480,1268,116.7
'31270, 포천시,'060004, 58세,2019,3212,1728,1484,116.4,3124,1673,1451,115.3
'31270, 포천시,'060005, 59세,2019,3231,1750,1481,118.2,3131,1692,1439,117.6
'31270, 포천시,'065,60~64세,2019,13278,7142,6136,116.4,12959,6965,5994,116.2
'31270, 포천시,'065001, 60세,2019,2974,1552,1422,109.1,2887,1505,1382,108.9
'31270, 포천시,'065002, 61세,2019,2892,1556,1336,116.5,2817,1512,1305,115.9
'31270, 포천시,'065003, 62세,2019,2681,1447,1234,117.3,2617,1412,1205,117.2
'31270, 포천시,'065004, 63세,2019,2397,1310,1087,120.5,2348,1284,1064,120.7
'31270, 포천시,'065005, 64세,2019,2334,1277,1057,120.8,2290,1252,1038,120.6
'31270, 포천시,'070,65~69세,2019,7658,3925,3733,105.1,7500,3836,3664,104.7
'31270, 포천시,'070001, 65세,2019,1958,1002,956,104.8,1912,979,933,104.9
'31270, 포천시,'070002, 66세,2019,1655,853,802,106.4,1609,829,780,106.3
'31270, 포천시,'070003, 67세,2019,1696,880,816,107.8,1666,861,805,107
'31270, 포천시,'070004, 68세,2019,1076,571,505,113.1,1053,557,496,112.3
'31270, 포천시,'070005, 69세,2019,1273,619,654,94.6,1260,610,650,93.8
'31270, 포천시,'075,70~74세,2019,6469,3087,3382,91.3,6416,3061,3355,91.2
'31270, 포천시,'075001, 70세,2019,1447,734,713,102.9,1434,730,704,103.7
'31270, 포천시,'075002, 71세,2019,1345,679,666,102,1329,668,661,101.1
'31270, 포천시,'075003, 72세,2019,1438,640,798,80.2,1429,636,793,80.2
'31270, 포천시,'075004, 73세,2019,1119,521,598,87.1,1109,515,594,86.7
'31270, 포천시,'075005, 74세,2019,1120,513,607,84.5,1115,512,603,84.9
'31270, 포천시,'080,75~79세,2019,5512,2315,3197,72.4,5478,2301,3177,72.4
'31270, 포천시,'080001, 75세,2019,1043,468,575,81.4,1034,463,571,81.1
'31270, 포천시,'080002, 76세,2019,1068,451,617,73.1,1058,446,612,72.9
'31270, 포천시,'080003, 77세,2019,1260,515,745,69.1,1252,513,739,69.4
'31270, 포천시,'080004, 78세,2019,1097,460,637,72.2,1091,458,633,72.4
'31270, 포천시,'080005, 79세,2019,1044,421,623,67.6,1043,421,622,67.7
'31270, 포천시,'085,80~84세,2019,4110,1540,2570,59.9,4089,1533,2556,60
'31270, 포천시,'085001, 80세,2019,1013,402,611,65.8,1009,401,608,66
'31270, 포천시,'085002, 81세,2019,879,325,554,58.7,876,324,552,58.7
'31270, 포천시,'085003, 82세,2019,814,315,499,63.1,808,312,496,62.9
'31270, 포천시,'085004, 83세,2019,699,257,442,58.1,695,256,439,58.3
'31270, 포천시,'085005, 84세,2019,705,241,464,51.9,701,240,461,52.1
'31270, 포천시,'086,85세이상,2019,2858,806,2052,39.3,2850,803,2047,39.2
'31270, 포천시,'090,85~89세,2019,1900,589,1311,44.9,1896,588,1308,45
'31270, 포천시,'090001, 85세,2019,547,192,355,54.1,545,191,354,54
'31270, 포천시,'090002, 86세,2019,439,139,300,46.3,439,139,300,46.3
'31270, 포천시,'090003, 87세,2019,360,104,256,40.6,360,104,256,40.6
'31270, 포천시,'090004, 88세,2019,279,93,186,50,277,93,184,50.5
'31270, 포천시,'090005, 89세,2019,275,61,214,28.5,275,61,214,28.5
'31270, 포천시,'095,90~94세,2019,726,155,571,27.1,723,154,569,27.1
'31270, 포천시,'095001, 90세,2019,251,60,191,31.4,250,59,191,30.9
'31270, 포천시,'095002, 91세,2019,161,31,130,23.8,161,31,130,23.8
'31270, 포천시,'095003, 92세,2019,124,24,100,24,124,24,100,24
'31270, 포천시,'095004, 93세,2019,99,20,79,25.3,99,20,79,25.3
'31270, 포천시,'095005, 94세,2019,91,20,71,28.2,89,20,69,29
'31270, 포천시,'100,95~99세,2019,206,56,150,37.3,206,56,150,37.3
'31270, 포천시,'100001, 95세,2019,59,17,42,40.5,59,17,42,40.5
'31270, 포천시,'100002, 96세,2019,63,12,51,23.5,63,12,51,23.5
'31270, 포천시,'100003, 97세,2019,36,13,23,56.5,36,13,23,56.5
'31270, 포천시,'100004, 98세,2019,29,5,24,20.8,29,5,24,20.8
'31270, 포천시,'100005, 99세,2019,19,9,10,90,19,9,10,90
'31270, 포천시,'101,100세이상,2019,26,6,20,30,25,5,20,25
'31270, 포천시,'102,15세미만,2019,15041,7838,7203,108.8,14819,7737,7082,109.2
'31270, 포천시,'103,15~64세,2019,118223,67965,50258,135.2,99786,54134,45652,118.6
'31270, 포천시,'104,65세이상,2019,26607,11673,14934,78.2,26333,11534,14799,77.9
'31270, 포천시,'126,평균연령,2019,44.3,42.7,46.2,,45.6,44.4,46.9,
'31270, 포천시,'127,중위연령,2019,45.8,43.2,48.5,,48.6,47.5,49.8,
'31280, 여주시,'000,합계,2019,111981,57249,54732,104.6,106631,53999,52632,102.6
'31280, 여주시,'005,0~4세,2019,3364,1743,1621,107.5,3326,1725,1601,107.7
'31280, 여주시,'005001, 0세,2019,601,299,302,99,595,297,298,99.7
'31280, 여주시,'005002, 1세,2019,607,324,283,114.5,597,318,279,114
'31280, 여주시,'005003, 2세,2019,626,320,306,104.6,622,317,305,103.9
'31280, 여주시,'005004, 3세,2019,739,375,364,103,731,371,360,103.1
'31280, 여주시,'005005, 4세,2019,791,425,366,116.1,781,422,359,117.5
'31280, 여주시,'010,5~9세,2019,4298,2250,2048,109.9,4271,2237,2034,110
'31280, 여주시,'010001, 5세,2019,791,407,384,106,784,404,380,106.3
'31280, 여주시,'010002, 6세,2019,823,459,364,126.1,818,458,360,127.2
'31280, 여주시,'010003, 7세,2019,881,469,412,113.8,877,467,410,113.9
'31280, 여주시,'010004, 8세,2019,940,482,458,105.2,933,476,457,104.2
'31280, 여주시,'010005, 9세,2019,863,433,430,100.7,859,432,427,101.2
'31280, 여주시,'015,10~14세,2019,4474,2325,2149,108.2,4461,2323,2138,108.7
'31280, 여주시,'015001, 10세,2019,900,484,416,116.3,898,484,414,116.9
'31280, 여주시,'015002, 11세,2019,859,466,393,118.6,856,465,391,118.9
'31280, 여주시,'015003, 12세,2019,960,473,487,97.1,959,473,486,97.3
'31280, 여주시,'015004, 13세,2019,863,436,427,102.1,859,436,423,103.1
'31280, 여주시,'015005, 14세,2019,892,466,426,109.4,889,465,424,109.7
'31280, 여주시,'020,15~19세,2019,5550,2852,2698,105.7,5509,2832,2677,105.8
'31280, 여주시,'020001, 15세,2019,984,530,454,116.7,984,530,454,116.7
'31280, 여주시,'020002, 16세,2019,1028,500,528,94.7,1022,498,524,95
'31280, 여주시,'020003, 17세,2019,1048,536,512,104.7,1043,533,510,104.5
'31280, 여주시,'020004, 18세,2019,1176,601,575,104.5,1166,595,571,104.2
'31280, 여주시,'020005, 19세,2019,1314,685,629,108.9,1294,676,618,109.4
'31280, 여주시,'025,20~24세,2019,6667,3669,2998,122.4,5885,3180,2705,117.6
'31280, 여주시,'025001, 20세,2019,1297,718,579,124,1243,685,558,122.8
'31280, 여주시,'025002, 21세,2019,1404,775,629,123.2,1245,679,566,120
'31280, 여주시,'025003, 22세,2019,1323,722,601,120.1,1166,624,542,115.1
'31280, 여주시,'025004, 23세,2019,1255,667,588,113.4,1059,549,510,107.6
'31280, 여주시,'025005, 24세,2019,1388,787,601,130.9,1172,643,529,121.6
'31280, 여주시,'030,25~29세,2019,6830,3896,2934,132.8,5604,3087,2517,122.6
'31280, 여주시,'030001, 25세,2019,1394,793,601,131.9,1150,641,509,125.9
'31280, 여주시,'030002, 26세,2019,1392,778,614,126.7,1142,620,522,118.8
'31280, 여주시,'030003, 27세,2019,1426,817,609,134.2,1162,643,519,123.9
'31280, 여주시,'030004, 28세,2019,1363,790,573,137.9,1122,627,495,126.7
'31280, 여주시,'030005, 29세,2019,1255,718,537,133.7,1028,556,472,117.8
'31280, 여주시,'035,30~34세,2019,6000,3366,2634,127.8,4914,2666,2248,118.6
'31280, 여주시,'035001, 30세,2019,1258,761,497,153.1,1016,596,420,141.9
'31280, 여주시,'035002, 31세,2019,1190,652,538,121.2,968,513,455,112.7
'31280, 여주시,'035003, 32세,2019,1119,632,487,129.8,910,497,413,120.3
'31280, 여주시,'035004, 33세,2019,1237,697,540,129.1,1021,555,466,119.1
'31280, 여주시,'035005, 34세,2019,1196,624,572,109.1,999,505,494,102.2
'31280, 여주시,'040,35~39세,2019,7288,3806,3482,109.3,6623,3386,3237,104.6
'31280, 여주시,'040001, 35세,2019,1292,719,573,125.5,1120,597,523,114.1
'31280, 여주시,'040002, 36세,2019,1313,663,650,102,1166,574,592,97
'31280, 여주시,'040003, 37세,2019,1521,777,744,104.4,1389,690,699,98.7
'31280, 여주시,'040004, 38세,2019,1546,801,745,107.5,1438,740,698,106
'31280, 여주시,'040005, 39세,2019,1616,846,770,109.9,1510,785,725,108.3
'31280, 여주시,'045,40~44세,2019,7317,3733,3584,104.2,6930,3519,3411,103.2
'31280, 여주시,'045001, 40세,2019,1508,759,749,101.3,1409,705,704,100.1
'31280, 여주시,'045002, 41세,2019,1397,721,676,106.7,1322,679,643,105.6
'31280, 여주시,'045003, 42세,2019,1472,767,705,108.8,1387,723,664,108.9
'31280, 여주시,'045004, 43세,2019,1428,715,713,100.3,1366,676,690,98
'31280, 여주시,'045005, 44세,2019,1512,771,741,104,1446,736,710,103.7
'31280, 여주시,'050,45~49세,2019,8739,4621,4118,112.2,8418,4447,3971,112
'31280, 여주시,'050001, 45세,2019,1696,874,822,106.3,1625,838,787,106.5
'31280, 여주시,'050002, 46세,2019,1750,901,849,106.1,1679,861,818,105.3
'31280, 여주시,'050003, 47세,2019,1651,895,756,118.4,1606,870,736,118.2
'31280, 여주시,'050004, 48세,2019,1851,970,881,110.1,1780,935,845,110.7
'31280, 여주시,'050005, 49세,2019,1791,981,810,121.1,1728,943,785,120.1
'31280, 여주시,'055,50~54세,2019,9465,4988,4477,111.4,9178,4836,4342,111.4
'31280, 여주시,'055001, 50세,2019,1973,1030,943,109.2,1913,997,916,108.8
'31280, 여주시,'055002, 51세,2019,1884,993,891,111.4,1828,962,866,111.1
'31280, 여주시,'055003, 52세,2019,1839,946,893,105.9,1772,913,859,106.3
'31280, 여주시,'055004, 53세,2019,1823,984,839,117.3,1776,961,815,117.9
'31280, 여주시,'055005, 54세,2019,1946,1035,911,113.6,1889,1003,886,113.2
'31280, 여주시,'060,55~59세,2019,10210,5276,4934,106.9,10002,5177,4825,107.3
'31280, 여주시,'060001, 55세,2019,1828,954,874,109.2,1792,940,852,110.3
'31280, 여주시,'060002, 56세,2019,1907,997,910,109.6,1853,970,883,109.9
'31280, 여주시,'060003, 57세,2019,1999,1038,961,108,1956,1014,942,107.6
'31280, 여주시,'060004, 58세,2019,2262,1159,1103,105.1,2220,1139,1081,105.4
'31280, 여주시,'060005, 59세,2019,2214,1128,1086,103.9,2181,1114,1067,104.4
'31280, 여주시,'065,60~64세,2019,9475,4816,4659,103.4,9339,4738,4601,103
'31280, 여주시,'065001, 60세,2019,1961,1012,949,106.6,1931,1000,931,107.4
'31280, 여주시,'065002, 61세,2019,1962,1000,962,104,1933,984,949,103.7
'31280, 여주시,'065003, 62세,2019,1874,932,942,98.9,1845,913,932,98
'31280, 여주시,'065004, 63세,2019,1842,948,894,106,1822,936,886,105.6
'31280, 여주시,'065005, 64세,2019,1836,924,912,101.3,1808,905,903,100.2
'31280, 여주시,'070,65~69세,2019,6731,3396,3335,101.8,6668,3366,3302,101.9
'31280, 여주시,'070001, 65세,2019,1554,753,801,94,1533,740,793,93.3
'31280, 여주시,'070002, 66세,2019,1398,710,688,103.2,1386,704,682,103.2
'31280, 여주시,'070003, 67세,2019,1751,912,839,108.7,1740,909,831,109.4
'31280, 여주시,'070004, 68세,2019,1035,533,502,106.2,1023,529,494,107.1
'31280, 여주시,'070005, 69세,2019,993,488,505,96.6,986,484,502,96.4
'31280, 여주시,'075,70~74세,2019,5093,2514,2579,97.5,5055,2496,2559,97.5
'31280, 여주시,'075001, 70세,2019,1066,525,541,97,1057,521,536,97.2
'31280, 여주시,'075002, 71세,2019,1080,559,521,107.3,1068,552,516,107
'31280, 여주시,'075003, 72세,2019,1151,582,569,102.3,1141,576,565,101.9
'31280, 여주시,'075004, 73세,2019,883,429,454,94.5,877,428,449,95.3
'31280, 여주시,'075005, 74세,2019,913,419,494,84.8,912,419,493,85
'31280, 여주시,'080,75~79세,2019,4665,2020,2645,76.4,4644,2010,2634,76.3
'31280, 여주시,'080001, 75세,2019,909,390,519,75.1,903,388,515,75.3
'31280, 여주시,'080002, 76세,2019,883,402,481,83.6,879,401,478,83.9
'31280, 여주시,'080003, 77세,2019,1103,487,616,79.1,1099,484,615,78.7
'31280, 여주시,'080004, 78세,2019,988,429,559,76.7,984,425,559,76
'31280, 여주시,'080005, 79세,2019,782,312,470,66.4,779,312,467,66.8
'31280, 여주시,'085,80~84세,2019,3390,1307,2083,62.7,3385,1305,2080,62.7
'31280, 여주시,'085001, 80세,2019,806,327,479,68.3,803,326,477,68.3
'31280, 여주시,'085002, 81세,2019,739,298,441,67.6,739,298,441,67.6
'31280, 여주시,'085003, 82세,2019,688,272,416,65.4,688,272,416,65.4
'31280, 여주시,'085004, 83세,2019,616,215,401,53.6,614,214,400,53.5
'31280, 여주시,'085005, 84세,2019,541,195,346,56.4,541,195,346,56.4
'31280, 여주시,'086,85세이상,2019,2425,671,1754,38.3,2419,669,1750,38.2
'31280, 여주시,'090,85~89세,2019,1684,518,1166,44.4,1678,516,1162,44.4
'31280, 여주시,'090001, 85세,2019,478,172,306,56.2,474,171,303,56.4
'31280, 여주시,'090002, 86세,2019,382,108,274,39.4,382,108,274,39.4
'31280, 여주시,'090003, 87세,2019,307,92,215,42.8,307,92,215,42.8
'31280, 여주시,'090004, 88세,2019,276,83,193,43,274,82,192,42.7
'31280, 여주시,'090005, 89세,2019,241,63,178,35.4,241,63,178,35.4
'31280, 여주시,'095,90~94세,2019,580,123,457,26.9,580,123,457,26.9
'31280, 여주시,'095001, 90세,2019,183,42,141,29.8,183,42,141,29.8
'31280, 여주시,'095002, 91세,2019,152,39,113,34.5,152,39,113,34.5
'31280, 여주시,'095003, 92세,2019,102,20,82,24.4,102,20,82,24.4
'31280, 여주시,'095004, 93세,2019,85,13,72,18.1,85,13,72,18.1
'31280, 여주시,'095005, 94세,2019,58,9,49,18.4,58,9,49,18.4
'31280, 여주시,'100,95~99세,2019,153,29,124,23.4,153,29,124,23.4
'31280, 여주시,'100001, 95세,2019,46,11,35,31.4,46,11,35,31.4
'31280, 여주시,'100002, 96세,2019,40,7,33,21.2,40,7,33,21.2
'31280, 여주시,'100003, 97세,2019,30,5,25,20,30,5,25,20
'31280, 여주시,'100004, 98세,2019,25,X,21,19,25,X,21,19
'31280, 여주시,'100005, 99세,2019,12,X,10,20,12,X,10,20
'31280, 여주시,'101,100세이상,2019,8,X,7,14.3,8,X,7,14.3
'31280, 여주시,'102,15세미만,2019,12136,6318,5818,108.6,12058,6285,5773,108.9
'31280, 여주시,'103,15~64세,2019,77541,41023,36518,112.3,72402,37868,34534,109.7
'31280, 여주시,'104,65세이상,2019,22304,9908,12396,79.9,22171,9846,12325,79.9
'31280, 여주시,'126,평균연령,2019,45.4,44,46.8,,45.9,44.6,47.2,
'31280, 여주시,'127,중위연령,2019,47.5,46.1,48.9,,48.5,47.4,49.7,
'31350, 연천군,'000,합계,2019,42540,22578,19962,113.1,41111,21565,19546,110.3
'31350, 연천군,'005,0~4세,2019,1429,739,690,107.1,1426,737,689,107
'31350, 연천군,'005001, 0세,2019,265,129,136,94.9,265,129,136,94.9
'31350, 연천군,'005002, 1세,2019,287,146,141,103.5,286,146,140,104.3
'31350, 연천군,'005003, 2세,2019,256,151,105,143.8,256,151,105,143.8
'31350, 연천군,'005004, 3세,2019,318,165,153,107.8,317,164,153,107.2
'31350, 연천군,'005005, 4세,2019,303,148,155,95.5,302,147,155,94.8
'31350, 연천군,'010,5~9세,2019,1484,762,722,105.5,1479,759,720,105.4
'31350, 연천군,'010001, 5세,2019,296,139,157,88.5,296,139,157,88.5
'31350, 연천군,'010002, 6세,2019,317,163,154,105.8,315,162,153,105.9
'31350, 연천군,'010003, 7세,2019,283,156,127,122.8,283,156,127,122.8
'31350, 연천군,'010004, 8세,2019,292,150,142,105.6,289,148,141,105
'31350, 연천군,'010005, 9세,2019,296,154,142,108.5,296,154,142,108.5
'31350, 연천군,'015,10~14세,2019,1429,759,670,113.3,1427,759,668,113.6
'31350, 연천군,'015001, 10세,2019,283,143,140,102.1,283,143,140,102.1
'31350, 연천군,'015002, 11세,2019,288,153,135,113.3,288,153,135,113.3
'31350, 연천군,'015003, 12세,2019,286,148,138,107.2,285,148,137,108
'31350, 연천군,'015004, 13세,2019,274,161,113,142.5,273,161,112,143.8
'31350, 연천군,'015005, 14세,2019,298,154,144,106.9,298,154,144,106.9
'31350, 연천군,'020,15~19세,2019,1649,920,729,126.2,1630,905,725,124.8
'31350, 연천군,'020001, 15세,2019,293,159,134,118.7,292,158,134,117.9
'31350, 연천군,'020002, 16세,2019,297,161,136,118.4,296,160,136,117.6
'31350, 연천군,'020003, 17세,2019,385,212,173,122.5,383,210,173,121.4
'31350, 연천군,'020004, 18세,2019,409,233,176,132.4,404,230,174,132.2
'31350, 연천군,'020005, 19세,2019,265,155,110,140.9,255,147,108,136.1
'31350, 연천군,'025,20~24세,2019,2272,1513,759,199.3,2082,1351,731,184.8
'31350, 연천군,'025001, 20세,2019,315,205,110,186.4,303,195,108,180.6
'31350, 연천군,'025002, 21세,2019,349,225,124,181.5,325,203,122,166.4
'31350, 연천군,'025003, 22세,2019,442,279,163,171.2,414,253,161,157.1
'31350, 연천군,'025004, 23세,2019,537,359,178,201.7,491,321,170,188.8
'31350, 연천군,'025005, 24세,2019,629,445,184,241.8,549,379,170,222.9
'31350, 연천군,'030,25~29세,2019,3094,2058,1036,198.6,2757,1789,968,184.8
'31350, 연천군,'030001, 25세,2019,644,444,200,222,580,390,190,205.3
'31350, 연천군,'030002, 26세,2019,637,420,217,193.5,575,375,200,187.5
'31350, 연천군,'030003, 27세,2019,668,445,223,199.6,607,392,215,182.3
'31350, 연천군,'030004, 28세,2019,621,406,215,188.8,534,341,193,176.7
'31350, 연천군,'030005, 29세,2019,524,343,181,189.5,461,291,170,171.2
'31350, 연천군,'035,30~34세,2019,2259,1348,911,148,2018,1181,837,141.1
'31350, 연천군,'035001, 30세,2019,497,321,176,182.4,440,283,157,180.3
'31350, 연천군,'035002, 31세,2019,477,287,190,151.1,430,255,175,145.7
'31350, 연천군,'035003, 32세,2019,455,249,206,120.9,403,212,191,111
'31350, 연천군,'035004, 33세,2019,432,269,163,165,388,234,154,151.9
'31350, 연천군,'035005, 34세,2019,398,222,176,126.1,357,197,160,123.1
'31350, 연천군,'040,35~39세,2019,2285,1266,1019,124.2,2125,1156,969,119.3
'31350, 연천군,'040001, 35세,2019,428,253,175,144.6,397,230,167,137.7
'31350, 연천군,'040002, 36세,2019,433,241,192,125.5,399,221,178,124.2
'31350, 연천군,'040003, 37세,2019,480,258,222,116.2,438,227,211,107.6
'31350, 연천군,'040004, 38세,2019,491,278,213,130.5,466,262,204,128.4
'31350, 연천군,'040005, 39세,2019,453,236,217,108.8,425,216,209,103.3
'31350, 연천군,'045,40~44세,2019,2192,1203,989,121.6,2065,1116,949,117.6
'31350, 연천군,'045001, 40세,2019,442,235,207,113.5,408,211,197,107.1
'31350, 연천군,'045002, 41세,2019,443,249,194,128.4,409,225,184,122.3
'31350, 연천군,'045003, 42세,2019,444,239,205,116.6,426,225,201,111.9
'31350, 연천군,'045004, 43세,2019,402,226,176,128.4,377,209,168,124.4
'31350, 연천군,'045005, 44세,2019,461,254,207,122.7,445,246,199,123.6
'31350, 연천군,'050,45~49세,2019,2803,1570,1233,127.3,2709,1513,1196,126.5
'31350, 연천군,'050001, 45세,2019,576,311,265,117.4,556,300,256,117.2
'31350, 연천군,'050002, 46세,2019,527,309,218,141.7,510,299,211,141.7
'31350, 연천군,'050003, 47세,2019,583,343,240,142.9,569,334,235,142.1
'31350, 연천군,'050004, 48세,2019,587,342,245,139.6,565,329,236,139.4
'31350, 연천군,'050005, 49세,2019,530,265,265,100,509,251,258,97.3
'31350, 연천군,'055,50~54세,2019,3255,1765,1490,118.5,3163,1708,1455,117.4
'31350, 연천군,'055001, 50세,2019,677,376,301,124.9,655,362,293,123.5
'31350, 연천군,'055002, 51세,2019,595,309,286,108,576,299,277,107.9
'31350, 연천군,'055003, 52세,2019,602,329,273,120.5,585,318,267,119.1
'31350, 연천군,'055004, 53세,2019,662,354,308,114.9,644,344,300,114.7
'31350, 연천군,'055005, 54세,2019,719,397,322,123.3,703,385,318,121.1
'31350, 연천군,'060,55~59세,2019,3904,2041,1863,109.6,3833,2002,1831,109.3
'31350, 연천군,'060001, 55세,2019,693,373,320,116.6,673,360,313,115
'31350, 연천군,'060002, 56세,2019,760,387,373,103.8,744,381,363,105
'31350, 연천군,'060003, 57세,2019,758,418,340,122.9,746,412,334,123.4
'31350, 연천군,'060004, 58세,2019,830,434,396,109.6,821,428,393,108.9
'31350, 연천군,'060005, 59세,2019,863,429,434,98.8,849,421,428,98.4
'31350, 연천군,'065,60~64세,2019,4050,2100,1950,107.7,4004,2081,1923,108.2
'31350, 연천군,'065001, 60세,2019,812,419,393,106.6,803,415,388,107
'31350, 연천군,'065002, 61세,2019,809,425,384,110.7,801,421,380,110.8
'31350, 연천군,'065003, 62세,2019,855,457,398,114.8,846,452,394,114.7
'31350, 연천군,'065004, 63세,2019,750,365,385,94.8,745,365,380,96.1
'31350, 연천군,'065005, 64세,2019,824,434,390,111.3,809,428,381,112.3
'31350, 연천군,'070,65~69세,2019,2678,1341,1337,100.3,2653,1322,1331,99.3
'31350, 연천군,'070001, 65세,2019,697,375,322,116.5,692,371,321,115.6
'31350, 연천군,'070002, 66세,2019,525,262,263,99.6,519,257,262,98.1
'31350, 연천군,'070003, 67세,2019,590,289,301,96,583,284,299,95
'31350, 연천군,'070004, 68세,2019,403,192,211,91,399,189,210,90
'31350, 연천군,'070005, 69세,2019,463,223,240,92.9,460,221,239,92.5
'31350, 연천군,'075,70~74세,2019,2602,1205,1397,86.3,2595,1202,1393,86.3
'31350, 연천군,'075001, 70세,2019,543,257,286,89.9,541,255,286,89.2
'31350, 연천군,'075002, 71세,2019,553,265,288,92,552,264,288,91.7
'31350, 연천군,'075003, 72세,2019,589,259,330,78.5,588,259,329,78.7
'31350, 연천군,'075004, 73세,2019,464,218,246,88.6,462,218,244,89.3
'31350, 연천군,'075005, 74세,2019,453,206,247,83.4,452,206,246,83.7
'31350, 연천군,'080,75~79세,2019,2330,975,1355,72,2321,971,1350,71.9
'31350, 연천군,'080001, 75세,2019,439,208,231,90,439,208,231,90
'31350, 연천군,'080002, 76세,2019,431,169,262,64.5,429,168,261,64.4
'31350, 연천군,'080003, 77세,2019,549,223,326,68.4,545,221,324,68.2
'31350, 연천군,'080004, 78세,2019,473,213,260,81.9,471,212,259,81.9
'31350, 연천군,'080005, 79세,2019,438,162,276,58.7,437,162,275,58.9
'31350, 연천군,'085,80~84세,2019,1743,653,1090,59.9,1742,653,1089,60
'31350, 연천군,'085001, 80세,2019,394,146,248,58.9,393,146,247,59.1
'31350, 연천군,'085002, 81세,2019,406,170,236,72,406,170,236,72
'31350, 연천군,'085003, 82세,2019,371,125,246,50.8,371,125,246,50.8
'31350, 연천군,'085004, 83세,2019,275,106,169,62.7,275,106,169,62.7
'31350, 연천군,'085005, 84세,2019,297,106,191,55.5,297,106,191,55.5
'31350, 연천군,'086,85세이상,2019,1082,360,722,49.9,1082,360,722,49.9
'31350, 연천군,'090,85~89세,2019,737,276,461,59.9,737,276,461,59.9
'31350, 연천군,'090001, 85세,2019,205,78,127,61.4,205,78,127,61.4
'31350, 연천군,'090002, 86세,2019,178,71,107,66.4,178,71,107,66.4
'31350, 연천군,'090003, 87세,2019,165,54,111,48.6,165,54,111,48.6
'31350, 연천군,'090004, 88세,2019,94,35,59,59.3,94,35,59,59.3
'31350, 연천군,'090005, 89세,2019,95,38,57,66.7,95,38,57,66.7
'31350, 연천군,'095,90~94세,2019,273,63,210,30,273,63,210,30
'31350, 연천군,'095001, 90세,2019,91,23,68,33.8,91,23,68,33.8
'31350, 연천군,'095002, 91세,2019,56,11,45,24.4,56,11,45,24.4
'31350, 연천군,'095003, 92세,2019,64,15,49,30.6,64,15,49,30.6
'31350, 연천군,'095004, 93세,2019,31,9,22,40.9,31,9,22,40.9
'31350, 연천군,'095005, 94세,2019,31,5,26,19.2,31,5,26,19.2
'31350, 연천군,'100,95~99세,2019,65,20,45,44.4,65,20,45,44.4
'31350, 연천군,'100001, 95세,2019,22,5,17,29.4,22,5,17,29.4
'31350, 연천군,'100002, 96세,2019,19,6,13,46.2,19,6,13,46.2
'31350, 연천군,'100003, 97세,2019,8,X,X,100,8,X,X,100
'31350, 연천군,'100004, 98세,2019,6,X,X,100,6,X,X,100
'31350, 연천군,'100005, 99세,2019,10,X,8,25,10,X,8,25
'31350, 연천군,'101,100세이상,2019,7,X,6,16.7,7,X,6,16.7
'31350, 연천군,'102,15세미만,2019,4342,2260,2082,108.5,4332,2255,2077,108.6
'31350, 연천군,'103,15~64세,2019,27763,15784,11979,131.8,26386,14802,11584,127.8
'31350, 연천군,'104,65세이상,2019,10435,4534,5901,76.8,10393,4508,5885,76.6
'31350, 연천군,'126,평균연령,2019,47.5,45.2,50.1,,47.9,45.7,50.3,
'31350, 연천군,'127,중위연령,2019,50.6,47.3,54.2,,51.3,48.3,54.6,
'31370, 가평군,'000,합계,2019,59823,30360,29463,103,58294,29676,28618,103.7
'31370, 가평군,'005,0~4세,2019,1627,830,797,104.1,1584,800,784,102
'31370, 가평군,'005001, 0세,2019,258,137,121,113.2,253,135,118,114.4
'31370, 가평군,'005002, 1세,2019,299,139,160,86.9,294,136,158,86.1
'31370, 가평군,'005003, 2세,2019,328,169,159,106.3,316,159,157,101.3
'31370, 가평군,'005004, 3세,2019,368,191,177,107.9,356,183,173,105.8
'31370, 가평군,'005005, 4세,2019,374,194,180,107.8,365,187,178,105.1
'31370, 가평군,'010,5~9세,2019,1954,964,990,97.4,1923,944,979,96.4
'31370, 가평군,'010001, 5세,2019,346,181,165,109.7,335,171,164,104.3
'31370, 가평군,'010002, 6세,2019,345,177,168,105.4,342,175,167,104.8
'31370, 가평군,'010003, 7세,2019,432,201,231,87,425,199,226,88.1
'31370, 가평군,'010004, 8세,2019,416,193,223,86.5,413,192,221,86.9
'31370, 가평군,'010005, 9세,2019,415,212,203,104.4,408,207,201,103
'31370, 가평군,'015,10~14세,2019,2098,1098,1000,109.8,2068,1082,986,109.7
'31370, 가평군,'015001, 10세,2019,409,208,201,103.5,405,205,200,102.5
'31370, 가평군,'015002, 11세,2019,423,226,197,114.7,415,223,192,116.1
'31370, 가평군,'015003, 12세,2019,426,216,210,102.9,421,213,208,102.4
'31370, 가평군,'015004, 13세,2019,409,226,183,123.5,405,226,179,126.3
'31370, 가평군,'015005, 14세,2019,431,222,209,106.2,422,215,207,103.9
'31370, 가평군,'020,15~19세,2019,2838,1436,1402,102.4,2809,1418,1391,101.9
'31370, 가평군,'020001, 15세,2019,480,243,237,102.5,475,240,235,102.1
'31370, 가평군,'020002, 16세,2019,529,289,240,120.4,526,287,239,120.1
'31370, 가평군,'020003, 17세,2019,528,280,248,112.9,522,276,246,112.2
'31370, 가평군,'020004, 18세,2019,675,311,364,85.4,669,307,362,84.8
'31370, 가평군,'020005, 19세,2019,626,313,313,100,617,308,309,99.7
'31370, 가평군,'025,20~24세,2019,2748,1557,1191,130.7,2613,1501,1112,135
'31370, 가평군,'025001, 20세,2019,521,301,220,136.8,505,294,211,139.3
'31370, 가평군,'025002, 21세,2019,521,300,221,135.7,508,296,212,139.6
'31370, 가평군,'025003, 22세,2019,534,298,236,126.3,499,282,217,130
'31370, 가평군,'025004, 23세,2019,563,316,247,127.9,535,303,232,130.6
'31370, 가평군,'025005, 24세,2019,609,342,267,128.1,566,326,240,135.8
'31370, 가평군,'030,25~29세,2019,3027,1735,1292,134.3,2834,1633,1201,136
'31370, 가평군,'030001, 25세,2019,600,346,254,136.2,558,318,240,132.5
'31370, 가평군,'030002, 26세,2019,639,361,278,129.9,608,343,265,129.4
'31370, 가평군,'030003, 27세,2019,630,350,280,125,591,334,257,130
'31370, 가평군,'030004, 28세,2019,585,346,239,144.8,552,328,224,146.4
'31370, 가평군,'030005, 29세,2019,573,332,241,137.8,525,310,215,144.2
'31370, 가평군,'035,30~34세,2019,2783,1491,1292,115.4,2608,1424,1184,120.3
'31370, 가평군,'035001, 30세,2019,536,305,231,132,500,292,208,140.4
'31370, 가평군,'035002, 31세,2019,571,309,262,117.9,539,294,245,120
'31370, 가평군,'035003, 32세,2019,572,306,266,115,544,292,252,115.9
'31370, 가평군,'035004, 33세,2019,558,290,268,108.2,514,279,235,118.7
'31370, 가평군,'035005, 34세,2019,546,281,265,106,511,267,244,109.4
'31370, 가평군,'040,35~39세,2019,3250,1691,1559,108.5,3109,1638,1471,111.4
'31370, 가평군,'040001, 35세,2019,543,295,248,119,512,286,226,126.5
'31370, 가평군,'040002, 36세,2019,600,319,281,113.5,567,302,265,114
'31370, 가평군,'040003, 37세,2019,659,329,330,99.7,636,321,315,101.9
'31370, 가평군,'040004, 38세,2019,720,380,340,111.8,691,367,324,113.3
'31370, 가평군,'040005, 39세,2019,728,368,360,102.2,703,362,341,106.2
'31370, 가평군,'045,40~44세,2019,3434,1800,1634,110.2,3306,1750,1556,112.5
'31370, 가평군,'045001, 40세,2019,645,345,300,115,621,332,289,114.9
'31370, 가평군,'045002, 41세,2019,683,354,329,107.6,651,345,306,112.7
'31370, 가평군,'045003, 42세,2019,668,358,310,115.5,645,347,298,116.4
'31370, 가평군,'045004, 43세,2019,699,350,349,100.3,675,341,334,102.1
'31370, 가평군,'045005, 44세,2019,739,393,346,113.6,714,385,329,117
'31370, 가평군,'050,45~49세,2019,4316,2318,1998,116,4182,2262,1920,117.8
'31370, 가평군,'050001, 45세,2019,822,434,388,111.9,799,426,373,114.2
'31370, 가평군,'050002, 46세,2019,782,448,334,134.1,761,439,322,136.3
'31370, 가평군,'050003, 47세,2019,900,502,398,126.1,872,488,384,127.1
'31370, 가평군,'050004, 48세,2019,871,453,418,108.4,840,441,399,110.5
'31370, 가평군,'050005, 49세,2019,941,481,460,104.6,910,468,442,105.9
'31370, 가평군,'055,50~54세,2019,5043,2644,2399,110.2,4887,2581,2306,111.9
'31370, 가평군,'055001, 50세,2019,1021,556,465,119.6,994,543,451,120.4
'31370, 가평군,'055002, 51세,2019,973,500,473,105.7,943,487,456,106.8
'31370, 가평군,'055003, 52세,2019,962,479,483,99.2,931,468,463,101.1
'31370, 가평군,'055004, 53세,2019,1013,538,475,113.3,980,525,455,115.4
'31370, 가평군,'055005, 54세,2019,1074,571,503,113.5,1039,558,481,116
'31370, 가평군,'060,55~59세,2019,6078,3104,2974,104.4,5955,3054,2901,105.3
'31370, 가평군,'060001, 55세,2019,1078,570,508,112.2,1048,557,491,113.4
'31370, 가평군,'060002, 56세,2019,1112,590,522,113,1085,576,509,113.2
'31370, 가평군,'060003, 57세,2019,1186,611,575,106.3,1163,602,561,107.3
'31370, 가평군,'060004, 58세,2019,1338,678,660,102.7,1319,672,647,103.9
'31370, 가평군,'060005, 59세,2019,1364,655,709,92.4,1340,647,693,93.4
'31370, 가평군,'065,60~64세,2019,6253,3232,3021,107,6153,3182,2971,107.1
'31370, 가평군,'065001, 60세,2019,1282,654,628,104.1,1271,649,622,104.3
'31370, 가평군,'065002, 61세,2019,1246,652,594,109.8,1215,631,584,108
'31370, 가평군,'065003, 62세,2019,1247,665,582,114.3,1222,657,565,116.3
'31370, 가평군,'065004, 63세,2019,1221,630,591,106.6,1203,619,584,106
'31370, 가평군,'065005, 64세,2019,1257,631,626,100.8,1242,626,616,101.6
'31370, 가평군,'070,65~69세,2019,4254,2134,2120,100.7,4195,2107,2088,100.9
'31370, 가평군,'070001, 65세,2019,1059,525,534,98.3,1046,519,527,98.5
'31370, 가평군,'070002, 66세,2019,941,490,451,108.6,920,481,439,109.6
'31370, 가평군,'070003, 67세,2019,1018,527,491,107.3,1009,521,488,106.8
'31370, 가평군,'070004, 68세,2019,580,290,290,100,573,288,285,101.1
'31370, 가평군,'070005, 69세,2019,656,302,354,85.3,647,298,349,85.4
'31370, 가평군,'075,70~74세,2019,3367,1627,1740,93.5,3345,1616,1729,93.5
'31370, 가평군,'075001, 70세,2019,660,315,345,91.3,652,310,342,90.6
'31370, 가평군,'075002, 71세,2019,697,351,346,101.4,695,350,345,101.4
'31370, 가평군,'075003, 72세,2019,723,347,376,92.3,719,346,373,92.8
'31370, 가평군,'075004, 73세,2019,609,296,313,94.6,604,294,310,94.8
'31370, 가평군,'075005, 74세,2019,678,318,360,88.3,675,316,359,88
'31370, 가평군,'080,75~79세,2019,3028,1342,1686,79.6,3016,1336,1680,79.5
'31370, 가평군,'080001, 75세,2019,596,287,309,92.9,592,284,308,92.2
'31370, 가평군,'080002, 76세,2019,625,271,354,76.6,622,270,352,76.7
'31370, 가평군,'080003, 77세,2019,698,312,386,80.8,696,311,385,80.8
'31370, 가평군,'080004, 78세,2019,560,236,324,72.8,559,235,324,72.5
'31370, 가평군,'080005, 79세,2019,549,236,313,75.4,547,236,311,75.9
'31370, 가평군,'085,80~84세,2019,2244,914,1330,68.7,2232,907,1325,68.5
'31370, 가평군,'085001, 80세,2019,571,239,332,72,567,237,330,71.8
'31370, 가평군,'085002, 81세,2019,456,176,280,62.9,454,176,278,63.3
'31370, 가평군,'085003, 82세,2019,441,195,246,79.3,440,194,246,78.9
'31370, 가평군,'085004, 83세,2019,408,171,237,72.2,406,169,237,71.3
'31370, 가평군,'085005, 84세,2019,368,133,235,56.6,365,131,234,56
'31370, 가평군,'086,85세이상,2019,1481,443,1038,42.7,1475,441,1034,42.6
'31370, 가평군,'090,85~89세,2019,1021,328,693,47.3,1016,327,689,47.5
'31370, 가평군,'090001, 85세,2019,291,98,193,50.8,290,97,193,50.3
'31370, 가평군,'090002, 86세,2019,240,79,161,49.1,240,79,161,49.1
'31370, 가평군,'090003, 87세,2019,234,75,159,47.2,232,75,157,47.8
'31370, 가평군,'090004, 88세,2019,134,49,85,57.6,133,49,84,58.3
'31370, 가평군,'090005, 89세,2019,122,27,95,28.4,121,27,94,28.7
'31370, 가평군,'095,90~94세,2019,362,90,272,33.1,361,89,272,32.7
'31370, 가평군,'095001, 90세,2019,120,30,90,33.3,120,30,90,33.3
'31370, 가평군,'095002, 91세,2019,84,20,64,31.3,83,19,64,29.7
'31370, 가평군,'095003, 92세,2019,60,19,41,46.3,60,19,41,46.3
'31370, 가평군,'095004, 93세,2019,53,12,41,29.3,53,12,41,29.3
'31370, 가평군,'095005, 94세,2019,45,9,36,25,45,9,36,25
'31370, 가평군,'100,95~99세,2019,87,22,65,33.8,87,22,65,33.8
'31370, 가평군,'100001, 95세,2019,33,8,25,32,33,8,25,32
'31370, 가평군,'100002, 96세,2019,18,X,15,20,18,X,15,20
'31370, 가평군,'100003, 97세,2019,20,X,16,25,20,X,16,25
'31370, 가평군,'100004, 98세,2019,9,5,X,125,9,5,X,125
'31370, 가평군,'100005, 99세,2019,7,X,5,40,7,X,5,40
'31370, 가평군,'101,100세이상,2019,11,X,8,37.5,11,X,8,37.5
'31370, 가평군,'102,15세미만,2019,5679,2892,2787,103.8,5575,2826,2749,102.8
'31370, 가평군,'103,15~64세,2019,39770,21008,18762,112,38456,20443,18013,113.5
'31370, 가평군,'104,65세이상,2019,14374,6460,7914,81.6,14263,6407,7856,81.6
'31370, 가평군,'126,평균연령,2019,48.3,47.1,49.6,,48.5,47.3,49.9,
'31370, 가평군,'127,중위연령,2019,51.8,50.5,53.3,,52.2,50.7,53.8,
'31380, 양평군,'000,합계,2019,111836,56004,55832,100.3,109413,54907,54506,100.7
'31380, 양평군,'005,0~4세,2019,3138,1590,1548,102.7,3126,1582,1544,102.5
'31380, 양평군,'005001, 0세,2019,526,259,267,97,523,257,266,96.6
'31380, 양평군,'005002, 1세,2019,548,280,268,104.5,546,278,268,103.7
'31380, 양평군,'005003, 2세,2019,627,326,301,108.3,626,325,301,108
'31380, 양평군,'005004, 3세,2019,728,366,362,101.1,723,364,359,101.4
'31380, 양평군,'005005, 4세,2019,709,359,350,102.6,708,358,350,102.3
'31380, 양평군,'010,5~9세,2019,4235,2205,2030,108.6,4228,2202,2026,108.7
'31380, 양평군,'010001, 5세,2019,768,417,351,118.8,763,415,348,119.3
'31380, 양평군,'010002, 6세,2019,751,367,384,95.6,751,367,384,95.6
'31380, 양평군,'010003, 7세,2019,917,480,437,109.8,916,480,436,110.1
'31380, 양평군,'010004, 8세,2019,914,480,434,110.6,913,479,434,110.4
'31380, 양평군,'010005, 9세,2019,885,461,424,108.7,885,461,424,108.7
'31380, 양평군,'015,10~14세,2019,4482,2340,2142,109.2,4476,2337,2139,109.3
'31380, 양평군,'015001, 10세,2019,877,460,417,110.3,876,459,417,110.1
'31380, 양평군,'015002, 11세,2019,900,458,442,103.6,899,458,441,103.9
'31380, 양평군,'015003, 12세,2019,952,469,483,97.1,951,468,483,96.9
'31380, 양평군,'015004, 13세,2019,912,487,425,114.6,912,487,425,114.6
'31380, 양평군,'015005, 14세,2019,841,466,375,124.3,838,465,373,124.7
'31380, 양평군,'020,15~19세,2019,5204,2814,2390,117.7,5177,2806,2371,118.3
'31380, 양평군,'020001, 15세,2019,958,503,455,110.5,956,503,453,111
'31380, 양평군,'020002, 16세,2019,974,499,475,105.1,970,498,472,105.5
'31380, 양평군,'020003, 17세,2019,1110,600,510,117.6,1107,599,508,117.9
'31380, 양평군,'020004, 18세,2019,1157,616,541,113.9,1152,614,538,114.1
'31380, 양평군,'020005, 19세,2019,1005,596,409,145.7,992,592,400,148
'31380, 양평군,'025,20~24세,2019,4890,2754,2136,128.9,4598,2628,1970,133.4
'31380, 양평군,'025001, 20세,2019,967,576,391,147.3,940,564,376,150
'31380, 양평군,'025002, 21세,2019,939,536,403,133,895,513,382,134.3
'31380, 양평군,'025003, 22세,2019,971,542,429,126.3,902,514,388,132.5
'31380, 양평군,'025004, 23세,2019,989,526,463,113.6,908,495,413,119.9
'31380, 양평군,'025005, 24세,2019,1024,574,450,127.6,953,542,411,131.9
'31380, 양평군,'030,25~29세,2019,5228,2849,2379,119.8,4728,2612,2116,123.4
'31380, 양평군,'030001, 25세,2019,1037,560,477,117.4,943,517,426,121.4
'31380, 양평군,'030002, 26세,2019,1061,580,481,120.6,961,531,430,123.5
'31380, 양평군,'030003, 27세,2019,1157,651,506,128.7,1065,610,455,134.1
'31380, 양평군,'030004, 28세,2019,993,515,478,107.7,888,465,423,109.9
'31380, 양평군,'030005, 29세,2019,980,543,437,124.3,871,489,382,128
'31380, 양평군,'035,30~34세,2019,4736,2510,2226,112.8,4336,2301,2035,113.1
'31380, 양평군,'035001, 30세,2019,920,524,396,132.3,835,475,360,131.9
'31380, 양평군,'035002, 31세,2019,939,487,452,107.7,853,444,409,108.6
'31380, 양평군,'035003, 32세,2019,904,472,432,109.3,826,437,389,112.3
'31380, 양평군,'035004, 33세,2019,960,510,450,113.3,880,462,418,110.5
'31380, 양평군,'035005, 34세,2019,1013,517,496,104.2,942,483,459,105.2
'31380, 양평군,'040,35~39세,2019,6252,3098,3154,98.2,5956,2976,2980,99.9
'31380, 양평군,'040001, 35세,2019,1014,521,493,105.7,944,491,453,108.4
'31380, 양평군,'040002, 36세,2019,1187,628,559,112.3,1125,601,524,114.7
'31380, 양평군,'040003, 37세,2019,1338,669,669,100,1271,638,633,100.8
'31380, 양평군,'040004, 38세,2019,1271,610,661,92.3,1217,590,627,94.1
'31380, 양평군,'040005, 39세,2019,1442,670,772,86.8,1399,656,743,88.3
'31380, 양평군,'045,40~44세,2019,6871,3455,3416,101.1,6687,3379,3308,102.1
'31380, 양평군,'045001, 40세,2019,1323,659,664,99.2,1287,648,639,101.4
'31380, 양평군,'045002, 41세,2019,1310,635,675,94.1,1269,618,651,94.9
'31380, 양평군,'045003, 42세,2019,1336,650,686,94.8,1296,632,664,95.2
'31380, 양평군,'045004, 43세,2019,1419,732,687,106.6,1390,718,672,106.8
'31380, 양평군,'045005, 44세,2019,1483,779,704,110.7,1445,763,682,111.9
'31380, 양평군,'050,45~49세,2019,8550,4419,4131,107,8367,4347,4020,108.1
'31380, 양평군,'050001, 45세,2019,1616,830,786,105.6,1588,817,771,106
'31380, 양평군,'050002, 46세,2019,1734,885,849,104.2,1700,869,831,104.6
'31380, 양평군,'050003, 47세,2019,1727,932,795,117.2,1688,919,769,119.5
'31380, 양평군,'050004, 48세,2019,1742,888,854,104,1706,872,834,104.6
'31380, 양평군,'050005, 49세,2019,1731,884,847,104.4,1685,870,815,106.7
'31380, 양평군,'055,50~54세,2019,8989,4625,4364,106,8845,4562,4283,106.5
'31380, 양평군,'055001, 50세,2019,1768,944,824,114.6,1732,925,807,114.6
'31380, 양평군,'055002, 51세,2019,1750,921,829,111.1,1719,909,810,112.2
'31380, 양평군,'055003, 52세,2019,1703,855,848,100.8,1681,844,837,100.8
'31380, 양평군,'055004, 53세,2019,1823,914,909,100.6,1792,899,893,100.7
'31380, 양평군,'055005, 54세,2019,1945,991,954,103.9,1921,985,936,105.2
'31380, 양평군,'060,55~59세,2019,10948,5443,5505,98.9,10811,5389,5422,99.4
'31380, 양평군,'060001, 55세,2019,1841,931,910,102.3,1814,921,893,103.1
'31380, 양평군,'060002, 56세,2019,2019,1025,994,103.1,1983,1014,969,104.6
'31380, 양평군,'060003, 57세,2019,2115,1055,1060,99.5,2085,1043,1042,100.1
'31380, 양평군,'060004, 58세,2019,2545,1264,1281,98.7,2517,1251,1266,98.8
'31380, 양평군,'060005, 59세,2019,2428,1168,1260,92.7,2412,1160,1252,92.7
'31380, 양평군,'065,60~64세,2019,11306,5594,5712,97.9,11196,5539,5657,97.9
'31380, 양평군,'065001, 60세,2019,2343,1153,1190,96.9,2321,1141,1180,96.7
'31380, 양평군,'065002, 61세,2019,2349,1182,1167,101.3,2330,1173,1157,101.4
'31380, 양평군,'065003, 62세,2019,2162,1072,1090,98.3,2137,1060,1077,98.4
'31380, 양평군,'065004, 63세,2019,2149,1056,1093,96.6,2127,1045,1082,96.6
'31380, 양평군,'065005, 64세,2019,2303,1131,1172,96.5,2281,1120,1161,96.5
'31380, 양평군,'070,65~69세,2019,8314,4088,4226,96.7,8251,4056,4195,96.7
'31380, 양평군,'070001, 65세,2019,1909,923,986,93.6,1895,917,978,93.8
'31380, 양평군,'070002, 66세,2019,1766,863,903,95.6,1752,857,895,95.8
'31380, 양평군,'070003, 67세,2019,2094,1060,1034,102.5,2076,1051,1025,102.5
'31380, 양평군,'070004, 68세,2019,1213,590,623,94.7,1201,582,619,94
'31380, 양평군,'070005, 69세,2019,1332,652,680,95.9,1327,649,678,95.7
'31380, 양평군,'075,70~74세,2019,6564,3314,3250,102,6535,3301,3234,102.1
'31380, 양평군,'075001, 70세,2019,1383,675,708,95.3,1378,674,704,95.7
'31380, 양평군,'075002, 71세,2019,1380,735,645,114,1364,726,638,113.8
'31380, 양평군,'075003, 72세,2019,1475,726,749,96.9,1471,725,746,97.2
'31380, 양평군,'075004, 73세,2019,1155,608,547,111.2,1152,606,546,111
'31380, 양평군,'075005, 74세,2019,1171,570,601,94.8,1170,570,600,95
'31380, 양평군,'080,75~79세,2019,5457,2555,2902,88,5439,2545,2894,87.9
'31380, 양평군,'080001, 75세,2019,1156,574,582,98.6,1154,573,581,98.6
'31380, 양평군,'080002, 76세,2019,1101,495,606,81.7,1098,492,606,81.2
'31380, 양평군,'080003, 77세,2019,1286,611,675,90.5,1283,610,673,90.6
'31380, 양평군,'080004, 78세,2019,1034,465,569,81.7,1030,464,566,82
'31380, 양평군,'080005, 79세,2019,880,410,470,87.2,874,406,468,86.8
'31380, 양평군,'085,80~84세,2019,3857,1528,2329,65.6,3851,1527,2324,65.7
'31380, 양평군,'085001, 80세,2019,929,393,536,73.3,927,392,535,73.3
'31380, 양평군,'085002, 81세,2019,842,348,494,70.4,840,348,492,70.7
'31380, 양평군,'085003, 82세,2019,761,304,457,66.5,761,304,457,66.5
'31380, 양평군,'085004, 83세,2019,716,285,431,66.1,715,285,430,66.3
'31380, 양평군,'085005, 84세,2019,609,198,411,48.2,608,198,410,48.3
'31380, 양평군,'086,85세이상,2019,2815,823,1992,41.3,2806,818,1988,41.1
'31380, 양평군,'090,85~89세,2019,1945,602,1343,44.8,1941,599,1342,44.6
'31380, 양평군,'090001, 85세,2019,564,198,366,54.1,563,198,365,54.2
'31380, 양평군,'090002, 86세,2019,458,153,305,50.2,457,152,305,49.8
'31380, 양평군,'090003, 87세,2019,335,94,241,39,335,94,241,39
'31380, 양평군,'090004, 88세,2019,296,80,216,37,295,79,216,36.6
'31380, 양평군,'090005, 89세,2019,292,77,215,35.8,291,76,215,35.3
'31380, 양평군,'095,90~94세,2019,696,170,526,32.3,692,168,524,32.1
'31380, 양평군,'095001, 90세,2019,219,56,163,34.4,218,55,163,33.7
'31380, 양평군,'095002, 91세,2019,178,40,138,29,177,39,138,28.3
'31380, 양평군,'095003, 92세,2019,125,35,90,38.9,123,35,88,39.8
'31380, 양평군,'095004, 93세,2019,104,23,81,28.4,104,23,81,28.4
'31380, 양평군,'095005, 94세,2019,70,16,54,29.6,70,16,54,29.6
'31380, 양평군,'100,95~99세,2019,157,46,111,41.4,156,46,110,41.8
'31380, 양평군,'100001, 95세,2019,44,17,27,63,44,17,27,63
'31380, 양평군,'100002, 96세,2019,35,7,28,25,35,7,28,25
'31380, 양평군,'100003, 97세,2019,32,8,24,33.3,32,8,24,33.3
'31380, 양평군,'100004, 98세,2019,25,7,18,38.9,24,7,17,41.2
'31380, 양평군,'100005, 99세,2019,21,7,14,50,21,7,14,50
'31380, 양평군,'101,100세이상,2019,17,5,12,41.7,17,5,12,41.7
'31380, 양평군,'102,15세미만,2019,11855,6135,5720,107.3,11830,6121,5709,107.2
'31380, 양평군,'103,15~64세,2019,72974,37561,35413,106.1,70701,36539,34162,107
'31380, 양평군,'104,65세이상,2019,27007,12308,14699,83.7,26882,12247,14635,83.7
'31380, 양평군,'126,평균연령,2019,48,46.6,49.3,,48.2,46.8,49.6,
'31380, 양평군,'127,중위연령,2019,51.3,50,52.8,,51.8,50.3,53.3,
'32,강원도,'000,합계,2019,1520127,767717,752410,102,1493119,753098,740021,101.8
'32,강원도,'005,0~4세,2019,47941,24485,23456,104.4,47717,24373,23344,104.4
'32,강원도,'005001, 0세,2019,8320,4245,4075,104.2,8277,4224,4053,104.2
'32,강원도,'005002, 1세,2019,8672,4431,4241,104.5,8624,4406,4218,104.5
'32,강원도,'005003, 2세,2019,9366,4800,4566,105.1,9328,4781,4547,105.1
'32,강원도,'005004, 3세,2019,10542,5421,5121,105.9,10490,5397,5093,106
'32,강원도,'005005, 4세,2019,11041,5588,5453,102.5,10998,5565,5433,102.4
'32,강원도,'010,5~9세,2019,60559,31058,29501,105.3,60404,30980,29424,105.3
'32,강원도,'010001, 5세,2019,11057,5664,5393,105,11008,5639,5369,105
'32,강원도,'010002, 6세,2019,11345,5794,5551,104.4,11324,5785,5539,104.4
'32,강원도,'010003, 7세,2019,12853,6549,6304,103.9,12817,6528,6289,103.8
'32,강원도,'010004, 8세,2019,12783,6617,6166,107.3,12752,6600,6152,107.3
'32,강원도,'010005, 9세,2019,12521,6434,6087,105.7,12503,6428,6075,105.8
'32,강원도,'015,10~14세,2019,63115,32744,30371,107.8,62983,32681,30302,107.9
'32,강원도,'015001, 10세,2019,12205,6276,5929,105.9,12181,6265,5916,105.9
'32,강원도,'015002, 11세,2019,12754,6567,6187,106.1,12723,6552,6171,106.2
'32,강원도,'015003, 12세,2019,13244,6911,6333,109.1,13221,6905,6316,109.3
'32,강원도,'015004, 13세,2019,12312,6389,5923,107.9,12283,6375,5908,107.9
'32,강원도,'015005, 14세,2019,12600,6601,5999,110,12575,6584,5991,109.9
'32,강원도,'020,15~19세,2019,79998,42385,37613,112.7,79303,42048,37255,112.9
'32,강원도,'020001, 15세,2019,13601,7071,6530,108.3,13579,7059,6520,108.3
'32,강원도,'020002, 16세,2019,13878,7234,6644,108.9,13861,7227,6634,108.9
'32,강원도,'020003, 17세,2019,14813,7746,7067,109.6,14778,7725,7053,109.5
'32,강원도,'020004, 18세,2019,17397,9287,8110,114.5,17246,9213,8033,114.7
'32,강원도,'020005, 19세,2019,20309,11047,9262,119.3,19839,10824,9015,120.1
'32,강원도,'025,20~24세,2019,102735,58406,44329,131.8,97721,55459,42262,131.2
'32,강원도,'025001, 20세,2019,20204,11014,9190,119.8,19413,10552,8861,119.1
'32,강원도,'025002, 21세,2019,20174,11019,9155,120.4,19169,10467,8702,120.3
'32,강원도,'025003, 22세,2019,20857,11550,9307,124.1,19863,10982,8881,123.7
'32,강원도,'025004, 23세,2019,21101,12415,8686,142.9,19981,11733,8248,142.3
'32,강원도,'025005, 24세,2019,20399,12408,7991,155.3,19295,11725,7570,154.9
'32,강원도,'030,25~29세,2019,87962,50362,37600,133.9,82877,47444,35433,133.9
'32,강원도,'030001, 25세,2019,19336,11571,7765,149,18223,10905,7318,149
'32,강원도,'030002, 26세,2019,18365,10736,7629,140.7,17305,10102,7203,140.2
'32,강원도,'030003, 27세,2019,17881,10083,7798,129.3,16881,9508,7373,129
'32,강원도,'030004, 28세,2019,16580,9186,7394,124.2,15617,8662,6955,124.5
'32,강원도,'030005, 29세,2019,15800,8786,7014,125.3,14851,8267,6584,125.6
'32,강원도,'035,30~34세,2019,76364,41162,35202,116.9,72207,38835,33372,116.4
'32,강원도,'035001, 30세,2019,15293,8521,6772,125.8,14431,8004,6427,124.5
'32,강원도,'035002, 31세,2019,15154,8157,6997,116.6,14326,7719,6607,116.8
'32,강원도,'035003, 32세,2019,15013,8006,7007,114.3,14142,7506,6636,113.1
'32,강원도,'035004, 33세,2019,15273,8174,7099,115.1,14459,7725,6734,114.7
'32,강원도,'035005, 34세,2019,15631,8304,7327,113.3,14849,7881,6968,113.1
'32,강원도,'040,35~39세,2019,95332,49118,46214,106.3,92272,47417,44855,105.7
'32,강원도,'040001, 35세,2019,16192,8505,7687,110.6,15501,8130,7371,110.3
'32,강원도,'040002, 36세,2019,18259,9523,8736,109,17585,9144,8441,108.3
'32,강원도,'040003, 37세,2019,20061,10173,9888,102.9,19455,9846,9609,102.5
'32,강원도,'040004, 38세,2019,20075,10436,9639,108.3,19551,10127,9424,107.5
'32,강원도,'040005, 39세,2019,20745,10481,10264,102.1,20180,10170,10010,101.6
'32,강원도,'045,40~44세,2019,99749,50936,48813,104.3,97651,49806,47845,104.1
'32,강원도,'045001, 40세,2019,19851,10073,9778,103,19364,9800,9564,102.5
'32,강원도,'045002, 41세,2019,19377,9904,9473,104.5,18945,9671,9274,104.3
'32,강원도,'045003, 42세,2019,19814,10127,9687,104.5,19403,9911,9492,104.4
'32,강원도,'045004, 43세,2019,19706,10067,9639,104.4,19316,9849,9467,104
'32,강원도,'045005, 44세,2019,21001,10765,10236,105.2,20623,10575,10048,105.2
'32,강원도,'050,45~49세,2019,122187,63420,58767,107.9,120356,62511,57845,108.1
'32,강원도,'050001, 45세,2019,23788,12222,11566,105.7,23434,12048,11386,105.8
'32,강원도,'050002, 46세,2019,24108,12496,11612,107.6,23753,12307,11446,107.5
'32,강원도,'050003, 47세,2019,23507,12379,11128,111.2,23152,12211,10941,111.6
'32,강원도,'050004, 48세,2019,25611,13189,12422,106.2,25236,13007,12229,106.4
'32,강원도,'050005, 49세,2019,25173,13134,12039,109.1,24781,12938,11843,109.2
'32,강원도,'055,50~54세,2019,125605,64518,61087,105.6,123945,63753,60192,105.9
'32,강원도,'055001, 50세,2019,26178,13488,12690,106.3,25813,13324,12489,106.7
'32,강원도,'055002, 51세,2019,26590,13839,12751,108.5,26226,13660,12566,108.7
'32,강원도,'055003, 52세,2019,24205,12350,11855,104.2,23917,12229,11688,104.6
'32,강원도,'055004, 53세,2019,24735,12922,11813,109.4,24417,12771,11646,109.7
'32,강원도,'055005, 54세,2019,23897,11919,11978,99.5,23572,11769,11803,99.7
'32,강원도,'060,55~59세,2019,137387,69326,68061,101.9,136177,68781,67396,102.1
'32,강원도,'060001, 55세,2019,23727,12256,11471,106.8,23440,12123,11317,107.1
'32,강원도,'060002, 56세,2019,26028,13361,12667,105.5,25730,13228,12502,105.8
'32,강원도,'060003, 57세,2019,27033,13793,13240,104.2,26818,13704,13114,104.5
'32,강원도,'060004, 58세,2019,30571,15229,15342,99.3,30367,15137,15230,99.4
'32,강원도,'060005, 59세,2019,30028,14687,15341,95.7,29822,14589,15233,95.8
'32,강원도,'065,60~64세,2019,128720,64683,64037,101,127907,64303,63604,101.1
'32,강원도,'065001, 60세,2019,27509,13668,13841,98.8,27320,13576,13744,98.8
'32,강원도,'065002, 61세,2019,26631,13373,13258,100.9,26462,13302,13160,101.1
'32,강원도,'065003, 62세,2019,26714,13633,13081,104.2,26542,13548,12994,104.3
'32,강원도,'065004, 63세,2019,23767,11933,11834,100.8,23615,11863,11752,100.9
'32,강원도,'065005, 64세,2019,24099,12076,12023,100.4,23968,12014,11954,100.5
'32,강원도,'070,65~69세,2019,84543,41131,43412,94.7,84095,40916,43179,94.8
'32,강원도,'070001, 65세,2019,20827,10435,10392,100.4,20710,10367,10343,100.2
'32,강원도,'070002, 66세,2019,17381,8575,8806,97.4,17285,8532,8753,97.5
'32,강원도,'070003, 67세,2019,21074,10326,10748,96.1,20986,10288,10698,96.2
'32,강원도,'070004, 68세,2019,12203,5774,6429,89.8,12124,5744,6380,90
'32,강원도,'070005, 69세,2019,13058,6021,7037,85.6,12990,5985,7005,85.4
'32,강원도,'075,70~74세,2019,68564,32083,36481,87.9,68360,31984,36376,87.9
'32,강원도,'075001, 70세,2019,13865,6642,7223,92,13809,6611,7198,91.8
'32,강원도,'075002, 71세,2019,14647,6871,7776,88.4,14598,6846,7752,88.3
'32,강원도,'075003, 72세,2019,14723,6949,7774,89.4,14687,6937,7750,89.5
'32,강원도,'075004, 73세,2019,12185,5635,6550,86,12148,5616,6532,86
'32,강원도,'075005, 74세,2019,13144,5986,7158,83.6,13118,5974,7144,83.6
'32,강원도,'080,75~79세,2019,64630,27293,37337,73.1,64515,27241,37274,73.1
'32,강원도,'080001, 75세,2019,12956,5635,7321,77,12927,5620,7307,76.9
'32,강원도,'080002, 76세,2019,12921,5556,7365,75.4,12896,5545,7351,75.4
'32,강원도,'080003, 77세,2019,14366,6111,8255,74,14336,6100,8236,74.1
'32,강원도,'080004, 78세,2019,12603,5231,7372,71,12586,5225,7361,71
'32,강원도,'080005, 79세,2019,11784,4760,7024,67.8,11770,4751,7019,67.7
'32,강원도,'085,80~84세,2019,44795,16822,27973,60.1,44740,16803,27937,60.1
'32,강원도,'085001, 80세,2019,11168,4403,6765,65.1,11158,4400,6758,65.1
'32,강원도,'085002, 81세,2019,10293,4025,6268,64.2,10275,4021,6254,64.3
'32,강원도,'085003, 82세,2019,8720,3330,5390,61.8,8705,3323,5382,61.7
'32,강원도,'085004, 83세,2019,7749,2835,4914,57.7,7741,2831,4910,57.7
'32,강원도,'085005, 84세,2019,6865,2229,4636,48.1,6861,2228,4633,48.1
'32,강원도,'086,85세이상,2019,29941,7785,22156,35.1,29889,7763,22126,35.1
'32,강원도,'090,85~89세,2019,20161,5609,14552,38.5,20126,5593,14533,38.5
'32,강원도,'090001, 85세,2019,5643,1699,3944,43.1,5632,1693,3939,43
'32,강원도,'090002, 86세,2019,4651,1353,3298,41,4642,1348,3294,40.9
'32,강원도,'090003, 87세,2019,3801,1029,2772,37.1,3794,1027,2767,37.1
'32,강원도,'090004, 88세,2019,3099,820,2279,36,3097,818,2279,35.9
'32,강원도,'090005, 89세,2019,2967,708,2259,31.3,2961,707,2254,31.4
'32,강원도,'095,90~94세,2019,7729,1678,6051,27.7,7721,1674,6047,27.7
'32,강원도,'095001, 90세,2019,2469,558,1911,29.2,2468,558,1910,29.2
'32,강원도,'095002, 91세,2019,1858,396,1462,27.1,1857,395,1462,27
'32,강원도,'095003, 92세,2019,1478,300,1178,25.5,1476,299,1177,25.4
'32,강원도,'095004, 93세,2019,1068,216,852,25.4,1066,215,851,25.3
'32,강원도,'095005, 94세,2019,856,208,648,32.1,854,207,647,32
'32,강원도,'100,95~99세,2019,1805,448,1357,33,1797,447,1350,33.1
'32,강원도,'100001, 95세,2019,621,153,468,32.7,621,153,468,32.7
'32,강원도,'100002, 96세,2019,506,146,360,40.6,506,146,360,40.6
'32,강원도,'100003, 97세,2019,319,77,242,31.8,314,77,237,32.5
'32,강원도,'100004, 98세,2019,224,42,182,23.1,222,41,181,22.7
'32,강원도,'100005, 99세,2019,135,30,105,28.6,134,30,104,28.8
'32,강원도,'101,100세이상,2019,246,50,196,25.5,245,49,196,25
'32,강원도,'102,15세미만,2019,171615,88287,83328,106,171104,88034,83070,106
'32,강원도,'103,15~64세,2019,1056039,554316,501723,110.5,1030416,540357,490059,110.3
'32,강원도,'104,65세이상,2019,292473,125114,167359,74.8,291599,124707,166892,74.7
'32,강원도,'126,평균연령,2019,44.9,43.3,46.5,,45,43.4,46.6,
'32,강원도,'127,중위연령,2019,46.9,45.3,48.7,,47.3,45.6,49,
'32004, 읍부,'000,합계,2019,256203,131052,125151,104.7,251290,128300,122990,104.3
'32004, 읍부,'005,0~4세,2019,8174,4174,4000,104.4,8143,4159,3984,104.4
'32004, 읍부,'005001, 0세,2019,1498,769,729,105.5,1491,767,724,105.9
'32004, 읍부,'005002, 1세,2019,1458,735,723,101.7,1454,733,721,101.7
'32004, 읍부,'005003, 2세,2019,1657,835,822,101.6,1650,831,819,101.5
'32004, 읍부,'005004, 3세,2019,1724,894,830,107.7,1718,891,827,107.7
'32004, 읍부,'005005, 4세,2019,1837,941,896,105,1830,937,893,104.9
'32004, 읍부,'010,5~9세,2019,9942,5065,4877,103.9,9924,5057,4867,103.9
'32004, 읍부,'010001, 5세,2019,1825,934,891,104.8,1816,931,885,105.2
'32004, 읍부,'010002, 6세,2019,1834,906,928,97.6,1833,906,927,97.7
'32004, 읍부,'010003, 7세,2019,2104,1071,1033,103.7,2099,1067,1032,103.4
'32004, 읍부,'010004, 8세,2019,2078,1065,1013,105.1,2076,1064,1012,105.1
'32004, 읍부,'010005, 9세,2019,2101,1089,1012,107.6,2100,1089,1011,107.7
'32004, 읍부,'015,10~14세,2019,10339,5426,4913,110.4,10313,5413,4900,110.5
'32004, 읍부,'015001, 10세,2019,1989,1042,947,110,1981,1039,942,110.3
'32004, 읍부,'015002, 11세,2019,2132,1097,1035,106,2126,1093,1033,105.8
'32004, 읍부,'015003, 12세,2019,2120,1113,1007,110.5,2114,1111,1003,110.8
'32004, 읍부,'015004, 13세,2019,2047,1079,968,111.5,2043,1076,967,111.3
'32004, 읍부,'015005, 14세,2019,2051,1095,956,114.5,2049,1094,955,114.6
'32004, 읍부,'020,15~19세,2019,13485,6953,6532,106.4,13444,6938,6506,106.6
'32004, 읍부,'020001, 15세,2019,2208,1135,1073,105.8,2204,1132,1072,105.6
'32004, 읍부,'020002, 16세,2019,2486,1282,1204,106.5,2484,1281,1203,106.5
'32004, 읍부,'020003, 17세,2019,2745,1418,1327,106.9,2741,1415,1326,106.7
'32004, 읍부,'020004, 18세,2019,2983,1550,1433,108.2,2977,1548,1429,108.3
'32004, 읍부,'020005, 19세,2019,3063,1568,1495,104.9,3038,1562,1476,105.8
'32004, 읍부,'025,20~24세,2019,15354,8963,6391,140.2,14775,8607,6168,139.5
'32004, 읍부,'025001, 20세,2019,3054,1686,1368,123.2,2993,1646,1347,122.2
'32004, 읍부,'025002, 21세,2019,3043,1751,1292,135.5,2957,1700,1257,135.2
'32004, 읍부,'025003, 22세,2019,3122,1717,1405,122.2,3008,1659,1349,123
'32004, 읍부,'025004, 23세,2019,2996,1822,1174,155.2,2849,1725,1124,153.5
'32004, 읍부,'025005, 24세,2019,3139,1987,1152,172.5,2968,1877,1091,172
'32004, 읍부,'030,25~29세,2019,14298,8624,5674,152,13233,7960,5273,151
'32004, 읍부,'030001, 25세,2019,3019,1909,1110,172,2796,1768,1028,172
'32004, 읍부,'030002, 26세,2019,2825,1734,1091,158.9,2624,1604,1020,157.3
'32004, 읍부,'030003, 27세,2019,2963,1785,1178,151.5,2741,1637,1104,148.3
'32004, 읍부,'030004, 28세,2019,2870,1679,1191,141,2654,1552,1102,140.8
'32004, 읍부,'030005, 29세,2019,2621,1517,1104,137.4,2418,1399,1019,137.3
'32004, 읍부,'035,30~34세,2019,12730,7176,5554,129.2,11819,6607,5212,126.8
'32004, 읍부,'035001, 30세,2019,2586,1532,1054,145.4,2393,1388,1005,138.1
'32004, 읍부,'035002, 31세,2019,2491,1369,1122,122,2303,1255,1048,119.8
'32004, 읍부,'035003, 32세,2019,2555,1440,1115,129.1,2385,1336,1049,127.4
'32004, 읍부,'035004, 33세,2019,2531,1388,1143,121.4,2346,1282,1064,120.5
'32004, 읍부,'035005, 34세,2019,2567,1447,1120,129.2,2392,1346,1046,128.7
'32004, 읍부,'040,35~39세,2019,15377,8000,7377,108.4,14738,7620,7118,107.1
'32004, 읍부,'040001, 35세,2019,2646,1398,1248,112,2486,1306,1180,110.7
'32004, 읍부,'040002, 36세,2019,2848,1471,1377,106.8,2725,1392,1333,104.4
'32004, 읍부,'040003, 37세,2019,3228,1661,1567,106,3112,1593,1519,104.9
'32004, 읍부,'040004, 38세,2019,3277,1707,1570,108.7,3165,1645,1520,108.2
'32004, 읍부,'040005, 39세,2019,3378,1763,1615,109.2,3250,1684,1566,107.5
'32004, 읍부,'045,40~44세,2019,16230,8589,7641,112.4,15813,8366,7447,112.3
'32004, 읍부,'045001, 40세,2019,3187,1702,1485,114.6,3077,1639,1438,114
'32004, 읍부,'045002, 41세,2019,3186,1696,1490,113.8,3102,1650,1452,113.6
'32004, 읍부,'045003, 42세,2019,3263,1713,1550,110.5,3185,1666,1519,109.7
'32004, 읍부,'045004, 43세,2019,3196,1702,1494,113.9,3119,1658,1461,113.5
'32004, 읍부,'045005, 44세,2019,3398,1776,1622,109.5,3330,1753,1577,111.2
'32004, 읍부,'050,45~49세,2019,19679,10641,9038,117.7,19324,10474,8850,118.4
'32004, 읍부,'050001, 45세,2019,3879,2110,1769,119.3,3814,2083,1731,120.3
'32004, 읍부,'050002, 46세,2019,3866,2114,1752,120.7,3792,2070,1722,120.2
'32004, 읍부,'050003, 47세,2019,3796,2034,1762,115.4,3736,2009,1727,116.3
'32004, 읍부,'050004, 48세,2019,4112,2209,1903,116.1,4029,2170,1859,116.7
'32004, 읍부,'050005, 49세,2019,4026,2174,1852,117.4,3953,2142,1811,118.3
'32004, 읍부,'055,50~54세,2019,20678,10961,9717,112.8,20335,10826,9509,113.9
'32004, 읍부,'055001, 50세,2019,4285,2290,1995,114.8,4196,2253,1943,116
'32004, 읍부,'055002, 51세,2019,4393,2412,1981,121.8,4317,2385,1932,123.4
'32004, 읍부,'055003, 52세,2019,3836,2007,1829,109.7,3779,1987,1792,110.9
'32004, 읍부,'055004, 53세,2019,4150,2237,1913,116.9,4089,2212,1877,117.8
'32004, 읍부,'055005, 54세,2019,4014,2015,1999,100.8,3954,1989,1965,101.2
'32004, 읍부,'060,55~59세,2019,23525,12354,11171,110.6,23316,12263,11053,110.9
'32004, 읍부,'060001, 55세,2019,4029,2177,1852,117.5,3985,2160,1825,118.4
'32004, 읍부,'060002, 56세,2019,4485,2413,2072,116.5,4445,2392,2053,116.5
'32004, 읍부,'060003, 57세,2019,4584,2420,2164,111.8,4540,2402,2138,112.3
'32004, 읍부,'060004, 58세,2019,5232,2716,2516,107.9,5188,2698,2490,108.4
'32004, 읍부,'060005, 59세,2019,5195,2628,2567,102.4,5158,2611,2547,102.5
'32004, 읍부,'065,60~64세,2019,22170,11311,10859,104.2,22013,11244,10769,104.4
'32004, 읍부,'065001, 60세,2019,4598,2351,2247,104.6,4564,2341,2223,105.3
'32004, 읍부,'065002, 61세,2019,4624,2397,2227,107.6,4590,2384,2206,108.1
'32004, 읍부,'065003, 62세,2019,4539,2360,2179,108.3,4499,2340,2159,108.4
'32004, 읍부,'065004, 63세,2019,4211,2089,2122,98.4,4181,2075,2106,98.5
'32004, 읍부,'065005, 64세,2019,4198,2114,2084,101.4,4179,2104,2075,101.4
'32004, 읍부,'070,65~69세,2019,15018,7187,7831,91.8,14949,7157,7792,91.9
'32004, 읍부,'070001, 65세,2019,3687,1802,1885,95.6,3672,1794,1878,95.5
'32004, 읍부,'070002, 66세,2019,2993,1435,1558,92.1,2977,1429,1548,92.3
'32004, 읍부,'070003, 67세,2019,3678,1793,1885,95.1,3661,1786,1875,95.3
'32004, 읍부,'070004, 68세,2019,2263,1059,1204,88,2251,1055,1196,88.2
'32004, 읍부,'070005, 69세,2019,2397,1098,1299,84.5,2388,1093,1295,84.4
'32004, 읍부,'075,70~74세,2019,12925,5918,7007,84.5,12897,5907,6990,84.5
'32004, 읍부,'075001, 70세,2019,2647,1227,1420,86.4,2643,1224,1419,86.3
'32004, 읍부,'075002, 71세,2019,2633,1208,1425,84.8,2626,1206,1420,84.9
'32004, 읍부,'075003, 72세,2019,2813,1285,1528,84.1,2809,1284,1525,84.2
'32004, 읍부,'075004, 73세,2019,2326,1057,1269,83.3,2319,1055,1264,83.5
'32004, 읍부,'075005, 74세,2019,2506,1141,1365,83.6,2500,1138,1362,83.6
'32004, 읍부,'080,75~79세,2019,12539,5209,7330,71.1,12525,5204,7321,71.1
'32004, 읍부,'080001, 75세,2019,2452,1064,1388,76.7,2450,1064,1386,76.8
'32004, 읍부,'080002, 76세,2019,2508,1056,1452,72.7,2504,1054,1450,72.7
'32004, 읍부,'080003, 77세,2019,2859,1198,1661,72.1,2855,1197,1658,72.2
'32004, 읍부,'080004, 78세,2019,2441,991,1450,68.3,2439,991,1448,68.4
'32004, 읍부,'080005, 79세,2019,2279,900,1379,65.3,2277,898,1379,65.1
'32004, 읍부,'085,80~84세,2019,8243,3053,5190,58.8,8236,3051,5185,58.8
'32004, 읍부,'085001, 80세,2019,2151,846,1305,64.8,2150,846,1304,64.9
'32004, 읍부,'085002, 81세,2019,1864,717,1147,62.5,1861,717,1144,62.7
'32004, 읍부,'085003, 82세,2019,1643,603,1040,58,1642,602,1040,57.9
'32004, 읍부,'085004, 83세,2019,1382,502,880,57,1380,501,879,57
'32004, 읍부,'085005, 84세,2019,1203,385,818,47.1,1203,385,818,47.1
'32004, 읍부,'086,85세이상,2019,5497,1448,4049,35.8,5493,1447,4046,35.8
'32004, 읍부,'090,85~89세,2019,3685,1031,2654,38.8,3683,1030,2653,38.8
'32004, 읍부,'090001, 85세,2019,1022,281,741,37.9,1020,280,740,37.8
'32004, 읍부,'090002, 86세,2019,873,265,608,43.6,873,265,608,43.6
'32004, 읍부,'090003, 87세,2019,700,209,491,42.6,700,209,491,42.6
'32004, 읍부,'090004, 88세,2019,534,145,389,37.3,534,145,389,37.3
'32004, 읍부,'090005, 89세,2019,556,131,425,30.8,556,131,425,30.8
'32004, 읍부,'095,90~94세,2019,1420,323,1097,29.4,1420,323,1097,29.4
'32004, 읍부,'095001, 90세,2019,475,121,354,34.2,475,121,354,34.2
'32004, 읍부,'095002, 91세,2019,337,75,262,28.6,337,75,262,28.6
'32004, 읍부,'095003, 92세,2019,262,55,207,26.6,262,55,207,26.6
'32004, 읍부,'095004, 93세,2019,187,36,151,23.8,187,36,151,23.8
'32004, 읍부,'095005, 94세,2019,159,36,123,29.3,159,36,123,29.3
'32004, 읍부,'100,95~99세,2019,346,84,262,32.1,344,84,260,32.3
'32004, 읍부,'100001, 95세,2019,127,30,97,30.9,127,30,97,30.9
'32004, 읍부,'100002, 96세,2019,93,21,72,29.2,93,21,72,29.2
'32004, 읍부,'100003, 97세,2019,62,14,48,29.2,60,14,46,30.4
'32004, 읍부,'100004, 98세,2019,41,11,30,36.7,41,11,30,36.7
'32004, 읍부,'100005, 99세,2019,23,8,15,53.3,23,8,15,53.3
'32004, 읍부,'101,100세이상,2019,46,10,36,27.8,46,10,36,27.8
'32004, 읍부,'102,15세미만,2019,28455,14665,13790,106.3,28380,14629,13751,106.4
'32004, 읍부,'103,15~64세,2019,173526,93572,79954,117,168810,90905,77905,116.7
'32004, 읍부,'104,65세이상,2019,54222,22815,31407,72.6,54100,22766,31334,72.7
'32004, 읍부,'126,평균연령,2019,45.8,44,47.6,,46,44.2,47.8,
'32004, 읍부,'127,중위연령,2019,48.2,46.2,50.3,,48.5,46.6,50.6,
'32005, 면부,'000,합계,2019,350394,181717,168677,107.7,341959,176831,165128,107.1
'32005, 면부,'005,0~4세,2019,9034,4618,4416,104.6,8992,4594,4398,104.5
'32005, 면부,'005001, 0세,2019,1633,832,801,103.9,1627,829,798,103.9
'32005, 면부,'005002, 1세,2019,1701,844,857,98.5,1690,840,850,98.8
'32005, 면부,'005003, 2세,2019,1707,893,814,109.7,1701,888,813,109.2
'32005, 면부,'005004, 3세,2019,1974,1015,959,105.8,1964,1009,955,105.7
'32005, 면부,'005005, 4세,2019,2019,1034,985,105,2010,1028,982,104.7
'32005, 면부,'010,5~9세,2019,10786,5658,5128,110.3,10761,5645,5116,110.3
'32005, 면부,'010001, 5세,2019,2011,1029,982,104.8,2005,1025,980,104.6
'32005, 면부,'010002, 6세,2019,2082,1118,964,116,2078,1117,961,116.2
'32005, 면부,'010003, 7세,2019,2249,1166,1083,107.7,2242,1162,1080,107.6
'32005, 면부,'010004, 8세,2019,2232,1211,1021,118.6,2227,1209,1018,118.8
'32005, 면부,'010005, 9세,2019,2212,1134,1078,105.2,2209,1132,1077,105.1
'32005, 면부,'015,10~14세,2019,10321,5289,5032,105.1,10300,5280,5020,105.2
'32005, 면부,'015001, 10세,2019,2105,1067,1038,102.8,2102,1067,1035,103.1
'32005, 면부,'015002, 11세,2019,2230,1125,1105,101.8,2226,1124,1102,102
'32005, 면부,'015003, 12세,2019,2078,1043,1035,100.8,2075,1042,1033,100.9
'32005, 면부,'015004, 13세,2019,1959,1036,923,112.2,1954,1034,920,112.4
'32005, 면부,'015005, 14세,2019,1949,1018,931,109.3,1943,1013,930,108.9
'32005, 면부,'020,15~19세,2019,13315,7147,6168,115.9,13076,7018,6058,115.8
'32005, 면부,'020001, 15세,2019,2120,1119,1001,111.8,2118,1118,1000,111.8
'32005, 면부,'020002, 16세,2019,2318,1152,1166,98.8,2313,1149,1164,98.7
'32005, 면부,'020003, 17세,2019,2332,1194,1138,104.9,2326,1191,1135,104.9
'32005, 면부,'020004, 18세,2019,2897,1583,1314,120.5,2839,1549,1290,120.1
'32005, 면부,'020005, 19세,2019,3648,2099,1549,135.5,3480,2011,1469,136.9
'32005, 면부,'025,20~24세,2019,21026,12611,8415,149.9,19389,11545,7844,147.2
'32005, 면부,'025001, 20세,2019,3888,2238,1650,135.6,3658,2096,1562,134.2
'32005, 면부,'025002, 21세,2019,3997,2208,1789,123.4,3711,2039,1672,121.9
'32005, 면부,'025003, 22세,2019,4214,2383,1831,130.1,3877,2163,1714,126.2
'32005, 면부,'025004, 23세,2019,4588,2922,1666,175.4,4170,2635,1535,171.7
'32005, 면부,'025005, 24세,2019,4339,2860,1479,193.4,3973,2612,1361,191.9
'32005, 면부,'030,25~29세,2019,19012,11969,7043,169.9,17445,10972,6473,169.5
'32005, 면부,'030001, 25세,2019,4269,2848,1421,200.4,3964,2648,1316,201.2
'32005, 면부,'030002, 26세,2019,3989,2651,1338,198.1,3657,2428,1229,197.6
'32005, 면부,'030003, 27세,2019,3807,2324,1483,156.7,3472,2127,1345,158.1
'32005, 면부,'030004, 28세,2019,3581,2137,1444,148,3274,1945,1329,146.4
'32005, 면부,'030005, 29세,2019,3366,2009,1357,148,3078,1824,1254,145.5
'32005, 면부,'035,30~34세,2019,15869,9062,6807,133.1,14528,8284,6244,132.7
'32005, 면부,'035001, 30세,2019,3162,1869,1293,144.5,2867,1693,1174,144.2
'32005, 면부,'035002, 31세,2019,3195,1831,1364,134.2,2961,1702,1259,135.2
'32005, 면부,'035003, 32세,2019,3148,1777,1371,129.6,2850,1598,1252,127.6
'32005, 면부,'035004, 33세,2019,3159,1797,1362,131.9,2909,1654,1255,131.8
'32005, 면부,'035005, 34세,2019,3205,1788,1417,126.2,2941,1637,1304,125.5
'32005, 면부,'040,35~39세,2019,18466,10114,8352,121.1,17452,9534,7918,120.4
'32005, 면부,'040001, 35세,2019,3304,1792,1512,118.5,3079,1669,1410,118.4
'32005, 면부,'040002, 36세,2019,3592,2004,1588,126.2,3357,1862,1495,124.5
'32005, 면부,'040003, 37세,2019,3895,2101,1794,117.1,3693,1988,1705,116.6
'32005, 면부,'040004, 38세,2019,3788,2123,1665,127.5,3617,2016,1601,125.9
'32005, 면부,'040005, 39세,2019,3887,2094,1793,116.8,3706,1999,1707,117.1
'32005, 면부,'045,40~44세,2019,18039,10043,7996,125.6,17411,9690,7721,125.5
'32005, 면부,'045001, 40세,2019,3737,1995,1742,114.5,3577,1899,1678,113.2
'32005, 면부,'045002, 41세,2019,3529,1964,1565,125.5,3404,1896,1508,125.7
'32005, 면부,'045003, 42세,2019,3552,1960,1592,123.1,3419,1893,1526,124
'32005, 면부,'045004, 43세,2019,3519,2027,1492,135.9,3408,1957,1451,134.9
'32005, 면부,'045005, 44세,2019,3702,2097,1605,130.7,3603,2045,1558,131.3
'32005, 면부,'050,45~49세,2019,22113,12394,9719,127.5,21566,12109,9457,128
'32005, 면부,'050001, 45세,2019,4208,2349,1859,126.4,4096,2293,1803,127.2
'32005, 면부,'050002, 46세,2019,4271,2399,1872,128.2,4170,2344,1826,128.4
'32005, 면부,'050003, 47세,2019,4225,2437,1788,136.3,4109,2374,1735,136.8
'32005, 면부,'050004, 48세,2019,4732,2656,2076,127.9,4635,2606,2029,128.4
'32005, 면부,'050005, 49세,2019,4677,2553,2124,120.2,4556,2492,2064,120.7
'32005, 면부,'055,50~54세,2019,27239,14594,12645,115.4,26783,14382,12401,116
'32005, 면부,'055001, 50세,2019,5262,2852,2410,118.3,5174,2812,2362,119.1
'32005, 면부,'055002, 51세,2019,5559,2986,2573,116.1,5446,2936,2510,117
'32005, 면부,'055003, 52세,2019,5270,2844,2426,117.2,5202,2818,2384,118.2
'32005, 면부,'055004, 53세,2019,5512,2967,2545,116.6,5419,2918,2501,116.7
'32005, 면부,'055005, 54세,2019,5636,2945,2691,109.4,5542,2898,2644,109.6
'32005, 면부,'060,55~59세,2019,36090,18427,17663,104.3,35688,18233,17455,104.5
'32005, 면부,'060001, 55세,2019,5740,2964,2776,106.8,5634,2911,2723,106.9
'32005, 면부,'060002, 56세,2019,6561,3402,3159,107.7,6465,3356,3109,107.9
'32005, 면부,'060003, 57세,2019,7089,3715,3374,110.1,7010,3681,3329,110.6
'32005, 면부,'060004, 58세,2019,8423,4214,4209,100.1,8366,4187,4179,100.2
'32005, 면부,'060005, 59세,2019,8277,4132,4145,99.7,8213,4098,4115,99.6
'32005, 면부,'065,60~64세,2019,37469,19485,17984,108.3,37211,19365,17846,108.5
'32005, 면부,'065001, 60세,2019,7714,3969,3745,106,7657,3940,3717,106
'32005, 면부,'065002, 61세,2019,7811,4031,3780,106.6,7747,4009,3738,107.2
'32005, 면부,'065003, 62세,2019,7797,4102,3695,111,7743,4075,3668,111.1
'32005, 면부,'065004, 63세,2019,6974,3656,3318,110.2,6929,3634,3295,110.3
'32005, 면부,'065005, 64세,2019,7173,3727,3446,108.2,7135,3707,3428,108.1
'32005, 면부,'070,65~69세,2019,25397,13053,12344,105.7,25266,12985,12281,105.7
'32005, 면부,'070001, 65세,2019,6268,3338,2930,113.9,6228,3310,2918,113.4
'32005, 면부,'070002, 66세,2019,5254,2745,2509,109.4,5225,2731,2494,109.5
'32005, 면부,'070003, 67세,2019,6487,3387,3100,109.3,6466,3378,3088,109.4
'32005, 면부,'070004, 68세,2019,3607,1767,1840,96,3587,1761,1826,96.4
'32005, 면부,'070005, 69세,2019,3781,1816,1965,92.4,3760,1805,1955,92.3
'32005, 면부,'075,70~74세,2019,20490,10148,10342,98.1,20422,10111,10311,98.1
'32005, 면부,'075001, 70세,2019,4095,2058,2037,101,4078,2049,2029,101
'32005, 면부,'075002, 71세,2019,4325,2155,2170,99.3,4307,2143,2164,99
'32005, 면부,'075003, 72세,2019,4379,2232,2147,104,4364,2226,2138,104.1
'32005, 면부,'075004, 73세,2019,3722,1825,1897,96.2,3711,1817,1894,95.9
'32005, 면부,'075005, 74세,2019,3969,1878,2091,89.8,3962,1876,2086,89.9
'32005, 면부,'080,75~79세,2019,20336,8835,11501,76.8,20307,8824,11483,76.8
'32005, 면부,'080001, 75세,2019,3919,1719,2200,78.1,3915,1716,2199,78
'32005, 면부,'080002, 76세,2019,3986,1753,2233,78.5,3977,1749,2228,78.5
'32005, 면부,'080003, 77세,2019,4509,1996,2513,79.4,4501,1994,2507,79.5
'32005, 면부,'080004, 78세,2019,4092,1734,2358,73.5,4086,1733,2353,73.7
'32005, 면부,'080005, 79세,2019,3830,1633,2197,74.3,3828,1632,2196,74.3
'32005, 면부,'085,80~84세,2019,15126,5692,9434,60.3,15112,5689,9423,60.4
'32005, 면부,'085001, 80세,2019,3673,1443,2230,64.7,3671,1443,2228,64.8
'32005, 면부,'085002, 81세,2019,3450,1346,2104,64,3445,1346,2099,64.1
'32005, 면부,'085003, 82세,2019,2970,1142,1828,62.5,2965,1140,1825,62.5
'32005, 면부,'085004, 83세,2019,2675,1008,1667,60.5,2673,1007,1666,60.4
'32005, 면부,'085005, 84세,2019,2358,753,1605,46.9,2358,753,1605,46.9
'32005, 면부,'086,85세이상,2019,10266,2578,7688,33.5,10250,2571,7679,33.5
'32005, 면부,'090,85~89세,2019,6818,1809,5009,36.1,6808,1805,5003,36.1
'32005, 면부,'090001, 85세,2019,1949,557,1392,40,1948,557,1391,40
'32005, 면부,'090002, 86세,2019,1515,424,1091,38.9,1512,422,1090,38.7
'32005, 면부,'090003, 87세,2019,1295,326,969,33.6,1293,326,967,33.7
'32005, 면부,'090004, 88세,2019,1089,277,812,34.1,1088,276,812,34
'32005, 면부,'090005, 89세,2019,970,225,745,30.2,967,224,743,30.1
'32005, 면부,'095,90~94세,2019,2667,570,2097,27.2,2664,568,2096,27.1
'32005, 면부,'095001, 90세,2019,800,173,627,27.6,800,173,627,27.6
'32005, 면부,'095002, 91세,2019,630,136,494,27.5,629,135,494,27.3
'32005, 면부,'095003, 92세,2019,516,93,423,22,516,93,423,22
'32005, 면부,'095004, 93세,2019,396,84,312,26.9,394,83,311,26.7
'32005, 면부,'095005, 94세,2019,325,84,241,34.9,325,84,241,34.9
'32005, 면부,'100,95~99세,2019,685,175,510,34.3,683,175,508,34.4
'32005, 면부,'100001, 95세,2019,248,71,177,40.1,248,71,177,40.1
'32005, 면부,'100002, 96세,2019,192,62,130,47.7,192,62,130,47.7
'32005, 면부,'100003, 97세,2019,116,26,90,28.9,115,26,89,29.2
'32005, 면부,'100004, 98세,2019,82,9,73,12.3,81,9,72,12.5
'32005, 면부,'100005, 99세,2019,47,7,40,17.5,47,7,40,17.5
'32005, 면부,'101,100세이상,2019,96,24,72,33.3,95,23,72,31.9
'32005, 면부,'102,15세미만,2019,30141,15565,14576,106.8,30053,15519,14534,106.8
'32005, 면부,'103,15~64세,2019,228638,125846,102792,122.4,220549,121132,99417,121.8
'32005, 면부,'104,65세이상,2019,91615,40306,51309,78.6,91357,40180,51177,78.5
'32005, 면부,'126,평균연령,2019,49.3,47.3,51.5,,49.6,47.6,51.8,
'32005, 면부,'127,중위연령,2019,53.2,50.7,55.9,,53.8,51.3,56.4,
'32003, 동부,'000,합계,2019,913530,454948,458582,99.2,899870,447967,451903,99.1
'32003, 동부,'005,0~4세,2019,30733,15693,15040,104.3,30582,15620,14962,104.4
'32003, 동부,'005001, 0세,2019,5189,2644,2545,103.9,5159,2628,2531,103.8
'32003, 동부,'005002, 1세,2019,5513,2852,2661,107.2,5480,2833,2647,107
'32003, 동부,'005003, 2세,2019,6002,3072,2930,104.8,5977,3062,2915,105
'32003, 동부,'005004, 3세,2019,6844,3512,3332,105.4,6808,3497,3311,105.6
'32003, 동부,'005005, 4세,2019,7185,3613,3572,101.1,7158,3600,3558,101.2
'32003, 동부,'010,5~9세,2019,39831,20335,19496,104.3,39719,20278,19441,104.3
'32003, 동부,'010001, 5세,2019,7221,3701,3520,105.1,7187,3683,3504,105.1
'32003, 동부,'010002, 6세,2019,7429,3770,3659,103,7413,3762,3651,103
'32003, 동부,'010003, 7세,2019,8500,4312,4188,103,8476,4299,4177,102.9
'32003, 동부,'010004, 8세,2019,8473,4341,4132,105.1,8449,4327,4122,105
'32003, 동부,'010005, 9세,2019,8208,4211,3997,105.4,8194,4207,3987,105.5
'32003, 동부,'015,10~14세,2019,42455,22029,20426,107.8,42370,21988,20382,107.9
'32003, 동부,'015001, 10세,2019,8111,4167,3944,105.7,8098,4159,3939,105.6
'32003, 동부,'015002, 11세,2019,8392,4345,4047,107.4,8371,4335,4036,107.4
'32003, 동부,'015003, 12세,2019,9046,4755,4291,110.8,9032,4752,4280,111
'32003, 동부,'015004, 13세,2019,8306,4274,4032,106,8286,4265,4021,106.1
'32003, 동부,'015005, 14세,2019,8600,4488,4112,109.1,8583,4477,4106,109
'32003, 동부,'020,15~19세,2019,53198,28285,24913,113.5,52783,28092,24691,113.8
'32003, 동부,'020001, 15세,2019,9273,4817,4456,108.1,9257,4809,4448,108.1
'32003, 동부,'020002, 16세,2019,9074,4800,4274,112.3,9064,4797,4267,112.4
'32003, 동부,'020003, 17세,2019,9736,5134,4602,111.6,9711,5119,4592,111.5
'32003, 동부,'020004, 18세,2019,11517,6154,5363,114.7,11430,6116,5314,115.1
'32003, 동부,'020005, 19세,2019,13598,7380,6218,118.7,13321,7251,6070,119.5
'32003, 동부,'025,20~24세,2019,66355,36832,29523,124.8,63557,35307,28250,125
'32003, 동부,'025001, 20세,2019,13262,7090,6172,114.9,12762,6810,5952,114.4
'32003, 동부,'025002, 21세,2019,13134,7060,6074,116.2,12501,6728,5773,116.5
'32003, 동부,'025003, 22세,2019,13521,7450,6071,122.7,12978,7160,5818,123.1
'32003, 동부,'025004, 23세,2019,13517,7671,5846,131.2,12962,7373,5589,131.9
'32003, 동부,'025005, 24세,2019,12921,7561,5360,141.1,12354,7236,5118,141.4
'32003, 동부,'030,25~29세,2019,54652,29769,24883,119.6,52199,28512,23687,120.4
'32003, 동부,'030001, 25세,2019,12048,6814,5234,130.2,11463,6489,4974,130.5
'32003, 동부,'030002, 26세,2019,11551,6351,5200,122.1,11024,6070,4954,122.5
'32003, 동부,'030003, 27세,2019,11111,5974,5137,116.3,10668,5744,4924,116.7
'32003, 동부,'030004, 28세,2019,10129,5370,4759,112.8,9689,5165,4524,114.2
'32003, 동부,'030005, 29세,2019,9813,5260,4553,115.5,9355,5044,4311,117
'32003, 동부,'035,30~34세,2019,47765,24924,22841,109.1,45860,23944,21916,109.3
'32003, 동부,'035001, 30세,2019,9545,5120,4425,115.7,9171,4923,4248,115.9
'32003, 동부,'035002, 31세,2019,9468,4957,4511,109.9,9062,4762,4300,110.7
'32003, 동부,'035003, 32세,2019,9310,4789,4521,105.9,8907,4572,4335,105.5
'32003, 동부,'035004, 33세,2019,9583,4989,4594,108.6,9204,4789,4415,108.5
'32003, 동부,'035005, 34세,2019,9859,5069,4790,105.8,9516,4898,4618,106.1
'32003, 동부,'040,35~39세,2019,61489,31004,30485,101.7,60082,30263,29819,101.5
'32003, 동부,'040001, 35세,2019,10242,5315,4927,107.9,9936,5155,4781,107.8
'32003, 동부,'040002, 36세,2019,11819,6048,5771,104.8,11503,5890,5613,104.9
'32003, 동부,'040003, 37세,2019,12938,6411,6527,98.2,12650,6265,6385,98.1
'32003, 동부,'040004, 38세,2019,13010,6606,6404,103.2,12769,6466,6303,102.6
'32003, 동부,'040005, 39세,2019,13480,6624,6856,96.6,13224,6487,6737,96.3
'32003, 동부,'045,40~44세,2019,65480,32304,33176,97.4,64427,31750,32677,97.2
'32003, 동부,'045001, 40세,2019,12927,6376,6551,97.3,12710,6262,6448,97.1
'32003, 동부,'045002, 41세,2019,12662,6244,6418,97.3,12439,6125,6314,97
'32003, 동부,'045003, 42세,2019,12999,6454,6545,98.6,12799,6352,6447,98.5
'32003, 동부,'045004, 43세,2019,12991,6338,6653,95.3,12789,6234,6555,95.1
'32003, 동부,'045005, 44세,2019,13901,6892,7009,98.3,13690,6777,6913,98
'32003, 동부,'050,45~49세,2019,80395,40385,40010,100.9,79466,39928,39538,101
'32003, 동부,'050001, 45세,2019,15701,7763,7938,97.8,15524,7672,7852,97.7
'32003, 동부,'050002, 46세,2019,15971,7983,7988,99.9,15791,7893,7898,99.9
'32003, 동부,'050003, 47세,2019,15486,7908,7578,104.4,15307,7828,7479,104.7
'32003, 동부,'050004, 48세,2019,16767,8324,8443,98.6,16572,8231,8341,98.7
'32003, 동부,'050005, 49세,2019,16470,8407,8063,104.3,16272,8304,7968,104.2
'32003, 동부,'055,50~54세,2019,77688,38963,38725,100.6,76827,38545,38282,100.7
'32003, 동부,'055001, 50세,2019,16631,8346,8285,100.7,16443,8259,8184,100.9
'32003, 동부,'055002, 51세,2019,16638,8441,8197,103,16463,8339,8124,102.6
'32003, 동부,'055003, 52세,2019,15099,7499,7600,98.7,14936,7424,7512,98.8
'32003, 동부,'055004, 53세,2019,15073,7718,7355,104.9,14909,7641,7268,105.1
'32003, 동부,'055005, 54세,2019,14247,6959,7288,95.5,14076,6882,7194,95.7
'32003, 동부,'060,55~59세,2019,77772,38545,39227,98.3,77173,38285,38888,98.4
'32003, 동부,'060001, 55세,2019,13958,7115,6843,104,13821,7052,6769,104.2
'32003, 동부,'060002, 56세,2019,14982,7546,7436,101.5,14820,7480,7340,101.9
'32003, 동부,'060003, 57세,2019,15360,7658,7702,99.4,15268,7621,7647,99.7
'32003, 동부,'060004, 58세,2019,16916,8299,8617,96.3,16813,8252,8561,96.4
'32003, 동부,'060005, 59세,2019,16556,7927,8629,91.9,16451,7880,8571,91.9
'32003, 동부,'065,60~64세,2019,69081,33887,35194,96.3,68683,33694,34989,96.3
'32003, 동부,'065001, 60세,2019,15197,7348,7849,93.6,15099,7295,7804,93.5
'32003, 동부,'065002, 61세,2019,14196,6945,7251,95.8,14125,6909,7216,95.7
'32003, 동부,'065003, 62세,2019,14378,7171,7207,99.5,14300,7133,7167,99.5
'32003, 동부,'065004, 63세,2019,12582,6188,6394,96.8,12505,6154,6351,96.9
'32003, 동부,'065005, 64세,2019,12728,6235,6493,96,12654,6203,6451,96.2
'32003, 동부,'070,65~69세,2019,44128,20891,23237,89.9,43880,20774,23106,89.9
'32003, 동부,'070001, 65세,2019,10872,5295,5577,94.9,10810,5263,5547,94.9
'32003, 동부,'070002, 66세,2019,9134,4395,4739,92.7,9083,4372,4711,92.8
'32003, 동부,'070003, 67세,2019,10909,5146,5763,89.3,10859,5124,5735,89.3
'32003, 동부,'070004, 68세,2019,6333,2948,3385,87.1,6286,2928,3358,87.2
'32003, 동부,'070005, 69세,2019,6880,3107,3773,82.3,6842,3087,3755,82.2
'32003, 동부,'075,70~74세,2019,35149,16017,19132,83.7,35041,15966,19075,83.7
'32003, 동부,'075001, 70세,2019,7123,3357,3766,89.1,7088,3338,3750,89
'32003, 동부,'075002, 71세,2019,7689,3508,4181,83.9,7665,3497,4168,83.9
'32003, 동부,'075003, 72세,2019,7531,3432,4099,83.7,7514,3427,4087,83.9
'32003, 동부,'075004, 73세,2019,6137,2753,3384,81.4,6118,2744,3374,81.3
'32003, 동부,'075005, 74세,2019,6669,2967,3702,80.1,6656,2960,3696,80.1
'32003, 동부,'080,75~79세,2019,31755,13249,18506,71.6,31683,13213,18470,71.5
'32003, 동부,'080001, 75세,2019,6585,2852,3733,76.4,6562,2840,3722,76.3
'32003, 동부,'080002, 76세,2019,6427,2747,3680,74.6,6415,2742,3673,74.7
'32003, 동부,'080003, 77세,2019,6998,2917,4081,71.5,6980,2909,4071,71.5
'32003, 동부,'080004, 78세,2019,6070,2506,3564,70.3,6061,2501,3560,70.3
'32003, 동부,'080005, 79세,2019,5675,2227,3448,64.6,5665,2221,3444,64.5
'32003, 동부,'085,80~84세,2019,21426,8077,13349,60.5,21392,8063,13329,60.5
'32003, 동부,'085001, 80세,2019,5344,2114,3230,65.4,5337,2111,3226,65.4
'32003, 동부,'085002, 81세,2019,4979,1962,3017,65,4969,1958,3011,65
'32003, 동부,'085003, 82세,2019,4107,1585,2522,62.8,4098,1581,2517,62.8
'32003, 동부,'085004, 83세,2019,3692,1325,2367,56,3688,1323,2365,55.9
'32003, 동부,'085005, 84세,2019,3304,1091,2213,49.3,3300,1090,2210,49.3
'32003, 동부,'086,85세이상,2019,14178,3759,10419,36.1,14146,3745,10401,36
'32003, 동부,'090,85~89세,2019,9658,2769,6889,40.2,9635,2758,6877,40.1
'32003, 동부,'090001, 85세,2019,2672,861,1811,47.5,2664,856,1808,47.3
'32003, 동부,'090002, 86세,2019,2263,664,1599,41.5,2257,661,1596,41.4
'32003, 동부,'090003, 87세,2019,1806,494,1312,37.7,1801,492,1309,37.6
'32003, 동부,'090004, 88세,2019,1476,398,1078,36.9,1475,397,1078,36.8
'32003, 동부,'090005, 89세,2019,1441,352,1089,32.3,1438,352,1086,32.4
'32003, 동부,'095,90~94세,2019,3642,785,2857,27.5,3637,783,2854,27.4
'32003, 동부,'095001, 90세,2019,1194,264,930,28.4,1193,264,929,28.4
'32003, 동부,'095002, 91세,2019,891,185,706,26.2,891,185,706,26.2
'32003, 동부,'095003, 92세,2019,700,152,548,27.7,698,151,547,27.6
'32003, 동부,'095004, 93세,2019,485,96,389,24.7,485,96,389,24.7
'32003, 동부,'095005, 94세,2019,372,88,284,31,370,87,283,30.7
'32003, 동부,'100,95~99세,2019,774,189,585,32.3,770,188,582,32.3
'32003, 동부,'100001, 95세,2019,246,52,194,26.8,246,52,194,26.8
'32003, 동부,'100002, 96세,2019,221,63,158,39.9,221,63,158,39.9
'32003, 동부,'100003, 97세,2019,141,37,104,35.6,139,37,102,36.3
'32003, 동부,'100004, 98세,2019,101,22,79,27.8,100,21,79,26.6
'32003, 동부,'100005, 99세,2019,65,15,50,30,64,15,49,30.6
'32003, 동부,'101,100세이상,2019,104,16,88,18.2,104,16,88,18.2
'32003, 동부,'102,15세미만,2019,113019,58057,54962,105.6,112671,57886,54785,105.7
'32003, 동부,'103,15~64세,2019,653875,334898,318977,105,641057,328320,312737,105
'32003, 동부,'104,65세이상,2019,146636,61993,84643,73.2,146142,61761,84381,73.2
'32003, 동부,'126,평균연령,2019,42.9,41.4,44.3,,43,41.5,44.5,
'32003, 동부,'127,중위연령,2019,44.6,42.9,46.1,,44.9,43.2,46.3,
'32010, 춘천시,'000,합계,2019,284753,140095,144658,96.8,278878,137000,141878,96.6
'32010, 춘천시,'005,0~4세,2019,9613,4885,4728,103.3,9534,4848,4686,103.5
'32010, 춘천시,'005001, 0세,2019,1645,841,804,104.6,1630,835,795,105
'32010, 춘천시,'005002, 1세,2019,1782,887,895,99.1,1762,877,885,99.1
'32010, 춘천시,'005003, 2세,2019,1799,917,882,104,1790,912,878,103.9
'32010, 춘천시,'005004, 3세,2019,2164,1115,1049,106.3,2145,1108,1037,106.8
'32010, 춘천시,'005005, 4세,2019,2223,1125,1098,102.5,2207,1116,1091,102.3
'32010, 춘천시,'010,5~9세,2019,12368,6389,5979,106.9,12318,6362,5956,106.8
'32010, 춘천시,'010001, 5세,2019,2305,1203,1102,109.2,2291,1195,1096,109
'32010, 춘천시,'010002, 6세,2019,2410,1231,1179,104.4,2402,1225,1177,104.1
'32010, 춘천시,'010003, 7세,2019,2555,1314,1241,105.9,2544,1310,1234,106.2
'32010, 춘천시,'010004, 8세,2019,2627,1372,1255,109.3,2616,1364,1252,108.9
'32010, 춘천시,'010005, 9세,2019,2471,1269,1202,105.6,2465,1268,1197,105.9
'32010, 춘천시,'015,10~14세,2019,12407,6438,5969,107.9,12382,6422,5960,107.8
'32010, 춘천시,'015001, 10세,2019,2381,1247,1134,110,2376,1243,1133,109.7
'32010, 춘천시,'015002, 11세,2019,2554,1311,1243,105.5,2547,1306,1241,105.2
'32010, 춘천시,'015003, 12세,2019,2552,1312,1240,105.8,2550,1312,1238,106
'32010, 춘천시,'015004, 13세,2019,2423,1241,1182,105,2418,1238,1180,104.9
'32010, 춘천시,'015005, 14세,2019,2497,1327,1170,113.4,2491,1323,1168,113.3
'32010, 춘천시,'020,15~19세,2019,17240,8827,8413,104.9,17025,8729,8296,105.2
'32010, 춘천시,'020001, 15세,2019,2611,1365,1246,109.6,2603,1360,1243,109.4
'32010, 춘천시,'020002, 16세,2019,2741,1442,1299,111,2739,1441,1298,111
'32010, 춘천시,'020003, 17세,2019,2874,1547,1327,116.6,2857,1537,1320,116.4
'32010, 춘천시,'020004, 18세,2019,3795,1952,1843,105.9,3746,1927,1819,105.9
'32010, 춘천시,'020005, 19세,2019,5219,2521,2698,93.4,5080,2464,2616,94.2
'32010, 춘천시,'025,20~24세,2019,23723,12253,11470,106.8,22125,11338,10787,105.1
'32010, 춘천시,'025001, 20세,2019,4862,2254,2608,86.4,4570,2096,2474,84.7
'32010, 춘천시,'025002, 21세,2019,4778,2331,2447,95.3,4400,2116,2284,92.6
'32010, 춘천시,'025003, 22세,2019,4793,2470,2323,106.3,4491,2298,2193,104.8
'32010, 춘천시,'025004, 23세,2019,4821,2655,2166,122.6,4490,2465,2025,121.7
'32010, 춘천시,'025005, 24세,2019,4469,2543,1926,132,4174,2363,1811,130.5
'32010, 춘천시,'030,25~29세,2019,18553,9972,8581,116.2,17369,9332,8037,116.1
'32010, 춘천시,'030001, 25세,2019,4044,2238,1806,123.9,3748,2064,1684,122.6
'32010, 춘천시,'030002, 26세,2019,3906,2109,1797,117.4,3634,1951,1683,115.9
'32010, 춘천시,'030003, 27세,2019,3764,2047,1717,119.2,3534,1913,1621,118
'32010, 춘천시,'030004, 28세,2019,3489,1820,1669,109,3299,1740,1559,111.6
'32010, 춘천시,'030005, 29세,2019,3350,1758,1592,110.4,3154,1664,1490,111.7
'32010, 춘천시,'035,30~34세,2019,15734,8110,7624,106.4,14980,7720,7260,106.3
'32010, 춘천시,'035001, 30세,2019,3090,1602,1488,107.7,2953,1532,1421,107.8
'32010, 춘천시,'035002, 31세,2019,3223,1676,1547,108.3,3053,1589,1464,108.5
'32010, 춘천시,'035003, 32세,2019,3045,1527,1518,100.6,2895,1449,1446,100.2
'32010, 춘천시,'035004, 33세,2019,3157,1655,1502,110.2,2995,1570,1425,110.2
'32010, 춘천시,'035005, 34세,2019,3219,1650,1569,105.2,3084,1580,1504,105.1
'32010, 춘천시,'040,35~39세,2019,19162,9590,9572,100.2,18656,9335,9321,100.2
'32010, 춘천시,'040001, 35세,2019,3292,1697,1595,106.4,3159,1630,1529,106.6
'32010, 춘천시,'040002, 36세,2019,3753,1908,1845,103.4,3649,1855,1794,103.4
'32010, 춘천시,'040003, 37세,2019,4005,1987,2018,98.5,3906,1941,1965,98.8
'32010, 춘천시,'040004, 38세,2019,3993,1960,2033,96.4,3909,1912,1997,95.7
'32010, 춘천시,'040005, 39세,2019,4119,2038,2081,97.9,4033,1997,2036,98.1
'32010, 춘천시,'045,40~44세,2019,18912,9237,9675,95.5,18525,9046,9479,95.4
'32010, 춘천시,'045001, 40세,2019,3864,1910,1954,97.7,3782,1870,1912,97.8
'32010, 춘천시,'045002, 41세,2019,3745,1874,1871,100.2,3660,1834,1826,100.4
'32010, 춘천시,'045003, 42세,2019,3691,1829,1862,98.2,3613,1790,1823,98.2
'32010, 춘천시,'045004, 43세,2019,3678,1756,1922,91.4,3604,1720,1884,91.3
'32010, 춘천시,'045005, 44세,2019,3934,1868,2066,90.4,3866,1832,2034,90.1
'32010, 춘천시,'050,45~49세,2019,22926,11483,11443,100.3,22628,11329,11299,100.3
'32010, 춘천시,'050001, 45세,2019,4405,2191,2214,99,4352,2155,2197,98.1
'32010, 춘천시,'050002, 46세,2019,4437,2180,2257,96.6,4378,2150,2228,96.5
'32010, 춘천시,'050003, 47세,2019,4562,2302,2260,101.9,4505,2278,2227,102.3
'32010, 춘천시,'050004, 48세,2019,4919,2457,2462,99.8,4861,2429,2432,99.9
'32010, 춘천시,'050005, 49세,2019,4603,2353,2250,104.6,4532,2317,2215,104.6
'32010, 춘천시,'055,50~54세,2019,22818,11428,11390,100.3,22490,11270,11220,100.4
'32010, 춘천시,'055001, 50세,2019,4872,2421,2451,98.8,4798,2385,2413,98.8
'32010, 춘천시,'055002, 51세,2019,4920,2450,2470,99.2,4855,2409,2446,98.5
'32010, 춘천시,'055003, 52세,2019,4554,2328,2226,104.6,4493,2295,2198,104.4
'32010, 춘천시,'055004, 53세,2019,4379,2207,2172,101.6,4321,2181,2140,101.9
'32010, 춘천시,'055005, 54세,2019,4093,2022,2071,97.6,4023,2000,2023,98.9
'32010, 춘천시,'060,55~59세,2019,23453,11486,11967,96,23264,11394,11870,96
'32010, 춘천시,'060001, 55세,2019,4369,2204,2165,101.8,4326,2184,2142,102
'32010, 춘천시,'060002, 56세,2019,4514,2266,2248,100.8,4466,2239,2227,100.5
'32010, 춘천시,'060003, 57세,2019,4599,2230,2369,94.1,4570,2221,2349,94.6
'32010, 춘천시,'060004, 58세,2019,5324,2606,2718,95.9,5291,2587,2704,95.7
'32010, 춘천시,'060005, 59세,2019,4647,2180,2467,88.4,4611,2163,2448,88.4
'32010, 춘천시,'065,60~64세,2019,21123,10311,10812,95.4,20995,10251,10744,95.4
'32010, 춘천시,'065001, 60세,2019,4444,2163,2281,94.8,4413,2148,2265,94.8
'32010, 춘천시,'065002, 61세,2019,4397,2140,2257,94.8,4375,2129,2246,94.8
'32010, 춘천시,'065003, 62세,2019,4368,2147,2221,96.7,4342,2139,2203,97.1
'32010, 춘천시,'065004, 63세,2019,3926,1912,2014,94.9,3897,1896,2001,94.8
'32010, 춘천시,'065005, 64세,2019,3988,1949,2039,95.6,3968,1939,2029,95.6
'32010, 춘천시,'070,65~69세,2019,13079,6240,6839,91.2,13016,6213,6803,91.3
'32010, 춘천시,'070001, 65세,2019,3307,1672,1635,102.3,3289,1661,1628,102
'32010, 춘천시,'070002, 66세,2019,2824,1342,1482,90.6,2814,1337,1477,90.5
'32010, 춘천시,'070003, 67세,2019,3344,1593,1751,91,3329,1589,1740,91.3
'32010, 춘천시,'070004, 68세,2019,1757,816,941,86.7,1748,815,933,87.4
'32010, 춘천시,'070005, 69세,2019,1847,817,1030,79.3,1836,811,1025,79.1
'32010, 춘천시,'075,70~74세,2019,10748,4880,5868,83.2,10717,4863,5854,83.1
'32010, 춘천시,'075001, 70세,2019,1986,917,1069,85.8,1977,911,1066,85.5
'32010, 춘천시,'075002, 71세,2019,2228,980,1248,78.5,2222,976,1246,78.3
'32010, 춘천시,'075003, 72세,2019,2378,1110,1268,87.5,2372,1108,1264,87.7
'32010, 춘천시,'075004, 73세,2019,2051,911,1140,79.9,2046,908,1138,79.8
'32010, 춘천시,'075005, 74세,2019,2105,962,1143,84.2,2100,960,1140,84.2
'32010, 춘천시,'080,75~79세,2019,10329,4305,6024,71.5,10311,4295,6016,71.4
'32010, 춘천시,'080001, 75세,2019,1960,844,1116,75.6,1956,842,1114,75.6
'32010, 춘천시,'080002, 76세,2019,2037,861,1176,73.2,2028,856,1172,73
'32010, 춘천시,'080003, 77세,2019,2353,1009,1344,75.1,2350,1007,1343,75
'32010, 춘천시,'080004, 78세,2019,2092,839,1253,67,2091,839,1252,67
'32010, 춘천시,'080005, 79세,2019,1887,752,1135,66.3,1886,751,1135,66.2
'32010, 춘천시,'085,80~84세,2019,7441,2822,4619,61.1,7430,2819,4611,61.1
'32010, 춘천시,'085001, 80세,2019,1798,711,1087,65.4,1795,710,1085,65.4
'32010, 춘천시,'085002, 81세,2019,1710,665,1045,63.6,1706,665,1041,63.9
'32010, 춘천시,'085003, 82세,2019,1448,564,884,63.8,1447,564,883,63.9
'32010, 춘천시,'085004, 83세,2019,1326,489,837,58.4,1324,487,837,58.2
'32010, 춘천시,'085005, 84세,2019,1159,393,766,51.3,1158,393,765,51.4
'32010, 춘천시,'086,85세이상,2019,5124,1439,3685,39.1,5113,1434,3679,39
'32010, 춘천시,'090,85~89세,2019,3389,1027,2362,43.5,3382,1024,2358,43.4
'32010, 춘천시,'090001, 85세,2019,923,300,623,48.2,922,299,623,48
'32010, 춘천시,'090002, 86세,2019,778,233,545,42.8,776,232,544,42.6
'32010, 춘천시,'090003, 87세,2019,650,189,461,41,648,189,459,41.2
'32010, 춘천시,'090004, 88세,2019,533,158,375,42.1,533,158,375,42.1
'32010, 춘천시,'090005, 89세,2019,505,147,358,41.1,503,146,357,40.9
'32010, 춘천시,'095,90~94세,2019,1382,310,1072,28.9,1382,310,1072,28.9
'32010, 춘천시,'095001, 90세,2019,436,117,319,36.7,436,117,319,36.7
'32010, 춘천시,'095002, 91세,2019,329,59,270,21.9,329,59,270,21.9
'32010, 춘천시,'095003, 92세,2019,281,57,224,25.4,281,57,224,25.4
'32010, 춘천시,'095004, 93세,2019,178,36,142,25.4,178,36,142,25.4
'32010, 춘천시,'095005, 94세,2019,158,41,117,35,158,41,117,35
'32010, 춘천시,'100,95~99세,2019,313,92,221,41.6,310,91,219,41.6
'32010, 춘천시,'100001, 95세,2019,97,28,69,40.6,97,28,69,40.6
'32010, 춘천시,'100002, 96세,2019,85,31,54,57.4,85,31,54,57.4
'32010, 춘천시,'100003, 97세,2019,57,19,38,50,55,19,36,52.8
'32010, 춘천시,'100004, 98세,2019,48,8,40,20,47,7,40,17.5
'32010, 춘천시,'100005, 99세,2019,26,6,20,30,26,6,20,30
'32010, 춘천시,'101,100세이상,2019,40,10,30,33.3,39,9,30,30
'32010, 춘천시,'102,15세미만,2019,34388,17712,16676,106.2,34234,17632,16602,106.2
'32010, 춘천시,'103,15~64세,2019,203644,102697,100947,101.7,198057,99744,98313,101.5
'32010, 춘천시,'104,65세이상,2019,46721,19686,27035,72.8,46587,19624,26963,72.8
'32010, 춘천시,'126,평균연령,2019,42.6,41.3,44,,42.8,41.5,44.2,
'32010, 춘천시,'127,중위연령,2019,43.6,41.9,45.1,,44.1,42.4,45.5,
'32020, 원주시,'000,합계,2019,349319,174245,175074,99.5,344184,171454,172730,99.3
'32020, 원주시,'005,0~4세,2019,12563,6443,6120,105.3,12504,6411,6093,105.2
'32020, 원주시,'005001, 0세,2019,2164,1107,1057,104.7,2151,1099,1052,104.5
'32020, 원주시,'005002, 1세,2019,2188,1117,1071,104.3,2180,1114,1066,104.5
'32020, 원주시,'005003, 2세,2019,2523,1296,1227,105.6,2512,1291,1221,105.7
'32020, 원주시,'005004, 3세,2019,2754,1436,1318,109,2740,1428,1312,108.8
'32020, 원주시,'005005, 4세,2019,2934,1487,1447,102.8,2921,1479,1442,102.6
'32020, 원주시,'010,5~9세,2019,15939,8063,7876,102.4,15910,8050,7860,102.4
'32020, 원주시,'010001, 5세,2019,2866,1455,1411,103.1,2856,1450,1406,103.1
'32020, 원주시,'010002, 6세,2019,2957,1491,1466,101.7,2955,1490,1465,101.7
'32020, 원주시,'010003, 7세,2019,3393,1708,1685,101.4,3388,1704,1684,101.2
'32020, 원주시,'010004, 8세,2019,3366,1715,1651,103.9,3359,1713,1646,104.1
'32020, 원주시,'010005, 9세,2019,3357,1694,1663,101.9,3352,1693,1659,102
'32020, 원주시,'015,10~14세,2019,16791,8684,8107,107.1,16757,8671,8086,107.2
'32020, 원주시,'015001, 10세,2019,3284,1715,1569,109.3,3277,1713,1564,109.5
'32020, 원주시,'015002, 11세,2019,3359,1733,1626,106.6,3354,1732,1622,106.8
'32020, 원주시,'015003, 12세,2019,3665,1885,1780,105.9,3658,1884,1774,106.2
'32020, 원주시,'015004, 13세,2019,3188,1634,1554,105.1,3181,1630,1551,105.1
'32020, 원주시,'015005, 14세,2019,3295,1717,1578,108.8,3287,1712,1575,108.7
'32020, 원주시,'020,15~19세,2019,20696,10953,9743,112.4,20530,10871,9659,112.5
'32020, 원주시,'020001, 15세,2019,3538,1845,1693,109,3533,1843,1690,109.1
'32020, 원주시,'020002, 16세,2019,3470,1856,1614,115,3465,1854,1611,115.1
'32020, 원주시,'020003, 17세,2019,3689,1908,1781,107.1,3682,1904,1778,107.1
'32020, 원주시,'020004, 18세,2019,4418,2370,2048,115.7,4369,2348,2021,116.2
'32020, 원주시,'020005, 19세,2019,5581,2974,2607,114.1,5481,2922,2559,114.2
'32020, 원주시,'025,20~24세,2019,26084,13982,12102,115.5,25304,13544,11760,115.2
'32020, 원주시,'025001, 20세,2019,5424,2853,2571,111,5278,2771,2507,110.5
'32020, 원주시,'025002, 21세,2019,5152,2666,2486,107.2,4994,2587,2407,107.5
'32020, 원주시,'025003, 22세,2019,5422,2835,2587,109.6,5262,2747,2515,109.2
'32020, 원주시,'025004, 23세,2019,5205,2869,2336,122.8,5062,2789,2273,122.7
'32020, 원주시,'025005, 24세,2019,4881,2759,2122,130,4708,2650,2058,128.8
'32020, 원주시,'030,25~29세,2019,22186,11923,10263,116.2,21370,11448,9922,115.4
'32020, 원주시,'030001, 25세,2019,4678,2644,2034,130,4513,2542,1971,129
'32020, 원주시,'030002, 26세,2019,4682,2597,2085,124.6,4506,2486,2020,123.1
'32020, 원주시,'030003, 27세,2019,4509,2368,2141,110.6,4361,2287,2074,110.3
'32020, 원주시,'030004, 28세,2019,4261,2204,2057,107.1,4094,2108,1986,106.1
'32020, 원주시,'030005, 29세,2019,4056,2110,1946,108.4,3896,2025,1871,108.2
'32020, 원주시,'035,30~34세,2019,20179,10547,9632,109.5,19357,10053,9304,108.1
'32020, 원주시,'035001, 30세,2019,3998,2147,1851,116,3828,2050,1778,115.3
'32020, 원주시,'035002, 31세,2019,3953,2030,1923,105.6,3788,1935,1853,104.4
'32020, 원주시,'035003, 32세,2019,3921,2032,1889,107.6,3756,1922,1834,104.8
'32020, 원주시,'035004, 33세,2019,4177,2155,2022,106.6,4008,2060,1948,105.7
'32020, 원주시,'035005, 34세,2019,4130,2183,1947,112.1,3977,2086,1891,110.3
'32020, 원주시,'040,35~39세,2019,25104,12608,12496,100.9,24521,12283,12238,100.4
'32020, 원주시,'040001, 35세,2019,4251,2179,2072,105.2,4122,2110,2012,104.9
'32020, 원주시,'040002, 36세,2019,4876,2470,2406,102.7,4752,2401,2351,102.1
'32020, 원주시,'040003, 37세,2019,5311,2633,2678,98.3,5198,2573,2625,98
'32020, 원주시,'040004, 38세,2019,5296,2696,2600,103.7,5182,2629,2553,103
'32020, 원주시,'040005, 39세,2019,5370,2630,2740,96,5267,2570,2697,95.3
'32020, 원주시,'045,40~44세,2019,25768,12739,13029,97.8,25297,12474,12823,97.3
'32020, 원주시,'045001, 40세,2019,5121,2542,2579,98.6,5015,2484,2531,98.1
'32020, 원주시,'045002, 41세,2019,5003,2478,2525,98.1,4902,2416,2486,97.2
'32020, 원주시,'045003, 42세,2019,5203,2571,2632,97.7,5107,2521,2586,97.5
'32020, 원주시,'045004, 43세,2019,5093,2492,2601,95.8,5010,2438,2572,94.8
'32020, 원주시,'045005, 44세,2019,5348,2656,2692,98.7,5263,2615,2648,98.8
'32020, 원주시,'050,45~49세,2019,30562,15151,15411,98.3,30157,14954,15203,98.4
'32020, 원주시,'050001, 45세,2019,6010,2878,3132,91.9,5934,2850,3084,92.4
'32020, 원주시,'050002, 46세,2019,6080,3015,3065,98.4,6004,2970,3034,97.9
'32020, 원주시,'050003, 47세,2019,5928,3012,2916,103.3,5848,2980,2868,103.9
'32020, 원주시,'050004, 48세,2019,6342,3166,3176,99.7,6255,3113,3142,99.1
'32020, 원주시,'050005, 49세,2019,6202,3080,3122,98.7,6116,3041,3075,98.9
'32020, 원주시,'055,50~54세,2019,29888,14931,14957,99.8,29574,14786,14788,100
'32020, 원주시,'055001, 50세,2019,6309,3150,3159,99.7,6239,3121,3118,100.1
'32020, 원주시,'055002, 51세,2019,6300,3199,3101,103.2,6232,3170,3062,103.5
'32020, 원주시,'055003, 52세,2019,5647,2748,2899,94.8,5586,2729,2857,95.5
'32020, 원주시,'055004, 53세,2019,5824,2968,2856,103.9,5770,2940,2830,103.9
'32020, 원주시,'055005, 54세,2019,5808,2866,2942,97.4,5747,2826,2921,96.7
'32020, 원주시,'060,55~59세,2019,29471,14848,14623,101.5,29200,14719,14481,101.6
'32020, 원주시,'060001, 55세,2019,5202,2641,2561,103.1,5139,2610,2529,103.2
'32020, 원주시,'060002, 56세,2019,5727,2928,2799,104.6,5663,2902,2761,105.1
'32020, 원주시,'060003, 57세,2019,5890,2963,2927,101.2,5840,2940,2900,101.4
'32020, 원주시,'060004, 58세,2019,6362,3231,3131,103.2,6307,3202,3105,103.1
'32020, 원주시,'060005, 59세,2019,6290,3085,3205,96.3,6251,3065,3186,96.2
'32020, 원주시,'065,60~64세,2019,24873,12480,12393,100.7,24699,12388,12311,100.6
'32020, 원주시,'065001, 60세,2019,5640,2771,2869,96.6,5595,2746,2849,96.4
'32020, 원주시,'065002, 61세,2019,5204,2598,2606,99.7,5171,2582,2589,99.7
'32020, 원주시,'065003, 62세,2019,5182,2661,2521,105.6,5145,2641,2504,105.5
'32020, 원주시,'065004, 63세,2019,4571,2310,2261,102.2,4537,2292,2245,102.1
'32020, 원주시,'065005, 64세,2019,4276,2140,2136,100.2,4251,2127,2124,100.1
'32020, 원주시,'070,65~69세,2019,14984,7303,7681,95.1,14868,7253,7615,95.2
'32020, 원주시,'070001, 65세,2019,3697,1868,1829,102.1,3671,1856,1815,102.3
'32020, 원주시,'070002, 66세,2019,2907,1441,1466,98.3,2883,1431,1452,98.6
'32020, 원주시,'070003, 67세,2019,4132,2012,2120,94.9,4111,2001,2110,94.8
'32020, 원주시,'070004, 68세,2019,2118,991,1127,87.9,2093,982,1111,88.4
'32020, 원주시,'070005, 69세,2019,2130,991,1139,87,2110,983,1127,87.2
'32020, 원주시,'075,70~74세,2019,10918,5070,5848,86.7,10870,5044,5826,86.6
'32020, 원주시,'075001, 70세,2019,2135,995,1140,87.3,2122,987,1135,87
'32020, 원주시,'075002, 71세,2019,2344,1117,1227,91,2327,1108,1219,90.9
'32020, 원주시,'075003, 72세,2019,2458,1136,1322,85.9,2454,1133,1321,85.8
'32020, 원주시,'075004, 73세,2019,1962,890,1072,83,1953,886,1067,83
'32020, 원주시,'075005, 74세,2019,2019,932,1087,85.7,2014,930,1084,85.8
'32020, 원주시,'080,75~79세,2019,10505,4332,6173,70.2,10484,4324,6160,70.2
'32020, 원주시,'080001, 75세,2019,2066,907,1159,78.3,2061,905,1156,78.3
'32020, 원주시,'080002, 76세,2019,2077,871,1206,72.2,2075,870,1205,72.2
'32020, 원주시,'080003, 77세,2019,2338,954,1384,68.9,2331,952,1379,69
'32020, 원주시,'080004, 78세,2019,2113,875,1238,70.7,2108,873,1235,70.7
'32020, 원주시,'080005, 79세,2019,1911,725,1186,61.1,1909,724,1185,61.1
'32020, 원주시,'085,80~84세,2019,7631,2831,4800,59,7620,2828,4792,59
'32020, 원주시,'085001, 80세,2019,1937,760,1177,64.6,1935,760,1175,64.7
'32020, 원주시,'085002, 81세,2019,1738,676,1062,63.7,1734,675,1059,63.7
'32020, 원주시,'085003, 82세,2019,1482,570,912,62.5,1479,569,910,62.5
'32020, 원주시,'085004, 83세,2019,1292,468,824,56.8,1292,468,824,56.8
'32020, 원주시,'085005, 84세,2019,1182,357,825,43.3,1180,356,824,43.2
'32020, 원주시,'086,85세이상,2019,5177,1357,3820,35.5,5162,1353,3809,35.5
'32020, 원주시,'090,85~89세,2019,3587,1001,2586,38.7,3577,997,2580,38.6
'32020, 원주시,'090001, 85세,2019,975,271,704,38.5,972,270,702,38.5
'32020, 원주시,'090002, 86세,2019,850,272,578,47.1,847,269,578,46.5
'32020, 원주시,'090003, 87세,2019,691,187,504,37.1,689,187,502,37.3
'32020, 원주시,'090004, 88세,2019,564,155,409,37.9,564,155,409,37.9
'32020, 원주시,'090005, 89세,2019,507,116,391,29.7,505,116,389,29.8
'32020, 원주시,'095,90~94세,2019,1275,289,986,29.3,1273,289,984,29.4
'32020, 원주시,'095001, 90세,2019,404,89,315,28.3,403,89,314,28.3
'32020, 원주시,'095002, 91세,2019,325,65,260,25,325,65,260,25
'32020, 원주시,'095003, 92세,2019,231,48,183,26.2,231,48,183,26.2
'32020, 원주시,'095004, 93세,2019,172,40,132,30.3,172,40,132,30.3
'32020, 원주시,'095005, 94세,2019,143,47,96,49,142,47,95,49.5
'32020, 원주시,'100,95~99세,2019,273,63,210,30,270,63,207,30.4
'32020, 원주시,'100001, 95세,2019,93,18,75,24,93,18,75,24
'32020, 원주시,'100002, 96세,2019,80,24,56,42.9,80,24,56,42.9
'32020, 원주시,'100003, 97세,2019,51,10,41,24.4,48,10,38,26.3
'32020, 원주시,'100004, 98세,2019,23,X,20,15,23,X,20,15
'32020, 원주시,'100005, 99세,2019,26,8,18,44.4,26,8,18,44.4
'32020, 원주시,'101,100세이상,2019,42,X,38,10.5,42,X,38,10.5
'32020, 원주시,'102,15세미만,2019,45293,23190,22103,104.9,45171,23132,22039,105
'32020, 원주시,'103,15~64세,2019,254811,130162,124649,104.4,250009,127520,122489,104.1
'32020, 원주시,'104,65세이상,2019,49215,20893,28322,73.8,49004,20802,28202,73.8
'32020, 원주시,'126,평균연령,2019,41.8,40.5,43,,41.8,40.6,43.1,
'32020, 원주시,'127,중위연령,2019,43,41.6,44.3,,43.2,41.8,44.5,
'32030, 강릉시,'000,합계,2019,216357,108707,107650,101,212865,106920,105945,100.9
'32030, 강릉시,'005,0~4세,2019,6017,3082,2935,105,5997,3074,2923,105.2
'32030, 강릉시,'005001, 0세,2019,1025,513,512,100.2,1021,511,510,100.2
'32030, 강릉시,'005002, 1세,2019,1105,610,495,123.2,1102,609,493,123.5
'32030, 강릉시,'005003, 2세,2019,1134,580,554,104.7,1129,579,550,105.3
'32030, 강릉시,'005004, 3세,2019,1341,686,655,104.7,1338,684,654,104.6
'32030, 강릉시,'005005, 4세,2019,1412,693,719,96.4,1407,691,716,96.5
'32030, 강릉시,'010,5~9세,2019,7898,4104,3794,108.2,7864,4085,3779,108.1
'32030, 강릉시,'010001, 5세,2019,1404,725,679,106.8,1395,719,676,106.4
'32030, 강릉시,'010002, 6세,2019,1441,763,678,112.5,1434,761,673,113.1
'32030, 강릉시,'010003, 7세,2019,1686,861,825,104.4,1679,856,823,104
'32030, 강릉시,'010004, 8세,2019,1710,890,820,108.5,1703,886,817,108.4
'32030, 강릉시,'010005, 9세,2019,1657,865,792,109.2,1653,863,790,109.2
'32030, 강릉시,'015,10~14세,2019,8652,4559,4093,111.4,8630,4547,4083,111.4
'32030, 강릉시,'015001, 10세,2019,1680,830,850,97.6,1677,828,849,97.5
'32030, 강릉시,'015002, 11세,2019,1673,862,811,106.3,1667,860,807,106.6
'32030, 강릉시,'015003, 12세,2019,1825,1005,820,122.6,1822,1004,818,122.7
'32030, 강릉시,'015004, 13세,2019,1725,951,774,122.9,1720,948,772,122.8
'32030, 강릉시,'015005, 14세,2019,1749,911,838,108.7,1744,907,837,108.4
'32030, 강릉시,'020,15~19세,2019,12966,6926,6040,114.7,12839,6869,5970,115.1
'32030, 강릉시,'020001, 15세,2019,1951,997,954,104.5,1947,995,952,104.5
'32030, 강릉시,'020002, 16세,2019,1964,1009,955,105.7,1961,1008,953,105.8
'32030, 강릉시,'020003, 17세,2019,2100,1103,997,110.6,2099,1103,996,110.7
'32030, 강릉시,'020004, 18세,2019,2779,1503,1276,117.8,2765,1498,1267,118.2
'32030, 강릉시,'020005, 19세,2019,4172,2314,1858,124.5,4067,2265,1802,125.7
'32030, 강릉시,'025,20~24세,2019,18256,10440,7816,133.6,17525,10066,7459,135
'32030, 강릉시,'025001, 20세,2019,3825,1978,1847,107.1,3687,1894,1793,105.6
'32030, 강릉시,'025002, 21세,2019,3624,1821,1803,101,3455,1744,1711,101.9
'32030, 강릉시,'025003, 22세,2019,3795,2204,1591,138.5,3646,2128,1518,140.2
'32030, 강릉시,'025004, 23세,2019,3587,2229,1358,164.1,3447,2154,1293,166.6
'32030, 강릉시,'025005, 24세,2019,3425,2208,1217,181.4,3290,2146,1144,187.6
'32030, 강릉시,'030,25~29세,2019,12226,7092,5134,138.1,11635,6792,4843,140.2
'32030, 강릉시,'030001, 25세,2019,3012,1843,1169,157.7,2865,1767,1098,160.9
'32030, 강릉시,'030002, 26세,2019,2604,1530,1074,142.5,2494,1476,1018,145
'32030, 강릉시,'030003, 27세,2019,2439,1387,1052,131.8,2334,1331,1003,132.7
'32030, 강릉시,'030004, 28세,2019,2164,1196,968,123.6,2049,1140,909,125.4
'32030, 강릉시,'030005, 29세,2019,2007,1136,871,130.4,1893,1078,815,132.3
'32030, 강릉시,'035,30~34세,2019,9580,5199,4381,118.7,9074,4927,4147,118.8
'32030, 강릉시,'035001, 30세,2019,1936,1086,850,127.8,1834,1029,805,127.8
'32030, 강릉시,'035002, 31세,2019,1874,1022,852,120,1762,966,796,121.4
'32030, 강릉시,'035003, 32세,2019,1907,1038,869,119.4,1796,981,815,120.4
'32030, 강릉시,'035004, 33세,2019,1919,1047,872,120.1,1822,990,832,119
'32030, 강릉시,'035005, 34세,2019,1944,1006,938,107.2,1860,961,899,106.9
'32030, 강릉시,'040,35~39세,2019,12669,6442,6227,103.5,12299,6240,6059,103
'32030, 강릉시,'040001, 35세,2019,2119,1116,1003,111.3,2041,1072,969,110.6
'32030, 강릉시,'040002, 36세,2019,2352,1204,1148,104.9,2283,1168,1115,104.8
'32030, 강릉시,'040003, 37세,2019,2629,1283,1346,95.3,2548,1235,1313,94.1
'32030, 강릉시,'040004, 38세,2019,2701,1411,1290,109.4,2643,1381,1262,109.4
'32030, 강릉시,'040005, 39세,2019,2868,1428,1440,99.2,2784,1384,1400,98.9
'32030, 강릉시,'045,40~44세,2019,14270,7227,7043,102.6,14007,7087,6920,102.4
'32030, 강릉시,'045001, 40세,2019,2821,1425,1396,102.1,2753,1384,1369,101.1
'32030, 강릉시,'045002, 41세,2019,2653,1331,1322,100.7,2600,1307,1293,101.1
'32030, 강릉시,'045003, 42세,2019,2801,1450,1351,107.3,2755,1423,1332,106.8
'32030, 강릉시,'045004, 43세,2019,2896,1448,1448,100,2850,1427,1423,100.3
'32030, 강릉시,'045005, 44세,2019,3099,1573,1526,103.1,3049,1546,1503,102.9
'32030, 강릉시,'050,45~49세,2019,17767,9183,8584,107,17533,9068,8465,107.1
'32030, 강릉시,'050001, 45세,2019,3492,1795,1697,105.8,3441,1766,1675,105.4
'32030, 강릉시,'050002, 46세,2019,3631,1846,1785,103.4,3582,1825,1757,103.9
'32030, 강릉시,'050003, 47세,2019,3302,1762,1540,114.4,3264,1745,1519,114.9
'32030, 강릉시,'050004, 48세,2019,3649,1876,1773,105.8,3601,1857,1744,106.5
'32030, 강릉시,'050005, 49세,2019,3693,1904,1789,106.4,3645,1875,1770,105.9
'32030, 강릉시,'055,50~54세,2019,17264,8690,8574,101.4,17062,8594,8468,101.5
'32030, 강릉시,'055001, 50세,2019,3584,1812,1772,102.3,3538,1793,1745,102.8
'32030, 강릉시,'055002, 51세,2019,3725,1887,1838,102.7,3683,1864,1819,102.5
'32030, 강릉시,'055003, 52세,2019,3363,1706,1657,103,3323,1686,1637,103
'32030, 강릉시,'055004, 53세,2019,3441,1779,1662,107,3398,1759,1639,107.3
'32030, 강릉시,'055005, 54세,2019,3151,1506,1645,91.6,3120,1492,1628,91.6
'32030, 강릉시,'060,55~59세,2019,18779,9232,9547,96.7,18627,9164,9463,96.8
'32030, 강릉시,'060001, 55세,2019,3223,1657,1566,105.8,3193,1643,1550,106
'32030, 강릉시,'060002, 56세,2019,3641,1805,1836,98.3,3606,1790,1816,98.6
'32030, 강릉시,'060003, 57세,2019,3696,1871,1825,102.5,3671,1861,1810,102.8
'32030, 강릉시,'060004, 58세,2019,4071,1894,2177,87,4039,1879,2160,87
'32030, 강릉시,'060005, 59세,2019,4148,2005,2143,93.6,4118,1991,2127,93.6
'32030, 강릉시,'065,60~64세,2019,17941,8709,9232,94.3,17831,8653,9178,94.3
'32030, 강릉시,'065001, 60세,2019,3947,1879,2068,90.9,3922,1863,2059,90.5
'32030, 강릉시,'065002, 61세,2019,3683,1827,1856,98.4,3664,1815,1849,98.2
'32030, 강릉시,'065003, 62세,2019,3746,1861,1885,98.7,3724,1851,1873,98.8
'32030, 강릉시,'065004, 63세,2019,3241,1553,1688,92,3217,1544,1673,92.3
'32030, 강릉시,'065005, 64세,2019,3324,1589,1735,91.6,3304,1580,1724,91.6
'32030, 강릉시,'070,65~69세,2019,12326,5796,6530,88.8,12256,5758,6498,88.6
'32030, 강릉시,'070001, 65세,2019,2916,1363,1553,87.8,2899,1351,1548,87.3
'32030, 강릉시,'070002, 66세,2019,2589,1222,1367,89.4,2571,1213,1358,89.3
'32030, 강릉시,'070003, 67세,2019,2970,1420,1550,91.6,2954,1412,1542,91.6
'32030, 강릉시,'070004, 68세,2019,1894,891,1003,88.8,1884,886,998,88.8
'32030, 강릉시,'070005, 69세,2019,1957,900,1057,85.1,1948,896,1052,85.2
'32030, 강릉시,'075,70~74세,2019,10269,4779,5490,87,10249,4772,5477,87.1
'32030, 강릉시,'075001, 70세,2019,2171,1015,1156,87.8,2165,1014,1151,88.1
'32030, 강릉시,'075002, 71세,2019,2224,1059,1165,90.9,2219,1057,1162,91
'32030, 강릉시,'075003, 72세,2019,2143,984,1159,84.9,2139,982,1157,84.9
'32030, 강릉시,'075004, 73세,2019,1745,830,915,90.7,1743,829,914,90.7
'32030, 강릉시,'075005, 74세,2019,1986,891,1095,81.4,1983,890,1093,81.4
'32030, 강릉시,'080,75~79세,2019,8986,3829,5157,74.2,8963,3816,5147,74.1
'32030, 강릉시,'080001, 75세,2019,1930,853,1077,79.2,1923,848,1075,78.9
'32030, 강릉시,'080002, 76세,2019,1785,768,1017,75.5,1782,767,1015,75.6
'32030, 강릉시,'080003, 77세,2019,1964,846,1118,75.7,1959,845,1114,75.9
'32030, 강릉시,'080004, 78세,2019,1640,663,977,67.9,1636,660,976,67.6
'32030, 강릉시,'080005, 79세,2019,1667,699,968,72.2,1663,696,967,72
'32030, 강릉시,'085,80~84세,2019,6130,2317,3813,60.8,6118,2311,3807,60.7
'32030, 강릉시,'085001, 80세,2019,1497,600,897,66.9,1494,598,896,66.7
'32030, 강릉시,'085002, 81세,2019,1416,559,857,65.2,1415,558,857,65.1
'32030, 강릉시,'085003, 82세,2019,1167,436,731,59.6,1161,433,728,59.5
'32030, 강릉시,'085004, 83세,2019,1065,398,667,59.7,1064,398,666,59.8
'32030, 강릉시,'085005, 84세,2019,985,324,661,49,984,324,660,49.1
'32030, 강릉시,'086,85세이상,2019,4361,1101,3260,33.8,4356,1097,3259,33.7
'32030, 강릉시,'090,85~89세,2019,2880,818,2062,39.7,2877,815,2062,39.5
'32030, 강릉시,'090001, 85세,2019,798,245,553,44.3,797,244,553,44.1
'32030, 강릉시,'090002, 86세,2019,658,197,461,42.7,657,196,461,42.5
'32030, 강릉시,'090003, 87세,2019,528,148,380,38.9,527,147,380,38.7
'32030, 강릉시,'090004, 88세,2019,449,121,328,36.9,449,121,328,36.9
'32030, 강릉시,'090005, 89세,2019,447,107,340,31.5,447,107,340,31.5
'32030, 강릉시,'095,90~94세,2019,1159,226,933,24.2,1158,225,933,24.1
'32030, 강릉시,'095001, 90세,2019,378,77,301,25.6,378,77,301,25.6
'32030, 강릉시,'095002, 91세,2019,256,51,205,24.9,256,51,205,24.9
'32030, 강릉시,'095003, 92세,2019,237,43,194,22.2,237,43,194,22.2
'32030, 강릉시,'095004, 93세,2019,163,30,133,22.6,162,29,133,21.8
'32030, 강릉시,'095005, 94세,2019,125,25,100,25,125,25,100,25
'32030, 강릉시,'100,95~99세,2019,283,52,231,22.5,282,52,230,22.6
'32030, 강릉시,'100001, 95세,2019,93,15,78,19.2,93,15,78,19.2
'32030, 강릉시,'100002, 96세,2019,82,16,66,24.2,82,16,66,24.2
'32030, 강릉시,'100003, 97세,2019,45,7,38,18.4,45,7,38,18.4
'32030, 강릉시,'100004, 98세,2019,41,11,30,36.7,41,11,30,36.7
'32030, 강릉시,'100005, 99세,2019,22,X,19,15.8,21,X,18,16.7
'32030, 강릉시,'101,100세이상,2019,39,5,34,14.7,39,5,34,14.7
'32030, 강릉시,'102,15세미만,2019,22567,11745,10822,108.5,22491,11706,10785,108.5
'32030, 강릉시,'103,15~64세,2019,151718,79140,72578,109,148432,77460,70972,109.1
'32030, 강릉시,'104,65세이상,2019,42072,17822,24250,73.5,41942,17754,24188,73.4
'32030, 강릉시,'126,평균연령,2019,44.7,42.8,46.6,,44.8,43,46.7,
'32030, 강릉시,'127,중위연령,2019,46.6,44.5,48.8,,46.9,44.9,49.1,
'32040, 동해시,'000,합계,2019,86780,44086,42694,103.3,85575,43365,42210,102.7
'32040, 동해시,'005,0~4세,2019,2882,1471,1411,104.3,2865,1460,1405,103.9
'32040, 동해시,'005001, 0세,2019,423,217,206,105.3,420,214,206,103.9
'32040, 동해시,'005002, 1세,2019,498,250,248,100.8,491,244,247,98.8
'32040, 동해시,'005003, 2세,2019,589,296,293,101,587,296,291,101.7
'32040, 동해시,'005004, 3세,2019,704,351,353,99.4,700,349,351,99.4
'32040, 동해시,'005005, 4세,2019,668,357,311,114.8,667,357,310,115.2
'32040, 동해시,'010,5~9세,2019,3995,2074,1921,108,3988,2071,1917,108
'32040, 동해시,'010001, 5세,2019,703,372,331,112.4,700,371,329,112.8
'32040, 동해시,'010002, 6세,2019,782,390,392,99.5,780,390,390,100
'32040, 동해시,'010003, 7세,2019,878,460,418,110,876,458,418,109.6
'32040, 동해시,'010004, 8세,2019,859,439,420,104.5,859,439,420,104.5
'32040, 동해시,'010005, 9세,2019,773,413,360,114.7,773,413,360,114.7
'32040, 동해시,'015,10~14세,2019,4137,2143,1994,107.5,4127,2139,1988,107.6
'32040, 동해시,'015001, 10세,2019,822,419,403,104,820,419,401,104.5
'32040, 동해시,'015002, 11세,2019,838,440,398,110.6,835,438,397,110.3
'32040, 동해시,'015003, 12세,2019,854,446,408,109.3,852,446,406,109.9
'32040, 동해시,'015004, 13세,2019,799,405,394,102.8,797,404,393,102.8
'32040, 동해시,'015005, 14세,2019,824,433,391,110.7,823,432,391,110.5
'32040, 동해시,'020,15~19세,2019,4115,2192,1923,114,4105,2190,1915,114.4
'32040, 동해시,'020001, 15세,2019,890,467,423,110.4,890,467,423,110.4
'32040, 동해시,'020002, 16세,2019,858,443,415,106.7,856,442,414,106.8
'32040, 동해시,'020003, 17세,2019,919,463,456,101.5,917,462,455,101.5
'32040, 동해시,'020004, 18세,2019,908,472,436,108.3,905,472,433,109
'32040, 동해시,'020005, 19세,2019,540,347,193,179.8,537,347,190,182.6
'32040, 동해시,'025,20~24세,2019,3919,2451,1468,167,3805,2387,1418,168.3
'32040, 동해시,'025001, 20세,2019,709,500,209,239.2,700,497,203,244.8
'32040, 동해시,'025002, 21세,2019,757,523,234,223.5,739,516,223,231.4
'32040, 동해시,'025003, 22세,2019,804,489,315,155.2,785,478,307,155.7
'32040, 동해시,'025004, 23세,2019,808,467,341,137,777,449,328,136.9
'32040, 동해시,'025005, 24세,2019,841,472,369,127.9,804,447,357,125.2
'32040, 동해시,'030,25~29세,2019,4141,2438,1703,143.2,3912,2286,1626,140.6
'32040, 동해시,'030001, 25세,2019,883,526,357,147.3,832,492,340,144.7
'32040, 동해시,'030002, 26세,2019,916,533,383,139.2,874,506,368,137.5
'32040, 동해시,'030003, 27세,2019,817,476,341,139.6,777,454,323,140.6
'32040, 동해시,'030004, 28세,2019,739,443,296,149.7,694,406,288,141
'32040, 동해시,'030005, 29세,2019,786,460,326,141.1,735,428,307,139.4
'32040, 동해시,'035,30~34세,2019,3942,2147,1795,119.6,3706,1995,1711,116.6
'32040, 동해시,'035001, 30세,2019,764,435,329,132.2,718,402,316,127.2
'32040, 동해시,'035002, 31세,2019,763,425,338,125.7,707,389,318,122.3
'32040, 동해시,'035003, 32세,2019,762,406,356,114,705,368,337,109.2
'32040, 동해시,'035004, 33세,2019,786,434,352,123.3,738,407,331,123
'32040, 동해시,'035005, 34세,2019,867,447,420,106.4,838,429,409,104.9
'32040, 동해시,'040,35~39세,2019,5756,3010,2746,109.6,5558,2877,2681,107.3
'32040, 동해시,'040001, 35세,2019,912,483,429,112.6,875,461,414,111.4
'32040, 동해시,'040002, 36세,2019,1080,580,500,116,1024,538,486,110.7
'32040, 동해시,'040003, 37세,2019,1205,635,570,111.4,1167,616,551,111.8
'32040, 동해시,'040004, 38세,2019,1283,690,593,116.4,1254,665,589,112.9
'32040, 동해시,'040005, 39세,2019,1276,622,654,95.1,1238,597,641,93.1
'32040, 동해시,'045,40~44세,2019,6511,3351,3160,106,6405,3279,3126,104.9
'32040, 동해시,'045001, 40세,2019,1269,634,635,99.8,1241,612,629,97.3
'32040, 동해시,'045002, 41세,2019,1276,624,652,95.7,1251,605,646,93.7
'32040, 동해시,'045003, 42세,2019,1304,680,624,109,1289,676,613,110.3
'32040, 동해시,'045004, 43세,2019,1271,663,608,109,1251,650,601,108.2
'32040, 동해시,'045005, 44세,2019,1391,750,641,117,1373,736,637,115.5
'32040, 동해시,'050,45~49세,2019,7963,4211,3752,112.2,7877,4168,3709,112.4
'32040, 동해시,'050001, 45세,2019,1595,828,767,108,1576,822,754,109
'32040, 동해시,'050002, 46세,2019,1614,892,722,123.5,1597,881,716,123
'32040, 동해시,'050003, 47세,2019,1491,809,682,118.6,1478,805,673,119.6
'32040, 동해시,'050004, 48세,2019,1665,822,843,97.5,1643,811,832,97.5
'32040, 동해시,'050005, 49세,2019,1598,860,738,116.5,1583,849,734,115.7
'32040, 동해시,'055,50~54세,2019,7498,3892,3606,107.9,7413,3851,3562,108.1
'32040, 동해시,'055001, 50세,2019,1631,822,809,101.6,1610,810,800,101.3
'32040, 동해시,'055002, 51세,2019,1570,861,709,121.4,1552,851,701,121.4
'32040, 동해시,'055003, 52세,2019,1481,761,720,105.7,1466,753,713,105.6
'32040, 동해시,'055004, 53세,2019,1435,733,702,104.4,1419,729,690,105.7
'32040, 동해시,'055005, 54세,2019,1381,715,666,107.4,1366,708,658,107.6
'32040, 동해시,'060,55~59세,2019,7774,3925,3849,102,7729,3906,3823,102.2
'32040, 동해시,'060001, 55세,2019,1360,714,646,110.5,1350,709,641,110.6
'32040, 동해시,'060002, 56세,2019,1447,735,712,103.2,1432,731,701,104.3
'32040, 동해시,'060003, 57세,2019,1555,799,756,105.7,1548,795,753,105.6
'32040, 동해시,'060004, 58세,2019,1617,807,810,99.6,1613,806,807,99.9
'32040, 동해시,'060005, 59세,2019,1795,870,925,94.1,1786,865,921,93.9
'32040, 동해시,'065,60~64세,2019,7322,3542,3780,93.7,7293,3529,3764,93.8
'32040, 동해시,'065001, 60세,2019,1559,743,816,91.1,1553,739,814,90.8
'32040, 동해시,'065002, 61세,2019,1499,693,806,86,1492,691,801,86.3
'32040, 동해시,'065003, 62세,2019,1526,759,767,99,1520,755,765,98.7
'32040, 동해시,'065004, 63세,2019,1294,644,650,99.1,1292,643,649,99.1
'32040, 동해시,'065005, 64세,2019,1444,703,741,94.9,1436,701,735,95.4
'32040, 동해시,'070,65~69세,2019,5114,2452,2662,92.1,5097,2445,2652,92.2
'32040, 동해시,'070001, 65세,2019,1246,586,660,88.8,1242,586,656,89.3
'32040, 동해시,'070002, 66세,2019,1133,571,562,101.6,1126,569,557,102.2
'32040, 동해시,'070003, 67세,2019,1146,538,608,88.5,1144,537,607,88.5
'32040, 동해시,'070004, 68세,2019,723,349,374,93.3,721,347,374,92.8
'32040, 동해시,'070005, 69세,2019,866,408,458,89.1,864,406,458,88.6
'32040, 동해시,'075,70~74세,2019,4073,1904,2169,87.8,4065,1902,2163,87.9
'32040, 동해시,'075001, 70세,2019,853,416,437,95.2,850,415,435,95.4
'32040, 동해시,'075002, 71세,2019,986,475,511,93,984,475,509,93.3
'32040, 동해시,'075003, 72세,2019,832,388,444,87.4,831,388,443,87.6
'32040, 동해시,'075004, 73세,2019,639,281,358,78.5,638,281,357,78.7
'32040, 동해시,'075005, 74세,2019,763,344,419,82.1,762,343,419,81.9
'32040, 동해시,'080,75~79세,2019,3726,1580,2146,73.6,3721,1579,2142,73.7
'32040, 동해시,'080001, 75세,2019,821,363,458,79.3,819,363,456,79.6
'32040, 동해시,'080002, 76세,2019,787,333,454,73.3,787,333,454,73.3
'32040, 동해시,'080003, 77세,2019,822,356,466,76.4,821,355,466,76.2
'32040, 동해시,'080004, 78세,2019,686,304,382,79.6,686,304,382,79.6
'32040, 동해시,'080005, 79세,2019,610,224,386,58,608,224,384,58.3
'32040, 동해시,'085,80~84세,2019,2351,920,1431,64.3,2350,919,1431,64.2
'32040, 동해시,'085001, 80세,2019,587,256,331,77.3,587,256,331,77.3
'32040, 동해시,'085002, 81세,2019,555,231,324,71.3,554,230,324,71
'32040, 동해시,'085003, 82세,2019,442,167,275,60.7,442,167,275,60.7
'32040, 동해시,'085004, 83세,2019,393,141,252,56,393,141,252,56
'32040, 동해시,'085005, 84세,2019,374,125,249,50.2,374,125,249,50.2
'32040, 동해시,'086,85세이상,2019,1561,383,1178,32.5,1559,382,1177,32.5
'32040, 동해시,'090,85~89세,2019,1115,301,814,37,1113,300,813,36.9
'32040, 동해시,'090001, 85세,2019,317,112,205,54.6,316,112,204,54.9
'32040, 동해시,'090002, 86세,2019,250,63,187,33.7,250,63,187,33.7
'32040, 동해시,'090003, 87세,2019,208,46,162,28.4,208,46,162,28.4
'32040, 동해시,'090004, 88세,2019,187,47,140,33.6,186,46,140,32.9
'32040, 동해시,'090005, 89세,2019,153,33,120,27.5,153,33,120,27.5
'32040, 동해시,'095,90~94세,2019,352,67,285,23.5,352,67,285,23.5
'32040, 동해시,'095001, 90세,2019,118,23,95,24.2,118,23,95,24.2
'32040, 동해시,'095002, 91세,2019,90,20,70,28.6,90,20,70,28.6
'32040, 동해시,'095003, 92세,2019,61,12,49,24.5,61,12,49,24.5
'32040, 동해시,'095004, 93세,2019,41,5,36,13.9,41,5,36,13.9
'32040, 동해시,'095005, 94세,2019,42,7,35,20,42,7,35,20
'32040, 동해시,'100,95~99세,2019,88,14,74,18.9,88,14,74,18.9
'32040, 동해시,'100001, 95세,2019,27,X,24,12.5,27,X,24,12.5
'32040, 동해시,'100002, 96세,2019,28,X,24,16.7,28,X,24,16.7
'32040, 동해시,'100003, 97세,2019,17,X,13,30.8,17,X,13,30.8
'32040, 동해시,'100004, 98세,2019,12,X,10,20,12,X,10,20
'32040, 동해시,'100005, 99세,2019,X,X,X,33.3,X,X,X,33.3
'32040, 동해시,'101,100세이상,2019,6,X,5,20,6,X,5,20
'32040, 동해시,'102,15세미만,2019,11014,5688,5326,106.8,10980,5670,5310,106.8
'32040, 동해시,'103,15~64세,2019,58941,31159,27782,112.2,57803,30468,27335,111.5
'32040, 동해시,'104,65세이상,2019,16825,7239,9586,75.5,16792,7227,9565,75.6
'32040, 동해시,'126,평균연령,2019,45.2,43.5,46.9,,45.3,43.6,47,
'32040, 동해시,'127,중위연령,2019,47.5,45.9,49.3,,47.8,46.2,49.5,
'32050, 태백시,'000,합계,2019,42474,21366,21108,101.2,42106,21259,20847,102
'32050, 태백시,'005,0~4세,2019,1156,597,559,106.8,1154,597,557,107.2
'32050, 태백시,'005001, 0세,2019,186,105,81,129.6,186,105,81,129.6
'32050, 태백시,'005002, 1세,2019,217,103,114,90.4,217,103,114,90.4
'32050, 태백시,'005003, 2세,2019,217,117,100,117,216,117,99,118.2
'32050, 태백시,'005004, 3세,2019,253,130,123,105.7,252,130,122,106.6
'32050, 태백시,'005005, 4세,2019,283,142,141,100.7,283,142,141,100.7
'32050, 태백시,'010,5~9세,2019,1715,863,852,101.3,1715,863,852,101.3
'32050, 태백시,'010001, 5세,2019,292,152,140,108.6,292,152,140,108.6
'32050, 태백시,'010002, 6세,2019,294,152,142,107,294,152,142,107
'32050, 태백시,'010003, 7세,2019,380,189,191,99,380,189,191,99
'32050, 태백시,'010004, 8세,2019,373,179,194,92.3,373,179,194,92.3
'32050, 태백시,'010005, 9세,2019,376,191,185,103.2,376,191,185,103.2
'32050, 태백시,'015,10~14세,2019,1804,922,882,104.5,1800,920,880,104.5
'32050, 태백시,'015001, 10세,2019,359,173,186,93,357,171,186,91.9
'32050, 태백시,'015002, 11세,2019,355,179,176,101.7,355,179,176,101.7
'32050, 태백시,'015003, 12세,2019,402,215,187,115,401,215,186,115.6
'32050, 태백시,'015004, 13세,2019,335,166,169,98.2,334,166,168,98.8
'32050, 태백시,'015005, 14세,2019,353,189,164,115.2,353,189,164,115.2
'32050, 태백시,'020,15~19세,2019,1966,1084,882,122.9,1961,1083,878,123.3
'32050, 태백시,'020001, 15세,2019,350,173,177,97.7,349,173,176,98.3
'32050, 태백시,'020002, 16세,2019,368,208,160,130,368,208,160,130
'32050, 태백시,'020003, 17세,2019,434,240,194,123.7,434,240,194,123.7
'32050, 태백시,'020004, 18세,2019,448,273,175,156,446,273,173,157.8
'32050, 태백시,'020005, 19세,2019,366,190,176,108,364,189,175,108
'32050, 태백시,'025,20~24세,2019,1807,1043,764,136.5,1788,1040,748,139
'32050, 태백시,'025001, 20세,2019,388,239,149,160.4,385,238,147,161.9
'32050, 태백시,'025002, 21세,2019,361,217,144,150.7,358,217,141,153.9
'32050, 태백시,'025003, 22세,2019,341,206,135,152.6,335,204,131,155.7
'32050, 태백시,'025004, 23세,2019,386,215,171,125.7,382,215,167,128.7
'32050, 태백시,'025005, 24세,2019,331,166,165,100.6,328,166,162,102.5
'32050, 태백시,'030,25~29세,2019,1529,811,718,113,1464,802,662,121.1
'32050, 태백시,'030001, 25세,2019,329,174,155,112.3,319,172,147,117
'32050, 태백시,'030002, 26세,2019,324,181,143,126.6,312,181,131,138.2
'32050, 태백시,'030003, 27세,2019,308,162,146,111,297,159,138,115.2
'32050, 태백시,'030004, 28세,2019,272,143,129,110.9,261,142,119,119.3
'32050, 태백시,'030005, 29세,2019,296,151,145,104.1,275,148,127,116.5
'32050, 태백시,'035,30~34세,2019,1574,825,749,110.1,1513,810,703,115.2
'32050, 태백시,'035001, 30세,2019,317,176,141,124.8,305,171,134,127.6
'32050, 태백시,'035002, 31세,2019,283,148,135,109.6,270,147,123,119.5
'32050, 태백시,'035003, 32세,2019,329,158,171,92.4,318,156,162,96.3
'32050, 태백시,'035004, 33세,2019,323,176,147,119.7,312,172,140,122.9
'32050, 태백시,'035005, 34세,2019,322,167,155,107.7,308,164,144,113.9
'32050, 태백시,'040,35~39세,2019,2635,1339,1296,103.3,2582,1329,1253,106.1
'32050, 태백시,'040001, 35세,2019,392,190,202,94.1,383,188,195,96.4
'32050, 태백시,'040002, 36세,2019,501,255,246,103.7,483,253,230,110
'32050, 태백시,'040003, 37세,2019,575,294,281,104.6,564,291,273,106.6
'32050, 태백시,'040004, 38세,2019,547,273,274,99.6,539,272,267,101.9
'32050, 태백시,'040005, 39세,2019,620,327,293,111.6,613,325,288,112.8
'32050, 태백시,'045,40~44세,2019,3076,1628,1448,112.4,3045,1614,1431,112.8
'32050, 태백시,'045001, 40세,2019,604,298,306,97.4,596,296,300,98.7
'32050, 태백시,'045002, 41세,2019,627,317,310,102.3,622,314,308,101.9
'32050, 태백시,'045003, 42세,2019,602,319,283,112.7,597,317,280,113.2
'32050, 태백시,'045004, 43세,2019,608,334,274,121.9,597,327,270,121.1
'32050, 태백시,'045005, 44세,2019,635,360,275,130.9,633,360,273,131.9
'32050, 태백시,'050,45~49세,2019,3535,1901,1634,116.3,3493,1886,1607,117.4
'32050, 태백시,'050001, 45세,2019,682,375,307,122.1,676,373,303,123.1
'32050, 태백시,'050002, 46세,2019,684,366,318,115.1,680,365,315,115.9
'32050, 태백시,'050003, 47세,2019,700,376,324,116,687,372,315,118.1
'32050, 태백시,'050004, 48세,2019,710,367,343,107,699,362,337,107.4
'32050, 태백시,'050005, 49세,2019,759,417,342,121.9,751,414,337,122.8
'32050, 태백시,'055,50~54세,2019,3701,1996,1705,117.1,3669,1981,1688,117.4
'32050, 태백시,'055001, 50세,2019,751,426,325,131.1,745,422,323,130.7
'32050, 태백시,'055002, 51세,2019,771,439,332,132.2,762,435,327,133
'32050, 태백시,'055003, 52세,2019,712,378,334,113.2,708,377,331,113.9
'32050, 태백시,'055004, 53세,2019,747,390,357,109.2,742,386,356,108.4
'32050, 태백시,'055005, 54세,2019,720,363,357,101.7,712,361,351,102.8
'32050, 태백시,'060,55~59세,2019,3974,2070,1904,108.7,3949,2058,1891,108.8
'32050, 태백시,'060001, 55세,2019,646,353,293,120.5,641,351,290,121
'32050, 태백시,'060002, 56세,2019,742,410,332,123.5,727,402,325,123.7
'32050, 태백시,'060003, 57세,2019,746,386,360,107.2,745,386,359,107.5
'32050, 태백시,'060004, 58세,2019,889,444,445,99.8,888,443,445,99.6
'32050, 태백시,'060005, 59세,2019,951,477,474,100.6,948,476,472,100.8
'32050, 태백시,'065,60~64세,2019,4133,2079,2054,101.2,4121,2077,2044,101.6
'32050, 태백시,'065001, 60세,2019,901,446,455,98,899,446,453,98.5
'32050, 태백시,'065002, 61세,2019,776,390,386,101,773,388,385,100.8
'32050, 태백시,'065003, 62세,2019,853,449,404,111.1,853,449,404,111.1
'32050, 태백시,'065004, 63세,2019,776,405,371,109.2,774,405,369,109.8
'32050, 태백시,'065005, 64세,2019,827,389,438,88.8,822,389,433,89.8
'32050, 태백시,'070,65~69세,2019,3111,1454,1657,87.7,3106,1452,1654,87.8
'32050, 태백시,'070001, 65세,2019,696,343,353,97.2,696,343,353,97.2
'32050, 태백시,'070002, 66세,2019,641,309,332,93.1,640,309,331,93.4
'32050, 태백시,'070003, 67세,2019,703,325,378,86,702,325,377,86.2
'32050, 태백시,'070004, 68세,2019,506,239,267,89.5,505,238,267,89.1
'32050, 태백시,'070005, 69세,2019,565,238,327,72.8,563,237,326,72.7
'32050, 태백시,'075,70~74세,2019,2544,1135,1409,80.6,2536,1130,1406,80.4
'32050, 태백시,'075001, 70세,2019,573,271,302,89.7,570,269,301,89.4
'32050, 태백시,'075002, 71세,2019,554,250,304,82.2,553,250,303,82.5
'32050, 태백시,'075003, 72세,2019,536,231,305,75.7,535,231,304,76
'32050, 태백시,'075004, 73세,2019,416,175,241,72.6,415,174,241,72.2
'32050, 태백시,'075005, 74세,2019,465,208,257,80.9,463,206,257,80.2
'32050, 태백시,'080,75~79세,2019,2205,959,1246,77,2203,957,1246,76.8
'32050, 태백시,'080001, 75세,2019,459,196,263,74.5,458,195,263,74.1
'32050, 태백시,'080002, 76세,2019,464,221,243,90.9,464,221,243,90.9
'32050, 태백시,'080003, 77세,2019,493,217,276,78.6,493,217,276,78.6
'32050, 태백시,'080004, 78세,2019,405,186,219,84.9,405,186,219,84.9
'32050, 태백시,'080005, 79세,2019,384,139,245,56.7,383,138,245,56.3
'32050, 태백시,'085,80~84세,2019,1342,494,848,58.3,1341,494,847,58.3
'32050, 태백시,'085001, 80세,2019,371,145,226,64.2,371,145,226,64.2
'32050, 태백시,'085002, 81세,2019,289,107,182,58.8,289,107,182,58.8
'32050, 태백시,'085003, 82세,2019,261,105,156,67.3,261,105,156,67.3
'32050, 태백시,'085004, 83세,2019,225,76,149,51,224,76,148,51.4
'32050, 태백시,'085005, 84세,2019,196,61,135,45.2,196,61,135,45.2
'32050, 태백시,'086,85세이상,2019,667,166,501,33.1,666,166,500,33.2
'32050, 태백시,'090,85~89세,2019,483,139,344,40.4,482,139,343,40.5
'32050, 태백시,'090001, 85세,2019,154,48,106,45.3,154,48,106,45.3
'32050, 태백시,'090002, 86세,2019,132,45,87,51.7,131,45,86,52.3
'32050, 태백시,'090003, 87세,2019,69,20,49,40.8,69,20,49,40.8
'32050, 태백시,'090004, 88세,2019,57,7,50,14,57,7,50,14
'32050, 태백시,'090005, 89세,2019,71,19,52,36.5,71,19,52,36.5
'32050, 태백시,'095,90~94세,2019,146,23,123,18.7,146,23,123,18.7
'32050, 태백시,'095001, 90세,2019,45,6,39,15.4,45,6,39,15.4
'32050, 태백시,'095002, 91세,2019,36,9,27,33.3,36,9,27,33.3
'32050, 태백시,'095003, 92세,2019,28,X,25,12,28,X,25,12
'32050, 태백시,'095004, 93세,2019,25,X,22,13.6,25,X,22,13.6
'32050, 태백시,'095005, 94세,2019,12,X,10,20,12,X,10,20
'32050, 태백시,'100,95~99세,2019,36,X,32,12.5,36,X,32,12.5
'32050, 태백시,'100001, 95세,2019,15,X,15,0,15,X,15,0
'32050, 태백시,'100002, 96세,2019,8,X,6,33.3,8,X,6,33.3
'32050, 태백시,'100003, 97세,2019,9,X,7,28.6,9,X,7,28.6
'32050, 태백시,'100004, 98세,2019,X,X,X,0,X,X,X,0
'32050, 태백시,'100005, 99세,2019,X,X,X,0,X,X,X,0
'32050, 태백시,'101,100세이상,2019,X,X,X,0,X,X,X,0
'32050, 태백시,'102,15세미만,2019,4675,2382,2293,103.9,4669,2380,2289,104
'32050, 태백시,'103,15~64세,2019,27930,14776,13154,112.3,27585,14680,12905,113.8
'32050, 태백시,'104,65세이상,2019,9869,4208,5661,74.3,9852,4199,5653,74.3
'32050, 태백시,'126,평균연령,2019,47.6,46.1,49.1,,47.6,46.1,49.2,
'32050, 태백시,'127,중위연령,2019,50.6,49.2,52.3,,50.7,49.2,52.6,
'32060, 속초시,'000,합계,2019,78643,39015,39628,98.5,77209,38163,39046,97.7
'32060, 속초시,'005,0~4세,2019,2650,1348,1302,103.5,2643,1343,1300,103.3
'32060, 속초시,'005001, 0세,2019,426,217,209,103.8,425,216,209,103.3
'32060, 속초시,'005002, 1세,2019,451,226,225,100.4,450,226,224,100.9
'32060, 속초시,'005003, 2세,2019,484,265,219,121,482,263,219,120.1
'32060, 속초시,'005004, 3세,2019,599,317,282,112.4,596,315,281,112.1
'32060, 속초시,'005005, 4세,2019,690,323,367,88,690,323,367,88
'32060, 속초시,'010,5~9세,2019,3254,1636,1618,101.1,3249,1635,1614,101.3
'32060, 속초시,'010001, 5세,2019,612,306,306,100,610,305,305,100
'32060, 속초시,'010002, 6세,2019,609,299,310,96.5,609,299,310,96.5
'32060, 속초시,'010003, 7세,2019,686,339,347,97.7,684,339,345,98.3
'32060, 속초시,'010004, 8세,2019,672,346,326,106.1,671,346,325,106.5
'32060, 속초시,'010005, 9세,2019,675,346,329,105.2,675,346,329,105.2
'32060, 속초시,'015,10~14세,2019,3297,1668,1629,102.4,3292,1666,1626,102.5
'32060, 속초시,'015001, 10세,2019,628,309,319,96.9,628,309,319,96.9
'32060, 속초시,'015002, 11세,2019,656,332,324,102.5,654,331,323,102.5
'32060, 속초시,'015003, 12세,2019,697,374,323,115.8,696,373,323,115.5
'32060, 속초시,'015004, 13세,2019,648,318,330,96.4,646,318,328,97
'32060, 속초시,'015005, 14세,2019,668,335,333,100.6,668,335,333,100.6
'32060, 속초시,'020,15~19세,2019,3676,1943,1733,112.1,3667,1940,1727,112.3
'32060, 속초시,'020001, 15세,2019,820,434,386,112.4,820,434,386,112.4
'32060, 속초시,'020002, 16세,2019,724,388,336,115.5,723,388,335,115.8
'32060, 속초시,'020003, 17세,2019,819,436,383,113.8,817,435,382,113.9
'32060, 속초시,'020004, 18세,2019,799,389,410,94.9,798,389,409,95.1
'32060, 속초시,'020005, 19세,2019,514,296,218,135.8,509,294,215,136.7
'32060, 속초시,'025,20~24세,2019,3616,2150,1466,146.7,3454,2063,1391,148.3
'32060, 속초시,'025001, 20세,2019,602,414,188,220.2,592,409,183,223.5
'32060, 속초시,'025002, 21세,2019,721,489,232,210.8,703,483,220,219.5
'32060, 속초시,'025003, 22세,2019,713,399,314,127.1,681,379,302,125.5
'32060, 속초시,'025004, 23세,2019,804,413,391,105.6,759,392,367,106.8
'32060, 속초시,'025005, 24세,2019,776,435,341,127.6,719,400,319,125.4
'32060, 속초시,'030,25~29세,2019,4170,2320,1850,125.4,3874,2140,1734,123.4
'32060, 속초시,'030001, 25세,2019,865,464,401,115.7,799,419,380,110.3
'32060, 속초시,'030002, 26세,2019,806,459,347,132.3,756,427,329,129.8
'32060, 속초시,'030003, 27세,2019,894,489,405,120.7,834,456,378,120.6
'32060, 속초시,'030004, 28세,2019,820,454,366,124,755,416,339,122.7
'32060, 속초시,'030005, 29세,2019,785,454,331,137.2,730,422,308,137
'32060, 속초시,'035,30~34세,2019,4050,2190,1860,117.7,3808,2043,1765,115.8
'32060, 속초시,'035001, 30세,2019,808,461,347,132.9,753,429,324,132.4
'32060, 속초시,'035002, 31세,2019,803,441,362,121.8,768,422,346,122
'32060, 속초시,'035003, 32세,2019,805,425,380,111.8,747,388,359,108.1
'32060, 속초시,'035004, 33세,2019,782,415,367,113.1,743,385,358,107.5
'32060, 속초시,'035005, 34세,2019,852,448,404,110.9,797,419,378,110.8
'32060, 속초시,'040,35~39세,2019,5226,2740,2486,110.2,5041,2621,2420,108.3
'32060, 속초시,'040001, 35세,2019,900,511,389,131.4,859,481,378,127.2
'32060, 속초시,'040002, 36세,2019,976,513,463,110.8,940,497,443,112.2
'32060, 속초시,'040003, 37세,2019,1118,573,545,105.1,1077,544,533,102.1
'32060, 속초시,'040004, 38세,2019,1109,579,530,109.2,1076,555,521,106.5
'32060, 속초시,'040005, 39세,2019,1123,564,559,100.9,1089,544,545,99.8
'32060, 속초시,'045,40~44세,2019,5450,2719,2731,99.6,5321,2627,2694,97.5
'32060, 속초시,'045001, 40세,2019,1102,553,549,100.7,1083,539,544,99.1
'32060, 속초시,'045002, 41세,2019,1069,532,537,99.1,1045,516,529,97.5
'32060, 속초시,'045003, 42세,2019,1068,533,535,99.6,1045,514,531,96.8
'32060, 속초시,'045004, 43세,2019,1078,548,530,103.4,1047,528,519,101.7
'32060, 속초시,'045005, 44세,2019,1133,553,580,95.3,1101,530,571,92.8
'32060, 속초시,'050,45~49세,2019,6975,3512,3463,101.4,6861,3432,3429,100.1
'32060, 속초시,'050001, 45세,2019,1337,696,641,108.6,1310,674,636,106
'32060, 속초시,'050002, 46세,2019,1316,658,658,100,1289,641,648,98.9
'32060, 속초시,'050003, 47세,2019,1353,672,681,98.7,1331,657,674,97.5
'32060, 속초시,'050004, 48세,2019,1457,709,748,94.8,1438,698,740,94.3
'32060, 속초시,'050005, 49세,2019,1512,777,735,105.7,1493,762,731,104.2
'32060, 속초시,'055,50~54세,2019,7193,3598,3595,100.1,7105,3551,3554,99.9
'32060, 속초시,'055001, 50세,2019,1548,784,764,102.6,1532,774,758,102.1
'32060, 속초시,'055002, 51세,2019,1569,754,815,92.5,1550,742,808,91.8
'32060, 속초시,'055003, 52세,2019,1391,673,718,93.7,1377,665,712,93.4
'32060, 속초시,'055004, 53세,2019,1341,720,621,115.9,1323,714,609,117.2
'32060, 속초시,'055005, 54세,2019,1344,667,677,98.5,1323,656,667,98.4
'32060, 속초시,'060,55~59세,2019,7676,3733,3943,94.7,7604,3710,3894,95.3
'32060, 속초시,'060001, 55세,2019,1386,683,703,97.2,1368,675,693,97.4
'32060, 속초시,'060002, 56세,2019,1498,739,759,97.4,1476,732,744,98.4
'32060, 속초시,'060003, 57세,2019,1445,737,708,104.1,1439,734,705,104.1
'32060, 속초시,'060004, 58세,2019,1681,793,888,89.3,1672,793,879,90.2
'32060, 속초시,'060005, 59세,2019,1666,781,885,88.2,1649,776,873,88.9
'32060, 속초시,'065,60~64세,2019,6932,3477,3455,100.6,6882,3452,3430,100.6
'32060, 속초시,'065001, 60세,2019,1500,723,777,93.1,1486,716,770,93
'32060, 속초시,'065002, 61세,2019,1450,732,718,101.9,1440,729,711,102.5
'32060, 속초시,'065003, 62세,2019,1389,701,688,101.9,1379,694,685,101.3
'32060, 속초시,'065004, 63세,2019,1251,643,608,105.8,1244,639,605,105.6
'32060, 속초시,'065005, 64세,2019,1342,678,664,102.1,1333,674,659,102.3
'32060, 속초시,'070,65~69세,2019,4361,2052,2309,88.9,4327,2031,2296,88.5
'32060, 속초시,'070001, 65세,2019,1178,563,615,91.5,1169,557,612,91
'32060, 속초시,'070002, 66세,2019,895,444,451,98.4,889,441,448,98.4
'32060, 속초시,'070003, 67세,2019,963,470,493,95.3,955,465,490,94.9
'32060, 속초시,'070004, 68세,2019,635,265,370,71.6,629,262,367,71.4
'32060, 속초시,'070005, 69세,2019,690,310,380,81.6,685,306,379,80.7
'32060, 속초시,'075,70~74세,2019,3609,1642,1967,83.5,3592,1633,1959,83.4
'32060, 속초시,'075001, 70세,2019,755,374,381,98.2,748,370,378,97.9
'32060, 속초시,'075002, 71세,2019,749,332,417,79.6,746,329,417,78.9
'32060, 속초시,'075003, 72세,2019,763,343,420,81.7,760,342,418,81.8
'32060, 속초시,'075004, 73세,2019,646,297,349,85.1,643,296,347,85.3
'32060, 속초시,'075005, 74세,2019,696,296,400,74,695,296,399,74.2
'32060, 속초시,'080,75~79세,2019,3034,1243,1791,69.4,3025,1239,1786,69.4
'32060, 속초시,'080001, 75세,2019,624,240,384,62.5,621,239,382,62.6
'32060, 속초시,'080002, 76세,2019,618,282,336,83.9,616,281,335,83.9
'32060, 속초시,'080003, 77세,2019,660,263,397,66.2,657,261,396,65.9
'32060, 속초시,'080004, 78세,2019,575,232,343,67.6,574,232,342,67.8
'32060, 속초시,'080005, 79세,2019,557,226,331,68.3,557,226,331,68.3
'32060, 속초시,'085,80~84세,2019,2003,704,1299,54.2,1999,702,1297,54.1
'32060, 속초시,'085001, 80세,2019,473,170,303,56.1,472,170,302,56.3
'32060, 속초시,'085002, 81세,2019,472,174,298,58.4,470,173,297,58.2
'32060, 속초시,'085003, 82세,2019,394,137,257,53.3,393,136,257,52.9
'32060, 속초시,'085004, 83세,2019,368,134,234,57.3,368,134,234,57.3
'32060, 속초시,'085005, 84세,2019,296,89,207,43,296,89,207,43
'32060, 속초시,'086,85세이상,2019,1471,340,1131,30.1,1465,335,1130,29.6
'32060, 속초시,'090,85~89세,2019,903,218,685,31.8,899,215,684,31.4
'32060, 속초시,'090001, 85세,2019,250,77,173,44.5,248,75,173,43.4
'32060, 속초시,'090002, 86세,2019,204,56,148,37.8,203,56,147,38.1
'32060, 속초시,'090003, 87세,2019,166,35,131,26.7,165,34,131,26
'32060, 속초시,'090004, 88세,2019,137,23,114,20.2,137,23,114,20.2
'32060, 속초시,'090005, 89세,2019,146,27,119,22.7,146,27,119,22.7
'32060, 속초시,'095,90~94세,2019,474,92,382,24.1,472,90,382,23.6
'32060, 속초시,'095001, 90세,2019,159,30,129,23.3,159,30,129,23.3
'32060, 속초시,'095002, 91세,2019,109,25,84,29.8,109,25,84,29.8
'32060, 속초시,'095003, 92세,2019,97,15,82,18.3,96,14,82,17.1
'32060, 속초시,'095004, 93세,2019,64,15,49,30.6,64,15,49,30.6
'32060, 속초시,'095005, 94세,2019,45,7,38,18.4,44,6,38,15.8
'32060, 속초시,'100,95~99세,2019,84,30,54,55.6,84,30,54,55.6
'32060, 속초시,'100001, 95세,2019,23,X,20,15,23,X,20,15
'32060, 속초시,'100002, 96세,2019,26,14,12,116.7,26,14,12,116.7
'32060, 속초시,'100003, 97세,2019,15,7,8,87.5,15,7,8,87.5
'32060, 속초시,'100004, 98세,2019,13,X,9,44.4,13,X,9,44.4
'32060, 속초시,'100005, 99세,2019,7,X,5,40,7,X,5,40
'32060, 속초시,'101,100세이상,2019,10,X,10,0,10,X,10,0
'32060, 속초시,'102,15세미만,2019,9201,4652,4549,102.3,9184,4644,4540,102.3
'32060, 속초시,'103,15~64세,2019,54964,28382,26582,106.8,53617,27579,26038,105.9
'32060, 속초시,'104,65세이상,2019,14478,5981,8497,70.4,14408,5940,8468,70.1
'32060, 속초시,'126,평균연령,2019,45.3,43.6,47,,45.4,43.7,47.1,
'32060, 속초시,'127,중위연령,2019,47.9,46.1,49.6,,48.2,46.5,49.8,
'32070, 삼척시,'000,합계,2019,67210,34827,32383,107.5,66197,34244,31953,107.2
'32070, 삼척시,'005,0~4세,2019,1825,918,907,101.2,1822,916,906,101.1
'32070, 삼척시,'005001, 0세,2019,348,157,191,82.2,348,157,191,82.2
'32070, 삼척시,'005002, 1세,2019,355,194,161,120.5,353,193,160,120.6
'32070, 삼척시,'005003, 2세,2019,348,180,168,107.1,348,180,168,107.1
'32070, 삼척시,'005004, 3세,2019,370,177,193,91.7,370,177,193,91.7
'32070, 삼척시,'005005, 4세,2019,404,210,194,108.2,403,209,194,107.7
'32070, 삼척시,'010,5~9세,2019,2246,1177,1069,110.1,2245,1177,1068,110.2
'32070, 삼척시,'010001, 5세,2019,429,229,200,114.5,428,229,199,115.1
'32070, 삼척시,'010002, 6세,2019,416,213,203,104.9,416,213,203,104.9
'32070, 삼척시,'010003, 7세,2019,494,262,232,112.9,494,262,232,112.9
'32070, 삼척시,'010004, 8세,2019,469,256,213,120.2,469,256,213,120.2
'32070, 삼척시,'010005, 9세,2019,438,217,221,98.2,438,217,221,98.2
'32070, 삼척시,'015,10~14세,2019,2326,1214,1112,109.2,2324,1214,1110,109.4
'32070, 삼척시,'015001, 10세,2019,467,248,219,113.2,467,248,219,113.2
'32070, 삼척시,'015002, 11세,2019,470,247,223,110.8,470,247,223,110.8
'32070, 삼척시,'015003, 12세,2019,478,237,241,98.3,478,237,241,98.3
'32070, 삼척시,'015004, 13세,2019,440,238,202,117.8,439,238,201,118.4
'32070, 삼척시,'015005, 14세,2019,471,244,227,107.5,470,244,226,108
'32070, 삼척시,'020,15~19세,2019,3610,2047,1563,131,3595,2035,1560,130.4
'32070, 삼척시,'020001, 15세,2019,458,222,236,94.1,458,222,236,94.1
'32070, 삼척시,'020002, 16세,2019,505,257,248,103.6,505,257,248,103.6
'32070, 삼척시,'020003, 17세,2019,538,288,250,115.2,537,287,250,114.8
'32070, 삼척시,'020004, 18세,2019,767,458,309,148.2,763,455,308,147.7
'32070, 삼척시,'020005, 19세,2019,1342,822,520,158.1,1332,814,518,157.1
'32070, 삼척시,'025,20~24세,2019,6181,3770,2411,156.4,6030,3677,2353,156.3
'32070, 삼척시,'025001, 20세,2019,1204,647,557,116.2,1179,634,545,116.3
'32070, 삼척시,'025002, 21세,2019,1162,588,574,102.4,1134,569,565,100.7
'32070, 삼척시,'025003, 22세,2019,1309,739,570,129.6,1281,726,555,130.8
'32070, 삼척시,'025004, 23세,2019,1321,922,399,231.1,1293,903,390,231.5
'32070, 삼척시,'025005, 24세,2019,1185,874,311,281,1143,845,298,283.6
'32070, 삼척시,'030,25~29세,2019,3219,1950,1269,153.7,2984,1814,1170,155
'32070, 삼척시,'030001, 25세,2019,853,603,250,241.2,806,574,232,247.4
'32070, 삼척시,'030002, 26세,2019,675,402,273,147.3,621,371,250,148.4
'32070, 삼척시,'030003, 27세,2019,593,324,269,120.4,542,292,250,116.8
'32070, 삼척시,'030004, 28세,2019,526,278,248,112.1,487,258,229,112.7
'32070, 삼척시,'030005, 29세,2019,572,343,229,149.8,528,319,209,152.6
'32070, 삼척시,'035,30~34세,2019,2747,1508,1239,121.7,2595,1405,1190,118.1
'32070, 삼척시,'035001, 30세,2019,544,313,231,135.5,507,287,220,130.5
'32070, 삼척시,'035002, 31세,2019,537,287,250,114.8,505,266,239,111.3
'32070, 삼척시,'035003, 32세,2019,562,312,250,124.8,528,286,242,118.2
'32070, 삼척시,'035004, 33세,2019,520,279,241,115.8,498,264,234,112.8
'32070, 삼척시,'035005, 34세,2019,584,317,267,118.7,557,302,255,118.4
'32070, 삼척시,'040,35~39세,2019,3620,1960,1660,118.1,3488,1878,1610,116.6
'32070, 삼척시,'040001, 35세,2019,619,345,274,125.9,598,329,269,122.3
'32070, 삼척시,'040002, 36세,2019,680,370,310,119.4,639,351,288,121.9
'32070, 삼척시,'040003, 37세,2019,756,408,348,117.2,739,396,343,115.5
'32070, 삼척시,'040004, 38세,2019,754,420,334,125.7,727,402,325,123.7
'32070, 삼척시,'040005, 39세,2019,811,417,394,105.8,785,400,385,103.9
'32070, 삼척시,'045,40~44세,2019,4054,2209,1845,119.7,3955,2152,1803,119.4
'32070, 삼척시,'045001, 40세,2019,766,425,341,124.6,739,405,334,121.3
'32070, 삼척시,'045002, 41세,2019,787,420,367,114.4,771,414,357,116
'32070, 삼척시,'045003, 42세,2019,782,433,349,124.1,768,423,345,122.6
'32070, 삼척시,'045004, 43세,2019,796,420,376,111.7,777,410,367,111.7
'32070, 삼척시,'045005, 44세,2019,923,511,412,124,900,500,400,125
'32070, 삼척시,'050,45~49세,2019,4969,2812,2157,130.4,4889,2775,2114,131.3
'32070, 삼척시,'050001, 45세,2019,1011,574,437,131.4,996,568,428,132.7
'32070, 삼척시,'050002, 46세,2019,990,569,421,135.2,977,563,414,136
'32070, 삼척시,'050003, 47세,2019,900,507,393,129,877,493,384,128.4
'32070, 삼척시,'050004, 48세,2019,1054,591,463,127.6,1041,587,454,129.3
'32070, 삼척시,'050005, 49세,2019,1014,571,443,128.9,998,564,434,130
'32070, 삼척시,'055,50~54세,2019,5218,2787,2431,114.6,5163,2767,2396,115.5
'32070, 삼척시,'055001, 50세,2019,1078,587,491,119.6,1067,583,484,120.5
'32070, 삼척시,'055002, 51세,2019,1091,604,487,124,1081,599,482,124.3
'32070, 삼척시,'055003, 52세,2019,1005,526,479,109.8,995,523,472,110.8
'32070, 삼척시,'055004, 53세,2019,1071,583,488,119.5,1059,580,479,121.1
'32070, 삼척시,'055005, 54세,2019,973,487,486,100.2,961,482,479,100.6
'32070, 삼척시,'060,55~59세,2019,6081,3159,2922,108.1,6039,3136,2903,108
'32070, 삼척시,'060001, 55세,2019,1030,562,468,120.1,1017,555,462,120.1
'32070, 삼척시,'060002, 56세,2019,1060,563,497,113.3,1045,555,490,113.3
'32070, 삼척시,'060003, 57세,2019,1167,607,560,108.4,1163,604,559,108.1
'32070, 삼척시,'060004, 58세,2019,1428,721,707,102,1423,718,705,101.8
'32070, 삼척시,'060005, 59세,2019,1396,706,690,102.3,1391,704,687,102.5
'32070, 삼척시,'065,60~64세,2019,5856,2921,2935,99.5,5830,2910,2920,99.7
'32070, 삼척시,'065001, 60세,2019,1290,645,645,100,1285,642,643,99.8
'32070, 삼척시,'065002, 61세,2019,1152,592,560,105.7,1145,589,556,105.9
'32070, 삼척시,'065003, 62세,2019,1215,610,605,100.8,1209,606,603,100.5
'32070, 삼척시,'065004, 63세,2019,1085,527,558,94.4,1077,526,551,95.5
'32070, 삼척시,'065005, 64세,2019,1114,547,567,96.5,1114,547,567,96.5
'32070, 삼척시,'070,65~69세,2019,4245,2098,2147,97.7,4232,2093,2139,97.8
'32070, 삼척시,'070001, 65세,2019,967,492,475,103.6,961,489,472,103.6
'32070, 삼척시,'070002, 66세,2019,904,445,459,96.9,901,444,457,97.2
'32070, 삼척시,'070003, 67세,2019,980,499,481,103.7,978,498,480,103.8
'32070, 삼척시,'070004, 68세,2019,620,287,333,86.2,618,287,331,86.7
'32070, 삼척시,'070005, 69세,2019,774,375,399,94,774,375,399,94
'32070, 삼척시,'075,70~74세,2019,3581,1704,1877,90.8,3579,1704,1875,90.9
'32070, 삼척시,'075001, 70세,2019,803,397,406,97.8,802,397,405,98
'32070, 삼척시,'075002, 71세,2019,836,377,459,82.1,836,377,459,82.1
'32070, 삼척시,'075003, 72세,2019,703,355,348,102,702,355,347,102.3
'32070, 삼척시,'075004, 73세,2019,583,276,307,89.9,583,276,307,89.9
'32070, 삼척시,'075005, 74세,2019,656,299,357,83.8,656,299,357,83.8
'32070, 삼척시,'080,75~79세,2019,3416,1343,2073,64.8,3412,1341,2071,64.8
'32070, 삼척시,'080001, 75세,2019,691,289,402,71.9,689,288,401,71.8
'32070, 삼척시,'080002, 76세,2019,734,302,432,69.9,733,302,431,70.1
'32070, 삼척시,'080003, 77세,2019,723,272,451,60.3,723,272,451,60.3
'32070, 삼척시,'080004, 78세,2019,649,235,414,56.8,648,234,414,56.5
'32070, 삼척시,'080005, 79세,2019,619,245,374,65.5,619,245,374,65.5
'32070, 삼척시,'085,80~84세,2019,2385,843,1542,54.7,2385,843,1542,54.7
'32070, 삼척시,'085001, 80세,2019,581,222,359,61.8,581,222,359,61.8
'32070, 삼척시,'085002, 81세,2019,516,184,332,55.4,516,184,332,55.4
'32070, 삼척시,'085003, 82세,2019,449,153,296,51.7,449,153,296,51.7
'32070, 삼척시,'085004, 83세,2019,430,144,286,50.3,430,144,286,50.3
'32070, 삼척시,'085005, 84세,2019,409,140,269,52,409,140,269,52
'32070, 삼척시,'086,85세이상,2019,1631,407,1224,33.3,1630,407,1223,33.3
'32070, 삼척시,'090,85~89세,2019,1165,316,849,37.2,1165,316,849,37.2
'32070, 삼척시,'090001, 85세,2019,342,102,240,42.5,342,102,240,42.5
'32070, 삼척시,'090002, 86세,2019,242,66,176,37.5,242,66,176,37.5
'32070, 삼척시,'090003, 87세,2019,251,72,179,40.2,251,72,179,40.2
'32070, 삼척시,'090004, 88세,2019,176,44,132,33.3,176,44,132,33.3
'32070, 삼척시,'090005, 89세,2019,154,32,122,26.2,154,32,122,26.2
'32070, 삼척시,'095,90~94세,2019,387,80,307,26.1,386,80,306,26.1
'32070, 삼척시,'095001, 90세,2019,130,26,104,25,130,26,104,25
'32070, 삼척시,'095002, 91세,2019,89,24,65,36.9,89,24,65,36.9
'32070, 삼척시,'095003, 92세,2019,67,14,53,26.4,66,14,52,26.9
'32070, 삼척시,'095004, 93세,2019,56,8,48,16.7,56,8,48,16.7
'32070, 삼척시,'095005, 94세,2019,45,8,37,21.6,45,8,37,21.6
'32070, 삼척시,'100,95~99세,2019,73,10,63,15.9,73,10,63,15.9
'32070, 삼척시,'100001, 95세,2019,28,6,22,27.3,28,6,22,27.3
'32070, 삼척시,'100002, 96세,2019,19,X,17,11.8,19,X,17,11.8
'32070, 삼척시,'100003, 97세,2019,15,X,13,15.4,15,X,13,15.4
'32070, 삼척시,'100004, 98세,2019,10,X,10,0,10,X,10,0
'32070, 삼척시,'100005, 99세,2019,X,X,X,0,X,X,X,0
'32070, 삼척시,'101,100세이상,2019,6,X,5,20,6,X,5,20
'32070, 삼척시,'102,15세미만,2019,6397,3309,3088,107.2,6391,3307,3084,107.2
'32070, 삼척시,'103,15~64세,2019,45555,25123,20432,123,44568,24549,20019,122.6
'32070, 삼척시,'104,65세이상,2019,15258,6395,8863,72.2,15238,6388,8850,72.2
'32070, 삼척시,'126,평균연령,2019,46.4,44.1,48.8,,46.5,44.3,49,
'32070, 삼척시,'127,중위연령,2019,48.8,46.2,52,,49.2,46.5,52.3,
'32310, 홍천군,'000,합계,2019,66634,34090,32544,104.8,65216,33291,31925,104.3
'32310, 홍천군,'005,0~4세,2019,1782,930,852,109.2,1772,923,849,108.7
'32310, 홍천군,'005001, 0세,2019,286,138,148,93.2,284,138,146,94.5
'32310, 홍천군,'005002, 1세,2019,329,171,158,108.2,328,170,158,107.6
'32310, 홍천군,'005003, 2세,2019,360,179,181,98.9,357,177,180,98.3
'32310, 홍천군,'005004, 3세,2019,396,228,168,135.7,394,226,168,134.5
'32310, 홍천군,'005005, 4세,2019,411,214,197,108.6,409,212,197,107.6
'32310, 홍천군,'010,5~9세,2019,2218,1083,1135,95.4,2214,1079,1135,95.1
'32310, 홍천군,'010001, 5세,2019,407,198,209,94.7,406,197,209,94.3
'32310, 홍천군,'010002, 6세,2019,385,200,185,108.1,385,200,185,108.1
'32310, 홍천군,'010003, 7세,2019,483,228,255,89.4,482,227,255,89
'32310, 홍천군,'010004, 8세,2019,454,219,235,93.2,453,218,235,92.8
'32310, 홍천군,'010005, 9세,2019,489,238,251,94.8,488,237,251,94.4
'32310, 홍천군,'015,10~14세,2019,2451,1270,1181,107.5,2443,1268,1175,107.9
'32310, 홍천군,'015001, 10세,2019,473,256,217,118,471,256,215,119.1
'32310, 홍천군,'015002, 11세,2019,485,230,255,90.2,483,229,254,90.2
'32310, 홍천군,'015003, 12세,2019,508,253,255,99.2,507,253,254,99.6
'32310, 홍천군,'015004, 13세,2019,469,256,213,120.2,466,255,211,120.9
'32310, 홍천군,'015005, 14세,2019,516,275,241,114.1,516,275,241,114.1
'32310, 홍천군,'020,15~19세,2019,2814,1446,1368,105.7,2797,1438,1359,105.8
'32310, 홍천군,'020001, 15세,2019,529,268,261,102.7,529,268,261,102.7
'32310, 홍천군,'020002, 16세,2019,635,290,345,84.1,633,289,344,84
'32310, 홍천군,'020003, 17세,2019,634,322,312,103.2,633,321,312,102.9
'32310, 홍천군,'020004, 18세,2019,637,332,305,108.9,632,329,303,108.6
'32310, 홍천군,'020005, 19세,2019,379,234,145,161.4,370,231,139,166.2
'32310, 홍천군,'025,20~24세,2019,2863,1695,1168,145.1,2715,1594,1121,142.2
'32310, 홍천군,'025001, 20세,2019,505,324,181,179,497,318,179,177.7
'32310, 홍천군,'025002, 21세,2019,574,350,224,156.3,545,329,216,152.3
'32310, 홍천군,'025003, 22세,2019,548,314,234,134.2,517,296,221,133.9
'32310, 홍천군,'025004, 23세,2019,619,338,281,120.3,583,312,271,115.1
'32310, 홍천군,'025005, 24세,2019,617,369,248,148.8,573,339,234,144.9
'32310, 홍천군,'030,25~29세,2019,3362,1989,1373,144.9,3060,1796,1264,142.1
'32310, 홍천군,'030001, 25세,2019,638,366,272,134.6,591,343,248,138.3
'32310, 홍천군,'030002, 26세,2019,710,431,279,154.5,640,379,261,145.2
'32310, 홍천군,'030003, 27세,2019,713,423,290,145.9,653,382,271,141
'32310, 홍천군,'030004, 28세,2019,694,406,288,141,630,367,263,139.5
'32310, 홍천군,'030005, 29세,2019,607,363,244,148.8,546,325,221,147.1
'32310, 홍천군,'035,30~34세,2019,3080,1759,1321,133.2,2807,1590,1217,130.6
'32310, 홍천군,'035001, 30세,2019,652,397,255,155.7,587,352,235,149.8
'32310, 홍천군,'035002, 31세,2019,614,347,267,130,571,319,252,126.6
'32310, 홍천군,'035003, 32세,2019,606,354,252,140.5,554,322,232,138.8
'32310, 홍천군,'035004, 33세,2019,573,323,250,129.2,521,292,229,127.5
'32310, 홍천군,'035005, 34세,2019,635,338,297,113.8,574,305,269,113.4
'32310, 홍천군,'040,35~39세,2019,3552,1905,1647,115.7,3365,1789,1576,113.5
'32310, 홍천군,'040001, 35세,2019,608,330,278,118.7,566,305,261,116.9
'32310, 홍천군,'040002, 36세,2019,659,361,298,121.1,615,332,283,117.3
'32310, 홍천군,'040003, 37세,2019,774,403,371,108.6,733,379,354,107.1
'32310, 홍천군,'040004, 38세,2019,743,408,335,121.8,720,394,326,120.9
'32310, 홍천군,'040005, 39세,2019,768,403,365,110.4,731,379,352,107.7
'32310, 홍천군,'045,40~44세,2019,3606,1899,1707,111.2,3507,1855,1652,112.3
'32310, 홍천군,'045001, 40세,2019,668,335,333,100.6,640,321,319,100.6
'32310, 홍천군,'045002, 41세,2019,687,381,306,124.5,664,371,293,126.6
'32310, 홍천군,'045003, 42세,2019,767,395,372,106.2,747,385,362,106.4
'32310, 홍천군,'045004, 43세,2019,726,378,348,108.6,711,372,339,109.7
'32310, 홍천군,'045005, 44세,2019,758,410,348,117.8,745,406,339,119.8
'32310, 홍천군,'050,45~49세,2019,4602,2479,2123,116.8,4524,2442,2082,117.3
'32310, 홍천군,'050001, 45세,2019,889,490,399,122.8,873,485,388,125
'32310, 홍천군,'050002, 46세,2019,916,495,421,117.6,903,491,412,119.2
'32310, 홍천군,'050003, 47세,2019,893,483,410,117.8,878,471,407,115.7
'32310, 홍천군,'050004, 48세,2019,949,506,443,114.2,935,497,438,113.5
'32310, 홍천군,'050005, 49세,2019,955,505,450,112.2,935,498,437,114
'32310, 홍천군,'055,50~54세,2019,5496,2852,2644,107.9,5393,2815,2578,109.2
'32310, 홍천군,'055001, 50세,2019,1108,573,535,107.1,1082,563,519,108.5
'32310, 홍천군,'055002, 51세,2019,1140,595,545,109.2,1122,592,530,111.7
'32310, 홍천군,'055003, 52세,2019,1068,538,530,101.5,1056,533,523,101.9
'32310, 홍천군,'055004, 53세,2019,1125,603,522,115.5,1104,594,510,116.5
'32310, 홍천군,'055005, 54세,2019,1055,543,512,106.1,1029,533,496,107.5
'32310, 홍천군,'060,55~59세,2019,7034,3617,3417,105.9,6957,3581,3376,106.1
'32310, 홍천군,'060001, 55세,2019,1214,674,540,124.8,1190,665,525,126.7
'32310, 홍천군,'060002, 56세,2019,1273,668,605,110.4,1264,665,599,111
'32310, 홍천군,'060003, 57세,2019,1421,742,679,109.3,1405,733,672,109.1
'32310, 홍천군,'060004, 58세,2019,1664,833,831,100.2,1651,826,825,100.1
'32310, 홍천군,'060005, 59세,2019,1462,700,762,91.9,1447,692,755,91.7
'32310, 홍천군,'065,60~64세,2019,7345,3838,3507,109.4,7289,3816,3473,109.9
'32310, 홍천군,'065001, 60세,2019,1451,759,692,109.7,1438,755,683,110.5
'32310, 홍천군,'065002, 61세,2019,1567,802,765,104.8,1549,796,753,105.7
'32310, 홍천군,'065003, 62세,2019,1546,816,730,111.8,1536,810,726,111.6
'32310, 홍천군,'065004, 63세,2019,1425,747,678,110.2,1419,744,675,110.2
'32310, 홍천군,'065005, 64세,2019,1356,714,642,111.2,1347,711,636,111.8
'32310, 홍천군,'070,65~69세,2019,4713,2469,2244,110,4681,2454,2227,110.2
'32310, 홍천군,'070001, 65세,2019,1147,601,546,110.1,1138,595,543,109.6
'32310, 홍천군,'070002, 66세,2019,951,489,462,105.8,943,485,458,105.9
'32310, 홍천군,'070003, 67세,2019,1281,695,586,118.6,1274,694,580,119.7
'32310, 홍천군,'070004, 68세,2019,643,330,313,105.4,639,328,311,105.5
'32310, 홍천군,'070005, 69세,2019,691,354,337,105,687,352,335,105.1
'32310, 홍천군,'075,70~74세,2019,3657,1820,1837,99.1,3645,1817,1828,99.4
'32310, 홍천군,'075001, 70세,2019,685,359,326,110.1,682,358,324,110.5
'32310, 홍천군,'075002, 71세,2019,777,383,394,97.2,774,381,393,96.9
'32310, 홍천군,'075003, 72세,2019,810,418,392,106.6,808,418,390,107.2
'32310, 홍천군,'075004, 73세,2019,711,337,374,90.1,709,337,372,90.6
'32310, 홍천군,'075005, 74세,2019,674,323,351,92,672,323,349,92.6
'32310, 홍천군,'080,75~79세,2019,3496,1512,1984,76.2,3488,1509,1979,76.3
'32310, 홍천군,'080001, 75세,2019,631,290,341,85,630,289,341,84.8
'32310, 홍천군,'080002, 76세,2019,687,297,390,76.2,682,295,387,76.2
'32310, 홍천군,'080003, 77세,2019,788,324,464,69.8,787,324,463,70
'32310, 홍천군,'080004, 78세,2019,715,318,397,80.1,714,318,396,80.3
'32310, 홍천군,'080005, 79세,2019,675,283,392,72.2,675,283,392,72.2
'32310, 홍천군,'085,80~84세,2019,2757,1057,1700,62.2,2754,1055,1699,62.1
'32310, 홍천군,'085001, 80세,2019,650,247,403,61.3,650,247,403,61.3
'32310, 홍천군,'085002, 81세,2019,634,263,371,70.9,633,263,370,71.1
'32310, 홍천군,'085003, 82세,2019,557,225,332,67.8,555,223,332,67.2
'32310, 홍천군,'085004, 83세,2019,480,184,296,62.2,480,184,296,62.2
'32310, 홍천군,'085005, 84세,2019,436,138,298,46.3,436,138,298,46.3
'32310, 홍천군,'086,85세이상,2019,1806,470,1336,35.2,1805,470,1335,35.2
'32310, 홍천군,'090,85~89세,2019,1260,327,933,35,1259,327,932,35.1
'32310, 홍천군,'090001, 85세,2019,370,105,265,39.6,370,105,265,39.6
'32310, 홍천군,'090002, 86세,2019,274,76,198,38.4,274,76,198,38.4
'32310, 홍천군,'090003, 87세,2019,216,54,162,33.3,216,54,162,33.3
'32310, 홍천군,'090004, 88세,2019,197,42,155,27.1,197,42,155,27.1
'32310, 홍천군,'090005, 89세,2019,203,50,153,32.7,202,50,152,32.9
'32310, 홍천군,'095,90~94세,2019,429,110,319,34.5,429,110,319,34.5
'32310, 홍천군,'095001, 90세,2019,134,34,100,34,134,34,100,34
'32310, 홍천군,'095002, 91세,2019,102,28,74,37.8,102,28,74,37.8
'32310, 홍천군,'095003, 92세,2019,70,14,56,25,70,14,56,25
'32310, 홍천군,'095004, 93세,2019,62,15,47,31.9,62,15,47,31.9
'32310, 홍천군,'095005, 94세,2019,61,19,42,45.2,61,19,42,45.2
'32310, 홍천군,'100,95~99세,2019,100,29,71,40.8,100,29,71,40.8
'32310, 홍천군,'100001, 95세,2019,35,15,20,75,35,15,20,75
'32310, 홍천군,'100002, 96세,2019,26,8,18,44.4,26,8,18,44.4
'32310, 홍천군,'100003, 97세,2019,15,X,13,15.4,15,X,13,15.4
'32310, 홍천군,'100004, 98세,2019,11,X,9,22.2,11,X,9,22.2
'32310, 홍천군,'100005, 99세,2019,13,X,11,18.2,13,X,11,18.2
'32310, 홍천군,'101,100세이상,2019,17,X,13,30.8,17,X,13,30.8
'32310, 홍천군,'102,15세미만,2019,6451,3283,3168,103.6,6429,3270,3159,103.5
'32310, 홍천군,'103,15~64세,2019,43754,23479,20275,115.8,42414,22716,19698,115.3
'32310, 홍천군,'104,65세이상,2019,16429,7328,9101,80.5,16373,7305,9068,80.6
'32310, 홍천군,'126,평균연령,2019,48.9,47.3,50.5,,49.1,47.6,50.7,
'32310, 홍천군,'127,중위연령,2019,52.7,51,54.5,,53.1,51.5,54.9,
'32320, 횡성군,'000,합계,2019,44431,22615,21816,103.7,43422,22052,21370,103.2
'32320, 횡성군,'005,0~4세,2019,1014,534,480,111.3,1011,533,478,111.5
'32320, 횡성군,'005001, 0세,2019,181,102,79,129.1,181,102,79,129.1
'32320, 횡성군,'005002, 1세,2019,162,93,69,134.8,161,92,69,133.3
'32320, 횡성군,'005003, 2세,2019,221,113,108,104.6,220,113,107,105.6
'32320, 횡성군,'005004, 3세,2019,206,111,95,116.8,205,111,94,118.1
'32320, 횡성군,'005005, 4세,2019,244,115,129,89.1,244,115,129,89.1
'32320, 횡성군,'010,5~9세,2019,1251,638,613,104.1,1247,637,610,104.4
'32320, 횡성군,'010001, 5세,2019,212,103,109,94.5,211,103,108,95.4
'32320, 횡성군,'010002, 6세,2019,235,119,116,102.6,234,119,115,103.5
'32320, 횡성군,'010003, 7세,2019,266,137,129,106.2,265,136,129,105.4
'32320, 횡성군,'010004, 8세,2019,267,146,121,120.7,267,146,121,120.7
'32320, 횡성군,'010005, 9세,2019,271,133,138,96.4,270,133,137,97.1
'32320, 횡성군,'015,10~14세,2019,1447,746,701,106.4,1438,740,698,106
'32320, 횡성군,'015001, 10세,2019,284,143,141,101.4,282,142,140,101.4
'32320, 횡성군,'015002, 11세,2019,285,164,121,135.5,282,162,120,135
'32320, 횡성군,'015003, 12세,2019,305,158,147,107.5,303,157,146,107.5
'32320, 횡성군,'015004, 13세,2019,279,141,138,102.2,278,140,138,101.4
'32320, 횡성군,'015005, 14세,2019,294,140,154,90.9,293,139,154,90.3
'32320, 횡성군,'020,15~19세,2019,2160,1150,1010,113.9,2152,1145,1007,113.7
'32320, 횡성군,'020001, 15세,2019,309,177,132,134.1,308,176,132,133.3
'32320, 횡성군,'020002, 16세,2019,487,250,237,105.5,487,250,237,105.5
'32320, 횡성군,'020003, 17세,2019,498,259,239,108.4,498,259,239,108.4
'32320, 횡성군,'020004, 18세,2019,471,243,228,106.6,470,243,227,107
'32320, 횡성군,'020005, 19세,2019,395,221,174,127,389,217,172,126.2
'32320, 횡성군,'025,20~24세,2019,2117,1206,911,132.4,1989,1126,863,130.5
'32320, 횡성군,'025001, 20세,2019,439,255,184,138.6,426,245,181,135.4
'32320, 횡성군,'025002, 21세,2019,444,265,179,148,428,255,173,147.4
'32320, 횡성군,'025003, 22세,2019,410,218,192,113.5,375,199,176,113.1
'32320, 횡성군,'025004, 23세,2019,440,256,184,139.1,412,237,175,135.4
'32320, 횡성군,'025005, 24세,2019,384,212,172,123.3,348,190,158,120.3
'32320, 횡성군,'030,25~29세,2019,1874,1084,790,137.2,1695,968,727,133.1
'32320, 횡성군,'030001, 25세,2019,423,244,179,136.3,393,227,166,136.7
'32320, 횡성군,'030002, 26세,2019,363,227,136,166.9,325,199,126,157.9
'32320, 횡성군,'030003, 27세,2019,375,207,168,123.2,340,185,155,119.4
'32320, 횡성군,'030004, 28세,2019,352,203,149,136.2,314,179,135,132.6
'32320, 횡성군,'030005, 29세,2019,361,203,158,128.5,323,178,145,122.8
'32320, 횡성군,'035,30~34세,2019,1685,913,772,118.3,1494,795,699,113.7
'32320, 횡성군,'035001, 30세,2019,352,205,147,139.5,300,169,131,129
'32320, 횡성군,'035002, 31세,2019,292,150,142,105.6,260,132,128,103.1
'32320, 횡성군,'035003, 32세,2019,327,176,151,116.6,285,147,138,106.5
'32320, 횡성군,'035004, 33세,2019,337,172,165,104.2,303,159,144,110.4
'32320, 횡성군,'035005, 34세,2019,377,210,167,125.7,346,188,158,119
'32320, 횡성군,'040,35~39세,2019,2009,1062,947,112.1,1873,988,885,111.6
'32320, 횡성군,'040001, 35세,2019,350,191,159,120.1,314,171,143,119.6
'32320, 횡성군,'040002, 36세,2019,401,218,183,119.1,369,195,174,112.1
'32320, 횡성군,'040003, 37세,2019,393,186,207,89.9,371,175,196,89.3
'32320, 횡성군,'040004, 38세,2019,440,236,204,115.7,411,225,186,121
'32320, 횡성군,'040005, 39세,2019,425,231,194,119.1,408,222,186,119.4
'32320, 횡성군,'045,40~44세,2019,2072,1127,945,119.3,2001,1100,901,122.1
'32320, 횡성군,'045001, 40세,2019,412,208,204,102,395,201,194,103.6
'32320, 횡성군,'045002, 41세,2019,412,206,206,100,397,202,195,103.6
'32320, 횡성군,'045003, 42세,2019,398,229,169,135.5,382,224,158,141.8
'32320, 횡성군,'045004, 43세,2019,413,238,175,136,399,230,169,136.1
'32320, 횡성군,'045005, 44세,2019,437,246,191,128.8,428,243,185,131.4
'32320, 횡성군,'050,45~49세,2019,2868,1533,1335,114.8,2794,1498,1296,115.6
'32320, 횡성군,'050001, 45세,2019,518,272,246,110.6,514,270,244,110.7
'32320, 횡성군,'050002, 46세,2019,535,307,228,134.6,522,298,224,133
'32320, 횡성군,'050003, 47세,2019,519,278,241,115.4,503,271,232,116.8
'32320, 횡성군,'050004, 48세,2019,651,342,309,110.7,629,336,293,114.7
'32320, 횡성군,'050005, 49세,2019,645,334,311,107.4,626,323,303,106.6
'32320, 횡성군,'055,50~54세,2019,3659,1923,1736,110.8,3573,1880,1693,111
'32320, 횡성군,'055001, 50세,2019,742,399,343,116.3,728,395,333,118.6
'32320, 횡성군,'055002, 51세,2019,691,375,316,118.7,660,359,301,119.3
'32320, 횡성군,'055003, 52세,2019,720,354,366,96.7,705,347,358,96.9
'32320, 횡성군,'055004, 53세,2019,733,407,326,124.8,716,397,319,124.5
'32320, 횡성군,'055005, 54세,2019,773,388,385,100.8,764,382,382,100
'32320, 횡성군,'060,55~59세,2019,4828,2464,2364,104.2,4783,2445,2338,104.6
'32320, 횡성군,'060001, 55세,2019,717,373,344,108.4,709,370,339,109.1
'32320, 횡성군,'060002, 56세,2019,844,434,410,105.9,839,432,407,106.1
'32320, 횡성군,'060003, 57세,2019,955,501,454,110.4,944,496,448,110.7
'32320, 횡성군,'060004, 58세,2019,1116,565,551,102.5,1106,562,544,103.3
'32320, 횡성군,'060005, 59세,2019,1196,591,605,97.7,1185,585,600,97.5
'32320, 횡성군,'065,60~64세,2019,5178,2654,2524,105.2,5137,2631,2506,105
'32320, 횡성군,'065001, 60세,2019,1031,528,503,105,1021,522,499,104.6
'32320, 횡성군,'065002, 61세,2019,1114,551,563,97.9,1103,547,556,98.4
'32320, 횡성군,'065003, 62세,2019,1034,552,482,114.5,1023,546,477,114.5
'32320, 횡성군,'065004, 63세,2019,1047,510,537,95,1040,505,535,94.4
'32320, 횡성군,'065005, 64세,2019,952,513,439,116.9,950,511,439,116.4
'32320, 횡성군,'070,65~69세,2019,3499,1822,1677,108.6,3483,1816,1667,108.9
'32320, 횡성군,'070001, 65세,2019,871,442,429,103,867,442,425,104
'32320, 횡성군,'070002, 66세,2019,679,366,313,116.9,677,365,312,117
'32320, 횡성군,'070003, 67세,2019,959,504,455,110.8,957,503,454,110.8
'32320, 횡성군,'070004, 68세,2019,470,245,225,108.9,467,244,223,109.4
'32320, 횡성군,'070005, 69세,2019,520,265,255,103.9,515,262,253,103.6
'32320, 횡성군,'075,70~74세,2019,2754,1399,1355,103.2,2743,1393,1350,103.2
'32320, 횡성군,'075001, 70세,2019,543,294,249,118.1,541,293,248,118.1
'32320, 횡성군,'075002, 71세,2019,596,291,305,95.4,594,289,305,94.8
'32320, 횡성군,'075003, 72세,2019,617,330,287,115,613,329,284,115.8
'32320, 횡성군,'075004, 73세,2019,490,226,264,85.6,489,225,264,85.2
'32320, 횡성군,'075005, 74세,2019,508,258,250,103.2,506,257,249,103.2
'32320, 횡성군,'080,75~79세,2019,2642,1192,1450,82.2,2638,1191,1447,82.3
'32320, 횡성군,'080001, 75세,2019,511,224,287,78,510,224,286,78.3
'32320, 횡성군,'080002, 76세,2019,516,227,289,78.5,516,227,289,78.5
'32320, 횡성군,'080003, 77세,2019,577,277,300,92.3,575,277,298,93
'32320, 횡성군,'080004, 78세,2019,572,253,319,79.3,572,253,319,79.3
'32320, 횡성군,'080005, 79세,2019,466,211,255,82.7,465,210,255,82.4
'32320, 횡성군,'085,80~84세,2019,2017,815,1202,67.8,2015,814,1201,67.8
'32320, 횡성군,'085001, 80세,2019,471,182,289,63,471,182,289,63
'32320, 횡성군,'085002, 81세,2019,470,215,255,84.3,469,215,254,84.6
'32320, 횡성군,'085003, 82세,2019,426,183,243,75.3,426,183,243,75.3
'32320, 횡성군,'085004, 83세,2019,357,141,216,65.3,356,140,216,64.8
'32320, 횡성군,'085005, 84세,2019,293,94,199,47.2,293,94,199,47.2
'32320, 횡성군,'086,85세이상,2019,1357,353,1004,35.2,1356,352,1004,35.1
'32320, 횡성군,'090,85~89세,2019,915,243,672,36.2,914,242,672,36
'32320, 횡성군,'090001, 85세,2019,255,79,176,44.9,255,79,176,44.9
'32320, 횡성군,'090002, 86세,2019,203,56,147,38.1,203,56,147,38.1
'32320, 횡성군,'090003, 87세,2019,162,35,127,27.6,162,35,127,27.6
'32320, 횡성군,'090004, 88세,2019,146,39,107,36.4,145,38,107,35.5
'32320, 횡성군,'090005, 89세,2019,149,34,115,29.6,149,34,115,29.6
'32320, 횡성군,'095,90~94세,2019,348,87,261,33.3,348,87,261,33.3
'32320, 횡성군,'095001, 90세,2019,111,28,83,33.7,111,28,83,33.7
'32320, 횡성군,'095002, 91세,2019,87,22,65,33.8,87,22,65,33.8
'32320, 횡성군,'095003, 92세,2019,63,16,47,34,63,16,47,34
'32320, 횡성군,'095004, 93세,2019,50,12,38,31.6,50,12,38,31.6
'32320, 횡성군,'095005, 94세,2019,37,9,28,32.1,37,9,28,32.1
'32320, 횡성군,'100,95~99세,2019,79,19,60,31.7,79,19,60,31.7
'32320, 횡성군,'100001, 95세,2019,23,9,14,64.3,23,9,14,64.3
'32320, 횡성군,'100002, 96세,2019,21,6,15,40,21,6,15,40
'32320, 횡성군,'100003, 97세,2019,18,X,14,28.6,18,X,14,28.6
'32320, 횡성군,'100004, 98세,2019,13,X,13,0,13,X,13,0
'32320, 횡성군,'100005, 99세,2019,X,X,X,0,X,X,X,0
'32320, 횡성군,'101,100세이상,2019,15,X,11,36.4,15,X,11,36.4
'32320, 횡성군,'102,15세미만,2019,3712,1918,1794,106.9,3696,1910,1786,106.9
'32320, 횡성군,'103,15~64세,2019,28450,15116,13334,113.4,27491,14576,12915,112.9
'32320, 횡성군,'104,65세이상,2019,12269,5581,6688,83.4,12235,5566,6669,83.5
'32320, 횡성군,'126,평균연령,2019,50.5,48.9,52.1,,50.8,49.3,52.4,
'32320, 횡성군,'127,중위연령,2019,55.1,53.5,56.8,,55.6,54,57.2,
'32330, 영월군,'000,합계,2019,36332,18696,17636,106,35813,18483,17330,106.7
'32330, 영월군,'005,0~4세,2019,714,372,342,108.8,711,372,339,109.7
'32330, 영월군,'005001, 0세,2019,126,65,61,106.6,124,65,59,110.2
'32330, 영월군,'005002, 1세,2019,126,67,59,113.6,126,67,59,113.6
'32330, 영월군,'005003, 2세,2019,141,77,64,120.3,141,77,64,120.3
'32330, 영월군,'005004, 3세,2019,165,85,80,106.3,165,85,80,106.3
'32330, 영월군,'005005, 4세,2019,156,78,78,100,155,78,77,101.3
'32330, 영월군,'010,5~9세,2019,1047,552,495,111.5,1043,552,491,112.4
'32330, 영월군,'010001, 5세,2019,209,111,98,113.3,206,111,95,116.8
'32330, 영월군,'010002, 6세,2019,177,94,83,113.3,177,94,83,113.3
'32330, 영월군,'010003, 7세,2019,205,121,84,144,205,121,84,144
'32330, 영월군,'010004, 8세,2019,237,114,123,92.7,236,114,122,93.4
'32330, 영월군,'010005, 9세,2019,219,112,107,104.7,219,112,107,104.7
'32330, 영월군,'015,10~14세,2019,1145,607,538,112.8,1141,606,535,113.3
'32330, 영월군,'015001, 10세,2019,206,109,97,112.4,205,109,96,113.5
'32330, 영월군,'015002, 11세,2019,217,113,104,108.7,216,113,103,109.7
'32330, 영월군,'015003, 12세,2019,228,117,111,105.4,226,116,110,105.5
'32330, 영월군,'015004, 13세,2019,264,136,128,106.3,264,136,128,106.3
'32330, 영월군,'015005, 14세,2019,230,132,98,134.7,230,132,98,134.7
'32330, 영월군,'020,15~19세,2019,1579,876,703,124.6,1574,874,700,124.9
'32330, 영월군,'020001, 15세,2019,284,145,139,104.3,284,145,139,104.3
'32330, 영월군,'020002, 16세,2019,285,163,122,133.6,285,163,122,133.6
'32330, 영월군,'020003, 17세,2019,309,167,142,117.6,308,166,142,116.9
'32330, 영월군,'020004, 18세,2019,370,203,167,121.6,370,203,167,121.6
'32330, 영월군,'020005, 19세,2019,331,198,133,148.9,327,197,130,151.5
'32330, 영월군,'025,20~24세,2019,1574,942,632,149.1,1537,932,605,154
'32330, 영월군,'025001, 20세,2019,378,231,147,157.1,374,230,144,159.7
'32330, 영월군,'025002, 21세,2019,334,217,117,185.5,331,216,115,187.8
'32330, 영월군,'025003, 22세,2019,300,179,121,147.9,292,178,114,156.1
'32330, 영월군,'025004, 23세,2019,289,167,122,136.9,276,163,113,144.2
'32330, 영월군,'025005, 24세,2019,273,148,125,118.4,264,145,119,121.8
'32330, 영월군,'030,25~29세,2019,1311,758,553,137.1,1222,731,491,148.9
'32330, 영월군,'030001, 25세,2019,271,150,121,124,249,142,107,132.7
'32330, 영월군,'030002, 26세,2019,265,163,102,159.8,255,158,97,162.9
'32330, 영월군,'030003, 27세,2019,281,156,125,124.8,261,152,109,139.4
'32330, 영월군,'030004, 28세,2019,274,168,106,158.5,254,161,93,173.1
'32330, 영월군,'030005, 29세,2019,220,121,99,122.2,203,118,85,138.8
'32330, 영월군,'035,30~34세,2019,1257,696,561,124.1,1183,667,516,129.3
'32330, 영월군,'035001, 30세,2019,248,139,109,127.5,236,132,104,126.9
'32330, 영월군,'035002, 31세,2019,254,146,108,135.2,243,144,99,145.5
'32330, 영월군,'035003, 32세,2019,248,129,119,108.4,233,124,109,113.8
'32330, 영월군,'035004, 33세,2019,262,157,105,149.5,245,150,95,157.9
'32330, 영월군,'035005, 34세,2019,245,125,120,104.2,226,117,109,107.3
'32330, 영월군,'040,35~39세,2019,1608,873,735,118.8,1551,846,705,120
'32330, 영월군,'040001, 35세,2019,274,150,124,121,263,146,117,124.8
'32330, 영월군,'040002, 36세,2019,302,168,134,125.4,289,164,125,131.2
'32330, 영월군,'040003, 37세,2019,366,193,173,111.6,353,184,169,108.9
'32330, 영월군,'040004, 38세,2019,311,180,131,137.4,304,176,128,137.5
'32330, 영월군,'040005, 39세,2019,355,182,173,105.2,342,176,166,106
'32330, 영월군,'045,40~44세,2019,1886,1015,871,116.5,1831,987,844,116.9
'32330, 영월군,'045001, 40세,2019,333,166,167,99.4,324,162,162,100
'32330, 영월군,'045002, 41세,2019,365,204,161,126.7,352,197,155,127.1
'32330, 영월군,'045003, 42세,2019,370,200,170,117.6,358,194,164,118.3
'32330, 영월군,'045004, 43세,2019,396,211,185,114.1,386,204,182,112.1
'32330, 영월군,'045005, 44세,2019,422,234,188,124.5,411,230,181,127.1
'32330, 영월군,'050,45~49세,2019,2704,1490,1214,122.7,2635,1459,1176,124.1
'32330, 영월군,'050001, 45세,2019,511,253,258,98.1,502,249,253,98.4
'32330, 영월군,'050002, 46세,2019,543,307,236,130.1,531,302,229,131.9
'32330, 영월군,'050003, 47세,2019,467,263,204,128.9,451,252,199,126.6
'32330, 영월군,'050004, 48세,2019,618,351,267,131.5,601,344,257,133.9
'32330, 영월군,'050005, 49세,2019,565,316,249,126.9,550,312,238,131.1
'32330, 영월군,'055,50~54세,2019,3191,1737,1454,119.5,3143,1716,1427,120.3
'32330, 영월군,'055001, 50세,2019,586,316,270,117,580,314,266,118
'32330, 영월군,'055002, 51세,2019,695,388,307,126.4,684,383,301,127.2
'32330, 영월군,'055003, 52세,2019,576,323,253,127.7,567,320,247,129.6
'32330, 영월군,'055004, 53세,2019,684,375,309,121.4,672,368,304,121.1
'32330, 영월군,'055005, 54세,2019,650,335,315,106.3,640,331,309,107.1
'32330, 영월군,'060,55~59세,2019,3925,2100,1825,115.1,3888,2086,1802,115.8
'32330, 영월군,'060001, 55세,2019,620,346,274,126.3,607,342,265,129.1
'32330, 영월군,'060002, 56세,2019,720,406,314,129.3,711,403,308,130.8
'32330, 영월군,'060003, 57세,2019,821,445,376,118.4,814,440,374,117.6
'32330, 영월군,'060004, 58세,2019,850,472,378,124.9,845,471,374,125.9
'32330, 영월군,'060005, 59세,2019,914,431,483,89.2,911,430,481,89.4
'32330, 영월군,'065,60~64세,2019,4057,2141,1916,111.7,4041,2133,1908,111.8
'32330, 영월군,'065001, 60세,2019,848,439,409,107.3,845,436,409,106.6
'32330, 영월군,'065002, 61세,2019,827,427,400,106.8,823,427,396,107.8
'32330, 영월군,'065003, 62세,2019,821,440,381,115.5,816,439,377,116.4
'32330, 영월군,'065004, 63세,2019,761,412,349,118.1,759,410,349,117.5
'32330, 영월군,'065005, 64세,2019,800,423,377,112.2,798,421,377,111.7
'32330, 영월군,'070,65~69세,2019,2992,1505,1487,101.2,2983,1497,1486,100.7
'32330, 영월군,'070001, 65세,2019,687,366,321,114,685,364,321,113.4
'32330, 영월군,'070002, 66세,2019,588,295,293,100.7,586,293,293,100
'32330, 영월군,'070003, 67세,2019,783,410,373,109.9,783,410,373,109.9
'32330, 영월군,'070004, 68세,2019,449,211,238,88.7,448,210,238,88.2
'32330, 영월군,'070005, 69세,2019,485,223,262,85.1,481,220,261,84.3
'32330, 영월군,'075,70~74세,2019,2329,1136,1193,95.2,2322,1132,1190,95.1
'32330, 영월군,'075001, 70세,2019,485,238,247,96.4,484,237,247,96
'32330, 영월군,'075002, 71세,2019,503,245,258,95,502,245,257,95.3
'32330, 영월군,'075003, 72세,2019,487,238,249,95.6,484,237,247,96
'32330, 영월군,'075004, 73세,2019,418,199,219,90.9,416,197,219,90
'32330, 영월군,'075005, 74세,2019,436,216,220,98.2,436,216,220,98.2
'32330, 영월군,'080,75~79세,2019,2414,1016,1398,72.7,2409,1013,1396,72.6
'32330, 영월군,'080001, 75세,2019,482,199,283,70.3,480,198,282,70.2
'32330, 영월군,'080002, 76세,2019,434,180,254,70.9,433,179,254,70.5
'32330, 영월군,'080003, 77세,2019,555,239,316,75.6,555,239,316,75.6
'32330, 영월군,'080004, 78세,2019,466,195,271,72,465,195,270,72.2
'32330, 영월군,'080005, 79세,2019,477,203,274,74.1,476,202,274,73.7
'32330, 영월군,'085,80~84세,2019,1630,639,991,64.5,1630,639,991,64.5
'32330, 영월군,'085001, 80세,2019,416,168,248,67.7,416,168,248,67.7
'32330, 영월군,'085002, 81세,2019,391,151,240,62.9,391,151,240,62.9
'32330, 영월군,'085003, 82세,2019,303,112,191,58.6,303,112,191,58.6
'32330, 영월군,'085004, 83세,2019,279,116,163,71.2,279,116,163,71.2
'32330, 영월군,'085005, 84세,2019,241,92,149,61.7,241,92,149,61.7
'32330, 영월군,'086,85세이상,2019,969,241,728,33.1,969,241,728,33.1
'32330, 영월군,'090,85~89세,2019,686,171,515,33.2,686,171,515,33.2
'32330, 영월군,'090001, 85세,2019,224,56,168,33.3,224,56,168,33.3
'32330, 영월군,'090002, 86세,2019,158,35,123,28.5,158,35,123,28.5
'32330, 영월군,'090003, 87세,2019,126,30,96,31.3,126,30,96,31.3
'32330, 영월군,'090004, 88세,2019,91,32,59,54.2,91,32,59,54.2
'32330, 영월군,'090005, 89세,2019,87,18,69,26.1,87,18,69,26.1
'32330, 영월군,'095,90~94세,2019,225,53,172,30.8,225,53,172,30.8
'32330, 영월군,'095001, 90세,2019,83,22,61,36.1,83,22,61,36.1
'32330, 영월군,'095002, 91세,2019,43,8,35,22.9,43,8,35,22.9
'32330, 영월군,'095003, 92세,2019,50,12,38,31.6,50,12,38,31.6
'32330, 영월군,'095004, 93세,2019,24,X,21,14.3,24,X,21,14.3
'32330, 영월군,'095005, 94세,2019,25,8,17,47.1,25,8,17,47.1
'32330, 영월군,'100,95~99세,2019,50,15,35,42.9,50,15,35,42.9
'32330, 영월군,'100001, 95세,2019,14,7,7,100,14,7,7,100
'32330, 영월군,'100002, 96세,2019,15,X,12,25,15,X,12,25
'32330, 영월군,'100003, 97세,2019,10,X,7,42.9,10,X,7,42.9
'32330, 영월군,'100004, 98세,2019,7,X,6,16.7,7,X,6,16.7
'32330, 영월군,'100005, 99세,2019,X,X,X,33.3,X,X,X,33.3
'32330, 영월군,'101,100세이상,2019,8,X,6,33.3,8,X,6,33.3
'32330, 영월군,'102,15세미만,2019,2906,1531,1375,111.3,2895,1530,1365,112.1
'32330, 영월군,'103,15~64세,2019,23092,12628,10464,120.7,22605,12431,10174,122.2
'32330, 영월군,'104,65세이상,2019,10334,4537,5797,78.3,10313,4522,5791,78.1
'32330, 영월군,'126,평균연령,2019,51.1,49.3,53.1,,51.3,49.4,53.4,
'32330, 영월군,'127,중위연령,2019,55.2,53.4,57.3,,55.6,53.5,57.7,
'32340, 평창군,'000,합계,2019,39657,20341,19316,105.3,39002,20051,18951,105.8
'32340, 평창군,'005,0~4세,2019,858,414,444,93.2,847,407,440,92.5
'32340, 평창군,'005001, 0세,2019,148,77,71,108.5,146,76,70,108.6
'32340, 평창군,'005002, 1세,2019,162,77,85,90.6,159,75,84,89.3
'32340, 평창군,'005003, 2세,2019,185,97,88,110.2,182,94,88,106.8
'32340, 평창군,'005004, 3세,2019,183,80,103,77.7,182,80,102,78.4
'32340, 평창군,'005005, 4세,2019,180,83,97,85.6,178,82,96,85.4
'32340, 평창군,'010,5~9세,2019,1170,610,560,108.9,1160,604,556,108.6
'32340, 평창군,'010001, 5세,2019,193,90,103,87.4,190,88,102,86.3
'32340, 평창군,'010002, 6세,2019,221,125,96,130.2,220,125,95,131.6
'32340, 평창군,'010003, 7세,2019,258,128,130,98.5,255,127,128,99.2
'32340, 평창군,'010004, 8세,2019,251,131,120,109.2,249,129,120,107.5
'32340, 평창군,'010005, 9세,2019,247,136,111,122.5,246,135,111,121.6
'32340, 평창군,'015,10~14세,2019,1347,717,630,113.8,1341,713,628,113.5
'32340, 평창군,'015001, 10세,2019,245,122,123,99.2,245,122,123,99.2
'32340, 평창군,'015002, 11세,2019,300,157,143,109.8,299,157,142,110.6
'32340, 평창군,'015003, 12세,2019,281,153,128,119.5,280,152,128,118.8
'32340, 평창군,'015004, 13세,2019,272,151,121,124.8,270,150,120,125
'32340, 평창군,'015005, 14세,2019,249,134,115,116.5,247,132,115,114.8
'32340, 평창군,'020,15~19세,2019,1373,753,620,121.5,1367,751,616,121.9
'32340, 평창군,'020001, 15세,2019,288,159,129,123.3,287,159,128,124.2
'32340, 평창군,'020002, 16세,2019,296,156,140,111.4,295,155,140,110.7
'32340, 평창군,'020003, 17세,2019,291,150,141,106.4,289,149,140,106.4
'32340, 평창군,'020004, 18세,2019,289,167,122,136.9,289,167,122,136.9
'32340, 평창군,'020005, 19세,2019,209,121,88,137.5,207,121,86,140.7
'32340, 평창군,'025,20~24세,2019,1428,883,545,162,1367,860,507,169.6
'32340, 평창군,'025001, 20세,2019,250,175,75,233.3,247,175,72,243.1
'32340, 평창군,'025002, 21세,2019,287,200,87,229.9,277,198,79,250.6
'32340, 평창군,'025003, 22세,2019,293,163,130,125.4,285,162,123,131.7
'32340, 평창군,'025004, 23세,2019,302,171,131,130.5,287,165,122,135.2
'32340, 평창군,'025005, 24세,2019,296,174,122,142.6,271,160,111,144.1
'32340, 평창군,'030,25~29세,2019,1665,942,723,130.3,1556,891,665,134
'32340, 평창군,'030001, 25세,2019,344,192,152,126.3,321,181,140,129.3
'32340, 평창군,'030002, 26세,2019,345,196,149,131.5,315,182,133,136.8
'32340, 평창군,'030003, 27세,2019,367,217,150,144.7,341,207,134,154.5
'32340, 평창군,'030004, 28세,2019,306,167,139,120.1,294,163,131,124.4
'32340, 평창군,'030005, 29세,2019,303,170,133,127.8,285,158,127,124.4
'32340, 평창군,'035,30~34세,2019,1511,831,680,122.2,1411,785,626,125.4
'32340, 평창군,'035001, 30세,2019,313,173,140,123.6,289,165,124,133.1
'32340, 평창군,'035002, 31세,2019,304,167,137,121.9,292,163,129,126.4
'32340, 평창군,'035003, 32세,2019,279,157,122,128.7,258,148,110,134.5
'32340, 평창군,'035004, 33세,2019,299,170,129,131.8,281,158,123,128.5
'32340, 평창군,'035005, 34세,2019,316,164,152,107.9,291,151,140,107.9
'32340, 평창군,'040,35~39세,2019,1924,1070,854,125.3,1876,1054,822,128.2
'32340, 평창군,'040001, 35세,2019,303,157,146,107.5,294,154,140,110
'32340, 평창군,'040002, 36세,2019,354,200,154,129.9,346,197,149,132.2
'32340, 평창군,'040003, 37세,2019,406,219,187,117.1,391,214,177,120.9
'32340, 평창군,'040004, 38세,2019,423,244,179,136.3,415,242,173,139.9
'32340, 평창군,'040005, 39세,2019,438,250,188,133,430,247,183,135
'32340, 평창군,'045,40~44세,2019,2252,1201,1051,114.3,2194,1174,1020,115.1
'32340, 평창군,'045001, 40세,2019,445,236,209,112.9,430,230,200,115
'32340, 평창군,'045002, 41세,2019,412,217,195,111.3,406,214,192,111.5
'32340, 평창군,'045003, 42세,2019,454,218,236,92.4,436,210,226,92.9
'32340, 평창군,'045004, 43세,2019,439,271,168,161.3,430,265,165,160.6
'32340, 평창군,'045005, 44세,2019,502,259,243,106.6,492,255,237,107.6
'32340, 평창군,'050,45~49세,2019,2997,1672,1325,126.2,2944,1649,1295,127.3
'32340, 평창군,'050001, 45세,2019,541,298,243,122.6,533,294,239,123
'32340, 평창군,'050002, 46세,2019,626,356,270,131.9,609,347,262,132.4
'32340, 평창군,'050003, 47세,2019,584,330,254,129.9,577,330,247,133.6
'32340, 평창군,'050004, 48세,2019,613,338,275,122.9,604,335,269,124.5
'32340, 평창군,'050005, 49세,2019,633,350,283,123.7,621,343,278,123.4
'32340, 평창군,'055,50~54세,2019,3560,1918,1642,116.8,3488,1889,1599,118.1
'32340, 평창군,'055001, 50세,2019,698,378,320,118.1,679,370,309,119.7
'32340, 평창군,'055002, 51세,2019,766,416,350,118.9,747,410,337,121.7
'32340, 평창군,'055003, 52세,2019,665,359,306,117.3,654,356,298,119.5
'32340, 평창군,'055004, 53세,2019,704,375,329,114,690,370,320,115.6
'32340, 평창군,'055005, 54세,2019,727,390,337,115.7,718,383,335,114.3
'32340, 평창군,'060,55~59세,2019,4419,2271,2148,105.7,4375,2247,2128,105.6
'32340, 평창군,'060001, 55세,2019,653,315,338,93.2,638,308,330,93.3
'32340, 평창군,'060002, 56세,2019,797,433,364,119,788,425,363,117.1
'32340, 평창군,'060003, 57세,2019,891,464,427,108.7,887,464,423,109.7
'32340, 평창군,'060004, 58세,2019,989,512,477,107.3,981,508,473,107.4
'32340, 평창군,'060005, 59세,2019,1089,547,542,100.9,1081,542,539,100.6
'32340, 평창군,'065,60~64세,2019,4590,2395,2195,109.1,4546,2376,2170,109.5
'32340, 평창군,'065001, 60세,2019,928,491,437,112.4,923,489,434,112.7
'32340, 평창군,'065002, 61세,2019,945,496,449,110.5,938,494,444,111.3
'32340, 평창군,'065003, 62세,2019,972,502,470,106.8,962,495,467,106
'32340, 평창군,'065004, 63세,2019,853,442,411,107.5,840,438,402,109
'32340, 평창군,'065005, 64세,2019,892,464,428,108.4,883,460,423,108.7
'32340, 평창군,'070,65~69세,2019,3087,1556,1531,101.6,3070,1548,1522,101.7
'32340, 평창군,'070001, 65세,2019,727,395,332,119,721,391,330,118.5
'32340, 평창군,'070002, 66세,2019,621,313,308,101.6,616,311,305,102
'32340, 평창군,'070003, 67세,2019,824,420,404,104,821,419,402,104.2
'32340, 평창군,'070004, 68세,2019,447,210,237,88.6,446,210,236,89
'32340, 평창군,'070005, 69세,2019,468,218,250,87.2,466,217,249,87.1
'32340, 평창군,'075,70~74세,2019,2550,1216,1334,91.2,2544,1211,1333,90.8
'32340, 평창군,'075001, 70세,2019,532,256,276,92.8,530,254,276,92
'32340, 평창군,'075002, 71세,2019,543,263,280,93.9,542,263,279,94.3
'32340, 평창군,'075003, 72세,2019,546,262,284,92.3,546,262,284,92.3
'32340, 평창군,'075004, 73세,2019,420,207,213,97.2,418,205,213,96.2
'32340, 평창군,'075005, 74세,2019,509,228,281,81.1,508,227,281,80.8
'32340, 평창군,'080,75~79세,2019,2282,1017,1265,80.4,2281,1017,1264,80.5
'32340, 평창군,'080001, 75세,2019,462,196,266,73.7,462,196,266,73.7
'32340, 평창군,'080002, 76세,2019,425,201,224,89.7,425,201,224,89.7
'32340, 평창군,'080003, 77세,2019,488,218,270,80.7,487,218,269,81
'32340, 평창군,'080004, 78세,2019,463,209,254,82.3,463,209,254,82.3
'32340, 평창군,'080005, 79세,2019,444,193,251,76.9,444,193,251,76.9
'32340, 평창군,'085,80~84세,2019,1673,643,1030,62.4,1668,643,1025,62.7
'32340, 평창군,'085001, 80세,2019,453,186,267,69.7,453,186,267,69.7
'32340, 평창군,'085002, 81세,2019,364,143,221,64.7,361,143,218,65.6
'32340, 평창군,'085003, 82세,2019,331,129,202,63.9,330,129,201,64.2
'32340, 평창군,'085004, 83세,2019,292,114,178,64,291,114,177,64.4
'32340, 평창군,'085005, 84세,2019,233,71,162,43.8,233,71,162,43.8
'32340, 평창군,'086,85세이상,2019,971,232,739,31.4,967,232,735,31.6
'32340, 평창군,'090,85~89세,2019,646,153,493,31,643,153,490,31.2
'32340, 평창군,'090001, 85세,2019,171,49,122,40.2,170,49,121,40.5
'32340, 평창군,'090002, 86세,2019,154,38,116,32.8,153,38,115,33
'32340, 평창군,'090003, 87세,2019,135,33,102,32.4,134,33,101,32.7
'32340, 평창군,'090004, 88세,2019,103,16,87,18.4,103,16,87,18.4
'32340, 평창군,'090005, 89세,2019,83,17,66,25.8,83,17,66,25.8
'32340, 평창군,'095,90~94세,2019,240,52,188,27.7,240,52,188,27.7
'32340, 평창군,'095001, 90세,2019,84,17,67,25.4,84,17,67,25.4
'32340, 평창군,'095002, 91세,2019,56,12,44,27.3,56,12,44,27.3
'32340, 평창군,'095003, 92세,2019,39,11,28,39.3,39,11,28,39.3
'32340, 평창군,'095004, 93세,2019,36,9,27,33.3,36,9,27,33.3
'32340, 평창군,'095005, 94세,2019,25,X,22,13.6,25,X,22,13.6
'32340, 평창군,'100,95~99세,2019,72,22,50,44,71,22,49,44.9
'32340, 평창군,'100001, 95세,2019,36,13,23,56.5,36,13,23,56.5
'32340, 평창군,'100002, 96세,2019,15,5,10,50,15,5,10,50
'32340, 평창군,'100003, 97세,2019,8,X,5,60,8,X,5,60
'32340, 평창군,'100004, 98세,2019,8,X,8,0,7,X,7,0
'32340, 평창군,'100005, 99세,2019,5,X,X,25,5,X,X,25
'32340, 평창군,'101,100세이상,2019,13,5,8,62.5,13,5,8,62.5
'32340, 평창군,'102,15세미만,2019,3375,1741,1634,106.5,3348,1724,1624,106.2
'32340, 평창군,'103,15~64세,2019,25719,13936,11783,118.3,25124,13676,11448,119.5
'32340, 평창군,'104,65세이상,2019,10563,4664,5899,79.1,10530,4651,5879,79.1
'32340, 평창군,'126,평균연령,2019,50.7,49.1,52.5,,50.9,49.2,52.7,
'32340, 평창군,'127,중위연령,2019,54.6,52.8,56.7,,54.9,53,57,
'32350, 정선군,'000,합계,2019,35255,18390,16865,109,34816,18256,16560,110.2
'32350, 정선군,'005,0~4세,2019,754,411,343,119.8,752,411,341,120.5
'32350, 정선군,'005001, 0세,2019,140,76,64,118.8,140,76,64,118.8
'32350, 정선군,'005002, 1세,2019,133,72,61,118,133,72,61,118
'32350, 정선군,'005003, 2세,2019,147,83,64,129.7,147,83,64,129.7
'32350, 정선군,'005004, 3세,2019,152,82,70,117.1,151,82,69,118.8
'32350, 정선군,'005005, 4세,2019,182,98,84,116.7,181,98,83,118.1
'32350, 정선군,'010,5~9세,2019,1127,572,555,103.1,1127,572,555,103.1
'32350, 정선군,'010001, 5세,2019,192,87,105,82.9,192,87,105,82.9
'32350, 정선군,'010002, 6세,2019,206,107,99,108.1,206,107,99,108.1
'32350, 정선군,'010003, 7세,2019,251,135,116,116.4,251,135,116,116.4
'32350, 정선군,'010004, 8세,2019,214,110,104,105.8,214,110,104,105.8
'32350, 정선군,'010005, 9세,2019,264,133,131,101.5,264,133,131,101.5
'32350, 정선군,'015,10~14세,2019,1193,605,588,102.9,1192,605,587,103.1
'32350, 정선군,'015001, 10세,2019,247,135,112,120.5,247,135,112,120.5
'32350, 정선군,'015002, 11세,2019,260,129,131,98.5,260,129,131,98.5
'32350, 정선군,'015003, 12세,2019,231,119,112,106.3,230,119,111,107.2
'32350, 정선군,'015004, 13세,2019,216,103,113,91.2,216,103,113,91.2
'32350, 정선군,'015005, 14세,2019,239,119,120,99.2,239,119,120,99.2
'32350, 정선군,'020,15~19세,2019,1168,635,533,119.1,1167,635,532,119.4
'32350, 정선군,'020001, 15세,2019,238,129,109,118.3,238,129,109,118.3
'32350, 정선군,'020002, 16세,2019,217,114,103,110.7,217,114,103,110.7
'32350, 정선군,'020003, 17세,2019,273,142,131,108.4,273,142,131,108.4
'32350, 정선군,'020004, 18세,2019,274,145,129,112.4,274,145,129,112.4
'32350, 정선군,'020005, 19세,2019,166,105,61,172.1,165,105,60,175
'32350, 정선군,'025,20~24세,2019,1195,729,466,156.4,1156,721,435,165.7
'32350, 정선군,'025001, 20세,2019,226,169,57,296.5,223,169,54,313
'32350, 정선군,'025002, 21세,2019,253,172,81,212.3,243,169,74,228.4
'32350, 정선군,'025003, 22세,2019,226,123,103,119.4,217,121,96,126
'32350, 정선군,'025004, 23세,2019,236,123,113,108.8,224,120,104,115.4
'32350, 정선군,'025005, 24세,2019,254,142,112,126.8,249,142,107,132.7
'32350, 정선군,'030,25~29세,2019,1366,761,605,125.8,1306,743,563,132
'32350, 정선군,'030001, 25세,2019,276,158,118,133.9,268,153,115,133
'32350, 정선군,'030002, 26세,2019,242,144,98,146.9,231,143,88,162.5
'32350, 정선군,'030003, 27세,2019,275,146,129,113.2,259,142,117,121.4
'32350, 정선군,'030004, 28세,2019,289,153,136,112.5,273,149,124,120.2
'32350, 정선군,'030005, 29세,2019,284,160,124,129,275,156,119,131.1
'32350, 정선군,'035,30~34세,2019,1648,932,716,130.2,1560,907,653,138.9
'32350, 정선군,'035001, 30세,2019,316,175,141,124.1,300,171,129,132.6
'32350, 정선군,'035002, 31세,2019,332,176,156,112.8,308,171,137,124.8
'32350, 정선군,'035003, 32세,2019,338,194,144,134.7,321,188,133,141.4
'32350, 정선군,'035004, 33세,2019,325,171,154,111,315,168,147,114.3
'32350, 정선군,'035005, 34세,2019,337,216,121,178.5,316,209,107,195.3
'32350, 정선군,'040,35~39세,2019,2091,1144,947,120.8,2036,1127,909,124
'32350, 정선군,'040001, 35세,2019,361,173,188,92,346,171,175,97.7
'32350, 정선군,'040002, 36세,2019,407,231,176,131.3,393,227,166,136.7
'32350, 정선군,'040003, 37세,2019,440,239,201,118.9,429,234,195,120
'32350, 정선군,'040004, 38세,2019,410,223,187,119.3,405,222,183,121.3
'32350, 정선군,'040005, 39세,2019,473,278,195,142.6,463,273,190,143.7
'32350, 정선군,'045,40~44세,2019,2243,1314,929,141.4,2210,1302,908,143.4
'32350, 정선군,'045001, 40세,2019,467,262,205,127.8,458,258,200,129
'32350, 정선군,'045002, 41세,2019,427,247,180,137.2,419,242,177,136.7
'32350, 정선군,'045003, 42세,2019,437,265,172,154.1,433,265,168,157.7
'32350, 정선군,'045004, 43세,2019,448,256,192,133.3,444,255,189,134.9
'32350, 정선군,'045005, 44세,2019,464,284,180,157.8,456,282,174,162.1
'32350, 정선군,'050,45~49세,2019,2696,1572,1124,139.9,2654,1561,1093,142.8
'32350, 정선군,'050001, 45세,2019,557,320,237,135,552,319,233,136.9
'32350, 정선군,'050002, 46세,2019,492,288,204,141.2,489,288,201,143.3
'32350, 정선군,'050003, 47세,2019,510,302,208,145.2,502,301,201,149.8
'32350, 정선군,'050004, 48세,2019,596,353,243,145.3,586,349,237,147.3
'32350, 정선군,'050005, 49세,2019,541,309,232,133.2,525,304,221,137.6
'32350, 정선군,'055,50~54세,2019,3086,1740,1346,129.3,3043,1725,1318,130.9
'32350, 정선군,'055001, 50세,2019,615,355,260,136.5,604,352,252,139.7
'32350, 정선군,'055002, 51세,2019,670,399,271,147.2,658,394,264,149.2
'32350, 정선군,'055003, 52세,2019,594,341,253,134.8,588,338,250,135.2
'32350, 정선군,'055004, 53세,2019,615,343,272,126.1,608,340,268,126.9
'32350, 정선군,'055005, 54세,2019,592,302,290,104.1,585,301,284,106
'32350, 정선군,'060,55~59세,2019,3784,1999,1785,112,3746,1985,1761,112.7
'32350, 정선군,'060001, 55세,2019,581,324,257,126.1,574,320,254,126
'32350, 정선군,'060002, 56세,2019,696,396,300,132,689,393,296,132.8
'32350, 정선군,'060003, 57세,2019,732,388,344,112.8,718,385,333,115.6
'32350, 정선군,'060004, 58세,2019,852,423,429,98.6,849,422,427,98.8
'32350, 정선군,'060005, 59세,2019,923,468,455,102.9,916,465,451,103.1
'32350, 정선군,'065,60~64세,2019,3847,2059,1788,115.2,3826,2052,1774,115.7
'32350, 정선군,'065001, 60세,2019,794,415,379,109.5,786,413,373,110.7
'32350, 정선군,'065002, 61세,2019,784,420,364,115.4,780,419,361,116.1
'32350, 정선군,'065003, 62세,2019,812,427,385,110.9,809,426,383,111.2
'32350, 정선군,'065004, 63세,2019,725,397,328,121,722,396,326,121.5
'32350, 정선군,'065005, 64세,2019,732,400,332,120.5,729,398,331,120.2
'32350, 정선군,'070,65~69세,2019,2639,1307,1332,98.1,2632,1302,1330,97.9
'32350, 정선군,'070001, 65세,2019,591,321,270,118.9,588,318,270,117.8
'32350, 정선군,'070002, 66세,2019,525,269,256,105.1,524,268,256,104.7
'32350, 정선군,'070003, 67세,2019,658,328,330,99.4,657,328,329,99.7
'32350, 정선군,'070004, 68세,2019,429,213,216,98.6,427,212,215,98.6
'32350, 정선군,'070005, 69세,2019,436,176,260,67.7,436,176,260,67.7
'32350, 정선군,'075,70~74세,2019,2175,1042,1133,92,2170,1040,1130,92
'32350, 정선군,'075001, 70세,2019,472,237,235,100.9,471,236,235,100.4
'32350, 정선군,'075002, 71세,2019,469,229,240,95.4,469,229,240,95.4
'32350, 정선군,'075003, 72세,2019,446,203,243,83.5,444,203,241,84.2
'32350, 정선군,'075004, 73세,2019,370,184,186,98.9,369,184,185,99.5
'32350, 정선군,'075005, 74세,2019,418,189,229,82.5,417,188,229,82.1
'32350, 정선군,'080,75~79세,2019,2119,907,1212,74.8,2116,907,1209,75
'32350, 정선군,'080001, 75세,2019,409,182,227,80.2,409,182,227,80.2
'32350, 정선군,'080002, 76세,2019,445,192,253,75.9,444,192,252,76.2
'32350, 정선군,'080003, 77세,2019,481,208,273,76.2,480,208,272,76.5
'32350, 정선군,'080004, 78세,2019,385,158,227,69.6,384,158,226,69.9
'32350, 정선군,'080005, 79세,2019,399,167,232,72,399,167,232,72
'32350, 정선군,'085,80~84세,2019,1288,462,826,55.9,1287,462,825,56
'32350, 정선군,'085001, 80세,2019,340,138,202,68.3,339,138,201,68.7
'32350, 정선군,'085002, 81세,2019,286,104,182,57.1,286,104,182,57.1
'32350, 정선군,'085003, 82세,2019,245,86,159,54.1,245,86,159,54.1
'32350, 정선군,'085004, 83세,2019,219,70,149,47,219,70,149,47
'32350, 정선군,'085005, 84세,2019,198,64,134,47.8,198,64,134,47.8
'32350, 정선군,'086,85세이상,2019,836,199,637,31.2,836,199,637,31.2
'32350, 정선군,'090,85~89세,2019,567,147,420,35,567,147,420,35
'32350, 정선군,'090001, 85세,2019,172,54,118,45.8,172,54,118,45.8
'32350, 정선군,'090002, 86세,2019,133,28,105,26.7,133,28,105,26.7
'32350, 정선군,'090003, 87세,2019,114,30,84,35.7,114,30,84,35.7
'32350, 정선군,'090004, 88세,2019,63,16,47,34,63,16,47,34
'32350, 정선군,'090005, 89세,2019,85,19,66,28.8,85,19,66,28.8
'32350, 정선군,'095,90~94세,2019,199,37,162,22.8,199,37,162,22.8
'32350, 정선군,'095001, 90세,2019,52,11,41,26.8,52,11,41,26.8
'32350, 정선군,'095002, 91세,2019,45,9,36,25,45,9,36,25
'32350, 정선군,'095003, 92세,2019,39,X,36,8.3,39,X,36,8.3
'32350, 정선군,'095004, 93세,2019,38,6,32,18.8,38,6,32,18.8
'32350, 정선군,'095005, 94세,2019,25,8,17,47.1,25,8,17,47.1
'32350, 정선군,'100,95~99세,2019,62,13,49,26.5,62,13,49,26.5
'32350, 정선군,'100001, 95세,2019,27,6,21,28.6,27,6,21,28.6
'32350, 정선군,'100002, 96세,2019,22,5,17,29.4,22,5,17,29.4
'32350, 정선군,'100003, 97세,2019,7,X,7,0,7,X,7,0
'32350, 정선군,'100004, 98세,2019,X,X,X,200,X,X,X,200
'32350, 정선군,'100005, 99세,2019,X,X,X,0,X,X,X,0
'32350, 정선군,'101,100세이상,2019,8,X,6,33.3,8,X,6,33.3
'32350, 정선군,'102,15세미만,2019,3074,1588,1486,106.9,3071,1588,1483,107.1
'32350, 정선군,'103,15~64세,2019,23124,12885,10239,125.8,22704,12758,9946,128.3
'32350, 정선군,'104,65세이상,2019,9057,3917,5140,76.2,9041,3910,5131,76.2
'32350, 정선군,'126,평균연령,2019,50.1,48.4,52,,50.2,48.4,52.2,
'32350, 정선군,'127,중위연령,2019,53.4,51.4,56.1,,53.7,51.5,56.4,
'32360, 철원군,'000,합계,2019,43520,22869,20651,110.7,42433,22217,20216,109.9
'32360, 철원군,'005,0~4세,2019,1694,871,823,105.8,1693,871,822,106
'32360, 철원군,'005001, 0세,2019,350,191,159,120.1,350,191,159,120.1
'32360, 철원군,'005002, 1세,2019,334,153,181,84.5,333,153,180,85
'32360, 철원군,'005003, 2세,2019,342,171,171,100,342,171,171,100
'32360, 철원군,'005004, 3세,2019,349,184,165,111.5,349,184,165,111.5
'32360, 철원군,'005005, 4세,2019,319,172,147,117,319,172,147,117
'32360, 철원군,'010,5~9세,2019,1701,883,818,107.9,1701,883,818,107.9
'32360, 철원군,'010001, 5세,2019,362,182,180,101.1,362,182,180,101.1
'32360, 철원군,'010002, 6세,2019,308,155,153,101.3,308,155,153,101.3
'32360, 철원군,'010003, 7세,2019,338,162,176,92,338,162,176,92
'32360, 철원군,'010004, 8세,2019,346,187,159,117.6,346,187,159,117.6
'32360, 철원군,'010005, 9세,2019,347,197,150,131.3,347,197,150,131.3
'32360, 철원군,'015,10~14세,2019,1766,921,845,109,1765,921,844,109.1
'32360, 철원군,'015001, 10세,2019,313,156,157,99.4,313,156,157,99.4
'32360, 철원군,'015002, 11세,2019,378,192,186,103.2,378,192,186,103.2
'32360, 철원군,'015003, 12세,2019,346,185,161,114.9,346,185,161,114.9
'32360, 철원군,'015004, 13세,2019,376,204,172,118.6,376,204,172,118.6
'32360, 철원군,'015005, 14세,2019,353,184,169,108.9,352,184,168,109.5
'32360, 철원군,'020,15~19세,2019,1855,988,867,114,1847,984,863,114
'32360, 철원군,'020001, 15세,2019,377,201,176,114.2,377,201,176,114.2
'32360, 철원군,'020002, 16세,2019,369,183,186,98.4,369,183,186,98.4
'32360, 철원군,'020003, 17세,2019,405,200,205,97.6,405,200,205,97.6
'32360, 철원군,'020004, 18세,2019,411,230,181,127.1,409,228,181,126
'32360, 철원군,'020005, 19세,2019,293,174,119,146.2,287,172,115,149.6
'32360, 철원군,'025,20~24세,2019,2560,1770,790,224.1,2363,1626,737,220.6
'32360, 철원군,'025001, 20세,2019,365,254,111,228.8,348,238,110,216.4
'32360, 철원군,'025002, 21세,2019,438,299,139,215.1,418,284,134,211.9
'32360, 철원군,'025003, 22세,2019,472,313,159,196.9,434,285,149,191.3
'32360, 철원군,'025004, 23세,2019,553,380,173,219.7,498,343,155,221.3
'32360, 철원군,'025005, 24세,2019,732,524,208,251.9,665,476,189,251.9
'32360, 철원군,'030,25~29세,2019,3209,2143,1066,201,2931,1954,977,200
'32360, 철원군,'030001, 25세,2019,725,517,208,248.6,670,479,191,250.8
'32360, 철원군,'030002, 26세,2019,606,409,197,207.6,547,373,174,214.4
'32360, 철원군,'030003, 27세,2019,711,477,234,203.8,643,425,218,195
'32360, 철원군,'030004, 28세,2019,628,402,226,177.9,573,364,209,174.2
'32360, 철원군,'030005, 29세,2019,539,338,201,168.2,498,313,185,169.2
'32360, 철원군,'035,30~34세,2019,2451,1411,1040,135.7,2254,1297,957,135.5
'32360, 철원군,'035001, 30세,2019,518,323,195,165.6,479,292,187,156.1
'32360, 철원군,'035002, 31세,2019,496,280,216,129.6,464,260,204,127.5
'32360, 철원군,'035003, 32세,2019,491,284,207,137.2,452,265,187,141.7
'32360, 철원군,'035004, 33세,2019,468,251,217,115.7,421,229,192,119.3
'32360, 철원군,'035005, 34세,2019,478,273,205,133.2,438,251,187,134.2
'32360, 철원군,'040,35~39세,2019,2534,1330,1204,110.5,2383,1243,1140,109
'32360, 철원군,'040001, 35세,2019,443,238,205,116.1,396,209,187,111.8
'32360, 철원군,'040002, 36세,2019,500,287,213,134.7,472,270,202,133.7
'32360, 철원군,'040003, 37세,2019,515,266,249,106.8,492,254,238,106.7
'32360, 철원군,'040004, 38세,2019,546,278,268,103.7,525,266,259,102.7
'32360, 철원군,'040005, 39세,2019,530,261,269,97,498,244,254,96.1
'32360, 철원군,'045,40~44세,2019,2596,1382,1214,113.8,2520,1342,1178,113.9
'32360, 철원군,'045001, 40세,2019,509,263,246,106.9,488,254,234,108.5
'32360, 철원군,'045002, 41세,2019,546,284,262,108.4,532,277,255,108.6
'32360, 철원군,'045003, 42세,2019,547,288,259,111.2,532,279,253,110.3
'32360, 철원군,'045004, 43세,2019,498,280,218,128.4,481,271,210,129
'32360, 철원군,'045005, 44세,2019,496,267,229,116.6,487,261,226,115.5
'32360, 철원군,'050,45~49세,2019,3124,1698,1426,119.1,3072,1671,1401,119.3
'32360, 철원군,'050001, 45세,2019,617,333,284,117.3,605,329,276,119.2
'32360, 철원군,'050002, 46세,2019,608,315,293,107.5,597,309,288,107.3
'32360, 철원군,'050003, 47세,2019,655,364,291,125.1,651,363,288,126
'32360, 철원군,'050004, 48세,2019,625,338,287,117.8,613,332,281,118.1
'32360, 철원군,'050005, 49세,2019,619,348,271,128.4,606,338,268,126.1
'32360, 철원군,'055,50~54세,2019,3309,1720,1589,108.2,3267,1702,1565,108.8
'32360, 철원군,'055001, 50세,2019,661,348,313,111.2,646,341,305,111.8
'32360, 철원군,'055002, 51세,2019,667,348,319,109.1,658,345,313,110.2
'32360, 철원군,'055003, 52세,2019,628,319,309,103.2,621,317,304,104.3
'32360, 철원군,'055004, 53세,2019,675,368,307,119.9,669,363,306,118.6
'32360, 철원군,'055005, 54세,2019,678,337,341,98.8,673,336,337,99.7
'32360, 철원군,'060,55~59세,2019,3853,2047,1806,113.3,3823,2036,1787,113.9
'32360, 철원군,'060001, 55세,2019,647,346,301,115,641,343,298,115.1
'32360, 철원군,'060002, 56세,2019,774,400,374,107,769,399,370,107.8
'32360, 철원군,'060003, 57세,2019,751,407,344,118.3,742,404,338,119.5
'32360, 철원군,'060004, 58세,2019,838,456,382,119.4,832,455,377,120.7
'32360, 철원군,'060005, 59세,2019,843,438,405,108.1,839,435,404,107.7
'32360, 철원군,'065,60~64세,2019,3544,1764,1780,99.1,3511,1751,1760,99.5
'32360, 철원군,'065001, 60세,2019,712,353,359,98.3,703,351,352,99.7
'32360, 철원군,'065002, 61세,2019,762,383,379,101.1,753,378,375,100.8
'32360, 철원군,'065003, 62세,2019,735,383,352,108.8,727,380,347,109.5
'32360, 철원군,'065004, 63세,2019,656,311,345,90.1,651,308,343,89.8
'32360, 철원군,'065005, 64세,2019,679,334,345,96.8,677,334,343,97.4
'32360, 철원군,'070,65~69세,2019,2376,1088,1288,84.5,2365,1085,1280,84.8
'32360, 철원군,'070001, 65세,2019,663,325,338,96.2,661,323,338,95.6
'32360, 철원군,'070002, 66세,2019,480,211,269,78.4,478,211,267,79
'32360, 철원군,'070003, 67세,2019,468,194,274,70.8,465,193,272,71
'32360, 철원군,'070004, 68세,2019,348,164,184,89.1,345,164,181,90.6
'32360, 철원군,'070005, 69세,2019,417,194,223,87,416,194,222,87.4
'32360, 철원군,'075,70~74세,2019,2381,1117,1264,88.4,2375,1116,1259,88.6
'32360, 철원군,'075001, 70세,2019,508,238,270,88.1,507,238,269,88.5
'32360, 철원군,'075002, 71세,2019,466,207,259,79.9,463,207,256,80.9
'32360, 철원군,'075003, 72세,2019,501,244,257,94.9,501,244,257,94.9
'32360, 철원군,'075004, 73세,2019,399,187,212,88.2,398,187,211,88.6
'32360, 철원군,'075005, 74세,2019,507,241,266,90.6,506,240,266,90.2
'32360, 철원군,'080,75~79세,2019,2297,960,1337,71.8,2294,959,1335,71.8
'32360, 철원군,'080001, 75세,2019,465,194,271,71.6,465,194,271,71.6
'32360, 철원군,'080002, 76세,2019,468,196,272,72.1,468,196,272,72.1
'32360, 철원군,'080003, 77세,2019,509,218,291,74.9,507,217,290,74.8
'32360, 철원군,'080004, 78세,2019,447,186,261,71.3,446,186,260,71.5
'32360, 철원군,'080005, 79세,2019,408,166,242,68.6,408,166,242,68.6
'32360, 철원군,'085,80~84세,2019,1394,523,871,60,1393,523,870,60.1
'32360, 철원군,'085001, 80세,2019,398,149,249,59.8,398,149,249,59.8
'32360, 철원군,'085002, 81세,2019,325,137,188,72.9,325,137,188,72.9
'32360, 철원군,'085003, 82세,2019,288,108,180,60,288,108,180,60
'32360, 철원군,'085004, 83세,2019,206,74,132,56.1,205,74,131,56.5
'32360, 철원군,'085005, 84세,2019,177,55,122,45.1,177,55,122,45.1
'32360, 철원군,'086,85세이상,2019,876,253,623,40.6,876,253,623,40.6
'32360, 철원군,'090,85~89세,2019,551,176,375,46.9,551,176,375,46.9
'32360, 철원군,'090001, 85세,2019,149,39,110,35.5,149,39,110,35.5
'32360, 철원군,'090002, 86세,2019,132,42,90,46.7,132,42,90,46.7
'32360, 철원군,'090003, 87세,2019,100,42,58,72.4,100,42,58,72.4
'32360, 철원군,'090004, 88세,2019,77,27,50,54,77,27,50,54
'32360, 철원군,'090005, 89세,2019,93,26,67,38.8,93,26,67,38.8
'32360, 철원군,'095,90~94세,2019,260,56,204,27.5,260,56,204,27.5
'32360, 철원군,'095001, 90세,2019,89,18,71,25.4,89,18,71,25.4
'32360, 철원군,'095002, 91세,2019,70,14,56,25,70,14,56,25
'32360, 철원군,'095003, 92세,2019,45,12,33,36.4,45,12,33,36.4
'32360, 철원군,'095004, 93세,2019,34,7,27,25.9,34,7,27,25.9
'32360, 철원군,'095005, 94세,2019,22,5,17,29.4,22,5,17,29.4
'32360, 철원군,'100,95~99세,2019,55,16,39,41,55,16,39,41
'32360, 철원군,'100001, 95세,2019,21,X,17,23.5,21,X,17,23.5
'32360, 철원군,'100002, 96세,2019,16,8,8,100,16,8,8,100
'32360, 철원군,'100003, 97세,2019,9,X,8,12.5,9,X,8,12.5
'32360, 철원군,'100004, 98세,2019,6,X,5,20,6,X,5,20
'32360, 철원군,'100005, 99세,2019,X,X,X,200,X,X,X,200
'32360, 철원군,'101,100세이상,2019,10,5,5,100,10,5,5,100
'32360, 철원군,'102,15세미만,2019,5161,2675,2486,107.6,5159,2675,2484,107.7
'32360, 철원군,'103,15~64세,2019,29035,16253,12782,127.2,27971,15606,12365,126.2
'32360, 철원군,'104,65세이상,2019,9324,3941,5383,73.2,9303,3936,5367,73.3
'32360, 철원군,'126,평균연령,2019,45.3,43,47.8,,45.6,43.3,48,
'32360, 철원군,'127,중위연령,2019,47.3,44,50.7,,47.9,45,51.2,
'32370, 화천군,'000,합계,2019,23425,12636,10789,117.1,23025,12443,10582,117.6
'32370, 화천군,'005,0~4세,2019,967,486,481,101,966,485,481,100.8
'32370, 화천군,'005001, 0세,2019,200,97,103,94.2,200,97,103,94.2
'32370, 화천군,'005002, 1세,2019,201,98,103,95.1,201,98,103,95.1
'32370, 화천군,'005003, 2세,2019,187,100,87,114.9,186,99,87,113.8
'32370, 화천군,'005004, 3세,2019,173,80,93,86,173,80,93,86
'32370, 화천군,'005005, 4세,2019,206,111,95,116.8,206,111,95,116.8
'32370, 화천군,'010,5~9세,2019,920,463,457,101.3,919,462,457,101.1
'32370, 화천군,'010001, 5세,2019,198,104,94,110.6,198,104,94,110.6
'32370, 화천군,'010002, 6세,2019,177,89,88,101.1,177,89,88,101.1
'32370, 화천군,'010003, 7세,2019,189,87,102,85.3,188,86,102,84.3
'32370, 화천군,'010004, 8세,2019,173,92,81,113.6,173,92,81,113.6
'32370, 화천군,'010005, 9세,2019,183,91,92,98.9,183,91,92,98.9
'32370, 화천군,'015,10~14세,2019,834,419,415,101,834,419,415,101
'32370, 화천군,'015001, 10세,2019,162,73,89,82,162,73,89,82
'32370, 화천군,'015002, 11세,2019,184,90,94,95.7,184,90,94,95.7
'32370, 화천군,'015003, 12세,2019,164,82,82,100,164,82,82,100
'32370, 화천군,'015004, 13세,2019,172,89,83,107.2,172,89,83,107.2
'32370, 화천군,'015005, 14세,2019,152,85,67,126.9,152,85,67,126.9
'32370, 화천군,'020,15~19세,2019,867,459,408,112.5,864,459,405,113.3
'32370, 화천군,'020001, 15세,2019,183,86,97,88.7,183,86,97,88.7
'32370, 화천군,'020002, 16세,2019,167,89,78,114.1,167,89,78,114.1
'32370, 화천군,'020003, 17세,2019,199,94,105,89.5,199,94,105,89.5
'32370, 화천군,'020004, 18세,2019,188,100,88,113.6,187,100,87,114.9
'32370, 화천군,'020005, 19세,2019,130,90,40,225,128,90,38,236.8
'32370, 화천군,'025,20~24세,2019,1339,934,405,230.6,1280,897,383,234.2
'32370, 화천군,'025001, 20세,2019,174,128,46,278.3,165,121,44,275
'32370, 화천군,'025002, 21세,2019,201,135,66,204.5,191,127,64,198.4
'32370, 화천군,'025003, 22세,2019,266,173,93,186,256,169,87,194.3
'32370, 화천군,'025004, 23세,2019,290,197,93,211.8,273,186,87,213.8
'32370, 화천군,'025005, 24세,2019,408,301,107,281.3,395,294,101,291.1
'32370, 화천군,'030,25~29세,2019,2117,1475,642,229.8,2043,1438,605,237.7
'32370, 화천군,'030001, 25세,2019,473,338,135,250.4,461,332,129,257.4
'32370, 화천군,'030002, 26세,2019,457,340,117,290.6,441,330,111,297.3
'32370, 화천군,'030003, 27세,2019,443,312,131,238.2,426,303,123,246.3
'32370, 화천군,'030004, 28세,2019,375,251,124,202.4,358,245,113,216.8
'32370, 화천군,'030005, 29세,2019,369,234,135,173.3,357,228,129,176.7
'32370, 화천군,'035,30~34세,2019,1498,883,615,143.6,1425,853,572,149.1
'32370, 화천군,'035001, 30세,2019,310,203,107,189.7,297,193,104,185.6
'32370, 화천군,'035002, 31세,2019,329,199,130,153.1,312,193,119,162.2
'32370, 화천군,'035003, 32세,2019,303,180,123,146.3,282,173,109,158.7
'32370, 화천군,'035004, 33세,2019,296,162,134,120.9,280,156,124,125.8
'32370, 화천군,'035005, 34세,2019,260,139,121,114.9,254,138,116,119
'32370, 화천군,'040,35~39세,2019,1359,742,617,120.3,1296,714,582,122.7
'32370, 화천군,'040001, 35세,2019,282,152,130,116.9,268,149,119,125.2
'32370, 화천군,'040002, 36세,2019,248,134,114,117.5,237,128,109,117.4
'32370, 화천군,'040003, 37세,2019,282,163,119,137,272,158,114,138.6
'32370, 화천군,'040004, 38세,2019,282,156,126,123.8,264,146,118,123.7
'32370, 화천군,'040005, 39세,2019,265,137,128,107,255,133,122,109
'32370, 화천군,'045,40~44세,2019,1248,719,529,135.9,1221,705,516,136.6
'32370, 화천군,'045001, 40세,2019,267,159,108,147.2,262,156,106,147.2
'32370, 화천군,'045002, 41세,2019,220,142,78,182.1,213,139,74,187.8
'32370, 화천군,'045003, 42세,2019,264,138,126,109.5,259,134,125,107.2
'32370, 화천군,'045004, 43세,2019,250,138,112,123.2,246,137,109,125.7
'32370, 화천군,'045005, 44세,2019,247,142,105,135.2,241,139,102,136.3
'32370, 화천군,'050,45~49세,2019,1448,769,679,113.3,1429,759,670,113.3
'32370, 화천군,'050001, 45세,2019,267,142,125,113.6,260,137,123,111.4
'32370, 화천군,'050002, 46세,2019,273,137,136,100.7,273,137,136,100.7
'32370, 화천군,'050003, 47세,2019,298,161,137,117.5,293,159,134,118.7
'32370, 화천군,'050004, 48세,2019,295,156,139,112.2,290,154,136,113.2
'32370, 화천군,'050005, 49세,2019,315,173,142,121.8,313,172,141,122
'32370, 화천군,'055,50~54세,2019,1737,942,795,118.5,1706,928,778,119.3
'32370, 화천군,'055001, 50세,2019,367,199,168,118.5,362,197,165,119.4
'32370, 화천군,'055002, 51세,2019,369,200,169,118.3,362,197,165,119.4
'32370, 화천군,'055003, 52세,2019,325,180,145,124.1,321,178,143,124.5
'32370, 화천군,'055004, 53세,2019,330,178,152,117.1,323,173,150,115.3
'32370, 화천군,'055005, 54세,2019,346,185,161,114.9,338,183,155,118.1
'32370, 화천군,'060,55~59세,2019,2108,1127,981,114.9,2078,1113,965,115.3
'32370, 화천군,'060001, 55세,2019,386,197,189,104.2,381,194,187,103.7
'32370, 화천군,'060002, 56세,2019,370,199,171,116.4,363,195,168,116.1
'32370, 화천군,'060003, 57세,2019,381,220,161,136.6,374,219,155,141.3
'32370, 화천군,'060004, 58세,2019,523,281,242,116.1,518,278,240,115.8
'32370, 화천군,'060005, 59세,2019,448,230,218,105.5,442,227,215,105.6
'32370, 화천군,'065,60~64세,2019,1963,1060,903,117.4,1954,1057,897,117.8
'32370, 화천군,'065001, 60세,2019,410,225,185,121.6,409,225,184,122.3
'32370, 화천군,'065002, 61세,2019,377,209,168,124.4,374,209,165,126.7
'32370, 화천군,'065003, 62세,2019,434,231,203,113.8,432,230,202,113.9
'32370, 화천군,'065004, 63세,2019,364,193,171,112.9,364,193,171,112.9
'32370, 화천군,'065005, 64세,2019,378,202,176,114.8,375,200,175,114.3
'32370, 화천군,'070,65~69세,2019,1276,645,631,102.2,1271,643,628,102.4
'32370, 화천군,'070001, 65세,2019,359,198,161,123,358,197,161,122.4
'32370, 화천군,'070002, 66세,2019,285,149,136,109.6,284,149,135,110.4
'32370, 화천군,'070003, 67세,2019,272,140,132,106.1,271,140,131,106.9
'32370, 화천군,'070004, 68세,2019,161,71,90,78.9,159,70,89,78.7
'32370, 화천군,'070005, 69세,2019,199,87,112,77.7,199,87,112,77.7
'32370, 화천군,'075,70~74세,2019,1149,520,629,82.7,1148,519,629,82.5
'32370, 화천군,'075001, 70세,2019,221,88,133,66.2,220,87,133,65.4
'32370, 화천군,'075002, 71세,2019,236,118,118,100,236,118,118,100
'32370, 화천군,'075003, 72세,2019,251,121,130,93.1,251,121,130,93.1
'32370, 화천군,'075004, 73세,2019,230,113,117,96.6,230,113,117,96.6
'32370, 화천군,'075005, 74세,2019,211,80,131,61.1,211,80,131,61.1
'32370, 화천군,'080,75~79세,2019,1264,545,719,75.8,1262,544,718,75.8
'32370, 화천군,'080001, 75세,2019,221,115,106,108.5,221,115,106,108.5
'32370, 화천군,'080002, 76세,2019,257,120,137,87.6,257,120,137,87.6
'32370, 화천군,'080003, 77세,2019,279,113,166,68.1,278,112,166,67.5
'32370, 화천군,'080004, 78세,2019,274,110,164,67.1,273,110,163,67.5
'32370, 화천군,'080005, 79세,2019,233,87,146,59.6,233,87,146,59.6
'32370, 화천군,'085,80~84세,2019,827,293,534,54.9,826,293,533,55
'32370, 화천군,'085001, 80세,2019,222,91,131,69.5,222,91,131,69.5
'32370, 화천군,'085002, 81세,2019,182,59,123,48,182,59,123,48
'32370, 화천군,'085003, 82세,2019,182,73,109,67,181,73,108,67.6
'32370, 화천군,'085004, 83세,2019,132,41,91,45.1,132,41,91,45.1
'32370, 화천군,'085005, 84세,2019,109,29,80,36.3,109,29,80,36.3
'32370, 화천군,'086,85세이상,2019,504,155,349,44.4,503,155,348,44.5
'32370, 화천군,'090,85~89세,2019,343,116,227,51.1,342,116,226,51.3
'32370, 화천군,'090001, 85세,2019,93,33,60,55,93,33,60,55
'32370, 화천군,'090002, 86세,2019,78,32,46,69.6,78,32,46,69.6
'32370, 화천군,'090003, 87세,2019,65,21,44,47.7,65,21,44,47.7
'32370, 화천군,'090004, 88세,2019,48,13,35,37.1,48,13,35,37.1
'32370, 화천군,'090005, 89세,2019,59,17,42,40.5,58,17,41,41.5
'32370, 화천군,'095,90~94세,2019,120,24,96,25,120,24,96,25
'32370, 화천군,'095001, 90세,2019,38,8,30,26.7,38,8,30,26.7
'32370, 화천군,'095002, 91세,2019,35,5,30,16.7,35,5,30,16.7
'32370, 화천군,'095003, 92세,2019,16,X,13,23.1,16,X,13,23.1
'32370, 화천군,'095004, 93세,2019,15,X,11,36.4,15,X,11,36.4
'32370, 화천군,'095005, 94세,2019,16,X,12,33.3,16,X,12,33.3
'32370, 화천군,'100,95~99세,2019,36,13,23,56.5,36,13,23,56.5
'32370, 화천군,'100001, 95세,2019,9,X,5,80,9,X,5,80
'32370, 화천군,'100002, 96세,2019,14,5,9,55.6,14,5,9,55.6
'32370, 화천군,'100003, 97세,2019,9,X,6,50,9,X,6,50
'32370, 화천군,'100004, 98세,2019,X,X,X,33.3,X,X,X,33.3
'32370, 화천군,'100005, 99세,2019,X,X,X,,X,X,X,
'32370, 화천군,'101,100세이상,2019,5,X,X,66.7,5,X,X,66.7
'32370, 화천군,'102,15세미만,2019,2721,1368,1353,101.1,2719,1366,1353,101
'32370, 화천군,'103,15~64세,2019,15684,9110,6574,138.6,15296,8923,6373,140
'32370, 화천군,'104,65세이상,2019,5020,2158,2862,75.4,5010,2154,2856,75.4
'32370, 화천군,'126,평균연령,2019,45.2,43.1,47.8,,45.4,43.2,47.9,
'32370, 화천군,'127,중위연령,2019,47.1,43.1,50.9,,47.4,43.5,51.2,
'32380, 양구군,'000,합계,2019,21780,11569,10211,113.3,21365,11413,9952,114.7
'32380, 양구군,'005,0~4세,2019,956,468,488,95.9,956,468,488,95.9
'32380, 양구군,'005001, 0세,2019,170,80,90,88.9,170,80,90,88.9
'32380, 양구군,'005002, 1세,2019,178,94,84,111.9,178,94,84,111.9
'32380, 양구군,'005003, 2세,2019,205,95,110,86.4,205,95,110,86.4
'32380, 양구군,'005004, 3세,2019,202,93,109,85.3,202,93,109,85.3
'32380, 양구군,'005005, 4세,2019,201,106,95,111.6,201,106,95,111.6
'32380, 양구군,'010,5~9세,2019,937,478,459,104.1,934,476,458,103.9
'32380, 양구군,'010001, 5세,2019,167,86,81,106.2,166,85,81,104.9
'32380, 양구군,'010002, 6세,2019,183,85,98,86.7,183,85,98,86.7
'32380, 양구군,'010003, 7세,2019,202,108,94,114.9,200,107,93,115.1
'32380, 양구군,'010004, 8세,2019,196,111,85,130.6,196,111,85,130.6
'32380, 양구군,'010005, 9세,2019,189,88,101,87.1,189,88,101,87.1
'32380, 양구군,'015,10~14세,2019,837,443,394,112.4,837,443,394,112.4
'32380, 양구군,'015001, 10세,2019,148,80,68,117.6,148,80,68,117.6
'32380, 양구군,'015002, 11세,2019,177,86,91,94.5,177,86,91,94.5
'32380, 양구군,'015003, 12세,2019,170,91,79,115.2,170,91,79,115.2
'32380, 양구군,'015004, 13세,2019,179,84,95,88.4,179,84,95,88.4
'32380, 양구군,'015005, 14세,2019,163,102,61,167.2,163,102,61,167.2
'32380, 양구군,'020,15~19세,2019,1104,533,571,93.3,1102,533,569,93.7
'32380, 양구군,'020001, 15세,2019,197,82,115,71.3,197,82,115,71.3
'32380, 양구군,'020002, 16세,2019,246,114,132,86.4,246,114,132,86.4
'32380, 양구군,'020003, 17세,2019,298,143,155,92.3,298,143,155,92.3
'32380, 양구군,'020004, 18세,2019,243,112,131,85.5,242,112,130,86.2
'32380, 양구군,'020005, 19세,2019,120,82,38,215.8,119,82,37,221.6
'32380, 양구군,'025,20~24세,2019,1210,883,327,270,1179,867,312,277.9
'32380, 양구군,'025001, 20세,2019,137,96,41,234.1,135,96,39,246.2
'32380, 양구군,'025002, 21세,2019,184,136,48,283.3,182,136,46,295.7
'32380, 양구군,'025003, 22세,2019,223,156,67,232.8,215,152,63,241.3
'32380, 양구군,'025004, 23세,2019,303,228,75,304,294,221,73,302.7
'32380, 양구군,'025005, 24세,2019,363,267,96,278.1,353,262,91,287.9
'32380, 양구군,'030,25~29세,2019,1809,1227,582,210.8,1725,1187,538,220.6
'32380, 양구군,'030001, 25세,2019,393,303,90,336.7,378,295,83,355.4
'32380, 양구군,'030002, 26세,2019,346,244,102,239.2,331,236,95,248.4
'32380, 양구군,'030003, 27세,2019,360,235,125,188,347,230,117,196.6
'32380, 양구군,'030004, 28세,2019,352,220,132,166.7,337,214,123,174
'32380, 양구군,'030005, 29세,2019,358,225,133,169.2,332,212,120,176.7
'32380, 양구군,'035,30~34세,2019,1341,768,573,134,1261,740,521,142
'32380, 양구군,'035001, 30세,2019,296,177,119,148.7,275,167,108,154.6
'32380, 양구군,'035002, 31세,2019,283,163,120,135.8,271,159,112,142
'32380, 양구군,'035003, 32세,2019,280,155,125,124,263,150,113,132.7
'32380, 양구군,'035004, 33세,2019,250,141,109,129.4,239,136,103,132
'32380, 양구군,'035005, 34세,2019,232,132,100,132,213,128,85,150.6
'32380, 양구군,'040,35~39세,2019,1379,719,660,108.9,1334,703,631,111.4
'32380, 양구군,'040001, 35세,2019,252,127,125,101.6,242,124,118,105.1
'32380, 양구군,'040002, 36세,2019,264,132,132,100,254,127,127,100
'32380, 양구군,'040003, 37세,2019,303,156,147,106.1,293,152,141,107.8
'32380, 양구군,'040004, 38세,2019,285,148,137,108,278,148,130,113.8
'32380, 양구군,'040005, 39세,2019,275,156,119,131.1,267,152,115,132.2
'32380, 양구군,'045,40~44세,2019,1184,624,560,111.4,1145,611,534,114.4
'32380, 양구군,'045001, 40세,2019,239,123,116,106,228,120,108,111.1
'32380, 양구군,'045002, 41세,2019,240,136,104,130.8,232,133,99,134.3
'32380, 양구군,'045003, 42세,2019,232,119,113,105.3,225,116,109,106.4
'32380, 양구군,'045004, 43세,2019,245,131,114,114.9,239,128,111,115.3
'32380, 양구군,'045005, 44세,2019,228,115,113,101.8,221,114,107,106.5
'32380, 양구군,'050,45~49세,2019,1383,751,632,118.8,1344,741,603,122.9
'32380, 양구군,'050001, 45세,2019,276,154,122,126.2,265,152,113,134.5
'32380, 양구군,'050002, 46세,2019,294,163,131,124.4,290,162,128,126.6
'32380, 양구군,'050003, 47세,2019,254,141,113,124.8,246,136,110,123.6
'32380, 양구군,'050004, 48세,2019,261,140,121,115.7,254,139,115,120.9
'32380, 양구군,'050005, 49세,2019,298,153,145,105.5,289,152,137,110.9
'32380, 양구군,'055,50~54세,2019,1541,828,713,116.1,1510,817,693,117.9
'32380, 양구군,'055001, 50세,2019,308,171,137,124.8,303,170,133,127.8
'32380, 양구군,'055002, 51세,2019,332,179,153,117,321,173,148,116.9
'32380, 양구군,'055003, 52세,2019,310,166,144,115.3,305,165,140,117.9
'32380, 양구군,'055004, 53세,2019,290,149,141,105.7,287,149,138,108
'32380, 양구군,'055005, 54세,2019,301,163,138,118.1,294,160,134,119.4
'32380, 양구군,'060,55~59세,2019,1993,1050,943,111.3,1962,1040,922,112.8
'32380, 양구군,'060001, 55세,2019,353,190,163,116.6,345,186,159,117
'32380, 양구군,'060002, 56세,2019,374,198,176,112.5,368,196,172,114
'32380, 양구군,'060003, 57세,2019,394,211,183,115.3,386,210,176,119.3
'32380, 양구군,'060004, 58세,2019,444,227,217,104.6,436,224,212,105.7
'32380, 양구군,'060005, 59세,2019,428,224,204,109.8,427,224,203,110.3
'32380, 양구군,'065,60~64세,2019,1819,968,851,113.7,1803,966,837,115.4
'32380, 양구군,'065001, 60세,2019,372,199,173,115,368,199,169,117.8
'32380, 양구군,'065002, 61세,2019,394,203,191,106.3,391,202,189,106.9
'32380, 양구군,'065003, 62세,2019,379,203,176,115.3,376,202,174,116.1
'32380, 양구군,'065004, 63세,2019,348,182,166,109.6,344,182,162,112.3
'32380, 양구군,'065005, 64세,2019,326,181,145,124.8,324,181,143,126.6
'32380, 양구군,'070,65~69세,2019,1104,572,532,107.5,1098,568,530,107.2
'32380, 양구군,'070001, 65세,2019,325,185,140,132.1,323,184,139,132.4
'32380, 양구군,'070002, 66세,2019,215,109,106,102.8,214,108,106,101.9
'32380, 양구군,'070003, 67세,2019,241,133,108,123.1,239,131,108,121.3
'32380, 양구군,'070004, 68세,2019,163,75,88,85.2,162,75,87,86.2
'32380, 양구군,'070005, 69세,2019,160,70,90,77.8,160,70,90,77.8
'32380, 양구군,'075,70~74세,2019,934,417,517,80.7,930,416,514,80.9
'32380, 양구군,'075001, 70세,2019,186,80,106,75.5,186,80,106,75.5
'32380, 양구군,'075002, 71세,2019,180,83,97,85.6,178,82,96,85.4
'32380, 양구군,'075003, 72세,2019,205,82,123,66.7,204,82,122,67.2
'32380, 양구군,'075004, 73세,2019,177,82,95,86.3,177,82,95,86.3
'32380, 양구군,'075005, 74세,2019,186,90,96,93.8,185,90,95,94.7
'32380, 양구군,'080,75~79세,2019,1081,456,625,73,1078,454,624,72.8
'32380, 양구군,'080001, 75세,2019,226,106,120,88.3,225,105,120,87.5
'32380, 양구군,'080002, 76세,2019,212,87,125,69.6,212,87,125,69.6
'32380, 양구군,'080003, 77세,2019,250,104,146,71.2,249,103,146,70.5
'32380, 양구군,'080004, 78세,2019,210,88,122,72.1,210,88,122,72.1
'32380, 양구군,'080005, 79세,2019,183,71,112,63.4,182,71,111,64
'32380, 양구군,'085,80~84세,2019,696,258,438,58.9,696,258,438,58.9
'32380, 양구군,'085001, 80세,2019,190,74,116,63.8,190,74,116,63.8
'32380, 양구군,'085002, 81세,2019,153,54,99,54.5,153,54,99,54.5
'32380, 양구군,'085003, 82세,2019,135,52,83,62.7,135,52,83,62.7
'32380, 양구군,'085004, 83세,2019,123,49,74,66.2,123,49,74,66.2
'32380, 양구군,'085005, 84세,2019,95,29,66,43.9,95,29,66,43.9
'32380, 양구군,'086,85세이상,2019,472,126,346,36.4,471,125,346,36.1
'32380, 양구군,'090,85~89세,2019,320,84,236,35.6,319,83,236,35.2
'32380, 양구군,'090001, 85세,2019,91,22,69,31.9,90,21,69,30.4
'32380, 양구군,'090002, 86세,2019,81,20,61,32.8,81,20,61,32.8
'32380, 양구군,'090003, 87세,2019,56,20,36,55.6,56,20,36,55.6
'32380, 양구군,'090004, 88세,2019,58,17,41,41.5,58,17,41,41.5
'32380, 양구군,'090005, 89세,2019,34,5,29,17.2,34,5,29,17.2
'32380, 양구군,'095,90~94세,2019,114,30,84,35.7,114,30,84,35.7
'32380, 양구군,'095001, 90세,2019,36,10,26,38.5,36,10,26,38.5
'32380, 양구군,'095002, 91세,2019,22,8,14,57.1,22,8,14,57.1
'32380, 양구군,'095003, 92세,2019,28,7,21,33.3,28,7,21,33.3
'32380, 양구군,'095004, 93세,2019,13,X,10,30,13,X,10,30
'32380, 양구군,'095005, 94세,2019,15,X,13,15.4,15,X,13,15.4
'32380, 양구군,'100,95~99세,2019,34,11,23,47.8,34,11,23,47.8
'32380, 양구군,'100001, 95세,2019,13,X,9,44.4,13,X,9,44.4
'32380, 양구군,'100002, 96세,2019,8,X,6,33.3,8,X,6,33.3
'32380, 양구군,'100003, 97세,2019,5,X,X,25,5,X,X,25
'32380, 양구군,'100004, 98세,2019,5,X,X,66.7,5,X,X,66.7
'32380, 양구군,'100005, 99세,2019,X,X,X,200,X,X,X,200
'32380, 양구군,'101,100세이상,2019,X,X,X,33.3,X,X,X,33.3
'32380, 양구군,'102,15세미만,2019,2730,1389,1341,103.6,2727,1387,1340,103.5
'32380, 양구군,'103,15~64세,2019,14763,8351,6412,130.2,14365,8205,6160,133.2
'32380, 양구군,'104,65세이상,2019,4287,1829,2458,74.4,4273,1821,2452,74.3
'32380, 양구군,'126,평균연령,2019,44.2,42.2,46.4,,44.3,42.3,46.5,
'32380, 양구군,'127,중위연령,2019,45.5,42.1,49,,45.8,42.3,49.5,
'32390, 인제군,'000,합계,2019,30133,16333,13800,118.4,29630,16071,13559,118.5
'32390, 인제군,'005,0~4세,2019,1316,671,645,104,1316,671,645,104
'32390, 인제군,'005001, 0세,2019,258,129,129,100,258,129,129,100
'32390, 인제군,'005002, 1세,2019,236,113,123,91.9,236,113,123,91.9
'32390, 인제군,'005003, 2세,2019,279,142,137,103.6,279,142,137,103.6
'32390, 인제군,'005004, 3세,2019,277,152,125,121.6,277,152,125,121.6
'32390, 인제군,'005005, 4세,2019,266,135,131,103.1,266,135,131,103.1
'32390, 인제군,'010,5~9세,2019,1294,693,601,115.3,1294,693,601,115.3
'32390, 인제군,'010001, 5세,2019,240,124,116,106.9,240,124,116,106.9
'32390, 인제군,'010002, 6세,2019,261,133,128,103.9,261,133,128,103.9
'32390, 인제군,'010003, 7세,2019,288,155,133,116.5,288,155,133,116.5
'32390, 인제군,'010004, 8세,2019,244,136,108,125.9,244,136,108,125.9
'32390, 인제군,'010005, 9세,2019,261,145,116,125,261,145,116,125
'32390, 인제군,'015,10~14세,2019,1149,574,575,99.8,1148,573,575,99.7
'32390, 인제군,'015001, 10세,2019,221,119,102,116.7,221,119,102,116.7
'32390, 인제군,'015002, 11세,2019,242,120,122,98.4,241,119,122,97.5
'32390, 인제군,'015003, 12세,2019,229,115,114,100.9,229,115,114,100.9
'32390, 인제군,'015004, 13세,2019,235,114,121,94.2,235,114,121,94.2
'32390, 인제군,'015005, 14세,2019,222,106,116,91.4,222,106,116,91.4
'32390, 인제군,'020,15~19세,2019,903,511,392,130.4,901,511,390,131
'32390, 인제군,'020001, 15세,2019,223,121,102,118.6,223,121,102,118.6
'32390, 인제군,'020002, 16세,2019,190,105,85,123.5,190,105,85,123.5
'32390, 인제군,'020003, 17세,2019,166,92,74,124.3,166,92,74,124.3
'32390, 인제군,'020004, 18세,2019,186,98,88,111.4,185,98,87,112.6
'32390, 인제군,'020005, 19세,2019,138,95,43,220.9,137,95,42,226.2
'32390, 인제군,'025,20~24세,2019,1576,1107,469,236,1508,1069,439,243.5
'32390, 인제군,'025001, 20세,2019,198,144,54,266.7,194,141,53,266
'32390, 인제군,'025002, 21세,2019,270,169,101,167.3,257,165,92,179.3
'32390, 인제군,'025003, 22세,2019,297,211,86,245.3,283,202,81,249.4
'32390, 인제군,'025004, 23세,2019,364,259,105,246.7,346,248,98,253.1
'32390, 인제군,'025005, 24세,2019,447,324,123,263.4,428,313,115,272.2
'32390, 인제군,'030,25~29세,2019,2223,1477,746,198,2107,1403,704,199.3
'32390, 인제군,'030001, 25세,2019,442,299,143,209.1,425,291,134,217.2
'32390, 인제군,'030002, 26세,2019,478,351,127,276.4,454,334,120,278.3
'32390, 인제군,'030003, 27세,2019,437,284,153,185.6,406,264,142,185.9
'32390, 인제군,'030004, 28세,2019,475,311,164,189.6,448,291,157,185.4
'32390, 인제군,'030005, 29세,2019,391,232,159,145.9,374,223,151,147.7
'32390, 인제군,'035,30~34세,2019,1864,1115,749,148.9,1788,1079,709,152.2
'32390, 인제군,'035001, 30세,2019,373,229,144,159,360,221,139,159
'32390, 인제군,'035002, 31세,2019,366,221,145,152.4,348,213,135,157.8
'32390, 인제군,'035003, 32세,2019,363,214,149,143.6,349,207,142,145.8
'32390, 인제군,'035004, 33세,2019,386,221,165,133.9,370,214,156,137.2
'32390, 인제군,'035005, 34세,2019,376,230,146,157.5,361,224,137,163.5
'32390, 인제군,'040,35~39세,2019,2075,1115,960,116.1,1995,1082,913,118.5
'32390, 인제군,'040001, 35세,2019,381,203,178,114,361,193,168,114.9
'32390, 인제군,'040002, 36세,2019,401,212,189,112.2,383,205,178,115.2
'32390, 인제군,'040003, 37세,2019,443,232,211,110,424,228,196,116.3
'32390, 인제군,'040004, 38세,2019,432,236,196,120.4,423,229,194,118
'32390, 인제군,'040005, 39세,2019,418,232,186,124.7,404,227,177,128.2
'32390, 인제군,'045,40~44세,2019,1842,994,848,117.2,1813,980,833,117.6
'32390, 인제군,'045001, 40세,2019,406,218,188,116,401,215,186,115.6
'32390, 인제군,'045002, 41세,2019,377,212,165,128.5,369,207,162,127.8
'32390, 인제군,'045003, 42세,2019,351,167,184,90.8,348,165,183,90.2
'32390, 인제군,'045004, 43세,2019,326,186,140,132.9,322,183,139,131.7
'32390, 인제군,'045005, 44세,2019,382,211,171,123.4,373,210,163,128.8
'32390, 인제군,'050,45~49세,2019,1996,1134,862,131.6,1959,1118,841,132.9
'32390, 인제군,'050001, 45세,2019,398,238,160,148.8,391,235,156,150.6
'32390, 인제군,'050002, 46세,2019,367,205,162,126.5,359,202,157,128.7
'32390, 인제군,'050003, 47세,2019,388,222,166,133.7,381,219,162,135.2
'32390, 인제군,'050004, 48세,2019,432,246,186,132.3,425,242,183,132.2
'32390, 인제군,'050005, 49세,2019,411,223,188,118.6,403,220,183,120.2
'32390, 인제군,'055,50~54세,2019,2247,1232,1015,121.4,2214,1215,999,121.6
'32390, 인제군,'055001, 50세,2019,473,272,201,135.3,466,268,198,135.4
'32390, 인제군,'055002, 51세,2019,474,263,211,124.6,465,258,207,124.6
'32390, 인제군,'055003, 52세,2019,390,221,169,130.8,385,219,166,131.9
'32390, 인제군,'055004, 53세,2019,457,254,203,125.1,453,252,201,125.4
'32390, 인제군,'055005, 54세,2019,453,222,231,96.1,445,218,227,96
'32390, 인제군,'060,55~59세,2019,2993,1555,1438,108.1,2964,1540,1424,108.1
'32390, 인제군,'060001, 55세,2019,512,265,247,107.3,507,262,245,106.9
'32390, 인제군,'060002, 56세,2019,566,277,289,95.8,554,270,284,95.1
'32390, 인제군,'060003, 57세,2019,581,319,262,121.8,575,316,259,122
'32390, 인제군,'060004, 58세,2019,713,364,349,104.3,712,364,348,104.6
'32390, 인제군,'060005, 59세,2019,621,330,291,113.4,616,328,288,113.9
'32390, 인제군,'065,60~64세,2019,2765,1526,1239,123.2,2752,1520,1232,123.4
'32390, 인제군,'065001, 60세,2019,557,308,249,123.7,554,307,247,124.3
'32390, 인제군,'065002, 61세,2019,566,323,243,132.9,562,322,240,134.2
'32390, 인제군,'065003, 62세,2019,615,345,270,127.8,613,344,269,127.9
'32390, 인제군,'065004, 63세,2019,503,271,232,116.8,502,271,231,117.3
'32390, 인제군,'065005, 64세,2019,524,279,245,113.9,521,276,245,112.7
'32390, 인제군,'070,65~69세,2019,1662,854,808,105.7,1651,846,805,105.1
'32390, 인제군,'070001, 65세,2019,414,212,202,105,410,209,201,104
'32390, 인제군,'070002, 66세,2019,357,194,163,119,354,193,161,119.9
'32390, 인제군,'070003, 67세,2019,436,227,209,108.6,434,225,209,107.7
'32390, 인제군,'070004, 68세,2019,240,120,120,100,239,119,120,99.2
'32390, 인제군,'070005, 69세,2019,215,101,114,88.6,214,100,114,87.7
'32390, 인제군,'075,70~74세,2019,1331,650,681,95.4,1325,646,679,95.1
'32390, 인제군,'075001, 70세,2019,262,125,137,91.2,260,124,136,91.2
'32390, 인제군,'075002, 71세,2019,256,131,125,104.8,256,131,125,104.8
'32390, 인제군,'075003, 72세,2019,298,148,150,98.7,296,147,149,98.7
'32390, 인제군,'075004, 73세,2019,237,119,118,100.8,235,117,118,99.2
'32390, 인제군,'075005, 74세,2019,278,127,151,84.1,278,127,151,84.1
'32390, 인제군,'080,75~79세,2019,1352,615,737,83.4,1351,615,736,83.6
'32390, 인제군,'080001, 75세,2019,281,145,136,106.6,281,145,136,106.6
'32390, 인제군,'080002, 76세,2019,276,114,162,70.4,276,114,162,70.4
'32390, 인제군,'080003, 77세,2019,284,132,152,86.8,283,132,151,87.4
'32390, 인제군,'080004, 78세,2019,267,120,147,81.6,267,120,147,81.6
'32390, 인제군,'080005, 79세,2019,244,104,140,74.3,244,104,140,74.3
'32390, 인제군,'085,80~84세,2019,935,340,595,57.1,935,340,595,57.1
'32390, 인제군,'085001, 80세,2019,228,78,150,52,228,78,150,52
'32390, 인제군,'085002, 81세,2019,236,81,155,52.3,236,81,155,52.3
'32390, 인제군,'085003, 82세,2019,183,83,100,83,183,83,100,83
'32390, 인제군,'085004, 83세,2019,154,57,97,58.8,154,57,97,58.8
'32390, 인제군,'085005, 84세,2019,134,41,93,44.1,134,41,93,44.1
'32390, 인제군,'086,85세이상,2019,610,170,440,38.6,609,170,439,38.7
'32390, 인제군,'090,85~89세,2019,396,105,291,36.1,396,105,291,36.1
'32390, 인제군,'090001, 85세,2019,98,31,67,46.3,98,31,67,46.3
'32390, 인제군,'090002, 86세,2019,99,29,70,41.4,99,29,70,41.4
'32390, 인제군,'090003, 87세,2019,78,19,59,32.2,78,19,59,32.2
'32390, 인제군,'090004, 88세,2019,64,18,46,39.1,64,18,46,39.1
'32390, 인제군,'090005, 89세,2019,57,8,49,16.3,57,8,49,16.3
'32390, 인제군,'095,90~94세,2019,161,40,121,33.1,160,40,120,33.3
'32390, 인제군,'095001, 90세,2019,43,9,34,26.5,43,9,34,26.5
'32390, 인제군,'095002, 91세,2019,50,13,37,35.1,50,13,37,35.1
'32390, 인제군,'095003, 92세,2019,33,9,24,37.5,33,9,24,37.5
'32390, 인제군,'095004, 93세,2019,25,6,19,31.6,24,6,18,33.3
'32390, 인제군,'095005, 94세,2019,10,X,7,42.9,10,X,7,42.9
'32390, 인제군,'100,95~99세,2019,47,23,24,95.8,47,23,24,95.8
'32390, 인제군,'100001, 95세,2019,22,11,11,100,22,11,11,100
'32390, 인제군,'100002, 96세,2019,10,5,5,100,10,5,5,100
'32390, 인제군,'100003, 97세,2019,6,X,X,50,6,X,X,50
'32390, 인제군,'100004, 98세,2019,5,X,X,150,5,X,X,150
'32390, 인제군,'100005, 99세,2019,X,X,X,100,X,X,X,100
'32390, 인제군,'101,100세이상,2019,6,X,X,50,6,X,X,50
'32390, 인제군,'102,15세미만,2019,3759,1938,1821,106.4,3758,1937,1821,106.4
'32390, 인제군,'103,15~64세,2019,20484,11766,8718,135,20001,11517,8484,135.7
'32390, 인제군,'104,65세이상,2019,5890,2629,3261,80.6,5871,2617,3254,80.4
'32390, 인제군,'126,평균연령,2019,45.1,43.3,47.2,,45.2,43.4,47.4,
'32390, 인제군,'127,중위연령,2019,47.2,44.6,50.3,,47.5,44.9,50.7,
'32400, 고성군,'000,합계,2019,27144,14505,12639,114.8,25520,13321,12199,109.2
'32400, 고성군,'005,0~4세,2019,600,299,301,99.3,595,298,297,100.3
'32400, 고성군,'005001, 0세,2019,131,71,60,118.3,130,71,59,120.3
'32400, 고성군,'005002, 1세,2019,99,51,48,106.3,98,51,47,108.5
'32400, 고성군,'005003, 2세,2019,111,46,65,70.8,111,46,65,70.8
'32400, 고성군,'005004, 3세,2019,132,60,72,83.3,130,59,71,83.1
'32400, 고성군,'005005, 4세,2019,127,71,56,126.8,126,71,55,129.1
'32400, 고성군,'010,5~9세,2019,703,367,336,109.2,702,367,335,109.6
'32400, 고성군,'010001, 5세,2019,131,65,66,98.5,131,65,66,98.5
'32400, 고성군,'010002, 6세,2019,125,60,65,92.3,125,60,65,92.3
'32400, 고성군,'010003, 7세,2019,147,80,67,119.4,147,80,67,119.4
'32400, 고성군,'010004, 8세,2019,163,88,75,117.3,162,88,74,118.9
'32400, 고성군,'010005, 9세,2019,137,74,63,117.5,137,74,63,117.5
'32400, 고성군,'015,10~14세,2019,723,396,327,121.1,723,396,327,121.1
'32400, 고성군,'015001, 10세,2019,130,63,67,94,130,63,67,94
'32400, 고성군,'015002, 11세,2019,162,97,65,149.2,162,97,65,149.2
'32400, 고성군,'015003, 12세,2019,134,73,61,119.7,134,73,61,119.7
'32400, 고성군,'015004, 13세,2019,146,83,63,131.7,146,83,63,131.7
'32400, 고성군,'015005, 14세,2019,151,80,71,112.7,151,80,71,112.7
'32400, 고성군,'020,15~19세,2019,1050,601,449,133.9,957,543,414,131.2
'32400, 고성군,'020001, 15세,2019,168,91,77,118.2,167,90,77,116.9
'32400, 고성군,'020002, 16세,2019,182,86,96,89.6,181,86,95,90.5
'32400, 고성군,'020003, 17세,2019,191,103,88,117,190,102,88,115.9
'32400, 고성군,'020004, 18세,2019,232,142,90,157.8,214,128,86,148.8
'32400, 고성군,'020005, 19세,2019,277,179,98,182.7,205,137,68,201.5
'32400, 고성군,'025,20~24세,2019,2287,1551,736,210.7,1639,1059,580,182.6
'32400, 고성군,'025001, 20세,2019,325,226,99,228.3,228,155,73,212.3
'32400, 고성군,'025002, 21세,2019,444,295,149,198,327,211,116,181.9
'32400, 고성군,'025003, 22세,2019,453,266,187,142.2,322,168,154,109.1
'32400, 고성군,'025004, 23세,2019,568,404,164,246.3,385,258,127,203.1
'32400, 고성군,'025005, 24세,2019,497,360,137,262.8,377,267,110,242.7
'32400, 고성군,'030,25~29세,2019,1903,1338,565,236.8,1618,1116,502,222.3
'32400, 고성군,'030001, 25세,2019,480,379,101,375.2,404,316,88,359.1
'32400, 고성군,'030002, 26세,2019,389,275,114,241.2,337,237,100,237
'32400, 고성군,'030003, 27세,2019,386,252,134,188.1,332,213,119,179
'32400, 고성군,'030004, 28세,2019,336,223,113,197.3,287,185,102,181.4
'32400, 고성군,'030005, 29세,2019,312,209,103,202.9,258,165,93,177.4
'32400, 고성군,'035,30~34세,2019,1172,745,427,174.5,1009,625,384,162.8
'32400, 고성군,'035001, 30세,2019,257,171,86,198.8,225,143,82,174.4
'32400, 고성군,'035002, 31세,2019,240,155,85,182.4,209,133,76,175
'32400, 고성군,'035003, 32세,2019,231,152,79,192.4,197,127,70,181.4
'32400, 고성군,'035004, 33세,2019,218,131,87,150.6,190,110,80,137.5
'32400, 고성군,'035005, 34세,2019,226,136,90,151.1,188,112,76,147.4
'32400, 고성군,'040,35~39세,2019,1242,717,525,136.6,1078,588,490,120
'32400, 고성군,'040001, 35세,2019,228,124,104,119.2,198,103,95,108.4
'32400, 고성군,'040002, 36세,2019,242,139,103,135,203,103,100,103
'32400, 고성군,'040003, 37세,2019,252,158,94,168.1,219,130,89,146.1
'32400, 고성군,'040004, 38세,2019,243,140,103,135.9,212,116,96,120.8
'32400, 고성군,'040005, 39세,2019,277,156,121,128.9,246,136,110,123.6
'32400, 고성군,'045,40~44세,2019,1263,717,546,131.3,1170,650,520,125
'32400, 고성군,'045001, 40세,2019,248,143,105,136.2,225,123,102,120.6
'32400, 고성군,'045002, 41세,2019,226,134,92,145.7,206,119,87,136.8
'32400, 고성군,'045003, 42세,2019,242,135,107,126.2,218,119,99,120.2
'32400, 고성군,'045004, 43세,2019,267,142,125,113.6,253,133,120,110.8
'32400, 고성군,'045005, 44세,2019,280,163,117,139.3,268,156,112,139.3
'32400, 고성군,'050,45~49세,2019,1796,1026,770,133.2,1722,982,740,132.7
'32400, 고성군,'050001, 45세,2019,335,194,141,137.6,318,186,132,140.9
'32400, 고성군,'050002, 46세,2019,313,173,140,123.6,294,160,134,119.4
'32400, 고성군,'050003, 47세,2019,357,212,145,146.2,338,199,139,143.2
'32400, 고성군,'050004, 48세,2019,390,224,166,134.9,382,219,163,134.4
'32400, 고성군,'050005, 49세,2019,401,223,178,125.3,390,218,172,126.7
'32400, 고성군,'055,50~54세,2019,2012,1110,902,123.1,1972,1083,889,121.8
'32400, 고성군,'055001, 50세,2019,398,225,173,130.1,389,220,169,130.2
'32400, 고성군,'055002, 51세,2019,392,223,169,132,387,220,167,131.7
'32400, 고성군,'055003, 52세,2019,360,197,163,120.9,358,197,161,122.4
'32400, 고성군,'055004, 53세,2019,441,243,198,122.7,429,233,196,118.9
'32400, 고성군,'055005, 54세,2019,421,222,199,111.6,409,213,196,108.7
'32400, 고성군,'060,55~59세,2019,2544,1275,1269,100.5,2524,1269,1255,101.1
'32400, 고성군,'060001, 55세,2019,388,207,181,114.4,384,205,179,114.5
'32400, 고성군,'060002, 56세,2019,503,257,246,104.5,494,255,239,106.7
'32400, 고성군,'060003, 57세,2019,497,246,251,98,495,245,250,98
'32400, 고성군,'060004, 58세,2019,578,271,307,88.3,577,271,306,88.6
'32400, 고성군,'060005, 59세,2019,578,294,284,103.5,574,293,281,104.3
'32400, 고성군,'065,60~64세,2019,2637,1358,1279,106.2,2620,1349,1271,106.1
'32400, 고성군,'065001, 60세,2019,558,293,265,110.6,555,292,263,111
'32400, 고성군,'065002, 61세,2019,550,284,266,106.8,546,282,264,106.8
'32400, 고성군,'065003, 62세,2019,524,281,243,115.6,521,279,242,115.3
'32400, 고성군,'065004, 63세,2019,455,231,224,103.1,452,229,223,102.7
'32400, 고성군,'065005, 64세,2019,550,269,281,95.7,546,267,279,95.7
'32400, 고성군,'070,65~69세,2019,1874,919,955,96.2,1865,916,949,96.5
'32400, 고성군,'070001, 65세,2019,495,247,248,99.6,493,246,247,99.6
'32400, 고성군,'070002, 66세,2019,380,203,177,114.7,379,202,177,114.1
'32400, 고성군,'070003, 67세,2019,414,198,216,91.7,412,198,214,92.5
'32400, 고성군,'070004, 68세,2019,283,134,149,89.9,281,134,147,91.2
'32400, 고성군,'070005, 69세,2019,302,137,165,83,300,136,164,82.9
'32400, 고성군,'075,70~74세,2019,1725,779,946,82.3,1717,775,942,82.3
'32400, 고성군,'075001, 70세,2019,332,153,179,85.5,331,152,179,84.9
'32400, 고성군,'075002, 71세,2019,341,167,174,96,339,166,173,96
'32400, 고성군,'075003, 72세,2019,341,152,189,80.4,339,151,188,80.3
'32400, 고성군,'075004, 73세,2019,354,151,203,74.4,351,150,201,74.6
'32400, 고성군,'075005, 74세,2019,357,156,201,77.6,357,156,201,77.6
'32400, 고성군,'080,75~79세,2019,1707,705,1002,70.4,1706,705,1001,70.4
'32400, 고성군,'080001, 75세,2019,341,130,211,61.6,341,130,211,61.6
'32400, 고성군,'080002, 76세,2019,330,139,191,72.8,329,139,190,73.2
'32400, 고성군,'080003, 77세,2019,418,181,237,76.4,418,181,237,76.4
'32400, 고성군,'080004, 78세,2019,314,125,189,66.1,314,125,189,66.1
'32400, 고성군,'080005, 79세,2019,304,130,174,74.7,304,130,174,74.7
'32400, 고성군,'085,80~84세,2019,1135,404,731,55.3,1133,403,730,55.2
'32400, 고성군,'085001, 80세,2019,281,113,168,67.3,281,113,168,67.3
'32400, 고성군,'085002, 81세,2019,274,108,166,65.1,273,108,165,65.5
'32400, 고성군,'085003, 82세,2019,226,68,158,43,226,68,158,43
'32400, 고성군,'085004, 83세,2019,186,64,122,52.5,185,63,122,51.6
'32400, 고성군,'085005, 84세,2019,168,51,117,43.6,168,51,117,43.6
'32400, 고성군,'086,85세이상,2019,771,198,573,34.6,770,197,573,34.4
'32400, 고성군,'090,85~89세,2019,479,132,347,38,479,132,347,38
'32400, 고성군,'090001, 85세,2019,126,36,90,40,126,36,90,40
'32400, 고성군,'090002, 86세,2019,116,35,81,43.2,116,35,81,43.2
'32400, 고성군,'090003, 87세,2019,88,22,66,33.3,88,22,66,33.3
'32400, 고성군,'090004, 88세,2019,74,20,54,37,74,20,54,37
'32400, 고성군,'090005, 89세,2019,75,19,56,33.9,75,19,56,33.9
'32400, 고성군,'095,90~94세,2019,227,52,175,29.7,226,51,175,29.1
'32400, 고성군,'095001, 90세,2019,66,16,50,32,66,16,50,32
'32400, 고성군,'095002, 91세,2019,61,11,50,22,60,10,50,20
'32400, 고성군,'095003, 92세,2019,41,10,31,32.3,41,10,31,32.3
'32400, 고성군,'095004, 93세,2019,38,9,29,31,38,9,29,31
'32400, 고성군,'095005, 94세,2019,21,6,15,40,21,6,15,40
'32400, 고성군,'100,95~99세,2019,57,12,45,26.7,57,12,45,26.7
'32400, 고성군,'100001, 95세,2019,18,X,15,20,18,X,15,20
'32400, 고성군,'100002, 96세,2019,17,X,15,13.3,17,X,15,13.3
'32400, 고성군,'100003, 97세,2019,13,6,7,85.7,13,6,7,85.7
'32400, 고성군,'100004, 98세,2019,6,X,5,20,6,X,5,20
'32400, 고성군,'100005, 99세,2019,X,X,X,0,X,X,X,0
'32400, 고성군,'101,100세이상,2019,8,X,6,33.3,8,X,6,33.3
'32400, 고성군,'102,15세미만,2019,2026,1062,964,110.2,2020,1061,959,110.6
'32400, 고성군,'103,15~64세,2019,17906,10438,7468,139.8,16309,9264,7045,131.5
'32400, 고성군,'104,65세이상,2019,7212,3005,4207,71.4,7191,2996,4195,71.4
'32400, 고성군,'126,평균연령,2019,48.8,45.6,52.5,,50,47,53.2,
'32400, 고성군,'127,중위연령,2019,52.1,47.7,57,,54,50.2,57.8,
'32410, 양양군,'000,합계,2019,26280,13332,12948,103,25863,13095,12768,102.6
'32410, 양양군,'005,0~4세,2019,580,285,295,96.6,579,285,294,96.9
'32410, 양양군,'005001, 0세,2019,113,62,51,121.6,113,62,51,121.6
'32410, 양양군,'005002, 1세,2019,116,55,61,90.2,116,55,61,90.2
'32410, 양양군,'005003, 2세,2019,94,46,48,95.8,94,46,48,95.8
'32410, 양양군,'005004, 3세,2019,122,54,68,79.4,121,54,67,80.6
'32410, 양양군,'005005, 4세,2019,135,68,67,101.5,135,68,67,101.5
'32410, 양양군,'010,5~9세,2019,776,413,363,113.8,774,412,362,113.8
'32410, 양양군,'010001, 5세,2019,135,72,63,114.3,134,72,62,116.1
'32410, 양양군,'010002, 6세,2019,158,88,70,125.7,158,88,70,125.7
'32410, 양양군,'010003, 7세,2019,154,75,79,94.9,153,74,79,93.7
'32410, 양양군,'010004, 8세,2019,162,86,76,113.2,162,86,76,113.2
'32410, 양양군,'010005, 9세,2019,167,92,75,122.7,167,92,75,122.7
'32410, 양양군,'015,10~14세,2019,809,418,391,106.9,809,418,391,106.9
'32410, 양양군,'015001, 10세,2019,155,79,76,103.9,155,79,76,103.9
'32410, 양양군,'015002, 11세,2019,159,85,74,114.9,159,85,74,114.9
'32410, 양양군,'015003, 12세,2019,175,91,84,108.3,175,91,84,108.3
'32410, 양양군,'015004, 13세,2019,146,75,71,105.6,146,75,71,105.6
'32410, 양양군,'015005, 14세,2019,174,88,86,102.3,174,88,86,102.3
'32410, 양양군,'020,15~19세,2019,856,461,395,116.7,853,458,395,115.9
'32410, 양양군,'020001, 15세,2019,187,109,78,139.7,186,108,78,138.5
'32410, 양양군,'020002, 16세,2019,174,81,93,87.1,174,81,93,87.1
'32410, 양양군,'020003, 17세,2019,176,89,87,102.3,176,89,87,102.3
'32410, 양양군,'020004, 18세,2019,182,98,84,116.7,182,98,84,116.7
'32410, 양양군,'020005, 19세,2019,137,84,53,158.5,135,82,53,154.7
'32410, 양양군,'025,20~24세,2019,1000,617,383,161.1,957,593,364,162.9
'32410, 양양군,'025001, 20세,2019,193,127,66,192.4,185,125,60,208.3
'32410, 양양군,'025002, 21세,2019,190,146,44,331.8,187,145,42,345.2
'32410, 양양군,'025003, 22세,2019,192,92,100,92,186,90,96,93.8
'32410, 양양군,'025004, 23세,2019,205,122,83,147,193,113,80,141.3
'32410, 양양군,'025005, 24세,2019,220,130,90,144.4,206,120,86,139.5
'32410, 양양군,'030,25~29세,2019,1099,662,437,151.5,1006,603,403,149.6
'32410, 양양군,'030001, 25세,2019,207,133,74,179.7,181,116,65,178.5
'32410, 양양군,'030002, 26세,2019,251,145,106,136.8,232,133,99,134.3
'32410, 양양군,'030003, 27세,2019,209,121,88,137.5,194,113,81,139.5
'32410, 양양군,'030004, 28세,2019,228,144,84,171.4,210,134,76,176.3
'32410, 양양군,'030005, 29세,2019,204,119,85,140,189,107,82,130.5
'32410, 양양군,'035,30~34세,2019,1051,583,468,124.6,982,544,438,124.2
'32410, 양양군,'035001, 30세,2019,201,109,92,118.5,185,99,86,115.1
'32410, 양양군,'035002, 31세,2019,208,124,84,147.6,195,118,77,153.2
'32410, 양양군,'035003, 32세,2019,216,113,103,109.7,203,105,98,107.1
'32410, 양양군,'035004, 33세,2019,195,114,81,140.7,178,105,73,143.8
'32410, 양양군,'035005, 34세,2019,231,123,108,113.9,221,117,104,112.5
'32410, 양양군,'040,35~39세,2019,1387,752,635,118.4,1340,720,620,116.1
'32410, 양양군,'040001, 35세,2019,225,139,86,161.6,216,134,82,163.4
'32410, 양양군,'040002, 36세,2019,263,141,122,115.6,254,133,121,109.9
'32410, 양양군,'040003, 37세,2019,288,145,143,101.4,279,142,137,103.6
'32410, 양양군,'040004, 38세,2019,277,158,119,132.8,264,147,117,125.6
'32410, 양양군,'040005, 39세,2019,334,169,165,102.4,327,164,163,100.6
'32410, 양양군,'045,40~44세,2019,1516,834,682,122.3,1484,821,663,123.8
'32410, 양양군,'045001, 40세,2019,310,173,137,126.3,304,170,134,126.9
'32410, 양양군,'045002, 41세,2019,305,165,140,117.9,304,164,140,117.1
'32410, 양양군,'045003, 42세,2019,301,158,143,110.5,291,156,135,115.6
'32410, 양양군,'045004, 43세,2019,278,175,103,169.9,269,171,98,174.5
'32410, 양양군,'045005, 44세,2019,322,163,159,102.5,316,160,156,102.6
'32410, 양양군,'050,45~49세,2019,1876,1043,833,125.2,1841,1019,822,124
'32410, 양양군,'050001, 45세,2019,347,191,156,122.4,336,184,152,121.1
'32410, 양양군,'050002, 46세,2019,389,224,165,135.8,379,216,163,132.5
'32410, 양양군,'050003, 47세,2019,346,183,163,112.3,342,180,162,111.1
'32410, 양양군,'050004, 48세,2019,385,207,178,116.3,379,203,176,115.3
'32410, 양양군,'050005, 49세,2019,409,238,171,139.2,405,236,169,139.6
'32410, 양양군,'055,50~54세,2019,2187,1194,993,120.2,2160,1183,977,121.1
'32410, 양양군,'055001, 50세,2019,449,250,199,125.6,445,246,199,123.6
'32410, 양양군,'055002, 51세,2019,448,259,189,137,447,259,188,137.8
'32410, 양양군,'055003, 52세,2019,416,232,184,126.1,409,231,178,129.8
'32410, 양양군,'055004, 53세,2019,443,247,196,126,434,243,191,127.2
'32410, 양양군,'055005, 54세,2019,431,206,225,91.6,425,204,221,92.3
'32410, 양양군,'060,55~59세,2019,2698,1368,1330,102.9,2665,1352,1313,103
'32410, 양양군,'060001, 55세,2019,440,205,235,87.2,430,201,229,87.8
'32410, 양양군,'060002, 56세,2019,482,247,235,105.1,476,244,232,105.2
'32410, 양양군,'060003, 57세,2019,511,257,254,101.2,502,251,251,100
'32410, 양양군,'060004, 58세,2019,632,329,303,108.6,627,328,299,109.7
'32410, 양양군,'060005, 59세,2019,633,330,303,108.9,630,328,302,108.6
'32410, 양양군,'065,60~64세,2019,2795,1401,1394,100.5,2777,1392,1385,100.5
'32410, 양양군,'065001, 60세,2019,567,288,279,103.2,565,287,278,103.2
'32410, 양양군,'065002, 61세,2019,584,303,281,107.8,583,303,280,108.2
'32410, 양양군,'065003, 62세,2019,563,265,298,88.9,555,262,293,89.4
'32410, 양양군,'065004, 63세,2019,486,243,243,100,484,242,242,100
'32410, 양양군,'065005, 64세,2019,595,302,293,103.1,590,298,292,102.1
'32410, 양양군,'070,65~69세,2019,2101,999,1102,90.7,2094,996,1098,90.7
'32410, 양양군,'070001, 65세,2019,541,256,285,89.8,539,255,284,89.8
'32410, 양양군,'070002, 66세,2019,407,203,204,99.5,406,203,203,100
'32410, 양양군,'070003, 67세,2019,500,220,280,78.6,500,220,280,78.6
'32410, 양양군,'070004, 68세,2019,317,163,154,105.8,313,161,152,105.9
'32410, 양양군,'070005, 69세,2019,336,157,179,87.7,336,157,179,87.7
'32410, 양양군,'075,70~74세,2019,1837,873,964,90.6,1833,871,962,90.5
'32410, 양양군,'075001, 70세,2019,363,189,174,108.6,363,189,174,108.6
'32410, 양양군,'075002, 71세,2019,359,164,195,84.1,358,163,195,83.6
'32410, 양양군,'075003, 72세,2019,408,204,204,100,408,204,204,100
'32410, 양양군,'075004, 73세,2019,337,170,167,101.8,335,169,166,101.8
'32410, 양양군,'075005, 74세,2019,370,146,224,65.2,369,146,223,65.5
'32410, 양양군,'080,75~79세,2019,1775,777,998,77.9,1773,776,997,77.8
'32410, 양양군,'080001, 75세,2019,376,162,214,75.7,376,162,214,75.7
'32410, 양양군,'080002, 76세,2019,369,165,204,80.9,369,165,204,80.9
'32410, 양양군,'080003, 77세,2019,384,180,204,88.2,383,180,203,88.7
'32410, 양양군,'080004, 78세,2019,330,135,195,69.2,330,135,195,69.2
'32410, 양양군,'080005, 79세,2019,316,135,181,74.6,315,134,181,74
'32410, 양양군,'085,80~84세,2019,1160,457,703,65,1160,457,703,65
'32410, 양양군,'085001, 80세,2019,275,113,162,69.8,275,113,162,69.8
'32410, 양양군,'085002, 81세,2019,282,114,168,67.9,282,114,168,67.9
'32410, 양양군,'085003, 82세,2019,201,79,122,64.8,201,79,122,64.8
'32410, 양양군,'085004, 83세,2019,222,75,147,51,222,75,147,51
'32410, 양양군,'085005, 84세,2019,180,76,104,73.1,180,76,104,73.1
'32410, 양양군,'086,85세이상,2019,777,195,582,33.5,776,195,581,33.6
'32410, 양양군,'090,85~89세,2019,476,135,341,39.6,475,135,340,39.7
'32410, 양양군,'090001, 85세,2019,135,40,95,42.1,134,40,94,42.6
'32410, 양양군,'090002, 86세,2019,109,30,79,38,109,30,79,38
'32410, 양양군,'090003, 87세,2019,98,26,72,36.1,98,26,72,36.1
'32410, 양양군,'090004, 88세,2019,75,25,50,50,75,25,50,50
'32410, 양양군,'090005, 89세,2019,59,14,45,31.1,59,14,45,31.1
'32410, 양양군,'095,90~94세,2019,231,50,181,27.6,231,50,181,27.6
'32410, 양양군,'095001, 90세,2019,63,17,46,37,63,17,46,37
'32410, 양양군,'095002, 91세,2019,53,13,40,32.5,53,13,40,32.5
'32410, 양양군,'095003, 92세,2019,52,11,41,26.8,52,11,41,26.8
'32410, 양양군,'095004, 93세,2019,34,5,29,17.2,34,5,29,17.2
'32410, 양양군,'095005, 94세,2019,29,X,25,16,29,X,25,16
'32410, 양양군,'100,95~99세,2019,63,10,53,18.9,63,10,53,18.9
'32410, 양양군,'100001, 95세,2019,27,X,23,17.4,27,X,23,17.4
'32410, 양양군,'100002, 96세,2019,14,X,10,40,14,X,10,40
'32410, 양양군,'100003, 97세,2019,10,X,9,11.1,10,X,9,11.1
'32410, 양양군,'100004, 98세,2019,8,X,7,14.3,8,X,7,14.3
'32410, 양양군,'100005, 99세,2019,X,X,X,0,X,X,X,0
'32410, 양양군,'101,100세이상,2019,7,X,7,0,7,X,7,0
'32410, 양양군,'102,15세미만,2019,2165,1116,1049,106.4,2162,1115,1047,106.5
'32410, 양양군,'103,15~64세,2019,16465,8915,7550,118.1,16065,8685,7380,117.7
'32410, 양양군,'104,65세이상,2019,7650,3301,4349,75.9,7636,3295,4341,75.9
'32410, 양양군,'126,평균연령,2019,51.3,49.2,53.4,,51.5,49.4,53.6,
'32410, 양양군,'127,중위연령,2019,55,52.4,57.5,,55.3,52.7,57.8,
'33,충청북도,'000,합계,2019,1629343,832543,796800,104.5,1569560,795522,774038,102.8
'33,충청북도,'005,0~4세,2019,58676,30021,28655,104.8,57751,29552,28199,104.8
'33,충청북도,'005001, 0세,2019,9741,5043,4698,107.3,9562,4957,4605,107.6
'33,충청북도,'005002, 1세,2019,10914,5542,5372,103.2,10729,5449,5280,103.2
'33,충청북도,'005003, 2세,2019,11611,5964,5647,105.6,11430,5865,5565,105.4
'33,충청북도,'005004, 3세,2019,13000,6652,6348,104.8,12796,6547,6249,104.8
'33,충청북도,'005005, 4세,2019,13410,6820,6590,103.5,13234,6734,6500,103.6
'33,충청북도,'010,5~9세,2019,71263,36251,35012,103.5,70566,35915,34651,103.6
'33,충청북도,'010001, 5세,2019,13440,6720,6720,100,13259,6630,6629,100
'33,충청북도,'010002, 6세,2019,13632,6927,6705,103.3,13491,6862,6629,103.5
'33,충청북도,'010003, 7세,2019,14887,7583,7304,103.8,14738,7516,7222,104.1
'33,충청북도,'010004, 8세,2019,14934,7633,7301,104.5,14814,7576,7238,104.7
'33,충청북도,'010005, 9세,2019,14370,7388,6982,105.8,14264,7331,6933,105.7
'33,충청북도,'015,10~14세,2019,70241,36486,33755,108.1,69786,36247,33539,108.1
'33,충청북도,'015001, 10세,2019,13739,7193,6546,109.9,13640,7138,6502,109.8
'33,충청북도,'015002, 11세,2019,14440,7509,6931,108.3,14347,7462,6885,108.4
'33,충청북도,'015003, 12세,2019,14940,7710,7230,106.6,14844,7667,7177,106.8
'33,충청북도,'015004, 13세,2019,13571,7006,6565,106.7,13488,6952,6536,106.4
'33,충청북도,'015005, 14세,2019,13551,7068,6483,109,13467,7028,6439,109.1
'33,충청북도,'020,15~19세,2019,87200,46116,41084,112.2,85988,45453,40535,112.1
'33,충청북도,'020001, 15세,2019,14698,7750,6948,111.5,14632,7717,6915,111.6
'33,충청북도,'020002, 16세,2019,14902,7808,7094,110.1,14831,7766,7065,109.9
'33,충청북도,'020003, 17세,2019,15648,8196,7452,110,15549,8144,7405,110
'33,충청북도,'020004, 18세,2019,18942,9981,8961,111.4,18682,9844,8838,111.4
'33,충청북도,'020005, 19세,2019,23010,12381,10629,116.5,22294,11982,10312,116.2
'33,충청북도,'025,20~24세,2019,115325,64204,51121,125.6,107757,59346,48411,122.6
'33,충청북도,'025001, 20세,2019,22161,11743,10418,112.7,21123,11164,9959,112.1
'33,충청북도,'025002, 21세,2019,22512,11871,10641,111.6,21240,11078,10162,109
'33,충청북도,'025003, 22세,2019,23567,12853,10714,120,22019,11888,10131,117.3
'33,충청북도,'025004, 23세,2019,23833,13915,9918,140.3,22048,12707,9341,136
'33,충청북도,'025005, 24세,2019,23252,13822,9430,146.6,21327,12509,8818,141.9
'33,충청북도,'030,25~29세,2019,107289,62250,45039,138.2,96911,55389,41522,133.4
'33,충청북도,'030001, 25세,2019,22635,13461,9174,146.7,20630,12109,8521,142.1
'33,충청북도,'030002, 26세,2019,22366,12962,9404,137.8,20347,11635,8712,133.6
'33,충청북도,'030003, 27세,2019,21922,12797,9125,140.2,19869,11455,8414,136.1
'33,충청북도,'030004, 28세,2019,20462,11735,8727,134.5,18367,10335,8032,128.7
'33,충청북도,'030005, 29세,2019,19904,11295,8609,131.2,17698,9855,7843,125.7
'33,충청북도,'035,30~34세,2019,96888,53193,43695,121.7,86830,46564,40266,115.6
'33,충청북도,'035001, 30세,2019,19137,10665,8472,125.9,16979,9240,7739,119.4
'33,충청북도,'035002, 31세,2019,19007,10443,8564,121.9,16932,9098,7834,116.1
'33,충청북도,'035003, 32세,2019,19333,10556,8777,120.3,17237,9147,8090,113.1
'33,충청북도,'035004, 33세,2019,19635,10828,8807,122.9,17726,9577,8149,117.5
'33,충청북도,'035005, 34세,2019,19776,10701,9075,117.9,17956,9502,8454,112.4
'33,충청북도,'040,35~39세,2019,115928,61457,54471,112.8,108382,56463,51919,108.8
'33,충청북도,'040001, 35세,2019,20744,11233,9511,118.1,19089,10149,8940,113.5
'33,충청북도,'040002, 36세,2019,22590,11992,10598,113.2,20918,10863,10055,108
'33,충청북도,'040003, 37세,2019,24731,12961,11770,110.1,23180,11950,11230,106.4
'33,충청북도,'040004, 38세,2019,23423,12497,10926,114.4,22033,11574,10459,110.7
'33,충청북도,'040005, 39세,2019,24440,12774,11666,109.5,23162,11927,11235,106.2
'33,충청북도,'045,40~44세,2019,113640,59283,54357,109.1,108378,55963,52415,106.8
'33,충청북도,'045001, 40세,2019,23448,12380,11068,111.9,22197,11563,10634,108.7
'33,충청북도,'045002, 41세,2019,21722,11380,10342,110,20604,10678,9926,107.6
'33,충청북도,'045003, 42세,2019,22563,11774,10789,109.1,21523,11108,10415,106.7
'33,충청북도,'045004, 43세,2019,22282,11639,10643,109.4,21327,11043,10284,107.4
'33,충청북도,'045005, 44세,2019,23625,12110,11515,105.2,22727,11571,11156,103.7
'33,충청북도,'050,45~49세,2019,130855,67998,62857,108.2,126317,65375,60942,107.3
'33,충청북도,'050001, 45세,2019,25924,13462,12462,108,25102,13001,12101,107.4
'33,충청북도,'050002, 46세,2019,26187,13492,12695,106.3,25280,12972,12308,105.4
'33,충청북도,'050003, 47세,2019,24752,12956,11796,109.8,23827,12427,11400,109
'33,충청북도,'050004, 48세,2019,27441,14305,13136,108.9,26513,13760,12753,107.9
'33,충청북도,'050005, 49세,2019,26551,13783,12768,107.9,25595,13215,12380,106.7
'33,충청북도,'055,50~54세,2019,137475,70336,67139,104.8,133346,67999,65347,104.1
'33,충청북도,'055001, 50세,2019,29168,14881,14287,104.2,28295,14389,13906,103.5
'33,충청북도,'055002, 51세,2019,28628,14369,14259,100.8,27704,13843,13861,99.9
'33,충청북도,'055003, 52세,2019,26466,13579,12887,105.4,25718,13171,12547,105
'33,충청북도,'055004, 53세,2019,26194,13618,12576,108.3,25404,13180,12224,107.8
'33,충청북도,'055005, 54세,2019,27019,13889,13130,105.8,26225,13416,12809,104.7
'33,충청북도,'060,55~59세,2019,135596,69416,66180,104.9,132320,67651,64669,104.6
'33,충청북도,'060001, 55세,2019,23364,12002,11362,105.6,22626,11598,11028,105.2
'33,충청북도,'060002, 56세,2019,25153,13163,11990,109.8,24286,12682,11604,109.3
'33,충청북도,'060003, 57세,2019,27593,14328,13265,108,26954,13992,12962,107.9
'33,충청북도,'060004, 58세,2019,31434,15997,15437,103.6,30962,15754,15208,103.6
'33,충청북도,'060005, 59세,2019,28052,13926,14126,98.6,27492,13625,13867,98.3
'33,충청북도,'065,60~64세,2019,121813,61505,60308,102,119685,60335,59350,101.7
'33,충청북도,'065001, 60세,2019,26117,13101,13016,100.7,25625,12854,12771,100.6
'33,충청북도,'065002, 61세,2019,25405,13030,12375,105.3,24912,12756,12156,104.9
'33,충청북도,'065003, 62세,2019,25310,12881,12429,103.6,24857,12622,12235,103.2
'33,충청북도,'065004, 63세,2019,22771,11563,11208,103.2,22402,11349,11053,102.7
'33,충청북도,'065005, 64세,2019,22210,10930,11280,96.9,21889,10754,11135,96.6
'33,충청북도,'070,65~69세,2019,80612,39510,41102,96.1,79658,39007,40651,96
'33,충청북도,'070001, 65세,2019,19439,9633,9806,98.2,19137,9464,9673,97.8
'33,충청북도,'070002, 66세,2019,16703,8296,8407,98.7,16481,8172,8309,98.4
'33,충청북도,'070003, 67세,2019,19051,9386,9665,97.1,18887,9303,9584,97.1
'33,충청북도,'070004, 68세,2019,12351,5902,6449,91.5,12208,5836,6372,91.6
'33,충청북도,'070005, 69세,2019,13068,6293,6775,92.9,12945,6232,6713,92.8
'33,충청북도,'075,70~74세,2019,60669,28779,31890,90.2,60286,28608,31678,90.3
'33,충청북도,'075001, 70세,2019,13626,6685,6941,96.3,13506,6623,6883,96.2
'33,충청북도,'075002, 71세,2019,13365,6470,6895,93.8,13281,6433,6848,93.9
'33,충청북도,'075003, 72세,2019,13063,6129,6934,88.4,12993,6101,6892,88.5
'33,충청북도,'075004, 73세,2019,9971,4666,5305,88,9908,4639,5269,88
'33,충청북도,'075005, 74세,2019,10644,4829,5815,83,10598,4812,5786,83.2
'33,충청북도,'080,75~79세,2019,56436,23339,33097,70.5,56303,23295,33008,70.6
'33,충청북도,'080001, 75세,2019,10877,4601,6276,73.3,10848,4588,6260,73.3
'33,충청북도,'080002, 76세,2019,11334,4813,6521,73.8,11304,4799,6505,73.8
'33,충청북도,'080003, 77세,2019,13579,5668,7911,71.6,13555,5663,7892,71.8
'33,충청북도,'080004, 78세,2019,10873,4399,6474,67.9,10846,4393,6453,68.1
'33,충청북도,'080005, 79세,2019,9773,3858,5915,65.2,9750,3852,5898,65.3
'33,충청북도,'085,80~84세,2019,41700,15117,26583,56.9,41611,15094,26517,56.9
'33,충청북도,'085001, 80세,2019,10087,3926,6161,63.7,10065,3918,6147,63.7
'33,충청북도,'085002, 81세,2019,8898,3322,5576,59.6,8876,3321,5555,59.8
'33,충청북도,'085003, 82세,2019,8125,2933,5192,56.5,8103,2925,5178,56.5
'33,충청북도,'085004, 83세,2019,7599,2643,4956,53.3,7586,2640,4946,53.4
'33,충청북도,'085005, 84세,2019,6991,2293,4698,48.8,6981,2290,4691,48.8
'33,충청북도,'086,85세이상,2019,27737,7282,20455,35.6,27685,7266,20419,35.6
'33,충청북도,'090,85~89세,2019,19575,5483,14092,38.9,19540,5470,14070,38.9
'33,충청북도,'090001, 85세,2019,5614,1756,3858,45.5,5603,1751,3852,45.5
'33,충청북도,'090002, 86세,2019,4726,1373,3353,40.9,4719,1370,3349,40.9
'33,충청북도,'090003, 87세,2019,3863,1059,2804,37.8,3856,1057,2799,37.8
'33,충청북도,'090004, 88세,2019,2755,684,2071,33,2748,682,2066,33
'33,충청북도,'090005, 89세,2019,2617,611,2006,30.5,2614,610,2004,30.4
'33,충청북도,'095,90~94세,2019,6560,1493,5067,29.5,6549,1491,5058,29.5
'33,충청북도,'095001, 90세,2019,2164,520,1644,31.6,2159,519,1640,31.6
'33,충청북도,'095002, 91세,2019,1611,364,1247,29.2,1610,364,1246,29.2
'33,충청북도,'095003, 92세,2019,1294,302,992,30.4,1292,302,990,30.5
'33,충청북도,'095004, 93세,2019,781,167,614,27.2,779,166,613,27.1
'33,충청북도,'095005, 94세,2019,710,140,570,24.6,709,140,569,24.6
'33,충청북도,'100,95~99세,2019,1427,282,1145,24.6,1421,281,1140,24.6
'33,충청북도,'100001, 95세,2019,435,98,337,29.1,431,97,334,29
'33,충청북도,'100002, 96세,2019,406,71,335,21.2,406,71,335,21.2
'33,충청북도,'100003, 97세,2019,296,66,230,28.7,296,66,230,28.7
'33,충청북도,'100004, 98세,2019,192,34,158,21.5,191,34,157,21.7
'33,충청북도,'100005, 99세,2019,98,13,85,15.3,97,13,84,15.5
'33,충청북도,'101,100세이상,2019,175,24,151,15.9,175,24,151,15.9
'33,충청북도,'102,15세미만,2019,200180,102758,97422,105.5,198103,101714,96389,105.5
'33,충청북도,'103,15~64세,2019,1162009,615758,546251,112.7,1105914,580538,525376,110.5
'33,충청북도,'104,65세이상,2019,267154,114027,153127,74.5,265543,113270,152273,74.4
'33,충청북도,'126,평균연령,2019,42.9,41.5,44.4,,43.2,41.7,44.6,
'33,충청북도,'127,중위연령,2019,44.1,42.2,45.9,,44.7,43,46.3,
'33004, 읍부,'000,합계,2019,349009,181615,167394,108.5,333325,171693,161632,106.2
'33004, 읍부,'005,0~4세,2019,16312,8352,7960,104.9,16028,8206,7822,104.9
'33004, 읍부,'005001, 0세,2019,2756,1447,1309,110.5,2692,1414,1278,110.6
'33004, 읍부,'005002, 1세,2019,3065,1538,1527,100.7,3013,1519,1494,101.7
'33004, 읍부,'005003, 2세,2019,3255,1643,1612,101.9,3198,1614,1584,101.9
'33004, 읍부,'005004, 3세,2019,3632,1882,1750,107.5,3566,1841,1725,106.7
'33004, 읍부,'005005, 4세,2019,3604,1842,1762,104.5,3559,1818,1741,104.4
'33004, 읍부,'010,5~9세,2019,18313,9358,8955,104.5,18124,9281,8843,105
'33004, 읍부,'010001, 5세,2019,3600,1840,1760,104.5,3556,1818,1738,104.6
'33004, 읍부,'010002, 6세,2019,3571,1805,1766,102.2,3525,1786,1739,102.7
'33004, 읍부,'010003, 7세,2019,3818,1935,1883,102.8,3780,1925,1855,103.8
'33004, 읍부,'010004, 8세,2019,3748,1914,1834,104.4,3711,1899,1812,104.8
'33004, 읍부,'010005, 9세,2019,3576,1864,1712,108.9,3552,1853,1699,109.1
'33004, 읍부,'015,10~14세,2019,16491,8580,7911,108.5,16380,8519,7861,108.4
'33004, 읍부,'015001, 10세,2019,3382,1787,1595,112,3353,1769,1584,111.7
'33004, 읍부,'015002, 11세,2019,3524,1819,1705,106.7,3501,1807,1694,106.7
'33004, 읍부,'015003, 12세,2019,3540,1799,1741,103.3,3517,1790,1727,103.6
'33004, 읍부,'015004, 13세,2019,3035,1580,1455,108.6,3016,1566,1450,108
'33004, 읍부,'015005, 14세,2019,3010,1595,1415,112.7,2993,1587,1406,112.9
'33004, 읍부,'020,15~19세,2019,18035,9557,8478,112.7,17731,9354,8377,111.7
'33004, 읍부,'020001, 15세,2019,3167,1646,1521,108.2,3153,1636,1517,107.8
'33004, 읍부,'020002, 16세,2019,3202,1618,1584,102.1,3188,1611,1577,102.2
'33004, 읍부,'020003, 17세,2019,3450,1727,1723,100.2,3426,1716,1710,100.4
'33004, 읍부,'020004, 18세,2019,3850,2097,1753,119.6,3783,2051,1732,118.4
'33004, 읍부,'020005, 19세,2019,4366,2469,1897,130.2,4181,2340,1841,127.1
'33004, 읍부,'025,20~24세,2019,21436,12434,9002,138.1,19832,11320,8512,133
'33004, 읍부,'025001, 20세,2019,4151,2334,1817,128.5,3946,2195,1751,125.4
'33004, 읍부,'025002, 21세,2019,4144,2283,1861,122.7,3896,2106,1790,117.7
'33004, 읍부,'025003, 22세,2019,4397,2425,1972,123,4082,2216,1866,118.8
'33004, 읍부,'025004, 23세,2019,4338,2678,1660,161.3,3934,2383,1551,153.6
'33004, 읍부,'025005, 24세,2019,4406,2714,1692,160.4,3974,2420,1554,155.7
'33004, 읍부,'030,25~29세,2019,22507,13397,9110,147.1,19865,11616,8249,140.8
'33004, 읍부,'030001, 25세,2019,4271,2630,1641,160.3,3796,2309,1487,155.3
'33004, 읍부,'030002, 26세,2019,4517,2689,1828,147.1,4033,2350,1683,139.6
'33004, 읍부,'030003, 27세,2019,4633,2746,1887,145.5,4096,2392,1704,140.4
'33004, 읍부,'030004, 28세,2019,4547,2703,1844,146.6,3956,2302,1654,139.2
'33004, 읍부,'030005, 29세,2019,4539,2629,1910,137.6,3984,2263,1721,131.5
'33004, 읍부,'035,30~34세,2019,23709,13029,10680,122,21060,11277,9783,115.3
'33004, 읍부,'035001, 30세,2019,4446,2522,1924,131.1,3879,2158,1721,125.4
'33004, 읍부,'035002, 31세,2019,4502,2411,2091,115.3,3987,2086,1901,109.7
'33004, 읍부,'035003, 32세,2019,4824,2629,2195,119.8,4243,2229,2014,110.7
'33004, 읍부,'035004, 33세,2019,4891,2713,2178,124.6,4385,2378,2007,118.5
'33004, 읍부,'035005, 34세,2019,5046,2754,2292,120.2,4566,2426,2140,113.4
'33004, 읍부,'040,35~39세,2019,29316,15755,13561,116.2,27305,14407,12898,111.7
'33004, 읍부,'040001, 35세,2019,5306,2912,2394,121.6,4822,2590,2232,116
'33004, 읍부,'040002, 36세,2019,5721,3130,2591,120.8,5311,2843,2468,115.2
'33004, 읍부,'040003, 37세,2019,6274,3311,2963,111.7,5834,3020,2814,107.3
'33004, 읍부,'040004, 38세,2019,5878,3173,2705,117.3,5528,2936,2592,113.3
'33004, 읍부,'040005, 39세,2019,6137,3229,2908,111,5810,3018,2792,108.1
'33004, 읍부,'045,40~44세,2019,26827,14480,12347,117.3,25409,13549,11860,114.2
'33004, 읍부,'045001, 40세,2019,5793,3135,2658,117.9,5427,2897,2530,114.5
'33004, 읍부,'045002, 41세,2019,5352,2885,2467,116.9,5063,2696,2367,113.9
'33004, 읍부,'045003, 42세,2019,5233,2812,2421,116.2,4946,2621,2325,112.7
'33004, 읍부,'045004, 43세,2019,5132,2776,2356,117.8,4893,2615,2278,114.8
'33004, 읍부,'045005, 44세,2019,5317,2872,2445,117.5,5080,2720,2360,115.3
'33004, 읍부,'050,45~49세,2019,27870,15086,12784,118,26633,14383,12250,117.4
'33004, 읍부,'050001, 45세,2019,5724,3090,2634,117.3,5506,2971,2535,117.2
'33004, 읍부,'050002, 46세,2019,5784,3116,2668,116.8,5544,2979,2565,116.1
'33004, 읍부,'050003, 47세,2019,5189,2814,2375,118.5,4944,2664,2280,116.8
'33004, 읍부,'050004, 48세,2019,5697,3045,2652,114.8,5444,2897,2547,113.7
'33004, 읍부,'050005, 49세,2019,5476,3021,2455,123.1,5195,2872,2323,123.6
'33004, 읍부,'055,50~54세,2019,26888,14370,12518,114.8,25709,13709,12000,114.2
'33004, 읍부,'055001, 50세,2019,5893,3171,2722,116.5,5657,3039,2618,116.1
'33004, 읍부,'055002, 51세,2019,5623,3004,2619,114.7,5377,2855,2522,113.2
'33004, 읍부,'055003, 52세,2019,5097,2717,2380,114.2,4882,2607,2275,114.6
'33004, 읍부,'055004, 53세,2019,5059,2718,2341,116.1,4811,2585,2226,116.1
'33004, 읍부,'055005, 54세,2019,5216,2760,2456,112.4,4982,2623,2359,111.2
'33004, 읍부,'060,55~59세,2019,25860,13502,12358,109.3,24891,12943,11948,108.3
'33004, 읍부,'060001, 55세,2019,4458,2412,2046,117.9,4263,2291,1972,116.2
'33004, 읍부,'060002, 56세,2019,4767,2510,2257,111.2,4502,2348,2154,109
'33004, 읍부,'060003, 57세,2019,5365,2912,2453,118.7,5155,2794,2361,118.3
'33004, 읍부,'060004, 58세,2019,5998,3037,2961,102.6,5866,2968,2898,102.4
'33004, 읍부,'060005, 59세,2019,5272,2631,2641,99.6,5105,2542,2563,99.2
'33004, 읍부,'065,60~64세,2019,23039,11597,11442,101.4,22431,11252,11179,100.7
'33004, 읍부,'065001, 60세,2019,4951,2493,2458,101.4,4822,2435,2387,102
'33004, 읍부,'065002, 61세,2019,4624,2379,2245,106,4485,2293,2192,104.6
'33004, 읍부,'065003, 62세,2019,4819,2439,2380,102.5,4683,2352,2331,100.9
'33004, 읍부,'065004, 63세,2019,4276,2148,2128,100.9,4171,2087,2084,100.1
'33004, 읍부,'065005, 64세,2019,4369,2138,2231,95.8,4270,2085,2185,95.4
'33004, 읍부,'070,65~69세,2019,15545,7508,8037,93.4,15261,7337,7924,92.6
'33004, 읍부,'070001, 65세,2019,3698,1799,1899,94.7,3611,1739,1872,92.9
'33004, 읍부,'070002, 66세,2019,3216,1607,1609,99.9,3151,1565,1586,98.7
'33004, 읍부,'070003, 67세,2019,3609,1748,1861,93.9,3550,1719,1831,93.9
'33004, 읍부,'070004, 68세,2019,2397,1122,1275,88,2356,1099,1257,87.4
'33004, 읍부,'070005, 69세,2019,2625,1232,1393,88.4,2593,1215,1378,88.2
'33004, 읍부,'075,70~74세,2019,11974,5618,6356,88.4,11859,5565,6294,88.4
'33004, 읍부,'075001, 70세,2019,2775,1384,1391,99.5,2741,1363,1378,98.9
'33004, 읍부,'075002, 71세,2019,2591,1212,1379,87.9,2566,1203,1363,88.3
'33004, 읍부,'075003, 72세,2019,2564,1189,1375,86.5,2539,1180,1359,86.8
'33004, 읍부,'075004, 73세,2019,2006,905,1101,82.2,1989,897,1092,82.1
'33004, 읍부,'075005, 74세,2019,2038,928,1110,83.6,2024,922,1102,83.7
'33004, 읍부,'080,75~79세,2019,11125,4619,6506,71,11096,4613,6483,71.2
'33004, 읍부,'080001, 75세,2019,2105,878,1227,71.6,2096,875,1221,71.7
'33004, 읍부,'080002, 76세,2019,2312,971,1341,72.4,2308,970,1338,72.5
'33004, 읍부,'080003, 77세,2019,2692,1117,1575,70.9,2691,1117,1574,71
'33004, 읍부,'080004, 78세,2019,2104,869,1235,70.4,2096,867,1229,70.5
'33004, 읍부,'080005, 79세,2019,1912,784,1128,69.5,1905,784,1121,69.9
'33004, 읍부,'085,80~84세,2019,8186,2927,5259,55.7,8156,2922,5234,55.8
'33004, 읍부,'085001, 80세,2019,1946,761,1185,64.2,1937,758,1179,64.3
'33004, 읍부,'085002, 81세,2019,1783,672,1111,60.5,1773,672,1101,61
'33004, 읍부,'085003, 82세,2019,1583,584,999,58.5,1576,583,993,58.7
'33004, 읍부,'085004, 83세,2019,1500,490,1010,48.5,1498,489,1009,48.5
'33004, 읍부,'085005, 84세,2019,1374,420,954,44,1372,420,952,44.1
'33004, 읍부,'086,85세이상,2019,5576,1446,4130,35,5555,1440,4115,35
'33004, 읍부,'090,85~89세,2019,3980,1100,2880,38.2,3967,1095,2872,38.1
'33004, 읍부,'090001, 85세,2019,1126,358,768,46.6,1121,356,765,46.5
'33004, 읍부,'090002, 86세,2019,940,262,678,38.6,937,260,677,38.4
'33004, 읍부,'090003, 87세,2019,820,212,608,34.9,819,212,607,34.9
'33004, 읍부,'090004, 88세,2019,584,145,439,33,581,144,437,33
'33004, 읍부,'090005, 89세,2019,510,123,387,31.8,509,123,386,31.9
'33004, 읍부,'095,90~94세,2019,1284,292,992,29.4,1279,291,988,29.5
'33004, 읍부,'095001, 90세,2019,438,110,328,33.5,435,109,326,33.4
'33004, 읍부,'095002, 91세,2019,326,65,261,24.9,326,65,261,24.9
'33004, 읍부,'095003, 92세,2019,225,55,170,32.4,225,55,170,32.4
'33004, 읍부,'095004, 93세,2019,168,35,133,26.3,167,35,132,26.5
'33004, 읍부,'095005, 94세,2019,127,27,100,27,126,27,99,27.3
'33004, 읍부,'100,95~99세,2019,282,50,232,21.6,279,50,229,21.8
'33004, 읍부,'100001, 95세,2019,97,24,73,32.9,96,24,72,33.3
'33004, 읍부,'100002, 96세,2019,88,9,79,11.4,88,9,79,11.4
'33004, 읍부,'100003, 97세,2019,49,10,39,25.6,49,10,39,25.6
'33004, 읍부,'100004, 98세,2019,32,5,27,18.5,31,5,26,19.2
'33004, 읍부,'100005, 99세,2019,16,X,14,14.3,15,X,13,15.4
'33004, 읍부,'101,100세이상,2019,30,X,26,15.4,30,X,26,15.4
'33004, 읍부,'102,15세미만,2019,51116,26290,24826,105.9,50532,26006,24526,106
'33004, 읍부,'103,15~64세,2019,245487,133207,112280,118.6,230866,123810,107056,115.6
'33004, 읍부,'104,65세이상,2019,52406,22118,30288,73,51927,21877,30050,72.8
'33004, 읍부,'126,평균연령,2019,41.3,40,42.8,,41.5,40.1,43,
'33004, 읍부,'127,중위연령,2019,41.5,40.1,43.2,,42,40.6,43.5,
'33005, 면부,'000,합계,2019,338833,179013,159820,112,316429,163126,153303,106.4
'33005, 면부,'005,0~4세,2019,7908,4088,3820,107,7773,4019,3754,107.1
'33005, 면부,'005001, 0세,2019,1484,788,696,113.2,1461,778,683,113.9
'33005, 면부,'005002, 1세,2019,1512,804,708,113.6,1488,791,697,113.5
'33005, 면부,'005003, 2세,2019,1530,755,775,97.4,1499,738,761,97
'33005, 면부,'005004, 3세,2019,1691,878,813,108,1656,862,794,108.6
'33005, 면부,'005005, 4세,2019,1691,863,828,104.2,1669,850,819,103.8
'33005, 면부,'010,5~9세,2019,8904,4512,4392,102.7,8789,4452,4337,102.7
'33005, 면부,'010001, 5세,2019,1692,803,889,90.3,1661,786,875,89.8
'33005, 면부,'010002, 6세,2019,1684,848,836,101.4,1660,838,822,101.9
'33005, 면부,'010003, 7세,2019,1888,968,920,105.2,1860,952,908,104.8
'33005, 면부,'010004, 8세,2019,1895,993,902,110.1,1880,986,894,110.3
'33005, 면부,'010005, 9세,2019,1745,900,845,106.5,1728,890,838,106.2
'33005, 면부,'015,10~14세,2019,8599,4561,4038,113,8522,4524,3998,113.2
'33005, 면부,'015001, 10세,2019,1670,862,808,106.7,1657,856,801,106.9
'33005, 면부,'015002, 11세,2019,1733,919,814,112.9,1710,907,803,113
'33005, 면부,'015003, 12세,2019,1783,954,829,115.1,1768,948,820,115.6
'33005, 면부,'015004, 13세,2019,1705,889,816,108.9,1693,882,811,108.8
'33005, 면부,'015005, 14세,2019,1708,937,771,121.5,1694,931,763,122
'33005, 면부,'020,15~19세,2019,12423,6829,5594,122.1,12269,6732,5537,121.6
'33005, 면부,'020001, 15세,2019,1886,1030,856,120.3,1877,1027,850,120.8
'33005, 면부,'020002, 16세,2019,1920,1088,832,130.8,1904,1075,829,129.7
'33005, 면부,'020003, 17세,2019,2060,1119,941,118.9,2050,1113,937,118.8
'33005, 면부,'020004, 18세,2019,2671,1421,1250,113.7,2642,1408,1234,114.1
'33005, 면부,'020005, 19세,2019,3886,2171,1715,126.6,3796,2109,1687,125
'33005, 면부,'025,20~24세,2019,18848,11385,7463,152.6,16366,9477,6889,137.6
'33005, 면부,'025001, 20세,2019,3572,1902,1670,113.9,3381,1770,1611,109.9
'33005, 면부,'025002, 21세,2019,3679,2073,1606,129.1,3325,1800,1525,118
'33005, 면부,'025003, 22세,2019,3794,2320,1474,157.4,3285,1927,1358,141.9
'33005, 면부,'025004, 23세,2019,3946,2555,1391,183.7,3293,2052,1241,165.4
'33005, 면부,'025005, 24세,2019,3857,2535,1322,191.8,3082,1928,1154,167.1
'33005, 면부,'030,25~29세,2019,18783,12039,6744,178.5,14045,8474,5571,152.1
'33005, 면부,'030001, 25세,2019,3862,2556,1306,195.7,2969,1856,1113,166.8
'33005, 면부,'030002, 26세,2019,3839,2427,1412,171.9,2889,1733,1156,149.9
'33005, 면부,'030003, 27세,2019,3822,2470,1352,182.7,2877,1757,1120,156.9
'33005, 면부,'030004, 28세,2019,3594,2280,1314,173.5,2637,1558,1079,144.4
'33005, 면부,'030005, 29세,2019,3666,2306,1360,169.6,2673,1570,1103,142.3
'33005, 면부,'035,30~34세,2019,17490,10834,6656,162.8,13092,7533,5559,135.5
'33005, 면부,'035001, 30세,2019,3622,2225,1397,159.3,2640,1490,1150,129.6
'33005, 면부,'035002, 31세,2019,3522,2211,1311,168.6,2596,1532,1064,144
'33005, 면부,'035003, 32세,2019,3469,2138,1331,160.6,2601,1483,1118,132.6
'33005, 면부,'035004, 33세,2019,3492,2163,1329,162.8,2655,1532,1123,136.4
'33005, 면부,'035005, 34세,2019,3385,2097,1288,162.8,2600,1496,1104,135.5
'33005, 면부,'040,35~39세,2019,18459,11089,7370,150.5,15255,8714,6541,133.2
'33005, 면부,'040001, 35세,2019,3452,2157,1295,166.6,2765,1634,1131,144.5
'33005, 면부,'040002, 36세,2019,3795,2258,1537,146.9,3073,1715,1358,126.3
'33005, 면부,'040003, 37세,2019,3787,2243,1544,145.3,3141,1776,1365,130.1
'33005, 면부,'040004, 38세,2019,3715,2238,1477,151.5,3120,1802,1318,136.7
'33005, 면부,'040005, 39세,2019,3710,2193,1517,144.6,3156,1787,1369,130.5
'33005, 면부,'045,40~44세,2019,17267,10216,7051,144.9,15254,8806,6448,136.6
'33005, 면부,'045001, 40세,2019,3609,2132,1477,144.3,3138,1788,1350,132.4
'33005, 면부,'045002, 41세,2019,3225,1913,1312,145.8,2806,1614,1192,135.4
'33005, 면부,'045003, 42세,2019,3435,2043,1392,146.8,3034,1759,1275,138
'33005, 면부,'045004, 43세,2019,3391,2016,1375,146.6,3008,1757,1251,140.4
'33005, 면부,'045005, 44세,2019,3607,2112,1495,141.3,3268,1888,1380,136.8
'33005, 면부,'050,45~49세,2019,20914,12056,8858,136.1,19319,11042,8277,133.4
'33005, 면부,'050001, 45세,2019,3869,2267,1602,141.5,3568,2076,1492,139.1
'33005, 면부,'050002, 46세,2019,4096,2382,1714,139,3761,2160,1601,134.9
'33005, 면부,'050003, 47세,2019,3915,2254,1661,135.7,3584,2052,1532,133.9
'33005, 면부,'050004, 48세,2019,4529,2601,1928,134.9,4220,2405,1815,132.5
'33005, 면부,'050005, 49세,2019,4505,2552,1953,130.7,4186,2349,1837,127.9
'33005, 면부,'055,50~54세,2019,27703,14956,12747,117.3,26309,14105,12204,115.6
'33005, 면부,'055001, 50세,2019,5225,2871,2354,122,4936,2690,2246,119.8
'33005, 면부,'055002, 51세,2019,5426,2875,2551,112.7,5105,2677,2428,110.3
'33005, 면부,'055003, 52세,2019,5383,2880,2503,115.1,5125,2731,2394,114.1
'33005, 면부,'055004, 53세,2019,5626,3095,2531,122.3,5373,2937,2436,120.6
'33005, 면부,'055005, 54세,2019,6043,3235,2808,115.2,5770,3070,2700,113.7
'33005, 면부,'060,55~59세,2019,33668,17745,15923,111.4,32627,17154,15473,110.9
'33005, 면부,'060001, 55세,2019,5440,2837,2603,109,5186,2684,2502,107.3
'33005, 면부,'060002, 56세,2019,5921,3244,2677,121.2,5648,3091,2557,120.9
'33005, 면부,'060003, 57세,2019,6720,3553,3167,112.2,6533,3453,3080,112.1
'33005, 면부,'060004, 58세,2019,8109,4312,3797,113.6,7952,4226,3726,113.4
'33005, 면부,'060005, 59세,2019,7478,3799,3679,103.3,7308,3700,3608,102.5
'33005, 면부,'065,60~64세,2019,35122,18513,16609,111.5,34518,18134,16384,110.7
'33005, 면부,'065001, 60세,2019,7138,3797,3341,113.6,6990,3701,3289,112.5
'33005, 면부,'065002, 61세,2019,7218,3863,3355,115.1,7087,3775,3312,114
'33005, 면부,'065003, 62세,2019,7357,3887,3470,112,7225,3808,3417,111.4
'33005, 면부,'065004, 63세,2019,6782,3595,3187,112.8,6681,3531,3150,112.1
'33005, 면부,'065005, 64세,2019,6627,3371,3256,103.5,6535,3319,3216,103.2
'33005, 면부,'070,65~69세,2019,25150,12925,12225,105.7,24869,12771,12098,105.6
'33005, 면부,'070001, 65세,2019,6111,3130,2981,105,6019,3077,2942,104.6
'33005, 면부,'070002, 66세,2019,5041,2642,2399,110.1,4973,2605,2368,110
'33005, 면부,'070003, 67세,2019,5938,3100,2838,109.2,5895,3077,2818,109.2
'33005, 면부,'070004, 68세,2019,3922,1947,1975,98.6,3887,1932,1955,98.8
'33005, 면부,'070005, 69세,2019,4138,2106,2032,103.6,4095,2080,2015,103.2
'33005, 면부,'075,70~74세,2019,19697,9811,9886,99.2,19594,9758,9836,99.2
'33005, 면부,'075001, 70세,2019,4439,2249,2190,102.7,4406,2231,2175,102.6
'33005, 면부,'075002, 71세,2019,4237,2163,2074,104.3,4218,2151,2067,104.1
'33005, 면부,'075003, 72세,2019,4166,2122,2044,103.8,4146,2110,2036,103.6
'33005, 면부,'075004, 73세,2019,3304,1635,1669,98,3286,1626,1660,98
'33005, 면부,'075005, 74세,2019,3551,1642,1909,86,3538,1640,1898,86.4
'33005, 면부,'080,75~79세,2019,20174,8351,11823,70.6,20137,8339,11798,70.7
'33005, 면부,'080001, 75세,2019,3651,1527,2124,71.9,3646,1526,2120,72
'33005, 면부,'080002, 76세,2019,3894,1648,2246,73.4,3885,1642,2243,73.2
'33005, 면부,'080003, 77세,2019,4890,2059,2831,72.7,4884,2059,2825,72.9
'33005, 면부,'080004, 78세,2019,4043,1654,2389,69.2,4035,1653,2382,69.4
'33005, 면부,'080005, 79세,2019,3696,1463,2233,65.5,3687,1459,2228,65.5
'33005, 면부,'085,80~84세,2019,16415,5981,10434,57.3,16395,5974,10421,57.3
'33005, 면부,'085001, 80세,2019,3907,1519,2388,63.6,3902,1517,2385,63.6
'33005, 면부,'085002, 81세,2019,3436,1303,2133,61.1,3432,1303,2129,61.2
'33005, 면부,'085003, 82세,2019,3192,1151,2041,56.4,3184,1147,2037,56.3
'33005, 면부,'085004, 83세,2019,3000,1068,1932,55.3,2998,1067,1931,55.3
'33005, 면부,'085005, 84세,2019,2880,940,1940,48.5,2879,940,1939,48.5
'33005, 면부,'086,85세이상,2019,11309,3122,8187,38.1,11296,3118,8178,38.1
'33005, 면부,'090,85~89세,2019,7964,2299,5665,40.6,7954,2295,5659,40.6
'33005, 면부,'090001, 85세,2019,2324,721,1603,45,2321,720,1601,45
'33005, 면부,'090002, 86세,2019,1956,589,1367,43.1,1954,588,1366,43
'33005, 면부,'090003, 87세,2019,1529,460,1069,43,1526,459,1067,43
'33005, 면부,'090004, 88세,2019,1115,271,844,32.1,1114,271,843,32.1
'33005, 면부,'090005, 89세,2019,1040,258,782,33,1039,257,782,32.9
'33005, 면부,'095,90~94세,2019,2698,684,2014,34,2697,684,2013,34
'33005, 면부,'095001, 90세,2019,875,224,651,34.4,875,224,651,34.4
'33005, 면부,'095002, 91세,2019,700,179,521,34.4,700,179,521,34.4
'33005, 면부,'095003, 92세,2019,545,143,402,35.6,544,143,401,35.7
'33005, 면부,'095004, 93세,2019,300,83,217,38.2,300,83,217,38.2
'33005, 면부,'095005, 94세,2019,278,55,223,24.7,278,55,223,24.7
'33005, 면부,'100,95~99세,2019,566,126,440,28.6,564,126,438,28.8
'33005, 면부,'100001, 95세,2019,170,48,122,39.3,168,48,120,40
'33005, 면부,'100002, 96세,2019,157,28,129,21.7,157,28,129,21.7
'33005, 면부,'100003, 97세,2019,110,28,82,34.1,110,28,82,34.1
'33005, 면부,'100004, 98세,2019,80,16,64,25,80,16,64,25
'33005, 면부,'100005, 99세,2019,49,6,43,14,49,6,43,14
'33005, 면부,'101,100세이상,2019,81,13,68,19.1,81,13,68,19.1
'33005, 면부,'102,15세미만,2019,25411,13161,12250,107.4,25084,12995,12089,107.5
'33005, 면부,'103,15~64세,2019,220677,125662,95015,132.3,199054,110171,88883,124
'33005, 면부,'104,65세이상,2019,92745,40190,52555,76.5,92291,39960,52331,76.4
'33005, 면부,'126,평균연령,2019,50.1,47.7,52.7,,51.1,48.9,53.3,
'33005, 면부,'127,중위연령,2019,53.7,50.7,57,,55.2,52.9,57.8,
'33003, 동부,'000,합계,2019,941501,471915,469586,100.5,919806,460703,459103,100.3
'33003, 동부,'005,0~4세,2019,34456,17581,16875,104.2,33950,17327,16623,104.2
'33003, 동부,'005001, 0세,2019,5501,2808,2693,104.3,5409,2765,2644,104.6
'33003, 동부,'005002, 1세,2019,6337,3200,3137,102,6228,3139,3089,101.6
'33003, 동부,'005003, 2세,2019,6826,3566,3260,109.4,6733,3513,3220,109.1
'33003, 동부,'005004, 3세,2019,7677,3892,3785,102.8,7574,3844,3730,103.1
'33003, 동부,'005005, 4세,2019,8115,4115,4000,102.9,8006,4066,3940,103.2
'33003, 동부,'010,5~9세,2019,44046,22381,21665,103.3,43653,22182,21471,103.3
'33003, 동부,'010001, 5세,2019,8148,4077,4071,100.1,8042,4026,4016,100.2
'33003, 동부,'010002, 6세,2019,8377,4274,4103,104.2,8306,4238,4068,104.2
'33003, 동부,'010003, 7세,2019,9181,4680,4501,104,9098,4639,4459,104
'33003, 동부,'010004, 8세,2019,9291,4726,4565,103.5,9223,4691,4532,103.5
'33003, 동부,'010005, 9세,2019,9049,4624,4425,104.5,8984,4588,4396,104.4
'33003, 동부,'015,10~14세,2019,45151,23345,21806,107.1,44884,23204,21680,107
'33003, 동부,'015001, 10세,2019,8687,4544,4143,109.7,8630,4513,4117,109.6
'33003, 동부,'015002, 11세,2019,9183,4771,4412,108.1,9136,4748,4388,108.2
'33003, 동부,'015003, 12세,2019,9617,4957,4660,106.4,9559,4929,4630,106.5
'33003, 동부,'015004, 13세,2019,8831,4537,4294,105.7,8779,4504,4275,105.4
'33003, 동부,'015005, 14세,2019,8833,4536,4297,105.6,8780,4510,4270,105.6
'33003, 동부,'020,15~19세,2019,56742,29730,27012,110.1,55988,29367,26621,110.3
'33003, 동부,'020001, 15세,2019,9645,5074,4571,111,9602,5054,4548,111.1
'33003, 동부,'020002, 16세,2019,9780,5102,4678,109.1,9739,5080,4659,109
'33003, 동부,'020003, 17세,2019,10138,5350,4788,111.7,10073,5315,4758,111.7
'33003, 동부,'020004, 18세,2019,12421,6463,5958,108.5,12257,6385,5872,108.7
'33003, 동부,'020005, 19세,2019,14758,7741,7017,110.3,14317,7533,6784,111
'33003, 동부,'025,20~24세,2019,75041,40385,34656,116.5,71559,38549,33010,116.8
'33003, 동부,'025001, 20세,2019,14438,7507,6931,108.3,13796,7199,6597,109.1
'33003, 동부,'025002, 21세,2019,14689,7515,7174,104.8,14019,7172,6847,104.7
'33003, 동부,'025003, 22세,2019,15376,8108,7268,111.6,14652,7745,6907,112.1
'33003, 동부,'025004, 23세,2019,15549,8682,6867,126.4,14821,8272,6549,126.3
'33003, 동부,'025005, 24세,2019,14989,8573,6416,133.6,14271,8161,6110,133.6
'33003, 동부,'030,25~29세,2019,65999,36814,29185,126.1,63001,35299,27702,127.4
'33003, 동부,'030001, 25세,2019,14502,8275,6227,132.9,13865,7944,5921,134.2
'33003, 동부,'030002, 26세,2019,14010,7846,6164,127.3,13425,7552,5873,128.6
'33003, 동부,'030003, 27세,2019,13467,7581,5886,128.8,12896,7306,5590,130.7
'33003, 동부,'030004, 28세,2019,12321,6752,5569,121.2,11774,6475,5299,122.2
'33003, 동부,'030005, 29세,2019,11699,6360,5339,119.1,11041,6022,5019,120
'33003, 동부,'035,30~34세,2019,55689,29330,26359,111.3,52678,27754,24924,111.4
'33003, 동부,'035001, 30세,2019,11069,5918,5151,114.9,10460,5592,4868,114.9
'33003, 동부,'035002, 31세,2019,10983,5821,5162,112.8,10349,5480,4869,112.5
'33003, 동부,'035003, 32세,2019,11040,5789,5251,110.2,10393,5435,4958,109.6
'33003, 동부,'035004, 33세,2019,11252,5952,5300,112.3,10686,5667,5019,112.9
'33003, 동부,'035005, 34세,2019,11345,5850,5495,106.5,10790,5580,5210,107.1
'33003, 동부,'040,35~39세,2019,68153,34613,33540,103.2,65822,33342,32480,102.7
'33003, 동부,'040001, 35세,2019,11986,6164,5822,105.9,11502,5925,5577,106.2
'33003, 동부,'040002, 36세,2019,13074,6604,6470,102.1,12534,6305,6229,101.2
'33003, 동부,'040003, 37세,2019,14670,7407,7263,102,14205,7154,7051,101.5
'33003, 동부,'040004, 38세,2019,13830,7086,6744,105.1,13385,6836,6549,104.4
'33003, 동부,'040005, 39세,2019,14593,7352,7241,101.5,14196,7122,7074,100.7
'33003, 동부,'045,40~44세,2019,69546,34587,34959,98.9,67715,33608,34107,98.5
'33003, 동부,'045001, 40세,2019,14046,7113,6933,102.6,13632,6878,6754,101.8
'33003, 동부,'045002, 41세,2019,13145,6582,6563,100.3,12735,6368,6367,100
'33003, 동부,'045003, 42세,2019,13895,6919,6976,99.2,13543,6728,6815,98.7
'33003, 동부,'045004, 43세,2019,13759,6847,6912,99.1,13426,6671,6755,98.8
'33003, 동부,'045005, 44세,2019,14701,7126,7575,94.1,14379,6963,7416,93.9
'33003, 동부,'050,45~49세,2019,82071,40856,41215,99.1,80365,39950,40415,98.8
'33003, 동부,'050001, 45세,2019,16331,8105,8226,98.5,16028,7954,8074,98.5
'33003, 동부,'050002, 46세,2019,16307,7994,8313,96.2,15975,7833,8142,96.2
'33003, 동부,'050003, 47세,2019,15648,7888,7760,101.6,15299,7711,7588,101.6
'33003, 동부,'050004, 48세,2019,17215,8659,8556,101.2,16849,8458,8391,100.8
'33003, 동부,'050005, 49세,2019,16570,8210,8360,98.2,16214,7994,8220,97.3
'33003, 동부,'055,50~54세,2019,82884,41010,41874,97.9,81328,40185,41143,97.7
'33003, 동부,'055001, 50세,2019,18050,8839,9211,96,17702,8660,9042,95.8
'33003, 동부,'055002, 51세,2019,17579,8490,9089,93.4,17222,8311,8911,93.3
'33003, 동부,'055003, 52세,2019,15986,7982,8004,99.7,15711,7833,7878,99.4
'33003, 동부,'055004, 53세,2019,15509,7805,7704,101.3,15220,7658,7562,101.3
'33003, 동부,'055005, 54세,2019,15760,7894,7866,100.4,15473,7723,7750,99.7
'33003, 동부,'060,55~59세,2019,76068,38169,37899,100.7,74802,37554,37248,100.8
'33003, 동부,'060001, 55세,2019,13466,6753,6713,100.6,13177,6623,6554,101.1
'33003, 동부,'060002, 56세,2019,14465,7409,7056,105,14136,7243,6893,105.1
'33003, 동부,'060003, 57세,2019,15508,7863,7645,102.9,15266,7745,7521,103
'33003, 동부,'060004, 58세,2019,17327,8648,8679,99.6,17144,8560,8584,99.7
'33003, 동부,'060005, 59세,2019,15302,7496,7806,96,15079,7383,7696,95.9
'33003, 동부,'065,60~64세,2019,63652,31395,32257,97.3,62736,30949,31787,97.4
'33003, 동부,'065001, 60세,2019,14028,6811,7217,94.4,13813,6718,7095,94.7
'33003, 동부,'065002, 61세,2019,13563,6788,6775,100.2,13340,6688,6652,100.5
'33003, 동부,'065003, 62세,2019,13134,6555,6579,99.6,12949,6462,6487,99.6
'33003, 동부,'065004, 63세,2019,11713,5820,5893,98.8,11550,5731,5819,98.5
'33003, 동부,'065005, 64세,2019,11214,5421,5793,93.6,11084,5350,5734,93.3
'33003, 동부,'070,65~69세,2019,39917,19077,20840,91.5,39528,18899,20629,91.6
'33003, 동부,'070001, 65세,2019,9630,4704,4926,95.5,9507,4648,4859,95.7
'33003, 동부,'070002, 66세,2019,8446,4047,4399,92,8357,4002,4355,91.9
'33003, 동부,'070003, 67세,2019,9504,4538,4966,91.4,9442,4507,4935,91.3
'33003, 동부,'070004, 68세,2019,6032,2833,3199,88.6,5965,2805,3160,88.8
'33003, 동부,'070005, 69세,2019,6305,2955,3350,88.2,6257,2937,3320,88.5
'33003, 동부,'075,70~74세,2019,28998,13350,15648,85.3,28833,13285,15548,85.4
'33003, 동부,'075001, 70세,2019,6412,3052,3360,90.8,6359,3029,3330,91
'33003, 동부,'075002, 71세,2019,6537,3095,3442,89.9,6497,3079,3418,90.1
'33003, 동부,'075003, 72세,2019,6333,2818,3515,80.2,6308,2811,3497,80.4
'33003, 동부,'075004, 73세,2019,4661,2126,2535,83.9,4633,2116,2517,84.1
'33003, 동부,'075005, 74세,2019,5055,2259,2796,80.8,5036,2250,2786,80.8
'33003, 동부,'080,75~79세,2019,25137,10369,14768,70.2,25070,10343,14727,70.2
'33003, 동부,'080001, 75세,2019,5121,2196,2925,75.1,5106,2187,2919,74.9
'33003, 동부,'080002, 76세,2019,5128,2194,2934,74.8,5111,2187,2924,74.8
'33003, 동부,'080003, 77세,2019,5997,2492,3505,71.1,5980,2487,3493,71.2
'33003, 동부,'080004, 78세,2019,4726,1876,2850,65.8,4715,1873,2842,65.9
'33003, 동부,'080005, 79세,2019,4165,1611,2554,63.1,4158,1609,2549,63.1
'33003, 동부,'085,80~84세,2019,17099,6209,10890,57,17060,6198,10862,57.1
'33003, 동부,'085001, 80세,2019,4234,1646,2588,63.6,4226,1643,2583,63.6
'33003, 동부,'085002, 81세,2019,3679,1347,2332,57.8,3671,1346,2325,57.9
'33003, 동부,'085003, 82세,2019,3350,1198,2152,55.7,3343,1195,2148,55.6
'33003, 동부,'085004, 83세,2019,3099,1085,2014,53.9,3090,1084,2006,54
'33003, 동부,'085005, 84세,2019,2737,933,1804,51.7,2730,930,1800,51.7
'33003, 동부,'086,85세이상,2019,10852,2714,8138,33.3,10834,2708,8126,33.3
'33003, 동부,'090,85~89세,2019,7631,2084,5547,37.6,7619,2080,5539,37.6
'33003, 동부,'090001, 85세,2019,2164,677,1487,45.5,2161,675,1486,45.4
'33003, 동부,'090002, 86세,2019,1830,522,1308,39.9,1828,522,1306,40
'33003, 동부,'090003, 87세,2019,1514,387,1127,34.3,1511,386,1125,34.3
'33003, 동부,'090004, 88세,2019,1056,268,788,34,1053,267,786,34
'33003, 동부,'090005, 89세,2019,1067,230,837,27.5,1066,230,836,27.5
'33003, 동부,'095,90~94세,2019,2578,517,2061,25.1,2573,516,2057,25.1
'33003, 동부,'095001, 90세,2019,851,186,665,28,849,186,663,28.1
'33003, 동부,'095002, 91세,2019,585,120,465,25.8,584,120,464,25.9
'33003, 동부,'095003, 92세,2019,524,104,420,24.8,523,104,419,24.8
'33003, 동부,'095004, 93세,2019,313,49,264,18.6,312,48,264,18.2
'33003, 동부,'095005, 94세,2019,305,58,247,23.5,305,58,247,23.5
'33003, 동부,'100,95~99세,2019,579,106,473,22.4,578,105,473,22.2
'33003, 동부,'100001, 95세,2019,168,26,142,18.3,167,25,142,17.6
'33003, 동부,'100002, 96세,2019,161,34,127,26.8,161,34,127,26.8
'33003, 동부,'100003, 97세,2019,137,28,109,25.7,137,28,109,25.7
'33003, 동부,'100004, 98세,2019,80,13,67,19.4,80,13,67,19.4
'33003, 동부,'100005, 99세,2019,33,5,28,17.9,33,5,28,17.9
'33003, 동부,'101,100세이상,2019,64,7,57,12.3,64,7,57,12.3
'33003, 동부,'102,15세미만,2019,123653,63307,60346,104.9,122487,62713,59774,104.9
'33003, 동부,'103,15~64세,2019,695845,356889,338956,105.3,675994,346557,329437,105.2
'33003, 동부,'104,65세이상,2019,122003,51719,70284,73.6,121325,51433,69892,73.6
'33003, 동부,'126,평균연령,2019,40.9,39.7,42.1,,41,39.8,42.3,
'33003, 동부,'127,중위연령,2019,41.9,40.2,43.5,,42.1,40.5,43.8,
'33020, 충주시,'000,합계,2019,216446,110758,105688,104.8,208759,105977,102782,103.1
'33020, 충주시,'005,0~4세,2019,6780,3452,3328,103.7,6711,3424,3287,104.2
'33020, 충주시,'005001, 0세,2019,1157,607,550,110.4,1142,601,541,111.1
'33020, 충주시,'005002, 1세,2019,1198,591,607,97.4,1183,587,596,98.5
'33020, 충주시,'005003, 2세,2019,1320,701,619,113.2,1307,694,613,113.2
'33020, 충주시,'005004, 3세,2019,1545,781,764,102.2,1536,776,760,102.1
'33020, 충주시,'005005, 4세,2019,1560,772,788,98,1543,766,777,98.6
'33020, 충주시,'010,5~9세,2019,8508,4259,4249,100.2,8463,4241,4222,100.5
'33020, 충주시,'010001, 5세,2019,1581,759,822,92.3,1570,754,816,92.4
'33020, 충주시,'010002, 6세,2019,1594,823,771,106.7,1582,818,764,107.1
'33020, 충주시,'010003, 7세,2019,1722,839,883,95,1715,837,878,95.3
'33020, 충주시,'010004, 8세,2019,1856,981,875,112.1,1849,979,870,112.5
'33020, 충주시,'010005, 9세,2019,1755,857,898,95.4,1747,853,894,95.4
'33020, 충주시,'015,10~14세,2019,8756,4570,4186,109.2,8728,4555,4173,109.2
'33020, 충주시,'015001, 10세,2019,1644,847,797,106.3,1641,846,795,106.4
'33020, 충주시,'015002, 11세,2019,1820,972,848,114.6,1812,970,842,115.2
'33020, 충주시,'015003, 12세,2019,1934,994,940,105.7,1927,990,937,105.7
'33020, 충주시,'015004, 13세,2019,1686,875,811,107.9,1681,871,810,107.5
'33020, 충주시,'015005, 14세,2019,1672,882,790,111.6,1667,878,789,111.3
'33020, 충주시,'020,15~19세,2019,11719,6235,5484,113.7,11606,6176,5430,113.7
'33020, 충주시,'020001, 15세,2019,1868,959,909,105.5,1861,953,908,105
'33020, 충주시,'020002, 16세,2019,1912,1000,912,109.6,1909,998,911,109.5
'33020, 충주시,'020003, 17세,2019,1985,1039,946,109.8,1979,1037,942,110.1
'33020, 충주시,'020004, 18세,2019,2591,1356,1235,109.8,2570,1350,1220,110.7
'33020, 충주시,'020005, 19세,2019,3363,1881,1482,126.9,3287,1838,1449,126.8
'33020, 충주시,'025,20~24세,2019,16579,9565,7014,136.4,15054,8581,6473,132.6
'33020, 충주시,'025001, 20세,2019,3274,1782,1492,119.4,3019,1646,1373,119.9
'33020, 충주시,'025002, 21세,2019,3270,1701,1569,108.4,2977,1519,1458,104.2
'33020, 충주시,'025003, 22세,2019,3409,1993,1416,140.7,3074,1786,1288,138.7
'33020, 충주시,'025004, 23세,2019,3433,2053,1380,148.8,3111,1824,1287,141.7
'33020, 충주시,'025005, 24세,2019,3193,2036,1157,176,2873,1806,1067,169.3
'33020, 충주시,'030,25~29세,2019,13389,8018,5371,149.3,11886,7054,4832,146
'33020, 충주시,'030001, 25세,2019,2950,1837,1113,165,2630,1621,1009,160.7
'33020, 충주시,'030002, 26세,2019,2786,1666,1120,148.8,2456,1471,985,149.3
'33020, 충주시,'030003, 27세,2019,2737,1672,1065,157,2444,1486,958,155.1
'33020, 충주시,'030004, 28세,2019,2508,1461,1047,139.5,2239,1284,955,134.5
'33020, 충주시,'030005, 29세,2019,2408,1382,1026,134.7,2117,1192,925,128.9
'33020, 충주시,'035,30~34세,2019,11526,6502,5024,129.4,10297,5690,4607,123.5
'33020, 충주시,'035001, 30세,2019,2297,1312,985,133.2,2021,1130,891,126.8
'33020, 충주시,'035002, 31세,2019,2265,1321,944,139.9,2020,1161,859,135.2
'33020, 충주시,'035003, 32세,2019,2306,1301,1005,129.5,2068,1135,933,121.7
'33020, 충주시,'035004, 33세,2019,2353,1299,1054,123.2,2108,1146,962,119.1
'33020, 충주시,'035005, 34세,2019,2305,1269,1036,122.5,2080,1118,962,116.2
'33020, 충주시,'040,35~39세,2019,13940,7402,6538,113.2,13102,6860,6242,109.9
'33020, 충주시,'040001, 35세,2019,2539,1385,1154,120,2350,1262,1088,116
'33020, 충주시,'040002, 36세,2019,2686,1419,1267,112,2501,1300,1201,108.2
'33020, 충주시,'040003, 37세,2019,2936,1549,1387,111.7,2762,1439,1323,108.8
'33020, 충주시,'040004, 38세,2019,2841,1552,1289,120.4,2695,1459,1236,118
'33020, 충주시,'040005, 39세,2019,2938,1497,1441,103.9,2794,1400,1394,100.4
'33020, 충주시,'045,40~44세,2019,14234,7331,6903,106.2,13618,6946,6672,104.1
'33020, 충주시,'045001, 40세,2019,2884,1479,1405,105.3,2751,1399,1352,103.5
'33020, 충주시,'045002, 41세,2019,2656,1380,1276,108.2,2523,1299,1224,106.1
'33020, 충주시,'045003, 42세,2019,2847,1467,1380,106.3,2725,1387,1338,103.7
'33020, 충주시,'045004, 43세,2019,2840,1493,1347,110.8,2709,1408,1301,108.2
'33020, 충주시,'045005, 44세,2019,3007,1512,1495,101.1,2910,1453,1457,99.7
'33020, 충주시,'050,45~49세,2019,17202,8904,8298,107.3,16694,8604,8090,106.4
'33020, 충주시,'050001, 45세,2019,3386,1787,1599,111.8,3297,1733,1564,110.8
'33020, 충주시,'050002, 46세,2019,3458,1794,1664,107.8,3346,1728,1618,106.8
'33020, 충주시,'050003, 47세,2019,3259,1699,1560,108.9,3144,1635,1509,108.3
'33020, 충주시,'050004, 48세,2019,3618,1848,1770,104.4,3530,1799,1731,103.9
'33020, 충주시,'050005, 49세,2019,3481,1776,1705,104.2,3377,1709,1668,102.5
'33020, 충주시,'055,50~54세,2019,18688,9610,9078,105.9,18232,9343,8889,105.1
'33020, 충주시,'055001, 50세,2019,3921,1970,1951,101,3815,1906,1909,99.8
'33020, 충주시,'055002, 51세,2019,3884,1971,1913,103,3783,1919,1864,103
'33020, 충주시,'055003, 52세,2019,3571,1827,1744,104.8,3495,1781,1714,103.9
'33020, 충주시,'055004, 53세,2019,3588,1925,1663,115.8,3504,1872,1632,114.7
'33020, 충주시,'055005, 54세,2019,3724,1917,1807,106.1,3635,1865,1770,105.4
'33020, 충주시,'060,55~59세,2019,18957,9652,9305,103.7,18607,9462,9145,103.5
'33020, 충주시,'060001, 55세,2019,3198,1630,1568,104,3108,1585,1523,104.1
'33020, 충주시,'060002, 56세,2019,3527,1813,1714,105.8,3446,1766,1680,105.1
'33020, 충주시,'060003, 57세,2019,3844,1997,1847,108.1,3768,1957,1811,108.1
'33020, 충주시,'060004, 58세,2019,4441,2237,2204,101.5,4393,2209,2184,101.1
'33020, 충주시,'060005, 59세,2019,3947,1975,1972,100.2,3892,1945,1947,99.9
'33020, 충주시,'065,60~64세,2019,17200,8774,8426,104.1,16983,8641,8342,103.6
'33020, 충주시,'065001, 60세,2019,3705,1909,1796,106.3,3651,1878,1773,105.9
'33020, 충주시,'065002, 61세,2019,3609,1841,1768,104.1,3554,1807,1747,103.4
'33020, 충주시,'065003, 62세,2019,3518,1816,1702,106.7,3475,1789,1686,106.1
'33020, 충주시,'065004, 63세,2019,3311,1697,1614,105.1,3274,1673,1601,104.5
'33020, 충주시,'065005, 64세,2019,3057,1511,1546,97.7,3029,1494,1535,97.3
'33020, 충주시,'070,65~69세,2019,11381,5488,5893,93.1,11276,5436,5840,93.1
'33020, 충주시,'070001, 65세,2019,2692,1364,1328,102.7,2657,1344,1313,102.4
'33020, 충주시,'070002, 66세,2019,2399,1171,1228,95.4,2377,1159,1218,95.2
'33020, 충주시,'070003, 67세,2019,2883,1351,1532,88.2,2866,1340,1526,87.8
'33020, 충주시,'070004, 68세,2019,1677,797,880,90.6,1659,792,867,91.3
'33020, 충주시,'070005, 69세,2019,1730,805,925,87,1717,801,916,87.4
'33020, 충주시,'075,70~74세,2019,8696,4017,4679,85.9,8647,3995,4652,85.9
'33020, 충주시,'075001, 70세,2019,1884,881,1003,87.8,1864,872,992,87.9
'33020, 충주시,'075002, 71세,2019,1807,863,944,91.4,1798,859,939,91.5
'33020, 충주시,'075003, 72세,2019,1967,907,1060,85.6,1961,905,1056,85.7
'33020, 충주시,'075004, 73세,2019,1480,689,791,87.1,1468,683,785,87
'33020, 충주시,'075005, 74세,2019,1558,677,881,76.8,1556,676,880,76.8
'33020, 충주시,'080,75~79세,2019,8590,3608,4982,72.4,8571,3606,4965,72.6
'33020, 충주시,'080001, 75세,2019,1697,736,961,76.6,1695,736,959,76.7
'33020, 충주시,'080002, 76세,2019,1641,703,938,74.9,1635,703,932,75.4
'33020, 충주시,'080003, 77세,2019,2013,866,1147,75.5,2008,865,1143,75.7
'33020, 충주시,'080004, 78세,2019,1711,691,1020,67.7,1709,691,1018,67.9
'33020, 충주시,'080005, 79세,2019,1528,612,916,66.8,1524,611,913,66.9
'33020, 충주시,'085,80~84세,2019,6267,2269,3998,56.8,6252,2261,3991,56.7
'33020, 충주시,'085001, 80세,2019,1649,623,1026,60.7,1643,620,1023,60.6
'33020, 충주시,'085002, 81세,2019,1339,512,827,61.9,1338,512,826,62
'33020, 충주시,'085003, 82세,2019,1196,442,754,58.6,1194,440,754,58.4
'33020, 충주시,'085004, 83세,2019,1095,390,705,55.3,1091,389,702,55.4
'33020, 충주시,'085005, 84세,2019,988,302,686,44,986,300,686,43.7
'33020, 충주시,'086,85세이상,2019,4034,1102,2932,37.6,4032,1102,2930,37.6
'33020, 충주시,'090,85~89세,2019,2907,811,2096,38.7,2906,811,2095,38.7
'33020, 충주시,'090001, 85세,2019,878,273,605,45.1,877,273,604,45.2
'33020, 충주시,'090002, 86세,2019,691,196,495,39.6,691,196,495,39.6
'33020, 충주시,'090003, 87세,2019,586,145,441,32.9,586,145,441,32.9
'33020, 충주시,'090004, 88세,2019,387,106,281,37.7,387,106,281,37.7
'33020, 충주시,'090005, 89세,2019,365,91,274,33.2,365,91,274,33.2
'33020, 충주시,'095,90~94세,2019,906,235,671,35,905,235,670,35.1
'33020, 충주시,'095001, 90세,2019,298,82,216,38,298,82,216,38
'33020, 충주시,'095002, 91세,2019,216,48,168,28.6,215,48,167,28.7
'33020, 충주시,'095003, 92세,2019,181,43,138,31.2,181,43,138,31.2
'33020, 충주시,'095004, 93세,2019,113,31,82,37.8,113,31,82,37.8
'33020, 충주시,'095005, 94세,2019,98,31,67,46.3,98,31,67,46.3
'33020, 충주시,'100,95~99세,2019,203,53,150,35.3,203,53,150,35.3
'33020, 충주시,'100001, 95세,2019,63,20,43,46.5,63,20,43,46.5
'33020, 충주시,'100002, 96세,2019,53,15,38,39.5,53,15,38,39.5
'33020, 충주시,'100003, 97세,2019,51,10,41,24.4,51,10,41,24.4
'33020, 충주시,'100004, 98세,2019,25,6,19,31.6,25,6,19,31.6
'33020, 충주시,'100005, 99세,2019,11,X,9,22.2,11,X,9,22.2
'33020, 충주시,'101,100세이상,2019,18,X,15,20,18,X,15,20
'33020, 충주시,'102,15세미만,2019,24044,12281,11763,104.4,23902,12220,11682,104.6
'33020, 충주시,'103,15~64세,2019,153434,81993,71441,114.8,146079,77357,68722,112.6
'33020, 충주시,'104,65세이상,2019,38968,16484,22484,73.3,38778,16400,22378,73.3
'33020, 충주시,'126,평균연령,2019,44.1,42.4,45.8,,44.4,42.8,46.1,
'33020, 충주시,'127,중위연령,2019,45.8,43.7,48,,46.5,44.6,48.4,
'33030, 제천시,'000,합계,2019,136093,68500,67593,101.3,133782,67369,66413,101.4
'33030, 제천시,'005,0~4세,2019,4069,2082,1987,104.8,4051,2074,1977,104.9
'33030, 제천시,'005001, 0세,2019,678,331,347,95.4,675,331,344,96.2
'33030, 제천시,'005002, 1세,2019,761,374,387,96.6,758,371,387,95.9
'33030, 제천시,'005003, 2세,2019,778,414,364,113.7,775,413,362,114.1
'33030, 제천시,'005004, 3세,2019,921,504,417,120.9,917,502,415,121
'33030, 제천시,'005005, 4세,2019,931,459,472,97.2,926,457,469,97.4
'33030, 제천시,'010,5~9세,2019,5185,2580,2605,99,5178,2576,2602,99
'33030, 제천시,'010001, 5세,2019,989,501,488,102.7,986,499,487,102.5
'33030, 제천시,'010002, 6세,2019,964,480,484,99.2,963,480,483,99.4
'33030, 제천시,'010003, 7세,2019,1084,553,531,104.1,1084,553,531,104.1
'33030, 제천시,'010004, 8세,2019,1072,529,543,97.4,1071,529,542,97.6
'33030, 제천시,'010005, 9세,2019,1076,517,559,92.5,1074,515,559,92.1
'33030, 제천시,'015,10~14세,2019,5396,2811,2585,108.7,5387,2805,2582,108.6
'33030, 제천시,'015001, 10세,2019,1000,516,484,106.6,1000,516,484,106.6
'33030, 제천시,'015002, 11세,2019,1090,581,509,114.1,1088,579,509,113.8
'33030, 제천시,'015003, 12세,2019,1115,559,556,100.5,1112,558,554,100.7
'33030, 제천시,'015004, 13세,2019,1085,574,511,112.3,1083,572,511,111.9
'33030, 제천시,'015005, 14세,2019,1106,581,525,110.7,1104,580,524,110.7
'33030, 제천시,'020,15~19세,2019,7972,4133,3839,107.7,7847,4072,3775,107.9
'33030, 제천시,'020001, 15세,2019,1174,612,562,108.9,1170,611,559,109.3
'33030, 제천시,'020002, 16세,2019,1150,599,551,108.7,1148,598,550,108.7
'33030, 제천시,'020003, 17세,2019,1271,683,588,116.2,1256,672,584,115.1
'33030, 제천시,'020004, 18세,2019,1805,977,828,118,1773,960,813,118.1
'33030, 제천시,'020005, 19세,2019,2572,1262,1310,96.3,2500,1231,1269,97
'33030, 제천시,'025,20~24세,2019,10358,5784,4574,126.5,9978,5597,4381,127.8
'33030, 제천시,'025001, 20세,2019,2180,1008,1172,86,2113,982,1131,86.8
'33030, 제천시,'025002, 21세,2019,2182,1105,1077,102.6,2098,1066,1032,103.3
'33030, 제천시,'025003, 22세,2019,2180,1245,935,133.2,2103,1208,895,135
'33030, 제천시,'025004, 23세,2019,1966,1230,736,167.1,1887,1189,698,170.3
'33030, 제천시,'025005, 24세,2019,1850,1196,654,182.9,1777,1152,625,184.3
'33030, 제천시,'030,25~29세,2019,7030,4048,2982,135.7,6691,3880,2811,138
'33030, 제천시,'030001, 25세,2019,1595,984,611,161,1524,946,578,163.7
'33030, 제천시,'030002, 26세,2019,1530,885,645,137.2,1466,850,616,138
'33030, 제천시,'030003, 27세,2019,1404,803,601,133.6,1342,772,570,135.4
'33030, 제천시,'030004, 28세,2019,1253,702,551,127.4,1188,669,519,128.9
'33030, 제천시,'030005, 29세,2019,1248,674,574,117.4,1171,643,528,121.8
'33030, 제천시,'035,30~34세,2019,6089,3220,2869,112.2,5741,3050,2691,113.3
'33030, 제천시,'035001, 30세,2019,1180,612,568,107.7,1112,576,536,107.5
'33030, 제천시,'035002, 31세,2019,1182,615,567,108.5,1102,576,526,109.5
'33030, 제천시,'035003, 32세,2019,1189,615,574,107.1,1106,577,529,109.1
'33030, 제천시,'035004, 33세,2019,1272,693,579,119.7,1216,669,547,122.3
'33030, 제천시,'035005, 34세,2019,1266,685,581,117.9,1205,652,553,117.9
'33030, 제천시,'040,35~39세,2019,7743,3940,3803,103.6,7496,3820,3676,103.9
'33030, 제천시,'040001, 35세,2019,1334,697,637,109.4,1293,680,613,110.9
'33030, 제천시,'040002, 36세,2019,1469,746,723,103.2,1404,715,689,103.8
'33030, 제천시,'040003, 37세,2019,1671,852,819,104,1614,828,786,105.3
'33030, 제천시,'040004, 38세,2019,1597,802,795,100.9,1555,777,778,99.9
'33030, 제천시,'040005, 39세,2019,1672,843,829,101.7,1630,820,810,101.2
'33030, 제천시,'045,40~44세,2019,8147,4170,3977,104.9,7964,4087,3877,105.4
'33030, 제천시,'045001, 40세,2019,1613,822,791,103.9,1575,802,773,103.8
'33030, 제천시,'045002, 41세,2019,1536,785,751,104.5,1492,772,720,107.2
'33030, 제천시,'045003, 42세,2019,1594,846,748,113.1,1562,828,734,112.8
'33030, 제천시,'045004, 43세,2019,1594,821,773,106.2,1559,804,755,106.5
'33030, 제천시,'045005, 44세,2019,1810,896,914,98,1776,881,895,98.4
'33030, 제천시,'050,45~49세,2019,10536,5423,5113,106.1,10365,5338,5027,106.2
'33030, 제천시,'050001, 45세,2019,2005,1002,1003,99.9,1969,987,982,100.5
'33030, 제천시,'050002, 46세,2019,1980,1000,980,102,1949,985,964,102.2
'33030, 제천시,'050003, 47세,2019,2065,1100,965,114,2028,1079,949,113.7
'33030, 제천시,'050004, 48세,2019,2288,1191,1097,108.6,2245,1167,1078,108.3
'33030, 제천시,'050005, 49세,2019,2198,1130,1068,105.8,2174,1120,1054,106.3
'33030, 제천시,'055,50~54세,2019,11819,6105,5714,106.8,11648,6014,5634,106.7
'33030, 제천시,'055001, 50세,2019,2434,1276,1158,110.2,2400,1261,1139,110.7
'33030, 제천시,'055002, 51세,2019,2478,1255,1223,102.6,2440,1235,1205,102.5
'33030, 제천시,'055003, 52세,2019,2284,1182,1102,107.3,2250,1165,1085,107.4
'33030, 제천시,'055004, 53세,2019,2309,1193,1116,106.9,2277,1174,1103,106.4
'33030, 제천시,'055005, 54세,2019,2314,1199,1115,107.5,2281,1179,1102,107
'33030, 제천시,'060,55~59세,2019,12338,6159,6179,99.7,12207,6097,6110,99.8
'33030, 제천시,'060001, 55세,2019,1985,1010,975,103.6,1951,991,960,103.2
'33030, 제천시,'060002, 56세,2019,2210,1111,1099,101.1,2184,1105,1079,102.4
'33030, 제천시,'060003, 57세,2019,2529,1251,1278,97.9,2504,1235,1269,97.3
'33030, 제천시,'060004, 58세,2019,2898,1473,1425,103.4,2876,1462,1414,103.4
'33030, 제천시,'060005, 59세,2019,2716,1314,1402,93.7,2692,1304,1388,93.9
'33030, 제천시,'065,60~64세,2019,12269,6187,6082,101.7,12169,6138,6031,101.8
'33030, 제천시,'065001, 60세,2019,2538,1245,1293,96.3,2511,1231,1280,96.2
'33030, 제천시,'065002, 61세,2019,2654,1361,1293,105.3,2628,1349,1279,105.5
'33030, 제천시,'065003, 62세,2019,2548,1272,1276,99.7,2533,1265,1268,99.8
'33030, 제천시,'065004, 63세,2019,2321,1168,1153,101.3,2299,1159,1140,101.7
'33030, 제천시,'065005, 64세,2019,2208,1141,1067,106.9,2198,1134,1064,106.6
'33030, 제천시,'070,65~69세,2019,8483,4186,4297,97.4,8445,4164,4281,97.3
'33030, 제천시,'070001, 65세,2019,1967,947,1020,92.8,1956,941,1015,92.7
'33030, 제천시,'070002, 66세,2019,1763,904,859,105.2,1755,899,856,105
'33030, 제천시,'070003, 67세,2019,2232,1139,1093,104.2,2225,1133,1092,103.8
'33030, 제천시,'070004, 68세,2019,1248,575,673,85.4,1239,572,667,85.8
'33030, 제천시,'070005, 69세,2019,1273,621,652,95.2,1270,619,651,95.1
'33030, 제천시,'075,70~74세,2019,6203,2923,3280,89.1,6182,2918,3264,89.4
'33030, 제천시,'075001, 70세,2019,1287,627,660,95,1284,626,658,95.1
'33030, 제천시,'075002, 71세,2019,1389,686,703,97.6,1387,685,702,97.6
'33030, 제천시,'075003, 72세,2019,1378,636,742,85.7,1371,635,736,86.3
'33030, 제천시,'075004, 73세,2019,996,454,542,83.8,990,452,538,84
'33030, 제천시,'075005, 74세,2019,1153,520,633,82.1,1150,520,630,82.5
'33030, 제천시,'080,75~79세,2019,5919,2510,3409,73.6,5906,2503,3403,73.6
'33030, 제천시,'080001, 75세,2019,1190,535,655,81.7,1187,532,655,81.2
'33030, 제천시,'080002, 76세,2019,1197,534,663,80.5,1193,532,661,80.5
'33030, 제천시,'080003, 77세,2019,1409,599,810,74,1404,598,806,74.2
'33030, 제천시,'080004, 78세,2019,1137,476,661,72,1137,476,661,72
'33030, 제천시,'080005, 79세,2019,986,366,620,59,985,365,620,58.9
'33030, 제천시,'085,80~84세,2019,4057,1568,2489,63,4052,1567,2485,63.1
'33030, 제천시,'085001, 80세,2019,976,396,580,68.3,974,395,579,68.2
'33030, 제천시,'085002, 81세,2019,930,370,560,66.1,930,370,560,66.1
'33030, 제천시,'085003, 82세,2019,813,307,506,60.7,813,307,506,60.7
'33030, 제천시,'085004, 83세,2019,715,269,446,60.3,713,269,444,60.6
'33030, 제천시,'085005, 84세,2019,623,226,397,56.9,622,226,396,57.1
'33030, 제천시,'086,85세이상,2019,2480,671,1809,37.1,2475,669,1806,37
'33030, 제천시,'090,85~89세,2019,1755,519,1236,42,1752,517,1235,41.9
'33030, 제천시,'090001, 85세,2019,498,162,336,48.2,497,161,336,47.9
'33030, 제천시,'090002, 86세,2019,393,125,268,46.6,393,125,268,46.6
'33030, 제천시,'090003, 87세,2019,338,98,240,40.8,337,97,240,40.4
'33030, 제천시,'090004, 88세,2019,269,71,198,35.9,268,71,197,36
'33030, 제천시,'090005, 89세,2019,257,63,194,32.5,257,63,194,32.5
'33030, 제천시,'095,90~94세,2019,561,121,440,27.5,559,121,438,27.6
'33030, 제천시,'095001, 90세,2019,181,50,131,38.2,180,50,130,38.5
'33030, 제천시,'095002, 91세,2019,134,27,107,25.2,134,27,107,25.2
'33030, 제천시,'095003, 92세,2019,109,17,92,18.5,108,17,91,18.7
'33030, 제천시,'095004, 93세,2019,75,10,65,15.4,75,10,65,15.4
'33030, 제천시,'095005, 94세,2019,62,17,45,37.8,62,17,45,37.8
'33030, 제천시,'100,95~99세,2019,142,27,115,23.5,142,27,115,23.5
'33030, 제천시,'100001, 95세,2019,49,8,41,19.5,49,8,41,19.5
'33030, 제천시,'100002, 96세,2019,33,5,28,17.9,33,5,28,17.9
'33030, 제천시,'100003, 97세,2019,26,10,16,62.5,26,10,16,62.5
'33030, 제천시,'100004, 98세,2019,22,X,20,10,22,X,20,10
'33030, 제천시,'100005, 99세,2019,12,X,10,20,12,X,10,20
'33030, 제천시,'101,100세이상,2019,22,X,18,22.2,22,X,18,22.2
'33030, 제천시,'102,15세미만,2019,14650,7473,7177,104.1,14616,7455,7161,104.1
'33030, 제천시,'103,15~64세,2019,94301,49169,45132,108.9,92106,48093,44013,109.3
'33030, 제천시,'104,65세이상,2019,27142,11858,15284,77.6,27060,11821,15239,77.6
'33030, 제천시,'126,평균연령,2019,45.2,43.8,46.6,,45.3,43.9,46.8,
'33030, 제천시,'127,중위연령,2019,48,46.5,49.5,,48.3,46.7,49.8,
'33040, 청주시,'000,합계,2019,850938,429372,421566,101.9,830095,417979,412116,101.4
'33040, 청주시,'005,0~4세,2019,35288,18032,17256,104.5,34780,17771,17009,104.5
'33040, 청주시,'005001, 0세,2019,5740,2952,2788,105.9,5638,2905,2733,106.3
'33040, 청주시,'005002, 1세,2019,6657,3395,3262,104.1,6551,3333,3218,103.6
'33040, 청주시,'005003, 2세,2019,7022,3600,3422,105.2,6934,3549,3385,104.8
'33040, 청주시,'005004, 3세,2019,7734,3908,3826,102.1,7627,3857,3770,102.3
'33040, 청주시,'005005, 4세,2019,8135,4177,3958,105.5,8030,4127,3903,105.7
'33040, 청주시,'010,5~9세,2019,42151,21446,20705,103.6,41764,21258,20506,103.7
'33040, 청주시,'010001, 5세,2019,8011,4009,4002,100.2,7904,3960,3944,100.4
'33040, 청주시,'010002, 6세,2019,8187,4180,4007,104.3,8118,4147,3971,104.4
'33040, 청주시,'010003, 7세,2019,8887,4542,4345,104.5,8802,4503,4299,104.7
'33040, 청주시,'010004, 8세,2019,8718,4396,4322,101.7,8650,4359,4291,101.6
'33040, 청주시,'010005, 9세,2019,8348,4319,4029,107.2,8290,4289,4001,107.2
'33040, 청주시,'015,10~14세,2019,40807,21120,19687,107.3,40552,20991,19561,107.3
'33040, 청주시,'015001, 10세,2019,8104,4257,3847,110.7,8045,4225,3820,110.6
'33040, 청주시,'015002, 11세,2019,8389,4322,4067,106.3,8344,4301,4043,106.4
'33040, 청주시,'015003, 12세,2019,8638,4468,4170,107.1,8586,4445,4141,107.3
'33040, 청주시,'015004, 13세,2019,7884,4054,3830,105.8,7836,4024,3812,105.6
'33040, 청주시,'015005, 14세,2019,7792,4019,3773,106.5,7741,3996,3745,106.7
'33040, 청주시,'020,15~19세,2019,48529,25528,23001,111,47939,25239,22700,111.2
'33040, 청주시,'020001, 15세,2019,8460,4476,3984,112.3,8425,4460,3965,112.5
'33040, 청주시,'020002, 16세,2019,8626,4527,4099,110.4,8586,4505,4081,110.4
'33040, 청주시,'020003, 17세,2019,8897,4735,4162,113.8,8848,4712,4136,113.9
'33040, 청주시,'020004, 18세,2019,10396,5405,4991,108.3,10270,5341,4929,108.4
'33040, 청주시,'020005, 19세,2019,12150,6385,5765,110.8,11810,6221,5589,111.3
'33040, 청주시,'025,20~24세,2019,63848,34034,29814,114.2,61115,32532,28583,113.8
'33040, 청주시,'025001, 20세,2019,11994,6281,5713,109.9,11564,6068,5496,110.4
'33040, 청주시,'025002, 21세,2019,12309,6312,5997,105.3,11846,6062,5784,104.8
'33040, 청주시,'025003, 22세,2019,12944,6687,6257,106.9,12386,6400,5986,106.9
'33040, 청주시,'025004, 23세,2019,13354,7387,5967,123.8,12743,7031,5712,123.1
'33040, 청주시,'025005, 24세,2019,13247,7367,5880,125.3,12576,6971,5605,124.4
'33040, 청주시,'030,25~29세,2019,62967,35263,27704,127.3,59783,33437,26346,126.9
'33040, 청주시,'030001, 25세,2019,13265,7559,5706,132.5,12641,7209,5432,132.7
'33040, 청주시,'030002, 26세,2019,13181,7406,5775,128.2,12577,7053,5524,127.7
'33040, 청주시,'030003, 27세,2019,12860,7285,5575,130.7,12252,6937,5315,130.5
'33040, 청주시,'030004, 28세,2019,12035,6629,5406,122.6,11402,6265,5137,122
'33040, 청주시,'030005, 29세,2019,11626,6384,5242,121.8,10911,5973,4938,121
'33040, 청주시,'035,30~34세,2019,56718,30055,26663,112.7,53480,28192,25288,111.5
'33040, 청주시,'035001, 30세,2019,11209,6031,5178,116.5,10541,5630,4911,114.6
'33040, 청주시,'035002, 31세,2019,11188,5912,5276,112.1,10495,5510,4985,110.5
'33040, 청주시,'035003, 32세,2019,11324,5980,5344,111.9,10646,5576,5070,110
'33040, 청주시,'035004, 33세,2019,11431,6114,5317,115,10828,5765,5063,113.9
'33040, 청주시,'035005, 34세,2019,11566,6018,5548,108.5,10970,5711,5259,108.6
'33040, 청주시,'040,35~39세,2019,67374,34839,32535,107.1,64896,33382,31514,105.9
'33040, 청주시,'040001, 35세,2019,12070,6336,5734,110.5,11552,6041,5511,109.6
'33040, 청주시,'040002, 36세,2019,13221,6816,6405,106.4,12629,6456,6173,104.6
'33040, 청주시,'040003, 37세,2019,14488,7377,7111,103.7,13989,7078,6911,102.4
'33040, 청주시,'040004, 38세,2019,13450,7022,6428,109.2,12977,6748,6229,108.3
'33040, 청주시,'040005, 39세,2019,14145,7288,6857,106.3,13749,7059,6690,105.5
'33040, 청주시,'045,40~44세,2019,64670,32789,31881,102.8,62861,31771,31090,102.2
'33040, 청주시,'045001, 40세,2019,13436,6952,6484,107.2,13009,6694,6315,106
'33040, 청주시,'045002, 41세,2019,12375,6345,6030,105.2,11997,6128,5869,104.4
'33040, 청주시,'045003, 42세,2019,12902,6500,6402,101.5,12538,6300,6238,101
'33040, 청주시,'045004, 43세,2019,12658,6395,6263,102.1,12337,6221,6116,101.7
'33040, 청주시,'045005, 44세,2019,13299,6597,6702,98.4,12980,6428,6552,98.1
'33040, 청주시,'050,45~49세,2019,71955,36200,35755,101.2,70326,35310,35016,100.8
'33040, 청주시,'050001, 45세,2019,14493,7293,7200,101.3,14202,7140,7062,101.1
'33040, 청주시,'050002, 46세,2019,14519,7190,7329,98.1,14189,7022,7167,98
'33040, 청주시,'050003, 47세,2019,13609,6904,6705,103,13287,6732,6555,102.7
'33040, 청주시,'050004, 48세,2019,14986,7605,7381,103,14645,7419,7226,102.7
'33040, 청주시,'050005, 49세,2019,14348,7208,7140,101,14003,6997,7006,99.9
'33040, 청주시,'055,50~54세,2019,71502,35419,36083,98.2,70080,34675,35405,97.9
'33040, 청주시,'055001, 50세,2019,15679,7739,7940,97.5,15362,7568,7794,97.1
'33040, 청주시,'055002, 51세,2019,15048,7265,7783,93.3,14731,7106,7625,93.2
'33040, 청주시,'055003, 52세,2019,13797,6909,6888,100.3,13566,6791,6775,100.2
'33040, 청주시,'055004, 53세,2019,13287,6673,6614,100.9,13021,6542,6479,101
'33040, 청주시,'055005, 54세,2019,13691,6833,6858,99.6,13400,6668,6732,99
'33040, 청주시,'060,55~59세,2019,65421,33055,32366,102.1,64253,32486,31767,102.3
'33040, 청주시,'060001, 55세,2019,11684,5870,5814,101,11439,5763,5676,101.5
'33040, 청주시,'060002, 56세,2019,12482,6471,6011,107.7,12158,6302,5856,107.6
'33040, 청주시,'060003, 57세,2019,13296,6830,6466,105.6,13079,6729,6350,106
'33040, 청주시,'060004, 58세,2019,14945,7495,7450,100.6,14778,7417,7361,100.8
'33040, 청주시,'060005, 59세,2019,13014,6389,6625,96.4,12799,6275,6524,96.2
'33040, 청주시,'065,60~64세,2019,54549,26897,27652,97.3,53710,26498,27212,97.4
'33040, 청주시,'065001, 60세,2019,12011,5836,6175,94.5,11821,5756,6065,94.9
'33040, 청주시,'065002, 61세,2019,11475,5747,5728,100.3,11279,5660,5619,100.7
'33040, 청주시,'065003, 62세,2019,11317,5624,5693,98.8,11135,5531,5604,98.7
'33040, 청주시,'065004, 63세,2019,9992,5017,4975,100.8,9844,4939,4905,100.7
'33040, 청주시,'065005, 64세,2019,9754,4673,5081,92,9631,4612,5019,91.9
'33040, 청주시,'070,65~69세,2019,33973,16484,17489,94.3,33620,16322,17298,94.4
'33040, 청주시,'070001, 65세,2019,8361,4099,4262,96.2,8250,4045,4205,96.2
'33040, 청주시,'070002, 66세,2019,7152,3474,3678,94.5,7067,3432,3635,94.4
'33040, 청주시,'070003, 67세,2019,7797,3824,3973,96.2,7736,3800,3936,96.5
'33040, 청주시,'070004, 68세,2019,5193,2478,2715,91.3,5138,2452,2686,91.3
'33040, 청주시,'070005, 69세,2019,5470,2609,2861,91.2,5429,2593,2836,91.4
'33040, 청주시,'075,70~74세,2019,24650,11597,13053,88.8,24506,11536,12970,88.9
'33040, 청주시,'075001, 70세,2019,5611,2727,2884,94.6,5565,2707,2858,94.7
'33040, 청주시,'075002, 71세,2019,5566,2646,2920,90.6,5529,2631,2898,90.8
'33040, 청주시,'075003, 72세,2019,5269,2434,2835,85.9,5247,2425,2822,85.9
'33040, 청주시,'075004, 73세,2019,3993,1864,2129,87.6,3974,1858,2116,87.8
'33040, 청주시,'075005, 74세,2019,4211,1926,2285,84.3,4191,1915,2276,84.1
'33040, 청주시,'080,75~79세,2019,21154,8684,12470,69.6,21100,8665,12435,69.7
'33040, 청주시,'080001, 75세,2019,4199,1747,2452,71.2,4187,1741,2446,71.2
'33040, 청주시,'080002, 76세,2019,4357,1862,2495,74.6,4347,1856,2491,74.5
'33040, 청주시,'080003, 77세,2019,5100,2125,2975,71.4,5089,2122,2967,71.5
'33040, 청주시,'080004, 78세,2019,3955,1567,2388,65.6,3939,1564,2375,65.9
'33040, 청주시,'080005, 79세,2019,3543,1383,2160,64,3538,1382,2156,64.1
'33040, 청주시,'085,80~84세,2019,15187,5397,9790,55.1,15155,5390,9765,55.2
'33040, 청주시,'085001, 80세,2019,3594,1387,2207,62.8,3589,1386,2203,62.9
'33040, 청주시,'085002, 81세,2019,3187,1143,2044,55.9,3179,1142,2037,56.1
'33040, 청주시,'085003, 82세,2019,2998,1062,1936,54.9,2988,1059,1929,54.9
'33040, 청주시,'085004, 83세,2019,2821,946,1875,50.5,2817,945,1872,50.5
'33040, 청주시,'085005, 84세,2019,2587,859,1728,49.7,2582,858,1724,49.8
'33040, 청주시,'086,85세이상,2019,10195,2533,7662,33.1,10175,2524,7651,33
'33040, 청주시,'090,85~89세,2019,7130,1934,5196,37.2,7116,1927,5189,37.1
'33040, 청주시,'090001, 85세,2019,1986,607,1379,44,1982,603,1379,43.7
'33040, 청주시,'090002, 86세,2019,1741,505,1236,40.9,1739,505,1234,40.9
'33040, 청주시,'090003, 87세,2019,1447,372,1075,34.6,1444,371,1073,34.6
'33040, 청주시,'090004, 88세,2019,974,230,744,30.9,971,229,742,30.9
'33040, 청주시,'090005, 89세,2019,982,220,762,28.9,980,219,761,28.8
'33040, 청주시,'095,90~94세,2019,2467,498,1969,25.3,2464,497,1967,25.3
'33040, 청주시,'095001, 90세,2019,815,164,651,25.2,813,164,649,25.3
'33040, 청주시,'095002, 91세,2019,602,140,462,30.3,602,140,462,30.3
'33040, 청주시,'095003, 92세,2019,490,103,387,26.6,490,103,387,26.6
'33040, 청주시,'095004, 93세,2019,287,49,238,20.6,286,48,238,20.2
'33040, 청주시,'095005, 94세,2019,273,42,231,18.2,273,42,231,18.2
'33040, 청주시,'100,95~99세,2019,539,96,443,21.7,536,95,441,21.5
'33040, 청주시,'100001, 95세,2019,160,29,131,22.1,158,28,130,21.5
'33040, 청주시,'100002, 96세,2019,150,29,121,24,150,29,121,24
'33040, 청주시,'100003, 97세,2019,116,18,98,18.4,116,18,98,18.4
'33040, 청주시,'100004, 98세,2019,78,17,61,27.9,78,17,61,27.9
'33040, 청주시,'100005, 99세,2019,35,X,32,9.4,34,X,31,9.7
'33040, 청주시,'101,100세이상,2019,59,5,54,9.3,59,5,54,9.3
'33040, 청주시,'102,15세미만,2019,118246,60598,57648,105.1,117096,60020,57076,105.2
'33040, 청주시,'103,15~64세,2019,627533,324079,303454,106.8,608443,313522,294921,106.3
'33040, 청주시,'104,65세이상,2019,105159,44695,60464,73.9,104556,44437,60119,73.9
'33040, 청주시,'126,평균연령,2019,40.3,39.1,41.5,,40.4,39.2,41.6,
'33040, 청주시,'127,중위연령,2019,40.6,39.2,42.1,,40.8,39.5,42.4,
'33041, 상당구,'000,합계,2019,173783,86676,87107,99.5,172165,85947,86218,99.7
'33041, 상당구,'005,0~4세,2019,6187,3106,3081,100.8,6173,3099,3074,100.8
'33041, 상당구,'005001, 0세,2019,897,455,442,102.9,895,453,442,102.5
'33041, 상당구,'005002, 1세,2019,1110,549,561,97.9,1108,547,561,97.5
'33041, 상당구,'005003, 2세,2019,1238,601,637,94.3,1233,600,633,94.8
'33041, 상당구,'005004, 3세,2019,1394,711,683,104.1,1391,710,681,104.3
'33041, 상당구,'005005, 4세,2019,1548,790,758,104.2,1546,789,757,104.2
'33041, 상당구,'010,5~9세,2019,8476,4377,4099,106.8,8459,4368,4091,106.8
'33041, 상당구,'010001, 5세,2019,1532,767,765,100.3,1531,767,764,100.4
'33041, 상당구,'010002, 6세,2019,1658,862,796,108.3,1656,860,796,108
'33041, 상당구,'010003, 7세,2019,1785,919,866,106.1,1781,917,864,106.1
'33041, 상당구,'010004, 8세,2019,1763,891,872,102.2,1758,889,869,102.3
'33041, 상당구,'010005, 9세,2019,1738,938,800,117.3,1733,935,798,117.2
'33041, 상당구,'015,10~14세,2019,8466,4377,4089,107,8453,4369,4084,107
'33041, 상당구,'015001, 10세,2019,1621,866,755,114.7,1619,865,754,114.7
'33041, 상당구,'015002, 11세,2019,1700,869,831,104.6,1698,868,830,104.6
'33041, 상당구,'015003, 12세,2019,1852,971,881,110.2,1849,969,880,110.1
'33041, 상당구,'015004, 13세,2019,1639,819,820,99.9,1636,816,820,99.5
'33041, 상당구,'015005, 14세,2019,1654,852,802,106.2,1651,851,800,106.4
'33041, 상당구,'020,15~19세,2019,10198,5480,4718,116.2,10182,5474,4708,116.3
'33041, 상당구,'020001, 15세,2019,1929,1002,927,108.1,1926,1001,925,108.2
'33041, 상당구,'020002, 16세,2019,2012,1062,950,111.8,2011,1061,950,111.7
'33041, 상당구,'020003, 17세,2019,2167,1194,973,122.7,2162,1192,970,122.9
'33041, 상당구,'020004, 18세,2019,2180,1171,1009,116.1,2178,1171,1007,116.3
'33041, 상당구,'020005, 19세,2019,1910,1051,859,122.4,1905,1049,856,122.5
'33041, 상당구,'025,20~24세,2019,11025,6090,4935,123.4,10890,6020,4870,123.6
'33041, 상당구,'025001, 20세,2019,2004,1164,840,138.6,1991,1157,834,138.7
'33041, 상당구,'025002, 21세,2019,2201,1246,955,130.5,2180,1237,943,131.2
'33041, 상당구,'025003, 22세,2019,2216,1176,1040,113.1,2186,1161,1025,113.3
'33041, 상당구,'025004, 23세,2019,2310,1264,1046,120.8,2281,1246,1035,120.4
'33041, 상당구,'025005, 24세,2019,2294,1240,1054,117.6,2252,1219,1033,118
'33041, 상당구,'030,25~29세,2019,10484,5725,4759,120.3,10248,5616,4632,121.2
'33041, 상당구,'030001, 25세,2019,2337,1306,1031,126.7,2303,1291,1012,127.6
'33041, 상당구,'030002, 26세,2019,2268,1241,1027,120.8,2222,1222,1000,122.2
'33041, 상당구,'030003, 27세,2019,2123,1134,989,114.7,2071,1112,959,116
'33041, 상당구,'030004, 28세,2019,1934,1051,883,119,1890,1027,863,119
'33041, 상당구,'030005, 29세,2019,1822,993,829,119.8,1762,964,798,120.8
'33041, 상당구,'035,30~34세,2019,8792,4557,4235,107.6,8533,4427,4106,107.8
'33041, 상당구,'035001, 30세,2019,1646,855,791,108.1,1596,822,774,106.2
'33041, 상당구,'035002, 31세,2019,1719,884,835,105.9,1650,851,799,106.5
'33041, 상당구,'035003, 32세,2019,1748,908,840,108.1,1693,878,815,107.7
'33041, 상당구,'035004, 33세,2019,1776,934,842,110.9,1734,918,816,112.5
'33041, 상당구,'035005, 34세,2019,1903,976,927,105.3,1860,958,902,106.2
'33041, 상당구,'040,35~39세,2019,11879,5971,5908,101.1,11698,5892,5806,101.5
'33041, 상당구,'040001, 35세,2019,1990,1032,958,107.7,1952,1014,938,108.1
'33041, 상당구,'040002, 36세,2019,2233,1081,1152,93.8,2199,1068,1131,94.4
'33041, 상당구,'040003, 37세,2019,2535,1277,1258,101.5,2495,1258,1237,101.7
'33041, 상당구,'040004, 38세,2019,2451,1236,1215,101.7,2412,1221,1191,102.5
'33041, 상당구,'040005, 39세,2019,2670,1345,1325,101.5,2640,1331,1309,101.7
'33041, 상당구,'045,40~44세,2019,12730,6298,6432,97.9,12597,6249,6348,98.4
'33041, 상당구,'045001, 40세,2019,2527,1292,1235,104.6,2502,1282,1220,105.1
'33041, 상당구,'045002, 41세,2019,2387,1152,1235,93.3,2363,1141,1222,93.4
'33041, 상당구,'045003, 42세,2019,2598,1280,1318,97.1,2570,1269,1301,97.5
'33041, 상당구,'045004, 43세,2019,2507,1251,1256,99.6,2477,1241,1236,100.4
'33041, 상당구,'045005, 44세,2019,2711,1323,1388,95.3,2685,1316,1369,96.1
'33041, 상당구,'050,45~49세,2019,15453,7665,7788,98.4,15307,7606,7701,98.8
'33041, 상당구,'050001, 45세,2019,3045,1499,1546,97,3023,1490,1533,97.2
'33041, 상당구,'050002, 46세,2019,3115,1509,1606,94,3071,1493,1578,94.6
'33041, 상당구,'050003, 47세,2019,2957,1499,1458,102.8,2935,1489,1446,103
'33041, 상당구,'050004, 48세,2019,3257,1621,1636,99.1,3227,1611,1616,99.7
'33041, 상당구,'050005, 49세,2019,3079,1537,1542,99.7,3051,1523,1528,99.7
'33041, 상당구,'055,50~54세,2019,16020,7862,8158,96.4,15865,7797,8068,96.6
'33041, 상당구,'055001, 50세,2019,3384,1623,1761,92.2,3356,1607,1749,91.9
'33041, 상당구,'055002, 51세,2019,3316,1590,1726,92.1,3279,1571,1708,92
'33041, 상당구,'055003, 52세,2019,3127,1546,1581,97.8,3095,1534,1561,98.3
'33041, 상당구,'055004, 53세,2019,3081,1549,1532,101.1,3053,1541,1512,101.9
'33041, 상당구,'055005, 54세,2019,3112,1554,1558,99.7,3082,1544,1538,100.4
'33041, 상당구,'060,55~59세,2019,14935,7624,7311,104.3,14808,7564,7244,104.4
'33041, 상당구,'060001, 55세,2019,2684,1358,1326,102.4,2661,1348,1313,102.7
'33041, 상당구,'060002, 56세,2019,2873,1497,1376,108.8,2831,1478,1353,109.2
'33041, 상당구,'060003, 57세,2019,3001,1561,1440,108.4,2974,1547,1427,108.4
'33041, 상당구,'060004, 58세,2019,3399,1718,1681,102.2,3380,1707,1673,102
'33041, 상당구,'060005, 59세,2019,2978,1490,1488,100.1,2962,1484,1478,100.4
'33041, 상당구,'065,60~64세,2019,12645,6253,6392,97.8,12548,6204,6344,97.8
'33041, 상당구,'065001, 60세,2019,2678,1302,1376,94.6,2657,1294,1363,94.9
'33041, 상당구,'065002, 61세,2019,2668,1339,1329,100.8,2643,1326,1317,100.7
'33041, 상당구,'065003, 62세,2019,2702,1373,1329,103.3,2682,1361,1321,103
'33041, 상당구,'065004, 63세,2019,2293,1145,1148,99.7,2277,1138,1139,99.9
'33041, 상당구,'065005, 64세,2019,2304,1094,1210,90.4,2289,1085,1204,90.1
'33041, 상당구,'070,65~69세,2019,8299,4104,4195,97.8,8252,4087,4165,98.1
'33041, 상당구,'070001, 65세,2019,2047,1057,990,106.8,2035,1051,984,106.8
'33041, 상당구,'070002, 66세,2019,1756,857,899,95.3,1745,851,894,95.2
'33041, 상당구,'070003, 67세,2019,1928,934,994,94,1917,931,986,94.4
'33041, 상당구,'070004, 68세,2019,1251,620,631,98.3,1246,618,628,98.4
'33041, 상당구,'070005, 69세,2019,1317,636,681,93.4,1309,636,673,94.5
'33041, 상당구,'075,70~74세,2019,6181,2890,3291,87.8,6158,2882,3276,88
'33041, 상당구,'075001, 70세,2019,1376,674,702,96,1370,672,698,96.3
'33041, 상당구,'075002, 71세,2019,1401,648,753,86.1,1394,646,748,86.4
'33041, 상당구,'075003, 72세,2019,1357,631,726,86.9,1352,629,723,87
'33041, 상당구,'075004, 73세,2019,975,457,518,88.2,973,456,517,88.2
'33041, 상당구,'075005, 74세,2019,1072,480,592,81.1,1069,479,590,81.2
'33041, 상당구,'080,75~79세,2019,5489,2230,3259,68.4,5478,2228,3250,68.6
'33041, 상당구,'080001, 75세,2019,1071,436,635,68.7,1069,435,634,68.6
'33041, 상당구,'080002, 76세,2019,1110,473,637,74.3,1108,472,636,74.2
'33041, 상당구,'080003, 77세,2019,1365,551,814,67.7,1361,551,810,68
'33041, 상당구,'080004, 78세,2019,1033,424,609,69.6,1031,424,607,69.9
'33041, 상당구,'080005, 79세,2019,910,346,564,61.3,909,346,563,61.5
'33041, 상당구,'085,80~84세,2019,3948,1401,2547,55,3942,1400,2542,55.1
'33041, 상당구,'085001, 80세,2019,912,369,543,68,911,369,542,68.1
'33041, 상당구,'085002, 81세,2019,818,284,534,53.2,816,284,532,53.4
'33041, 상당구,'085003, 82세,2019,803,265,538,49.3,800,264,536,49.3
'33041, 상당구,'085004, 83세,2019,741,256,485,52.8,741,256,485,52.8
'33041, 상당구,'085005, 84세,2019,674,227,447,50.8,674,227,447,50.8
'33041, 상당구,'086,85세이상,2019,2576,666,1910,34.9,2574,665,1909,34.8
'33041, 상당구,'090,85~89세,2019,1792,487,1305,37.3,1790,486,1304,37.3
'33041, 상당구,'090001, 85세,2019,519,162,357,45.4,518,161,357,45.1
'33041, 상당구,'090002, 86세,2019,420,118,302,39.1,420,118,302,39.1
'33041, 상당구,'090003, 87세,2019,365,95,270,35.2,365,95,270,35.2
'33041, 상당구,'090004, 88세,2019,222,49,173,28.3,221,49,172,28.5
'33041, 상당구,'090005, 89세,2019,266,63,203,31,266,63,203,31
'33041, 상당구,'095,90~94세,2019,644,152,492,30.9,644,152,492,30.9
'33041, 상당구,'095001, 90세,2019,228,53,175,30.3,228,53,175,30.3
'33041, 상당구,'095002, 91세,2019,165,45,120,37.5,165,45,120,37.5
'33041, 상당구,'095003, 92세,2019,126,33,93,35.5,126,33,93,35.5
'33041, 상당구,'095004, 93세,2019,80,13,67,19.4,80,13,67,19.4
'33041, 상당구,'095005, 94세,2019,45,8,37,21.6,45,8,37,21.6
'33041, 상당구,'100,95~99세,2019,127,27,100,27,127,27,100,27
'33041, 상당구,'100001, 95세,2019,41,X,38,7.9,41,X,38,7.9
'33041, 상당구,'100002, 96세,2019,29,8,21,38.1,29,8,21,38.1
'33041, 상당구,'100003, 97세,2019,29,6,23,26.1,29,6,23,26.1
'33041, 상당구,'100004, 98세,2019,22,9,13,69.2,22,9,13,69.2
'33041, 상당구,'100005, 99세,2019,6,X,5,20,6,X,5,20
'33041, 상당구,'101,100세이상,2019,13,X,13,0,13,X,13,0
'33041, 상당구,'102,15세미만,2019,23129,11860,11269,105.2,23085,11836,11249,105.2
'33041, 상당구,'103,15~64세,2019,124161,63525,60636,104.8,122676,62849,59827,105.1
'33041, 상당구,'104,65세이상,2019,26493,11291,15202,74.3,26404,11262,15142,74.4
'33041, 상당구,'126,평균연령,2019,42.5,41.1,43.8,,42.5,41.1,43.9,
'33041, 상당구,'127,중위연령,2019,44.5,42.9,45.8,,44.6,43,45.9,
'33042, 서원구,'000,합계,2019,210273,104590,105683,99,205407,102101,103306,98.8
'33042, 서원구,'005,0~4세,2019,6943,3558,3385,105.1,6821,3501,3320,105.5
'33042, 서원구,'005001, 0세,2019,1103,569,534,106.6,1080,561,519,108.1
'33042, 서원구,'005002, 1세,2019,1306,671,635,105.7,1284,659,625,105.4
'33042, 서원구,'005003, 2세,2019,1382,723,659,109.7,1357,710,647,109.7
'33042, 서원구,'005004, 3세,2019,1509,749,760,98.6,1483,734,749,98
'33042, 서원구,'005005, 4세,2019,1643,846,797,106.1,1617,837,780,107.3
'33042, 서원구,'010,5~9세,2019,9161,4591,4570,100.5,9051,4538,4513,100.6
'33042, 서원구,'010001, 5세,2019,1641,813,828,98.2,1607,799,808,98.9
'33042, 서원구,'010002, 6세,2019,1697,823,874,94.2,1677,813,864,94.1
'33042, 서원구,'010003, 7세,2019,1963,1015,948,107.1,1941,1006,935,107.6
'33042, 서원구,'010004, 8세,2019,1957,964,993,97.1,1945,957,988,96.9
'33042, 서원구,'010005, 9세,2019,1903,976,927,105.3,1881,963,918,104.9
'33042, 서원구,'015,10~14세,2019,9931,5143,4788,107.4,9852,5103,4749,107.5
'33042, 서원구,'015001, 10세,2019,1867,985,882,111.7,1847,976,871,112.1
'33042, 서원구,'015002, 11세,2019,2040,1040,1000,104,2025,1031,994,103.7
'33042, 서원구,'015003, 12세,2019,2055,1085,970,111.9,2040,1077,963,111.8
'33042, 서원구,'015004, 13세,2019,1984,1017,967,105.2,1970,1008,962,104.8
'33042, 서원구,'015005, 14세,2019,1985,1016,969,104.9,1970,1011,959,105.4
'33042, 서원구,'020,15~19세,2019,13163,6913,6250,110.6,12997,6824,6173,110.5
'33042, 서원구,'020001, 15세,2019,2081,1109,972,114.1,2071,1106,965,114.6
'33042, 서원구,'020002, 16세,2019,2160,1124,1036,108.5,2148,1115,1033,107.9
'33042, 서원구,'020003, 17세,2019,2148,1133,1015,111.6,2135,1126,1009,111.6
'33042, 서원구,'020004, 18세,2019,2882,1481,1401,105.7,2844,1462,1382,105.8
'33042, 서원구,'020005, 19세,2019,3892,2066,1826,113.1,3799,2015,1784,112.9
'33042, 서원구,'025,20~24세,2019,19424,10223,9201,111.1,18632,9843,8789,112
'33042, 서원구,'025001, 20세,2019,3772,1848,1924,96,3654,1798,1856,96.9
'33042, 서원구,'025002, 21세,2019,3833,1835,1998,91.8,3674,1766,1908,92.6
'33042, 서원구,'025003, 22세,2019,4019,2043,1976,103.4,3837,1955,1882,103.9
'33042, 서원구,'025004, 23세,2019,4037,2303,1734,132.8,3867,2215,1652,134.1
'33042, 서원구,'025005, 24세,2019,3763,2194,1569,139.8,3600,2109,1491,141.4
'33042, 서원구,'030,25~29세,2019,14980,8480,6500,130.5,14318,8120,6198,131
'33042, 서원구,'030001, 25세,2019,3538,2095,1443,145.2,3407,2022,1385,146
'33042, 서원구,'030002, 26세,2019,3176,1781,1395,127.7,3036,1717,1319,130.2
'33042, 서원구,'030003, 27세,2019,3060,1765,1295,136.3,2926,1689,1237,136.5
'33042, 서원구,'030004, 28세,2019,2724,1481,1243,119.1,2611,1419,1192,119
'33042, 서원구,'030005, 29세,2019,2482,1358,1124,120.8,2338,1273,1065,119.5
'33042, 서원구,'035,30~34세,2019,11744,6156,5588,110.2,11054,5782,5272,109.7
'33042, 서원구,'035001, 30세,2019,2389,1279,1110,115.2,2241,1208,1033,116.9
'33042, 서원구,'035002, 31세,2019,2318,1224,1094,111.9,2181,1146,1035,110.7
'33042, 서원구,'035003, 32세,2019,2366,1216,1150,105.7,2225,1129,1096,103
'33042, 서원구,'035004, 33세,2019,2311,1227,1084,113.2,2175,1151,1024,112.4
'33042, 서원구,'035005, 34세,2019,2360,1210,1150,105.2,2232,1148,1084,105.9
'33042, 서원구,'040,35~39세,2019,14170,7147,7023,101.8,13605,6830,6775,100.8
'33042, 서원구,'040001, 35세,2019,2484,1286,1198,107.3,2379,1225,1154,106.2
'33042, 서원구,'040002, 36세,2019,2717,1360,1357,100.2,2573,1281,1292,99.1
'33042, 서원구,'040003, 37세,2019,2964,1488,1476,100.8,2866,1435,1431,100.3
'33042, 서원구,'040004, 38세,2019,2986,1510,1476,102.3,2869,1443,1426,101.2
'33042, 서원구,'040005, 39세,2019,3019,1503,1516,99.1,2918,1446,1472,98.2
'33042, 서원구,'045,40~44세,2019,14902,7342,7560,97.1,14502,7129,7373,96.7
'33042, 서원구,'045001, 40세,2019,2953,1462,1491,98.1,2874,1417,1457,97.3
'33042, 서원구,'045002, 41세,2019,2807,1393,1414,98.5,2717,1345,1372,98
'33042, 서원구,'045003, 42세,2019,2967,1483,1484,99.9,2880,1436,1444,99.4
'33042, 서원구,'045004, 43세,2019,3003,1476,1527,96.7,2938,1448,1490,97.2
'33042, 서원구,'045005, 44세,2019,3172,1528,1644,92.9,3093,1483,1610,92.1
'33042, 서원구,'050,45~49세,2019,18109,8833,9276,95.2,17732,8649,9083,95.2
'33042, 서원구,'050001, 45세,2019,3571,1768,1803,98.1,3490,1733,1757,98.6
'33042, 서원구,'050002, 46세,2019,3611,1701,1910,89.1,3541,1669,1872,89.2
'33042, 서원구,'050003, 47세,2019,3454,1697,1757,96.6,3382,1666,1716,97.1
'33042, 서원구,'050004, 48세,2019,3796,1877,1919,97.8,3722,1837,1885,97.5
'33042, 서원구,'050005, 49세,2019,3677,1790,1887,94.9,3597,1744,1853,94.1
'33042, 서원구,'055,50~54세,2019,18374,8963,9411,95.2,18071,8811,9260,95.2
'33042, 서원구,'055001, 50세,2019,4025,1920,2105,91.2,3960,1892,2068,91.5
'33042, 서원구,'055002, 51세,2019,3876,1829,2047,89.4,3814,1801,2013,89.5
'33042, 서원구,'055003, 52세,2019,3685,1799,1886,95.4,3628,1772,1856,95.5
'33042, 서원구,'055004, 53세,2019,3348,1675,1673,100.1,3289,1642,1647,99.7
'33042, 서원구,'055005, 54세,2019,3440,1740,1700,102.4,3380,1704,1676,101.7
'33042, 서원구,'060,55~59세,2019,17054,8442,8612,98,16763,8304,8459,98.2
'33042, 서원구,'060001, 55세,2019,2956,1430,1526,93.7,2897,1411,1486,95
'33042, 서원구,'060002, 56세,2019,3246,1661,1585,104.8,3178,1621,1557,104.1
'33042, 서원구,'060003, 57세,2019,3450,1728,1722,100.3,3395,1704,1691,100.8
'33042, 서원구,'060004, 58세,2019,3944,1965,1979,99.3,3895,1943,1952,99.5
'33042, 서원구,'060005, 59세,2019,3458,1658,1800,92.1,3398,1625,1773,91.7
'33042, 서원구,'065,60~64세,2019,14420,7045,7375,95.5,14248,6966,7282,95.7
'33042, 서원구,'065001, 60세,2019,3150,1485,1665,89.2,3115,1471,1644,89.5
'33042, 서원구,'065002, 61세,2019,3058,1520,1538,98.8,3003,1498,1505,99.5
'33042, 서원구,'065003, 62세,2019,3017,1501,1516,99,2987,1485,1502,98.9
'33042, 서원구,'065004, 63세,2019,2655,1324,1331,99.5,2630,1309,1321,99.1
'33042, 서원구,'065005, 64세,2019,2540,1215,1325,91.7,2513,1203,1310,91.8
'33042, 서원구,'070,65~69세,2019,9024,4280,4744,90.2,8951,4250,4701,90.4
'33042, 서원구,'070001, 65세,2019,2229,1115,1114,100.1,2198,1101,1097,100.4
'33042, 서원구,'070002, 66세,2019,1870,858,1012,84.8,1857,851,1006,84.6
'33042, 서원구,'070003, 67세,2019,2052,995,1057,94.1,2044,994,1050,94.7
'33042, 서원구,'070004, 68세,2019,1369,629,740,85,1358,625,733,85.3
'33042, 서원구,'070005, 69세,2019,1504,683,821,83.2,1494,679,815,83.3
'33042, 서원구,'075,70~74세,2019,6592,3051,3541,86.2,6554,3038,3516,86.4
'33042, 서원구,'075001, 70세,2019,1487,689,798,86.3,1474,685,789,86.8
'33042, 서원구,'075002, 71세,2019,1498,697,801,87,1486,694,792,87.6
'33042, 서원구,'075003, 72세,2019,1420,642,778,82.5,1414,640,774,82.7
'33042, 서원구,'075004, 73세,2019,1084,512,572,89.5,1080,510,570,89.5
'33042, 서원구,'075005, 74세,2019,1103,511,592,86.3,1100,509,591,86.1
'33042, 서원구,'080,75~79세,2019,5603,2319,3284,70.6,5588,2313,3275,70.6
'33042, 서원구,'080001, 75세,2019,1140,504,636,79.2,1137,502,635,79.1
'33042, 서원구,'080002, 76세,2019,1126,473,653,72.4,1125,472,653,72.3
'33042, 서원구,'080003, 77세,2019,1335,563,772,72.9,1331,561,770,72.9
'33042, 서원구,'080004, 78세,2019,1055,405,650,62.3,1051,405,646,62.7
'33042, 서원구,'080005, 79세,2019,947,374,573,65.3,944,373,571,65.3
'33042, 서원구,'085,80~84세,2019,3987,1460,2527,57.8,3978,1456,2522,57.7
'33042, 서원구,'085001, 80세,2019,921,356,565,63,921,356,565,63
'33042, 서원구,'085002, 81세,2019,843,319,524,60.9,840,318,522,60.9
'33042, 서원구,'085003, 82세,2019,816,303,513,59.1,812,301,511,58.9
'33042, 서원구,'085004, 83세,2019,726,257,469,54.8,726,257,469,54.8
'33042, 서원구,'085005, 84세,2019,681,225,456,49.3,679,224,455,49.2
'33042, 서원구,'086,85세이상,2019,2692,644,2048,31.4,2690,644,2046,31.5
'33042, 서원구,'090,85~89세,2019,1860,493,1367,36.1,1858,493,1365,36.1
'33042, 서원구,'090001, 85세,2019,507,146,361,40.4,507,146,361,40.4
'33042, 서원구,'090002, 86세,2019,467,140,327,42.8,466,140,326,42.9
'33042, 서원구,'090003, 87세,2019,363,88,275,32,363,88,275,32
'33042, 서원구,'090004, 88세,2019,275,58,217,26.7,274,58,216,26.9
'33042, 서원구,'090005, 89세,2019,248,61,187,32.6,248,61,187,32.6
'33042, 서원구,'095,90~94세,2019,673,130,543,23.9,673,130,543,23.9
'33042, 서원구,'095001, 90세,2019,188,34,154,22.1,188,34,154,22.1
'33042, 서원구,'095002, 91세,2019,148,36,112,32.1,148,36,112,32.1
'33042, 서원구,'095003, 92세,2019,156,28,128,21.9,156,28,128,21.9
'33042, 서원구,'095004, 93세,2019,89,18,71,25.4,89,18,71,25.4
'33042, 서원구,'095005, 94세,2019,92,14,78,17.9,92,14,78,17.9
'33042, 서원구,'100,95~99세,2019,145,20,125,16,145,20,125,16
'33042, 서원구,'100001, 95세,2019,44,8,36,22.2,44,8,36,22.2
'33042, 서원구,'100002, 96세,2019,39,6,33,18.2,39,6,33,18.2
'33042, 서원구,'100003, 97세,2019,32,X,29,10.3,32,X,29,10.3
'33042, 서원구,'100004, 98세,2019,21,X,19,10.5,21,X,19,10.5
'33042, 서원구,'100005, 99세,2019,9,X,8,12.5,9,X,8,12.5
'33042, 서원구,'101,100세이상,2019,14,X,13,7.7,14,X,13,7.7
'33042, 서원구,'102,15세미만,2019,26035,13292,12743,104.3,25724,13142,12582,104.5
'33042, 서원구,'103,15~64세,2019,156340,79544,76796,103.6,151922,77258,74664,103.5
'33042, 서원구,'104,65세이상,2019,27898,11754,16144,72.8,27761,11701,16060,72.9
'33042, 서원구,'126,평균연령,2019,41.1,39.7,42.4,,41.2,39.8,42.5,
'33042, 서원구,'127,중위연령,2019,42,40.1,43.8,,42.3,40.4,44.1,
'33043, 흥덕구,'000,합계,2019,266301,135116,131185,103,258149,130585,127564,102.4
'33043, 흥덕구,'005,0~4세,2019,11605,5950,5655,105.2,11329,5803,5526,105
'33043, 흥덕구,'005001, 0세,2019,1986,998,988,101,1931,970,961,100.9
'33043, 흥덕구,'005002, 1세,2019,2235,1142,1093,104.5,2174,1107,1067,103.7
'33043, 흥덕구,'005003, 2세,2019,2352,1219,1133,107.6,2306,1189,1117,106.4
'33043, 흥덕구,'005004, 3세,2019,2448,1248,1200,104,2390,1223,1167,104.8
'33043, 흥덕구,'005005, 4세,2019,2584,1343,1241,108.2,2528,1314,1214,108.2
'33043, 흥덕구,'010,5~9세,2019,13208,6729,6479,103.9,13012,6624,6388,103.7
'33043, 흥덕구,'010001, 5세,2019,2553,1281,1272,100.7,2502,1253,1249,100.3
'33043, 흥덕구,'010002, 6세,2019,2577,1339,1238,108.2,2543,1321,1222,108.1
'33043, 흥덕구,'010003, 7세,2019,2714,1371,1343,102.1,2667,1347,1320,102
'33043, 흥덕구,'010004, 8세,2019,2736,1396,1340,104.2,2697,1373,1324,103.7
'33043, 흥덕구,'010005, 9세,2019,2628,1342,1286,104.4,2603,1330,1273,104.5
'33043, 흥덕구,'015,10~14세,2019,12545,6505,6040,107.7,12414,6435,5979,107.6
'33043, 흥덕구,'015001, 10세,2019,2567,1322,1245,106.2,2535,1303,1232,105.8
'33043, 흥덕구,'015002, 11세,2019,2587,1372,1215,112.9,2567,1364,1203,113.4
'33043, 흥덕구,'015003, 12세,2019,2590,1348,1242,108.5,2564,1336,1228,108.8
'33043, 흥덕구,'015004, 13세,2019,2447,1266,1181,107.2,2418,1249,1169,106.8
'33043, 흥덕구,'015005, 14세,2019,2354,1197,1157,103.5,2330,1183,1147,103.1
'33043, 흥덕구,'020,15~19세,2019,14242,7517,6725,111.8,14071,7437,6634,112.1
'33043, 흥덕구,'020001, 15세,2019,2649,1425,1224,116.4,2631,1415,1216,116.4
'33043, 흥덕구,'020002, 16세,2019,2605,1387,1218,113.9,2583,1378,1205,114.4
'33043, 흥덕구,'020003, 17세,2019,2642,1394,1248,111.7,2622,1384,1238,111.8
'33043, 흥덕구,'020004, 18세,2019,3009,1581,1428,110.7,2973,1559,1414,110.3
'33043, 흥덕구,'020005, 19세,2019,3337,1730,1607,107.7,3262,1701,1561,109
'33043, 흥덕구,'025,20~24세,2019,19467,10144,9323,108.8,18628,9667,8961,107.9
'33043, 흥덕구,'025001, 20세,2019,3502,1846,1656,111.5,3396,1788,1608,111.2
'33043, 흥덕구,'025002, 21세,2019,3674,1881,1793,104.9,3554,1810,1744,103.8
'33043, 흥덕구,'025003, 22세,2019,3865,1973,1892,104.3,3702,1893,1809,104.6
'33043, 흥덕구,'025004, 23세,2019,4176,2200,1976,111.3,3961,2069,1892,109.4
'33043, 흥덕구,'025005, 24세,2019,4250,2244,2006,111.9,4015,2107,1908,110.4
'33043, 흥덕구,'030,25~29세,2019,22728,12518,10210,122.6,21457,11801,9656,122.2
'33043, 흥덕구,'030001, 25세,2019,4542,2484,2058,120.7,4287,2344,1943,120.6
'33043, 흥덕구,'030002, 26세,2019,4745,2656,2089,127.1,4510,2513,1997,125.8
'33043, 흥덕구,'030003, 27세,2019,4664,2587,2077,124.6,4440,2472,1968,125.6
'33043, 흥덕구,'030004, 28세,2019,4387,2397,1990,120.5,4133,2253,1880,119.8
'33043, 흥덕구,'030005, 29세,2019,4390,2394,1996,119.9,4087,2219,1868,118.8
'33043, 흥덕구,'035,30~34세,2019,20291,10738,9553,112.4,18971,9982,8989,111
'33043, 흥덕구,'035001, 30세,2019,4201,2255,1946,115.9,3933,2086,1847,112.9
'33043, 흥덕구,'035002, 31세,2019,4072,2127,1945,109.4,3786,1960,1826,107.3
'33043, 흥덕구,'035003, 32세,2019,3996,2119,1877,112.9,3731,1974,1757,112.4
'33043, 흥덕구,'035004, 33세,2019,4081,2163,1918,112.8,3825,2011,1814,110.9
'33043, 흥덕구,'035005, 34세,2019,3941,2074,1867,111.1,3696,1951,1745,111.8
'33043, 흥덕구,'040,35~39세,2019,22416,11642,10774,108.1,21451,11060,10391,106.4
'33043, 흥덕구,'040001, 35세,2019,4130,2155,1975,109.1,3936,2046,1890,108.3
'33043, 흥덕구,'040002, 36세,2019,4522,2363,2159,109.4,4293,2217,2076,106.8
'33043, 흥덕구,'040003, 37세,2019,4879,2487,2392,104,4678,2358,2320,101.6
'33043, 흥덕구,'040004, 38세,2019,4372,2325,2047,113.6,4180,2214,1966,112.6
'33043, 흥덕구,'040005, 39세,2019,4513,2312,2201,105,4364,2225,2139,104
'33043, 흥덕구,'045,40~44세,2019,20788,10577,10211,103.6,20034,10141,9893,102.5
'33043, 흥덕구,'045001, 40세,2019,4376,2260,2116,106.8,4184,2143,2041,105
'33043, 흥덕구,'045002, 41세,2019,4025,2103,1922,109.4,3857,1997,1860,107.4
'33043, 흥덕구,'045003, 42세,2019,4101,2031,2070,98.1,3960,1952,2008,97.2
'33043, 흥덕구,'045004, 43세,2019,4022,2038,1984,102.7,3888,1964,1924,102.1
'33043, 흥덕구,'045005, 44세,2019,4264,2145,2119,101.2,4145,2085,2060,101.2
'33043, 흥덕구,'050,45~49세,2019,22848,11540,11308,102.1,22207,11176,11031,101.3
'33043, 흥덕구,'050001, 45세,2019,4538,2226,2312,96.3,4423,2162,2261,95.6
'33043, 흥덕구,'050002, 46세,2019,4619,2328,2291,101.6,4504,2264,2240,101.1
'33043, 흥덕구,'050003, 47세,2019,4268,2180,2088,104.4,4143,2112,2031,104
'33043, 흥덕구,'050004, 48세,2019,4726,2445,2281,107.2,4587,2365,2222,106.4
'33043, 흥덕구,'050005, 49세,2019,4697,2361,2336,101.1,4550,2273,2277,99.8
'33043, 흥덕구,'055,50~54세,2019,22486,11123,11363,97.9,21942,10827,11115,97.4
'33043, 흥덕구,'055001, 50세,2019,5008,2483,2525,98.3,4877,2414,2463,98
'33043, 흥덕구,'055002, 51세,2019,4775,2315,2460,94.1,4638,2248,2390,94.1
'33043, 흥덕구,'055003, 52세,2019,4205,2145,2060,104.1,4129,2099,2030,103.4
'33043, 흥덕구,'055004, 53세,2019,4153,2056,2097,98,4053,2004,2049,97.8
'33043, 흥덕구,'055005, 54세,2019,4345,2124,2221,95.6,4245,2062,2183,94.5
'33043, 흥덕구,'060,55~59세,2019,20281,10362,9919,104.5,19815,10132,9683,104.6
'33043, 흥덕구,'060001, 55세,2019,3756,1914,1842,103.9,3648,1862,1786,104.3
'33043, 흥덕구,'060002, 56세,2019,3914,2047,1867,109.6,3772,1974,1798,109.8
'33043, 흥덕구,'060003, 57세,2019,4143,2138,2005,106.6,4067,2103,1964,107.1
'33043, 흥덕구,'060004, 58세,2019,4568,2332,2236,104.3,4512,2307,2205,104.6
'33043, 흥덕구,'060005, 59세,2019,3900,1931,1969,98.1,3816,1886,1930,97.7
'33043, 흥덕구,'065,60~64세,2019,15872,7904,7968,99.2,15534,7749,7785,99.5
'33043, 흥덕구,'065001, 60세,2019,3562,1777,1785,99.6,3481,1743,1738,100.3
'33043, 흥덕구,'065002, 61세,2019,3391,1716,1675,102.4,3328,1688,1640,102.9
'33043, 흥덕구,'065003, 62세,2019,3251,1583,1668,94.9,3175,1546,1629,94.9
'33043, 흥덕구,'065004, 63세,2019,2879,1480,1399,105.8,2810,1446,1364,106
'33043, 흥덕구,'065005, 64세,2019,2789,1348,1441,93.5,2740,1326,1414,93.8
'33043, 흥덕구,'070,65~69세,2019,9484,4620,4864,95,9333,4546,4787,95
'33043, 흥덕구,'070001, 65세,2019,2369,1123,1246,90.1,2322,1101,1221,90.2
'33043, 흥덕구,'070002, 66세,2019,1978,997,981,101.6,1941,980,961,102
'33043, 흥덕구,'070003, 67세,2019,2181,1068,1113,96,2159,1058,1101,96.1
'33043, 흥덕구,'070004, 68세,2019,1469,699,770,90.8,1439,683,756,90.3
'33043, 흥덕구,'070005, 69세,2019,1487,733,754,97.2,1472,724,748,96.8
'33043, 흥덕구,'075,70~74세,2019,6488,3143,3345,94,6436,3116,3320,93.9
'33043, 흥덕구,'075001, 70세,2019,1563,781,782,99.9,1547,772,775,99.6
'33043, 흥덕구,'075002, 71세,2019,1441,714,727,98.2,1431,708,723,97.9
'33043, 흥덕구,'075003, 72세,2019,1343,628,715,87.8,1336,624,712,87.6
'33043, 흥덕구,'075004, 73세,2019,1023,492,531,92.7,1014,489,525,93.1
'33043, 흥덕구,'075005, 74세,2019,1118,528,590,89.5,1108,523,585,89.4
'33043, 흥덕구,'080,75~79세,2019,5264,2149,3115,69,5245,2140,3105,68.9
'33043, 흥덕구,'080001, 75세,2019,1046,427,619,69,1041,425,616,69
'33043, 흥덕구,'080002, 76세,2019,1143,473,670,70.6,1138,470,668,70.4
'33043, 흥덕구,'080003, 77세,2019,1229,529,700,75.6,1227,528,699,75.5
'33043, 흥덕구,'080004, 78세,2019,995,385,610,63.1,989,382,607,62.9
'33043, 흥덕구,'080005, 79세,2019,851,335,516,64.9,850,335,515,65
'33043, 흥덕구,'085,80~84세,2019,3776,1326,2450,54.1,3769,1326,2443,54.3
'33043, 흥덕구,'085001, 80세,2019,921,333,588,56.6,919,333,586,56.8
'33043, 흥덕구,'085002, 81세,2019,743,266,477,55.8,741,266,475,56
'33043, 흥덕구,'085003, 82세,2019,712,253,459,55.1,710,253,457,55.4
'33043, 흥덕구,'085004, 83세,2019,717,240,477,50.3,716,240,476,50.4
'33043, 흥덕구,'085005, 84세,2019,683,234,449,52.1,683,234,449,52.1
'33043, 흥덕구,'086,85세이상,2019,2512,629,1883,33.4,2501,623,1878,33.2
'33043, 흥덕구,'090,85~89세,2019,1796,489,1307,37.4,1789,485,1304,37.2
'33043, 흥덕구,'090001, 85세,2019,482,158,324,48.8,480,156,324,48.1
'33043, 흥덕구,'090002, 86세,2019,446,134,312,42.9,445,134,311,43.1
'33043, 흥덕구,'090003, 87세,2019,387,86,301,28.6,384,85,299,28.4
'33043, 흥덕구,'090004, 88세,2019,236,62,174,35.6,235,61,174,35.1
'33043, 흥덕구,'090005, 89세,2019,245,49,196,25,245,49,196,25
'33043, 흥덕구,'095,90~94세,2019,567,112,455,24.6,565,111,454,24.4
'33043, 흥덕구,'095001, 90세,2019,191,37,154,24,190,37,153,24.2
'33043, 흥덕구,'095002, 91세,2019,145,31,114,27.2,145,31,114,27.2
'33043, 흥덕구,'095003, 92세,2019,98,24,74,32.4,98,24,74,32.4
'33043, 흥덕구,'095004, 93세,2019,57,7,50,14,56,6,50,12
'33043, 흥덕구,'095005, 94세,2019,76,13,63,20.6,76,13,63,20.6
'33043, 흥덕구,'100,95~99세,2019,133,27,106,25.5,131,26,105,24.8
'33043, 흥덕구,'100001, 95세,2019,37,10,27,37,35,9,26,34.6
'33043, 흥덕구,'100002, 96세,2019,43,9,34,26.5,43,9,34,26.5
'33043, 흥덕구,'100003, 97세,2019,33,5,28,17.9,33,5,28,17.9
'33043, 흥덕구,'100004, 98세,2019,15,X,12,25,15,X,12,25
'33043, 흥덕구,'100005, 99세,2019,5,X,5,0,5,X,5,0
'33043, 흥덕구,'101,100세이상,2019,16,X,15,6.7,16,X,15,6.7
'33043, 흥덕구,'102,15세미만,2019,37358,19184,18174,105.6,36755,18862,17893,105.4
'33043, 흥덕구,'103,15~64세,2019,201419,104065,97354,106.9,194110,99972,94138,106.2
'33043, 흥덕구,'104,65세이상,2019,27524,11867,15657,75.8,27284,11751,15533,75.7
'33043, 흥덕구,'126,평균연령,2019,39.3,38.3,40.2,,39.4,38.4,40.3,
'33043, 흥덕구,'127,중위연령,2019,39.3,38.2,40.4,,39.5,38.4,40.6,
'33044, 청원구,'000,합계,2019,200581,102990,97591,105.5,194374,99346,95028,104.5
'33044, 청원구,'005,0~4세,2019,10553,5418,5135,105.5,10457,5368,5089,105.5
'33044, 청원구,'005001, 0세,2019,1754,930,824,112.9,1732,921,811,113.6
'33044, 청원구,'005002, 1세,2019,2006,1033,973,106.2,1985,1020,965,105.7
'33044, 청원구,'005003, 2세,2019,2050,1057,993,106.4,2038,1050,988,106.3
'33044, 청원구,'005004, 3세,2019,2383,1200,1183,101.4,2363,1190,1173,101.4
'33044, 청원구,'005005, 4세,2019,2360,1198,1162,103.1,2339,1187,1152,103
'33044, 청원구,'010,5~9세,2019,11306,5749,5557,103.5,11242,5728,5514,103.9
'33044, 청원구,'010001, 5세,2019,2285,1148,1137,101,2264,1141,1123,101.6
'33044, 청원구,'010002, 6세,2019,2255,1156,1099,105.2,2242,1153,1089,105.9
'33044, 청원구,'010003, 7세,2019,2425,1237,1188,104.1,2413,1233,1180,104.5
'33044, 청원구,'010004, 8세,2019,2262,1145,1117,102.5,2250,1140,1110,102.7
'33044, 청원구,'010005, 9세,2019,2079,1063,1016,104.6,2073,1061,1012,104.8
'33044, 청원구,'015,10~14세,2019,9865,5095,4770,106.8,9833,5084,4749,107.1
'33044, 청원구,'015001, 10세,2019,2049,1084,965,112.3,2044,1081,963,112.3
'33044, 청원구,'015002, 11세,2019,2062,1041,1021,102,2054,1038,1016,102.2
'33044, 청원구,'015003, 12세,2019,2141,1064,1077,98.8,2133,1063,1070,99.3
'33044, 청원구,'015004, 13세,2019,1814,952,862,110.4,1812,951,861,110.5
'33044, 청원구,'015005, 14세,2019,1799,954,845,112.9,1790,951,839,113.3
'33044, 청원구,'020,15~19세,2019,10926,5618,5308,105.8,10689,5504,5185,106.2
'33044, 청원구,'020001, 15세,2019,1801,940,861,109.2,1797,938,859,109.2
'33044, 청원구,'020002, 16세,2019,1849,954,895,106.6,1844,951,893,106.5
'33044, 청원구,'020003, 17세,2019,1940,1014,926,109.5,1929,1010,919,109.9
'33044, 청원구,'020004, 18세,2019,2325,1172,1153,101.6,2275,1149,1126,102
'33044, 청원구,'020005, 19세,2019,3011,1538,1473,104.4,2844,1456,1388,104.9
'33044, 청원구,'025,20~24세,2019,13932,7577,6355,119.2,12965,7002,5963,117.4
'33044, 청원구,'025001, 20세,2019,2716,1423,1293,110.1,2523,1325,1198,110.6
'33044, 청원구,'025002, 21세,2019,2601,1350,1251,107.9,2438,1249,1189,105
'33044, 청원구,'025003, 22세,2019,2844,1495,1349,110.8,2661,1391,1270,109.5
'33044, 청원구,'025004, 23세,2019,2831,1620,1211,133.8,2634,1501,1133,132.5
'33044, 청원구,'025005, 24세,2019,2940,1689,1251,135,2709,1536,1173,130.9
'33044, 청원구,'030,25~29세,2019,14775,8540,6235,137,13760,7900,5860,134.8
'33044, 청원구,'030001, 25세,2019,2848,1674,1174,142.6,2644,1552,1092,142.1
'33044, 청원구,'030002, 26세,2019,2992,1728,1264,136.7,2809,1601,1208,132.5
'33044, 청원구,'030003, 27세,2019,3013,1799,1214,148.2,2815,1664,1151,144.6
'33044, 청원구,'030004, 28세,2019,2990,1700,1290,131.8,2768,1566,1202,130.3
'33044, 청원구,'030005, 29세,2019,2932,1639,1293,126.8,2724,1517,1207,125.7
'33044, 청원구,'035,30~34세,2019,15891,8604,7287,118.1,14922,8001,6921,115.6
'33044, 청원구,'035001, 30세,2019,2973,1642,1331,123.4,2771,1514,1257,120.4
'33044, 청원구,'035002, 31세,2019,3079,1677,1402,119.6,2878,1553,1325,117.2
'33044, 청원구,'035003, 32세,2019,3214,1737,1477,117.6,2997,1595,1402,113.8
'33044, 청원구,'035004, 33세,2019,3263,1790,1473,121.5,3094,1685,1409,119.6
'33044, 청원구,'035005, 34세,2019,3362,1758,1604,109.6,3182,1654,1528,108.2
'33044, 청원구,'040,35~39세,2019,18909,10079,8830,114.1,18142,9600,8542,112.4
'33044, 청원구,'040001, 35세,2019,3466,1863,1603,116.2,3285,1756,1529,114.8
'33044, 청원구,'040002, 36세,2019,3749,2012,1737,115.8,3564,1890,1674,112.9
'33044, 청원구,'040003, 37세,2019,4110,2125,1985,107.1,3950,2027,1923,105.4
'33044, 청원구,'040004, 38세,2019,3641,1951,1690,115.4,3516,1870,1646,113.6
'33044, 청원구,'040005, 39세,2019,3943,2128,1815,117.2,3827,2057,1770,116.2
'33044, 청원구,'045,40~44세,2019,16250,8572,7678,111.6,15728,8252,7476,110.4
'33044, 청원구,'045001, 40세,2019,3580,1938,1642,118,3449,1852,1597,116
'33044, 청원구,'045002, 41세,2019,3156,1697,1459,116.3,3060,1645,1415,116.3
'33044, 청원구,'045003, 42세,2019,3236,1706,1530,111.5,3128,1643,1485,110.6
'33044, 청원구,'045004, 43세,2019,3126,1630,1496,109,3034,1568,1466,107
'33044, 청원구,'045005, 44세,2019,3152,1601,1551,103.2,3057,1544,1513,102
'33044, 청원구,'050,45~49세,2019,15545,8162,7383,110.6,15080,7879,7201,109.4
'33044, 청원구,'050001, 45세,2019,3339,1800,1539,117,3266,1755,1511,116.1
'33044, 청원구,'050002, 46세,2019,3174,1652,1522,108.5,3073,1596,1477,108.1
'33044, 청원구,'050003, 47세,2019,2930,1528,1402,109,2827,1465,1362,107.6
'33044, 청원구,'050004, 48세,2019,3207,1662,1545,107.6,3109,1606,1503,106.9
'33044, 청원구,'050005, 49세,2019,2895,1520,1375,110.5,2805,1457,1348,108.1
'33044, 청원구,'055,50~54세,2019,14622,7471,7151,104.5,14202,7240,6962,104
'33044, 청원구,'055001, 50세,2019,3262,1713,1549,110.6,3169,1655,1514,109.3
'33044, 청원구,'055002, 51세,2019,3081,1531,1550,98.8,3000,1486,1514,98.2
'33044, 청원구,'055003, 52세,2019,2780,1419,1361,104.3,2714,1386,1328,104.4
'33044, 청원구,'055004, 53세,2019,2705,1393,1312,106.2,2626,1355,1271,106.6
'33044, 청원구,'055005, 54세,2019,2794,1415,1379,102.6,2693,1358,1335,101.7
'33044, 청원구,'060,55~59세,2019,13151,6627,6524,101.6,12867,6486,6381,101.6
'33044, 청원구,'060001, 55세,2019,2288,1168,1120,104.3,2233,1142,1091,104.7
'33044, 청원구,'060002, 56세,2019,2449,1266,1183,107,2377,1229,1148,107.1
'33044, 청원구,'060003, 57세,2019,2702,1403,1299,108,2643,1375,1268,108.4
'33044, 청원구,'060004, 58세,2019,3034,1480,1554,95.2,2991,1460,1531,95.4
'33044, 청원구,'060005, 59세,2019,2678,1310,1368,95.8,2623,1280,1343,95.3
'33044, 청원구,'065,60~64세,2019,11612,5695,5917,96.2,11380,5579,5801,96.2
'33044, 청원구,'065001, 60세,2019,2621,1272,1349,94.3,2568,1248,1320,94.5
'33044, 청원구,'065002, 61세,2019,2358,1172,1186,98.8,2305,1148,1157,99.2
'33044, 청원구,'065003, 62세,2019,2347,1167,1180,98.9,2291,1139,1152,98.9
'33044, 청원구,'065004, 63세,2019,2165,1068,1097,97.4,2127,1046,1081,96.8
'33044, 청원구,'065005, 64세,2019,2121,1016,1105,91.9,2089,998,1091,91.5
'33044, 청원구,'070,65~69세,2019,7166,3480,3686,94.4,7084,3439,3645,94.3
'33044, 청원구,'070001, 65세,2019,1716,804,912,88.2,1695,792,903,87.7
'33044, 청원구,'070002, 66세,2019,1548,762,786,96.9,1524,750,774,96.9
'33044, 청원구,'070003, 67세,2019,1636,827,809,102.2,1616,817,799,102.3
'33044, 청원구,'070004, 68세,2019,1104,530,574,92.3,1095,526,569,92.4
'33044, 청원구,'070005, 69세,2019,1162,557,605,92.1,1154,554,600,92.3
'33044, 청원구,'075,70~74세,2019,5389,2513,2876,87.4,5358,2500,2858,87.5
'33044, 청원구,'075001, 70세,2019,1185,583,602,96.8,1174,578,596,97
'33044, 청원구,'075002, 71세,2019,1226,587,639,91.9,1218,583,635,91.8
'33044, 청원구,'075003, 72세,2019,1149,533,616,86.5,1145,532,613,86.8
'33044, 청원구,'075004, 73세,2019,911,403,508,79.3,907,403,504,80
'33044, 청원구,'075005, 74세,2019,918,407,511,79.6,914,404,510,79.2
'33044, 청원구,'080,75~79세,2019,4798,1986,2812,70.6,4789,1984,2805,70.7
'33044, 청원구,'080001, 75세,2019,942,380,562,67.6,940,379,561,67.6
'33044, 청원구,'080002, 76세,2019,978,443,535,82.8,976,442,534,82.8
'33044, 청원구,'080003, 77세,2019,1171,482,689,70,1170,482,688,70.1
'33044, 청원구,'080004, 78세,2019,872,353,519,68,868,353,515,68.5
'33044, 청원구,'080005, 79세,2019,835,328,507,64.7,835,328,507,64.7
'33044, 청원구,'085,80~84세,2019,3476,1210,2266,53.4,3466,1208,2258,53.5
'33044, 청원구,'085001, 80세,2019,840,329,511,64.4,838,328,510,64.3
'33044, 청원구,'085002, 81세,2019,783,274,509,53.8,782,274,508,53.9
'33044, 청원구,'085003, 82세,2019,667,241,426,56.6,666,241,425,56.7
'33044, 청원구,'085004, 83세,2019,637,193,444,43.5,634,192,442,43.4
'33044, 청원구,'085005, 84세,2019,549,173,376,46,546,173,373,46.4
'33044, 청원구,'086,85세이상,2019,2415,594,1821,32.6,2410,592,1818,32.6
'33044, 청원구,'090,85~89세,2019,1682,465,1217,38.2,1679,463,1216,38.1
'33044, 청원구,'090001, 85세,2019,478,141,337,41.8,477,140,337,41.5
'33044, 청원구,'090002, 86세,2019,408,113,295,38.3,408,113,295,38.3
'33044, 청원구,'090003, 87세,2019,332,103,229,45,332,103,229,45
'33044, 청원구,'090004, 88세,2019,241,61,180,33.9,241,61,180,33.9
'33044, 청원구,'090005, 89세,2019,223,47,176,26.7,221,46,175,26.3
'33044, 청원구,'095,90~94세,2019,583,104,479,21.7,582,104,478,21.8
'33044, 청원구,'095001, 90세,2019,208,40,168,23.8,207,40,167,24
'33044, 청원구,'095002, 91세,2019,144,28,116,24.1,144,28,116,24.1
'33044, 청원구,'095003, 92세,2019,110,18,92,19.6,110,18,92,19.6
'33044, 청원구,'095004, 93세,2019,61,11,50,22,61,11,50,22
'33044, 청원구,'095005, 94세,2019,60,7,53,13.2,60,7,53,13.2
'33044, 청원구,'100,95~99세,2019,134,22,112,19.6,133,22,111,19.8
'33044, 청원구,'100001, 95세,2019,38,8,30,26.7,38,8,30,26.7
'33044, 청원구,'100002, 96세,2019,39,6,33,18.2,39,6,33,18.2
'33044, 청원구,'100003, 97세,2019,22,X,18,22.2,22,X,18,22.2
'33044, 청원구,'100004, 98세,2019,20,X,17,17.6,20,X,17,17.6
'33044, 청원구,'100005, 99세,2019,15,X,14,7.1,14,X,13,7.7
'33044, 청원구,'101,100세이상,2019,16,X,13,23.1,16,X,13,23.1
'33044, 청원구,'102,15세미만,2019,31724,16262,15462,105.2,31532,16180,15352,105.4
'33044, 청원구,'103,15~64세,2019,145613,76945,68668,112.1,139735,73443,66292,110.8
'33044, 청원구,'104,65세이상,2019,23244,9783,13461,72.7,23107,9723,13384,72.6
'33044, 청원구,'126,평균연령,2019,38.9,37.7,40.1,,39,37.8,40.2,
'33044, 청원구,'127,중위연령,2019,38.5,37.5,39.6,,38.7,37.7,39.8,
'33320, 보은군,'000,합계,2019,32001,16139,15862,101.7,31293,15790,15503,101.9
'33320, 보은군,'005,0~4세,2019,705,363,342,106.1,704,363,341,106.5
'33320, 보은군,'005001, 0세,2019,114,50,64,78.1,114,50,64,78.1
'33320, 보은군,'005002, 1세,2019,148,73,75,97.3,148,73,75,97.3
'33320, 보은군,'005003, 2세,2019,136,71,65,109.2,136,71,65,109.2
'33320, 보은군,'005004, 3세,2019,165,96,69,139.1,164,96,68,141.2
'33320, 보은군,'005005, 4세,2019,142,73,69,105.8,142,73,69,105.8
'33320, 보은군,'010,5~9세,2019,863,454,409,111,861,453,408,111
'33320, 보은군,'010001, 5세,2019,147,76,71,107,146,76,70,108.6
'33320, 보은군,'010002, 6세,2019,156,72,84,85.7,155,71,84,84.5
'33320, 보은군,'010003, 7세,2019,168,88,80,110,168,88,80,110
'33320, 보은군,'010004, 8세,2019,197,104,93,111.8,197,104,93,111.8
'33320, 보은군,'010005, 9세,2019,195,114,81,140.7,195,114,81,140.7
'33320, 보은군,'015,10~14세,2019,956,535,421,127.1,954,534,420,127.1
'33320, 보은군,'015001, 10세,2019,187,95,92,103.3,186,95,91,104.4
'33320, 보은군,'015002, 11세,2019,171,91,80,113.8,171,91,80,113.8
'33320, 보은군,'015003, 12세,2019,198,115,83,138.6,198,115,83,138.6
'33320, 보은군,'015004, 13세,2019,182,105,77,136.4,181,104,77,135.1
'33320, 보은군,'015005, 14세,2019,218,129,89,144.9,218,129,89,144.9
'33320, 보은군,'020,15~19세,2019,1180,612,568,107.7,1178,612,566,108.1
'33320, 보은군,'020001, 15세,2019,220,103,117,88,220,103,117,88
'33320, 보은군,'020002, 16세,2019,222,98,124,79,222,98,124,79
'33320, 보은군,'020003, 17세,2019,277,129,148,87.2,277,129,148,87.2
'33320, 보은군,'020004, 18세,2019,272,156,116,134.5,270,156,114,136.8
'33320, 보은군,'020005, 19세,2019,189,126,63,200,189,126,63,200
'33320, 보은군,'025,20~24세,2019,1207,733,474,154.6,1134,692,442,156.6
'33320, 보은군,'025001, 20세,2019,235,148,87,170.1,234,148,86,172.1
'33320, 보은군,'025002, 21세,2019,239,152,87,174.7,227,145,82,176.8
'33320, 보은군,'025003, 22세,2019,257,155,102,152,238,143,95,150.5
'33320, 보은군,'025004, 23세,2019,244,148,96,154.2,229,135,94,143.6
'33320, 보은군,'025005, 24세,2019,232,130,102,127.5,206,121,85,142.4
'33320, 보은군,'030,25~29세,2019,1195,696,499,139.5,1071,634,437,145.1
'33320, 보은군,'030001, 25세,2019,218,136,82,165.9,199,121,78,155.1
'33320, 보은군,'030002, 26세,2019,255,148,107,138.3,231,138,93,148.4
'33320, 보은군,'030003, 27세,2019,262,149,113,131.9,236,140,96,145.8
'33320, 보은군,'030004, 28세,2019,237,140,97,144.3,202,120,82,146.3
'33320, 보은군,'030005, 29세,2019,223,123,100,123,203,115,88,130.7
'33320, 보은군,'035,30~34세,2019,1173,658,515,127.8,1063,604,459,131.6
'33320, 보은군,'035001, 30세,2019,217,116,101,114.9,192,107,85,125.9
'33320, 보은군,'035002, 31세,2019,214,120,94,127.7,197,111,86,129.1
'33320, 보은군,'035003, 32세,2019,249,144,105,137.1,227,134,93,144.1
'33320, 보은군,'035004, 33세,2019,227,128,99,129.3,202,113,89,127
'33320, 보은군,'035005, 34세,2019,266,150,116,129.3,245,139,106,131.1
'33320, 보은군,'040,35~39세,2019,1399,797,602,132.4,1295,743,552,134.6
'33320, 보은군,'040001, 35세,2019,245,130,115,113,228,122,106,115.1
'33320, 보은군,'040002, 36세,2019,261,153,108,141.7,237,136,101,134.7
'33320, 보은군,'040003, 37세,2019,302,169,133,127.1,274,159,115,138.3
'33320, 보은군,'040004, 38세,2019,324,192,132,145.5,304,181,123,147.2
'33320, 보은군,'040005, 39세,2019,267,153,114,134.2,252,145,107,135.5
'33320, 보은군,'045,40~44세,2019,1426,800,626,127.8,1366,772,594,130
'33320, 보은군,'045001, 40세,2019,301,173,128,135.2,289,168,121,138.8
'33320, 보은군,'045002, 41세,2019,258,153,105,145.7,242,144,98,146.9
'33320, 보은군,'045003, 42세,2019,261,135,126,107.1,250,131,119,110.1
'33320, 보은군,'045004, 43세,2019,312,187,125,149.6,304,181,123,147.2
'33320, 보은군,'045005, 44세,2019,294,152,142,107,281,148,133,111.3
'33320, 보은군,'050,45~49세,2019,2011,1118,893,125.2,1962,1096,866,126.6
'33320, 보은군,'050001, 45세,2019,379,211,168,125.6,370,207,163,127
'33320, 보은군,'050002, 46세,2019,380,208,172,120.9,375,207,168,123.2
'33320, 보은군,'050003, 47세,2019,380,214,166,128.9,371,211,160,131.9
'33320, 보은군,'050004, 48세,2019,449,256,193,132.6,436,249,187,133.2
'33320, 보은군,'050005, 49세,2019,423,229,194,118,410,222,188,118.1
'33320, 보은군,'055,50~54세,2019,2571,1416,1155,122.6,2498,1381,1117,123.6
'33320, 보은군,'055001, 50세,2019,454,247,207,119.3,440,242,198,122.2
'33320, 보은군,'055002, 51세,2019,491,254,237,107.2,481,248,233,106.4
'33320, 보은군,'055003, 52세,2019,497,276,221,124.9,486,271,215,126
'33320, 보은군,'055004, 53세,2019,556,323,233,138.6,536,314,222,141.4
'33320, 보은군,'055005, 54세,2019,573,316,257,123,555,306,249,122.9
'33320, 보은군,'060,55~59세,2019,3253,1724,1529,112.8,3199,1697,1502,113
'33320, 보은군,'060001, 55세,2019,490,260,230,113,479,253,226,111.9
'33320, 보은군,'060002, 56세,2019,568,305,263,116,555,299,256,116.8
'33320, 보은군,'060003, 57세,2019,674,375,299,125.4,664,371,293,126.6
'33320, 보은군,'060004, 58세,2019,824,442,382,115.7,814,437,377,115.9
'33320, 보은군,'060005, 59세,2019,697,342,355,96.3,687,337,350,96.3
'33320, 보은군,'065,60~64세,2019,3564,1833,1731,105.9,3533,1819,1714,106.1
'33320, 보은군,'065001, 60세,2019,697,356,341,104.4,688,353,335,105.4
'33320, 보은군,'065002, 61세,2019,724,394,330,119.4,718,391,327,119.6
'33320, 보은군,'065003, 62세,2019,726,371,355,104.5,721,368,353,104.2
'33320, 보은군,'065004, 63세,2019,718,372,346,107.5,715,370,345,107.2
'33320, 보은군,'065005, 64세,2019,699,340,359,94.7,691,337,354,95.2
'33320, 보은군,'070,65~69세,2019,2606,1300,1306,99.5,2592,1292,1300,99.4
'33320, 보은군,'070001, 65세,2019,619,305,314,97.1,616,304,312,97.4
'33320, 보은군,'070002, 66세,2019,525,263,262,100.4,519,260,259,100.4
'33320, 보은군,'070003, 67세,2019,565,281,284,98.9,564,281,283,99.3
'33320, 보은군,'070004, 68세,2019,432,222,210,105.7,431,221,210,105.2
'33320, 보은군,'070005, 69세,2019,465,229,236,97,462,226,236,95.8
'33320, 보은군,'075,70~74세,2019,2165,1062,1103,96.3,2161,1060,1101,96.3
'33320, 보은군,'075001, 70세,2019,507,263,244,107.8,506,262,244,107.4
'33320, 보은군,'075002, 71세,2019,473,244,229,106.6,471,243,228,106.6
'33320, 보은군,'075003, 72세,2019,451,214,237,90.3,450,214,236,90.7
'33320, 보은군,'075004, 73세,2019,370,173,197,87.8,370,173,197,87.8
'33320, 보은군,'075005, 74세,2019,364,168,196,85.7,364,168,196,85.7
'33320, 보은군,'080,75~79세,2019,2312,908,1404,64.7,2310,908,1402,64.8
'33320, 보은군,'080001, 75세,2019,395,170,225,75.6,394,170,224,75.9
'33320, 보은군,'080002, 76세,2019,458,185,273,67.8,458,185,273,67.8
'33320, 보은군,'080003, 77세,2019,548,208,340,61.2,548,208,340,61.2
'33320, 보은군,'080004, 78세,2019,461,167,294,56.8,461,167,294,56.8
'33320, 보은군,'080005, 79세,2019,450,178,272,65.4,449,178,271,65.7
'33320, 보은군,'085,80~84세,2019,1981,730,1251,58.4,1979,730,1249,58.4
'33320, 보은군,'085001, 80세,2019,461,182,279,65.2,461,182,279,65.2
'33320, 보은군,'085002, 81세,2019,400,158,242,65.3,399,158,241,65.6
'33320, 보은군,'085003, 82세,2019,394,137,257,53.3,394,137,257,53.3
'33320, 보은군,'085004, 83세,2019,358,114,244,46.7,358,114,244,46.7
'33320, 보은군,'085005, 84세,2019,368,139,229,60.7,367,139,228,61
'33320, 보은군,'086,85세이상,2019,1434,400,1034,38.7,1433,400,1033,38.7
'33320, 보은군,'090,85~89세,2019,988,291,697,41.8,987,291,696,41.8
'33320, 보은군,'090001, 85세,2019,283,94,189,49.7,283,94,189,49.7
'33320, 보은군,'090002, 86세,2019,241,74,167,44.3,240,74,166,44.6
'33320, 보은군,'090003, 87세,2019,201,60,141,42.6,201,60,141,42.6
'33320, 보은군,'090004, 88세,2019,128,33,95,34.7,128,33,95,34.7
'33320, 보은군,'090005, 89세,2019,135,30,105,28.6,135,30,105,28.6
'33320, 보은군,'095,90~94세,2019,380,99,281,35.2,380,99,281,35.2
'33320, 보은군,'095001, 90세,2019,130,34,96,35.4,130,34,96,35.4
'33320, 보은군,'095002, 91세,2019,77,20,57,35.1,77,20,57,35.1
'33320, 보은군,'095003, 92세,2019,88,25,63,39.7,88,25,63,39.7
'33320, 보은군,'095004, 93세,2019,43,14,29,48.3,43,14,29,48.3
'33320, 보은군,'095005, 94세,2019,42,6,36,16.7,42,6,36,16.7
'33320, 보은군,'100,95~99세,2019,57,10,47,21.3,57,10,47,21.3
'33320, 보은군,'100001, 95세,2019,28,8,20,40,28,8,20,40
'33320, 보은군,'100002, 96세,2019,14,X,13,7.7,14,X,13,7.7
'33320, 보은군,'100003, 97세,2019,X,X,X,33.3,X,X,X,33.3
'33320, 보은군,'100004, 98세,2019,7,X,7,0,7,X,7,0
'33320, 보은군,'100005, 99세,2019,X,X,X,0,X,X,X,0
'33320, 보은군,'101,100세이상,2019,9,X,9,0,9,X,9,0
'33320, 보은군,'102,15세미만,2019,2524,1352,1172,115.4,2519,1350,1169,115.5
'33320, 보은군,'103,15~64세,2019,18979,10387,8592,120.9,18299,10050,8249,121.8
'33320, 보은군,'104,65세이상,2019,10498,4400,6098,72.2,10475,4390,6085,72.1
'33320, 보은군,'126,평균연령,2019,53,50.5,55.5,,53.3,50.7,55.9,
'33320, 보은군,'127,중위연령,2019,57.4,54.6,59.7,,57.8,55,60.1,
'33330, 옥천군,'000,합계,2019,49117,24706,24411,101.2,48069,24080,23989,100.4
'33330, 옥천군,'005,0~4세,2019,1095,579,516,112.2,1089,576,513,112.3
'33330, 옥천군,'005001, 0세,2019,172,98,74,132.4,170,97,73,132.9
'33330, 옥천군,'005002, 1세,2019,187,99,88,112.5,185,98,87,112.6
'33330, 옥천군,'005003, 2세,2019,211,97,114,85.1,210,96,114,84.2
'33330, 옥천군,'005004, 3세,2019,259,144,115,125.2,259,144,115,125.2
'33330, 옥천군,'005005, 4세,2019,266,141,125,112.8,265,141,124,113.7
'33330, 옥천군,'010,5~9세,2019,1667,864,803,107.6,1666,864,802,107.7
'33330, 옥천군,'010001, 5세,2019,291,141,150,94,291,141,150,94
'33330, 옥천군,'010002, 6세,2019,291,153,138,110.9,291,153,138,110.9
'33330, 옥천군,'010003, 7세,2019,343,167,176,94.9,342,167,175,95.4
'33330, 옥천군,'010004, 8세,2019,388,215,173,124.3,388,215,173,124.3
'33330, 옥천군,'010005, 9세,2019,354,188,166,113.3,354,188,166,113.3
'33330, 옥천군,'015,10~14세,2019,1781,925,856,108.1,1778,923,855,108
'33330, 옥천군,'015001, 10세,2019,331,174,157,110.8,331,174,157,110.8
'33330, 옥천군,'015002, 11세,2019,368,185,183,101.1,367,185,182,101.6
'33330, 옥천군,'015003, 12세,2019,378,195,183,106.6,377,194,183,106
'33330, 옥천군,'015004, 13세,2019,361,193,168,114.9,360,192,168,114.3
'33330, 옥천군,'015005, 14세,2019,343,178,165,107.9,343,178,165,107.9
'33330, 옥천군,'020,15~19세,2019,1953,1056,897,117.7,1939,1049,890,117.9
'33330, 옥천군,'020001, 15세,2019,368,191,177,107.9,368,191,177,107.9
'33330, 옥천군,'020002, 16세,2019,358,191,167,114.4,356,190,166,114.5
'33330, 옥천군,'020003, 17세,2019,364,189,175,108,362,188,174,108
'33330, 옥천군,'020004, 18세,2019,475,252,223,113,472,251,221,113.6
'33330, 옥천군,'020005, 19세,2019,388,233,155,150.3,381,229,152,150.7
'33330, 옥천군,'025,20~24세,2019,2336,1412,924,152.8,2234,1348,886,152.1
'33330, 옥천군,'025001, 20세,2019,434,270,164,164.6,430,268,162,165.4
'33330, 옥천군,'025002, 21세,2019,459,276,183,150.8,440,264,176,150
'33330, 옥천군,'025003, 22세,2019,496,304,192,158.3,464,279,185,150.8
'33330, 옥천군,'025004, 23세,2019,473,273,200,136.5,451,261,190,137.4
'33330, 옥천군,'025005, 24세,2019,474,289,185,156.2,449,276,173,159.5
'33330, 옥천군,'030,25~29세,2019,1999,1168,831,140.6,1799,1043,756,138
'33330, 옥천군,'030001, 25세,2019,431,255,176,144.9,389,227,162,140.1
'33330, 옥천군,'030002, 26세,2019,408,237,171,138.6,375,216,159,135.8
'33330, 옥천군,'030003, 27세,2019,409,221,188,117.6,367,199,168,118.5
'33330, 옥천군,'030004, 28세,2019,379,231,148,156.1,346,212,134,158.2
'33330, 옥천군,'030005, 29세,2019,372,224,148,151.4,322,189,133,142.1
'33330, 옥천군,'035,30~34세,2019,1759,964,795,121.3,1578,844,734,115
'33330, 옥천군,'035001, 30세,2019,315,181,134,135.1,287,162,125,129.6
'33330, 옥천군,'035002, 31세,2019,349,187,162,115.4,305,161,144,111.8
'33330, 옥천군,'035003, 32세,2019,363,196,167,117.4,323,173,150,115.3
'33330, 옥천군,'035004, 33세,2019,365,205,160,128.1,325,174,151,115.2
'33330, 옥천군,'035005, 34세,2019,367,195,172,113.4,338,174,164,106.1
'33330, 옥천군,'040,35~39세,2019,2531,1344,1187,113.2,2370,1238,1132,109.4
'33330, 옥천군,'040001, 35세,2019,437,225,212,106.1,404,204,200,102
'33330, 옥천군,'040002, 36세,2019,467,257,210,122.4,434,232,202,114.9
'33330, 옥천군,'040003, 37세,2019,552,302,250,120.8,512,278,234,118.8
'33330, 옥천군,'040004, 38세,2019,519,274,245,111.8,488,255,233,109.4
'33330, 옥천군,'040005, 39세,2019,556,286,270,105.9,532,269,263,102.3
'33330, 옥천군,'045,40~44세,2019,2739,1494,1245,120,2647,1441,1206,119.5
'33330, 옥천군,'045001, 40세,2019,508,282,226,124.8,491,272,219,124.2
'33330, 옥천군,'045002, 41세,2019,546,289,257,112.5,524,278,246,113
'33330, 옥천군,'045003, 42세,2019,544,299,245,122,526,288,238,121
'33330, 옥천군,'045004, 43세,2019,538,293,245,119.6,522,282,240,117.5
'33330, 옥천군,'045005, 44세,2019,603,331,272,121.7,584,321,263,122.1
'33330, 옥천군,'050,45~49세,2019,3440,1883,1557,120.9,3367,1845,1522,121.2
'33330, 옥천군,'050001, 45세,2019,662,351,311,112.9,654,347,307,113
'33330, 옥천군,'050002, 46세,2019,719,401,318,126.1,697,387,310,124.8
'33330, 옥천군,'050003, 47세,2019,629,347,282,123,615,341,274,124.5
'33330, 옥천군,'050004, 48세,2019,721,384,337,113.9,708,378,330,114.5
'33330, 옥천군,'050005, 49세,2019,709,400,309,129.4,693,392,301,130.2
'33330, 옥천군,'055,50~54세,2019,4088,2121,1967,107.8,4012,2086,1926,108.3
'33330, 옥천군,'055001, 50세,2019,852,447,405,110.4,837,440,397,110.8
'33330, 옥천군,'055002, 51세,2019,828,418,410,102,811,411,400,102.8
'33330, 옥천군,'055003, 52세,2019,789,410,379,108.2,773,402,371,108.4
'33330, 옥천군,'055004, 53세,2019,787,413,374,110.4,771,407,364,111.8
'33330, 옥천군,'055005, 54세,2019,832,433,399,108.5,820,426,394,108.1
'33330, 옥천군,'060,55~59세,2019,4832,2466,2366,104.2,4773,2434,2339,104.1
'33330, 옥천군,'060001, 55세,2019,776,415,361,115,759,404,355,113.8
'33330, 옥천군,'060002, 56세,2019,872,466,406,114.8,859,458,401,114.2
'33330, 옥천군,'060003, 57세,2019,971,525,446,117.7,961,519,442,117.4
'33330, 옥천군,'060004, 58세,2019,1128,547,581,94.1,1118,545,573,95.1
'33330, 옥천군,'060005, 59세,2019,1085,513,572,89.7,1076,508,568,89.4
'33330, 옥천군,'065,60~64세,2019,4891,2482,2409,103,4853,2460,2393,102.8
'33330, 옥천군,'065001, 60세,2019,964,502,462,108.7,954,494,460,107.4
'33330, 옥천군,'065002, 61세,2019,908,462,446,103.6,903,460,443,103.8
'33330, 옥천군,'065003, 62세,2019,1072,561,511,109.8,1068,559,509,109.8
'33330, 옥천군,'065004, 63세,2019,975,488,487,100.2,966,484,482,100.4
'33330, 옥천군,'065005, 64세,2019,972,469,503,93.2,962,463,499,92.8
'33330, 옥천군,'070,65~69세,2019,3946,1963,1983,99,3925,1953,1972,99
'33330, 옥천군,'070001, 65세,2019,886,437,449,97.3,884,437,447,97.8
'33330, 옥천군,'070002, 66세,2019,761,380,381,99.7,758,378,380,99.5
'33330, 옥천군,'070003, 67세,2019,892,425,467,91,885,422,463,91.1
'33330, 옥천군,'070004, 68세,2019,658,319,339,94.1,654,317,337,94.1
'33330, 옥천군,'070005, 69세,2019,749,402,347,115.9,744,399,345,115.7
'33330, 옥천군,'075,70~74세,2019,2974,1446,1528,94.6,2959,1440,1519,94.8
'33330, 옥천군,'075001, 70세,2019,712,369,343,107.6,709,368,341,107.9
'33330, 옥천군,'075002, 71세,2019,640,318,322,98.8,635,316,319,99.1
'33330, 옥천군,'075003, 72세,2019,647,302,345,87.5,644,300,344,87.2
'33330, 옥천군,'075004, 73세,2019,486,222,264,84.1,486,222,264,84.1
'33330, 옥천군,'075005, 74세,2019,489,235,254,92.5,485,234,251,93.2
'33330, 옥천군,'080,75~79세,2019,2999,1216,1783,68.2,2994,1213,1781,68.1
'33330, 옥천군,'080001, 75세,2019,535,229,306,74.8,533,227,306,74.2
'33330, 옥천군,'080002, 76세,2019,594,242,352,68.8,594,242,352,68.8
'33330, 옥천군,'080003, 77세,2019,829,335,494,67.8,829,335,494,67.8
'33330, 옥천군,'080004, 78세,2019,569,227,342,66.4,568,227,341,66.6
'33330, 옥천군,'080005, 79세,2019,472,183,289,63.3,470,182,288,63.2
'33330, 옥천군,'085,80~84세,2019,2327,842,1485,56.7,2327,842,1485,56.7
'33330, 옥천군,'085001, 80세,2019,545,196,349,56.2,545,196,349,56.2
'33330, 옥천군,'085002, 81세,2019,468,170,298,57,468,170,298,57
'33330, 옥천군,'085003, 82세,2019,437,174,263,66.2,437,174,263,66.2
'33330, 옥천군,'085004, 83세,2019,440,159,281,56.6,440,159,281,56.6
'33330, 옥천군,'085005, 84세,2019,437,143,294,48.6,437,143,294,48.6
'33330, 옥천군,'086,85세이상,2019,1760,481,1279,37.6,1759,481,1278,37.6
'33330, 옥천군,'090,85~89세,2019,1254,356,898,39.6,1254,356,898,39.6
'33330, 옥천군,'090001, 85세,2019,352,109,243,44.9,352,109,243,44.9
'33330, 옥천군,'090002, 86세,2019,323,91,232,39.2,323,91,232,39.2
'33330, 옥천군,'090003, 87세,2019,234,70,164,42.7,234,70,164,42.7
'33330, 옥천군,'090004, 88세,2019,182,42,140,30,182,42,140,30
'33330, 옥천군,'090005, 89세,2019,163,44,119,37,163,44,119,37
'33330, 옥천군,'095,90~94세,2019,413,107,306,35,412,107,305,35.1
'33330, 옥천군,'095001, 90세,2019,139,38,101,37.6,139,38,101,37.6
'33330, 옥천군,'095002, 91세,2019,108,26,82,31.7,108,26,82,31.7
'33330, 옥천군,'095003, 92세,2019,85,21,64,32.8,85,21,64,32.8
'33330, 옥천군,'095004, 93세,2019,41,14,27,51.9,40,14,26,53.8
'33330, 옥천군,'095005, 94세,2019,40,8,32,25,40,8,32,25
'33330, 옥천군,'100,95~99세,2019,84,17,67,25.4,84,17,67,25.4
'33330, 옥천군,'100001, 95세,2019,25,X,21,19,25,X,21,19
'33330, 옥천군,'100002, 96세,2019,31,5,26,19.2,31,5,26,19.2
'33330, 옥천군,'100003, 97세,2019,16,X,12,33.3,16,X,12,33.3
'33330, 옥천군,'100004, 98세,2019,7,X,5,40,7,X,5,40
'33330, 옥천군,'100005, 99세,2019,5,X,X,66.7,5,X,X,66.7
'33330, 옥천군,'101,100세이상,2019,9,X,8,12.5,9,X,8,12.5
'33330, 옥천군,'102,15세미만,2019,4543,2368,2175,108.9,4533,2363,2170,108.9
'33330, 옥천군,'103,15~64세,2019,30568,16390,14178,115.6,29572,15788,13784,114.5
'33330, 옥천군,'104,65세이상,2019,14006,5948,8058,73.8,13964,5929,8035,73.8
'33330, 옥천군,'126,평균연령,2019,50.3,48.1,52.6,,50.6,48.4,52.8,
'33330, 옥천군,'127,중위연령,2019,54,51.5,56.7,,54.5,52,57,
'33340, 영동군,'000,합계,2019,48004,24076,23928,100.6,46907,23445,23462,99.9
'33340, 영동군,'005,0~4세,2019,1187,635,552,115,1185,634,551,115.1
'33340, 영동군,'005001, 0세,2019,227,124,103,120.4,227,124,103,120.4
'33340, 영동군,'005002, 1세,2019,276,157,119,131.9,275,157,118,133.1
'33340, 영동군,'005003, 2세,2019,226,108,118,91.5,225,107,118,90.7
'33340, 영동군,'005004, 3세,2019,218,120,98,122.4,218,120,98,122.4
'33340, 영동군,'005005, 4세,2019,240,126,114,110.5,240,126,114,110.5
'33340, 영동군,'010,5~9세,2019,1385,713,672,106.1,1383,711,672,105.8
'33340, 영동군,'010001, 5세,2019,268,133,135,98.5,268,133,135,98.5
'33340, 영동군,'010002, 6세,2019,233,113,120,94.2,233,113,120,94.2
'33340, 영동군,'010003, 7세,2019,277,131,146,89.7,276,130,146,89
'33340, 영동군,'010004, 8세,2019,299,160,139,115.1,299,160,139,115.1
'33340, 영동군,'010005, 9세,2019,308,176,132,133.3,307,175,132,132.6
'33340, 영동군,'015,10~14세,2019,1447,769,678,113.4,1445,767,678,113.1
'33340, 영동군,'015001, 10세,2019,264,143,121,118.2,263,142,121,117.4
'33340, 영동군,'015002, 11세,2019,273,153,120,127.5,272,152,120,126.7
'33340, 영동군,'015003, 12세,2019,326,172,154,111.7,326,172,154,111.7
'33340, 영동군,'015004, 13세,2019,299,149,150,99.3,299,149,150,99.3
'33340, 영동군,'015005, 14세,2019,285,152,133,114.3,285,152,133,114.3
'33340, 영동군,'020,15~19세,2019,2296,1255,1041,120.6,2227,1191,1036,115
'33340, 영동군,'020001, 15세,2019,347,161,186,86.6,347,161,186,86.6
'33340, 영동군,'020002, 16세,2019,354,174,180,96.7,353,174,179,97.2
'33340, 영동군,'020003, 17세,2019,365,190,175,108.6,363,188,175,107.4
'33340, 영동군,'020004, 18세,2019,504,282,222,127,491,270,221,122.2
'33340, 영동군,'020005, 19세,2019,726,448,278,161.2,673,398,275,144.7
'33340, 영동군,'025,20~24세,2019,3278,1958,1320,148.3,3040,1784,1256,142
'33340, 영동군,'025001, 20세,2019,674,359,315,114,620,316,304,103.9
'33340, 영동군,'025002, 21세,2019,659,353,306,115.4,615,316,299,105.7
'33340, 영동군,'025003, 22세,2019,699,401,298,134.6,647,361,286,126.2
'33340, 영동군,'025004, 23세,2019,678,449,229,196.1,632,418,214,195.3
'33340, 영동군,'025005, 24세,2019,568,396,172,230.2,526,373,153,243.8
'33340, 영동군,'030,25~29세,2019,1981,1207,774,155.9,1814,1115,699,159.5
'33340, 영동군,'030001, 25세,2019,486,330,156,211.5,455,311,144,216
'33340, 영동군,'030002, 26세,2019,374,209,165,126.7,339,193,146,132.2
'33340, 영동군,'030003, 27세,2019,415,253,162,156.2,381,235,146,161
'33340, 영동군,'030004, 28세,2019,372,225,147,153.1,334,203,131,155
'33340, 영동군,'030005, 29세,2019,334,190,144,131.9,305,173,132,131.1
'33340, 영동군,'035,30~34세,2019,1706,896,810,110.6,1558,821,737,111.4
'33340, 영동군,'035001, 30세,2019,358,184,174,105.7,321,168,153,109.8
'33340, 영동군,'035002, 31세,2019,336,197,139,141.7,308,181,127,142.5
'33340, 영동군,'035003, 32세,2019,333,152,181,84,295,134,161,83.2
'33340, 영동군,'035004, 33세,2019,347,192,155,123.9,320,176,144,122.2
'33340, 영동군,'035005, 34세,2019,332,171,161,106.2,314,162,152,106.6
'33340, 영동군,'040,35~39세,2019,2013,1032,981,105.2,1899,983,916,107.3
'33340, 영동군,'040001, 35세,2019,367,200,167,119.8,334,183,151,121.2
'33340, 영동군,'040002, 36세,2019,378,179,199,89.9,363,174,189,92.1
'33340, 영동군,'040003, 37세,2019,406,203,203,100,377,194,183,106
'33340, 영동군,'040004, 38세,2019,413,214,199,107.5,389,202,187,108
'33340, 영동군,'040005, 39세,2019,449,236,213,110.8,436,230,206,111.7
'33340, 영동군,'045,40~44세,2019,2303,1220,1083,112.7,2218,1179,1039,113.5
'33340, 영동군,'045001, 40세,2019,464,231,233,99.1,440,218,222,98.2
'33340, 영동군,'045002, 41세,2019,432,225,207,108.7,416,214,202,105.9
'33340, 영동군,'045003, 42세,2019,420,232,188,123.4,404,225,179,125.7
'33340, 영동군,'045004, 43세,2019,449,241,208,115.9,429,233,196,118.9
'33340, 영동군,'045005, 44세,2019,538,291,247,117.8,529,289,240,120.4
'33340, 영동군,'050,45~49세,2019,3134,1731,1403,123.4,3067,1698,1369,124
'33340, 영동군,'050001, 45세,2019,596,346,250,138.4,585,341,244,139.8
'33340, 영동군,'050002, 46세,2019,657,362,295,122.7,639,353,286,123.4
'33340, 영동군,'050003, 47세,2019,557,292,265,110.2,543,285,258,110.5
'33340, 영동군,'050004, 48세,2019,636,353,283,124.7,627,349,278,125.5
'33340, 영동군,'050005, 49세,2019,688,378,310,121.9,673,370,303,122.1
'33340, 영동군,'055,50~54세,2019,3861,2061,1800,114.5,3787,2033,1754,115.9
'33340, 영동군,'055001, 50세,2019,745,402,343,117.2,733,400,333,120.1
'33340, 영동군,'055002, 51세,2019,778,415,363,114.3,758,407,351,116
'33340, 영동군,'055003, 52세,2019,741,391,350,111.7,732,387,345,112.2
'33340, 영동군,'055004, 53세,2019,779,405,374,108.3,756,396,360,110
'33340, 영동군,'055005, 54세,2019,818,448,370,121.1,808,443,365,121.4
'33340, 영동군,'060,55~59세,2019,4525,2272,2253,100.8,4463,2241,2222,100.9
'33340, 영동군,'060001, 55세,2019,713,346,367,94.3,692,335,357,93.8
'33340, 영동군,'060002, 56세,2019,757,395,362,109.1,746,388,358,108.4
'33340, 영동군,'060003, 57세,2019,923,473,450,105.1,913,470,443,106.1
'33340, 영동군,'060004, 58세,2019,1111,564,547,103.1,1104,561,543,103.3
'33340, 영동군,'060005, 59세,2019,1021,494,527,93.7,1008,487,521,93.5
'33340, 영동군,'065,60~64세,2019,4751,2452,2299,106.7,4718,2432,2286,106.4
'33340, 영동군,'065001, 60세,2019,985,490,495,99,974,484,490,98.8
'33340, 영동군,'065002, 61세,2019,937,521,416,125.2,930,515,415,124.1
'33340, 영동군,'065003, 62세,2019,1014,515,499,103.2,1008,513,495,103.6
'33340, 영동군,'065004, 63세,2019,873,423,450,94,867,419,448,93.5
'33340, 영동군,'065005, 64세,2019,942,503,439,114.6,939,501,438,114.4
'33340, 영동군,'070,65~69세,2019,3622,1750,1872,93.5,3603,1740,1863,93.4
'33340, 영동군,'070001, 65세,2019,802,413,389,106.2,797,410,387,105.9
'33340, 영동군,'070002, 66세,2019,733,382,351,108.8,729,380,349,108.9
'33340, 영동군,'070003, 67세,2019,786,367,419,87.6,781,364,417,87.3
'33340, 영동군,'070004, 68세,2019,628,284,344,82.6,627,283,344,82.3
'33340, 영동군,'070005, 69세,2019,673,304,369,82.4,669,303,366,82.8
'33340, 영동군,'075,70~74세,2019,3084,1443,1641,87.9,3075,1437,1638,87.7
'33340, 영동군,'075001, 70세,2019,751,343,408,84.1,746,339,407,83.3
'33340, 영동군,'075002, 71세,2019,670,316,354,89.3,668,315,353,89.2
'33340, 영동군,'075003, 72세,2019,603,301,302,99.7,603,301,302,99.7
'33340, 영동군,'075004, 73세,2019,536,244,292,83.6,535,244,291,83.8
'33340, 영동군,'075005, 74세,2019,524,239,285,83.9,523,238,285,83.5
'33340, 영동군,'080,75~79세,2019,3248,1322,1926,68.6,3246,1320,1926,68.5
'33340, 영동군,'080001, 75세,2019,580,227,353,64.3,580,227,353,64.3
'33340, 영동군,'080002, 76세,2019,688,289,399,72.4,687,288,399,72.2
'33340, 영동군,'080003, 77세,2019,816,339,477,71.1,816,339,477,71.1
'33340, 영동군,'080004, 78세,2019,621,248,373,66.5,620,247,373,66.2
'33340, 영동군,'080005, 79세,2019,543,219,324,67.6,543,219,324,67.6
'33340, 영동군,'085,80~84세,2019,2527,903,1624,55.6,2525,903,1622,55.7
'33340, 영동군,'085001, 80세,2019,606,233,373,62.5,605,233,372,62.6
'33340, 영동군,'085002, 81세,2019,534,200,334,59.9,533,200,333,60.1
'33340, 영동군,'085003, 82세,2019,499,162,337,48.1,499,162,337,48.1
'33340, 영동군,'085004, 83세,2019,466,163,303,53.8,466,163,303,53.8
'33340, 영동군,'085005, 84세,2019,422,145,277,52.3,422,145,277,52.3
'33340, 영동군,'086,85세이상,2019,1656,457,1199,38.1,1654,456,1198,38.1
'33340, 영동군,'090,85~89세,2019,1133,338,795,42.5,1131,337,794,42.4
'33340, 영동군,'090001, 85세,2019,327,108,219,49.3,327,108,219,49.3
'33340, 영동군,'090002, 86세,2019,279,81,198,40.9,278,80,198,40.4
'33340, 영동군,'090003, 87세,2019,221,82,139,59,221,82,139,59
'33340, 영동군,'090004, 88세,2019,171,37,134,27.6,170,37,133,27.8
'33340, 영동군,'090005, 89세,2019,135,30,105,28.6,135,30,105,28.6
'33340, 영동군,'095,90~94세,2019,424,100,324,30.9,424,100,324,30.9
'33340, 영동군,'095001, 90세,2019,137,29,108,26.9,137,29,108,26.9
'33340, 영동군,'095002, 91세,2019,103,24,79,30.4,103,24,79,30.4
'33340, 영동군,'095003, 92세,2019,95,30,65,46.2,95,30,65,46.2
'33340, 영동군,'095004, 93세,2019,51,9,42,21.4,51,9,42,21.4
'33340, 영동군,'095005, 94세,2019,38,8,30,26.7,38,8,30,26.7
'33340, 영동군,'100,95~99세,2019,94,19,75,25.3,94,19,75,25.3
'33340, 영동군,'100001, 95세,2019,21,8,13,61.5,21,8,13,61.5
'33340, 영동군,'100002, 96세,2019,24,X,20,20,24,X,20,20
'33340, 영동군,'100003, 97세,2019,27,5,22,22.7,27,5,22,22.7
'33340, 영동군,'100004, 98세,2019,8,X,8,0,8,X,8,0
'33340, 영동군,'100005, 99세,2019,14,X,12,16.7,14,X,12,16.7
'33340, 영동군,'101,100세이상,2019,5,X,5,0,5,X,5,0
'33340, 영동군,'102,15세미만,2019,4019,2117,1902,111.3,4013,2112,1901,111.1
'33340, 영동군,'103,15~64세,2019,29848,16084,13764,116.9,28791,15477,13314,116.2
'33340, 영동군,'104,65세이상,2019,14137,5875,8262,71.1,14103,5856,8247,71
'33340, 영동군,'126,평균연령,2019,50.3,47.8,52.8,,50.6,48.2,53.1,
'33340, 영동군,'127,중위연령,2019,54.3,51.5,57.3,,54.8,52.1,57.7,
'33350, 진천군,'000,합계,2019,87525,47307,40218,117.6,78467,41050,37417,109.7
'33350, 진천군,'005,0~4세,2019,3699,1898,1801,105.4,3546,1811,1735,104.4
'33350, 진천군,'005001, 0세,2019,634,339,295,114.9,607,323,284,113.7
'33350, 진천군,'005002, 1세,2019,647,326,321,101.6,621,314,307,102.3
'33350, 진천군,'005003, 2세,2019,754,383,371,103.2,718,363,355,102.3
'33350, 진천군,'005004, 3세,2019,818,427,391,109.2,777,401,376,106.6
'33350, 진천군,'005005, 4세,2019,846,423,423,100,823,410,413,99.3
'33350, 진천군,'010,5~9세,2019,4269,2190,2079,105.3,4145,2132,2013,105.9
'33350, 진천군,'010001, 5세,2019,801,421,380,110.8,769,401,368,109
'33350, 진천군,'010002, 6세,2019,846,435,411,105.8,819,421,398,105.8
'33350, 진천군,'010003, 7세,2019,883,439,444,98.9,854,430,424,101.4
'33350, 진천군,'010004, 8세,2019,889,453,436,103.9,871,448,423,105.9
'33350, 진천군,'010005, 9세,2019,850,442,408,108.3,832,432,400,108
'33350, 진천군,'015,10~14세,2019,3880,2012,1868,107.7,3803,1969,1834,107.4
'33350, 진천군,'015001, 10세,2019,790,410,380,107.9,771,398,373,106.7
'33350, 진천군,'015002, 11세,2019,849,451,398,113.3,834,441,393,112.2
'33350, 진천군,'015003, 12세,2019,854,444,410,108.3,838,437,401,109
'33350, 진천군,'015004, 13세,2019,705,354,351,100.9,694,348,346,100.6
'33350, 진천군,'015005, 14세,2019,682,353,329,107.3,666,345,321,107.5
'33350, 진천군,'020,15~19세,2019,4287,2319,1968,117.8,4192,2260,1932,117
'33350, 진천군,'020001, 15세,2019,778,425,353,120.4,767,421,346,121.7
'33350, 진천군,'020002, 16세,2019,800,434,366,118.6,788,425,363,117.1
'33350, 진천군,'020003, 17세,2019,845,388,457,84.9,834,384,450,85.3
'33350, 진천군,'020004, 18세,2019,877,485,392,123.7,859,475,384,123.7
'33350, 진천군,'020005, 19세,2019,987,587,400,146.8,944,555,389,142.7
'33350, 진천군,'025,20~24세,2019,4846,3029,1817,166.7,4125,2468,1657,148.9
'33350, 진천군,'025001, 20세,2019,885,563,322,174.8,835,524,311,168.5
'33350, 진천군,'025002, 21세,2019,909,562,347,162,805,477,328,145.4
'33350, 진천군,'025003, 22세,2019,984,569,415,137.1,839,465,374,124.3
'33350, 진천군,'025004, 23세,2019,1006,633,373,169.7,802,474,328,144.5
'33350, 진천군,'025005, 24세,2019,1062,702,360,195,844,528,316,167.1
'33350, 진천군,'030,25~29세,2019,5936,3742,2194,170.6,4434,2611,1823,143.2
'33350, 진천군,'030001, 25세,2019,1102,684,418,163.6,858,497,361,137.7
'33350, 진천군,'030002, 26세,2019,1196,740,456,162.3,911,523,388,134.8
'33350, 진천군,'030003, 27세,2019,1200,763,437,174.6,908,553,355,155.8
'33350, 진천군,'030004, 28세,2019,1199,762,437,174.4,861,508,353,143.9
'33350, 진천군,'030005, 29세,2019,1239,793,446,177.8,896,530,366,144.8
'33350, 진천군,'035,30~34세,2019,6263,3801,2462,154.4,4576,2561,2015,127.1
'33350, 진천군,'035001, 30세,2019,1198,765,433,176.7,834,502,332,151.2
'33350, 진천군,'035002, 31세,2019,1198,719,479,150.1,875,482,393,122.6
'33350, 진천군,'035003, 32세,2019,1231,725,506,143.3,876,458,418,109.6
'33350, 진천군,'035004, 33세,2019,1322,794,528,150.4,992,559,433,129.1
'33350, 진천군,'035005, 34세,2019,1314,798,516,154.7,999,560,439,127.6
'33350, 진천군,'040,35~39세,2019,7783,4437,3346,132.6,6475,3474,3001,115.8
'33350, 진천군,'040001, 35세,2019,1376,816,560,145.7,1054,582,472,123.3
'33350, 진천군,'040002, 36세,2019,1549,911,638,142.8,1280,709,571,124.2
'33350, 진천군,'040003, 37세,2019,1646,938,708,132.5,1384,751,633,118.6
'33350, 진천군,'040004, 38세,2019,1573,887,686,129.3,1339,709,630,112.5
'33350, 진천군,'040005, 39세,2019,1639,885,754,117.4,1418,723,695,104
'33350, 진천군,'045,40~44세,2019,7061,3999,3062,130.6,6169,3345,2824,118.4
'33350, 진천군,'045001, 40세,2019,1499,873,626,139.5,1294,715,579,123.5
'33350, 진천군,'045002, 41세,2019,1400,781,619,126.2,1219,648,571,113.5
'33350, 진천군,'045003, 42세,2019,1395,792,603,131.3,1221,665,556,119.6
'33350, 진천군,'045004, 43세,2019,1378,793,585,135.6,1214,675,539,125.2
'33350, 진천군,'045005, 44세,2019,1389,760,629,120.8,1221,642,579,110.9
'33350, 진천군,'050,45~49세,2019,6981,3890,3091,125.8,6218,3429,2789,122.9
'33350, 진천군,'050001, 45세,2019,1363,767,596,128.7,1235,692,543,127.4
'33350, 진천군,'050002, 46세,2019,1424,800,624,128.2,1270,706,564,125.2
'33350, 진천군,'050003, 47세,2019,1295,721,574,125.6,1145,625,520,120.2
'33350, 진천군,'050004, 48세,2019,1483,838,645,129.9,1313,733,580,126.4
'33350, 진천군,'050005, 49세,2019,1416,764,652,117.2,1255,673,582,115.6
'33350, 진천군,'055,50~54세,2019,7129,3913,3216,121.7,6479,3528,2951,119.6
'33350, 진천군,'055001, 50세,2019,1485,797,688,115.8,1361,728,633,115
'33350, 진천군,'055002, 51세,2019,1472,791,681,116.2,1324,699,625,111.8
'33350, 진천군,'055003, 52세,2019,1374,768,606,126.7,1246,695,551,126.1
'33350, 진천군,'055004, 53세,2019,1394,781,613,127.4,1268,709,559,126.8
'33350, 진천군,'055005, 54세,2019,1404,776,628,123.6,1280,697,583,119.6
'33350, 진천군,'060,55~59세,2019,6854,3688,3166,116.5,6312,3371,2941,114.6
'33350, 진천군,'060001, 55세,2019,1238,681,557,122.3,1111,598,513,116.6
'33350, 진천군,'060002, 56세,2019,1265,694,571,121.5,1117,612,505,121.2
'33350, 진천군,'060003, 57세,2019,1398,764,634,120.5,1302,711,591,120.3
'33350, 진천군,'060004, 58세,2019,1583,819,764,107.2,1513,781,732,106.7
'33350, 진천군,'060005, 59세,2019,1370,730,640,114.1,1269,669,600,111.5
'33350, 진천군,'065,60~64세,2019,5692,2971,2721,109.2,5374,2782,2592,107.3
'33350, 진천군,'065001, 60세,2019,1234,656,578,113.5,1162,615,547,112.4
'33350, 진천군,'065002, 61세,2019,1152,620,532,116.5,1071,568,503,112.9
'33350, 진천군,'065003, 62세,2019,1207,632,575,109.9,1134,587,547,107.3
'33350, 진천군,'065004, 63세,2019,1052,550,502,109.6,999,516,483,106.8
'33350, 진천군,'065005, 64세,2019,1047,513,534,96.1,1008,496,512,96.9
'33350, 진천군,'070,65~69세,2019,3798,1835,1963,93.5,3662,1763,1899,92.8
'33350, 진천군,'070001, 65세,2019,943,449,494,90.9,899,429,470,91.3
'33350, 진천군,'070002, 66세,2019,820,406,414,98.1,790,385,405,95.1
'33350, 진천군,'070003, 67세,2019,861,419,442,94.8,834,406,428,94.9
'33350, 진천군,'070004, 68세,2019,570,280,290,96.6,551,271,280,96.8
'33350, 진천군,'070005, 69세,2019,604,281,323,87,588,272,316,86.1
'33350, 진천군,'075,70~74세,2019,2851,1389,1462,95,2800,1361,1439,94.6
'33350, 진천군,'075001, 70세,2019,649,344,305,112.8,630,330,300,110
'33350, 진천군,'075002, 71세,2019,628,308,320,96.3,617,304,313,97.1
'33350, 진천군,'075003, 72세,2019,577,280,297,94.3,568,275,293,93.9
'33350, 진천군,'075004, 73세,2019,478,238,240,99.2,470,234,236,99.2
'33350, 진천군,'075005, 74세,2019,519,219,300,73,515,218,297,73.4
'33350, 진천군,'080,75~79세,2019,2570,1057,1513,69.9,2556,1053,1503,70.1
'33350, 진천군,'080001, 75세,2019,456,186,270,68.9,454,186,268,69.4
'33350, 진천군,'080002, 76세,2019,509,199,310,64.2,504,196,308,63.6
'33350, 진천군,'080003, 77세,2019,623,265,358,74,622,265,357,74.2
'33350, 진천군,'080004, 78세,2019,487,196,291,67.4,485,196,289,67.8
'33350, 진천군,'080005, 79세,2019,495,211,284,74.3,491,210,281,74.7
'33350, 진천군,'085,80~84세,2019,2224,781,1443,54.1,2207,778,1429,54.4
'33350, 진천군,'085001, 80세,2019,531,192,339,56.6,528,190,338,56.2
'33350, 진천군,'085002, 81세,2019,468,198,270,73.3,460,198,262,75.6
'33350, 진천군,'085003, 82세,2019,441,155,286,54.2,438,155,283,54.8
'33350, 진천군,'085004, 83세,2019,414,143,271,52.8,411,142,269,52.8
'33350, 진천군,'085005, 84세,2019,370,93,277,33.6,370,93,277,33.6
'33350, 진천군,'086,85세이상,2019,1402,356,1046,34,1394,354,1040,34
'33350, 진천군,'090,85~89세,2019,984,271,713,38,978,269,709,37.9
'33350, 진천군,'090001, 85세,2019,298,89,209,42.6,297,89,208,42.8
'33350, 진천군,'090002, 86세,2019,256,76,180,42.2,254,75,179,41.9
'33350, 진천군,'090003, 87세,2019,176,55,121,45.5,174,55,119,46.2
'33350, 진천군,'090004, 88세,2019,142,31,111,27.9,141,30,111,27
'33350, 진천군,'090005, 89세,2019,112,20,92,21.7,112,20,92,21.7
'33350, 진천군,'095,90~94세,2019,338,73,265,27.5,337,73,264,27.7
'33350, 진천군,'095001, 90세,2019,105,33,72,45.8,105,33,72,45.8
'33350, 진천군,'095002, 91세,2019,90,15,75,20,90,15,75,20
'33350, 진천군,'095003, 92세,2019,65,14,51,27.5,64,14,50,28
'33350, 진천군,'095004, 93세,2019,45,8,37,21.6,45,8,37,21.6
'33350, 진천군,'095005, 94세,2019,33,X,30,10,33,X,30,10
'33350, 진천군,'100,95~99세,2019,75,11,64,17.2,74,11,63,17.5
'33350, 진천군,'100001, 95세,2019,21,X,18,16.7,20,X,17,17.6
'33350, 진천군,'100002, 96세,2019,27,X,25,8,27,X,25,8
'33350, 진천군,'100003, 97세,2019,12,X,10,20,12,X,10,20
'33350, 진천군,'100004, 98세,2019,11,X,8,37.5,11,X,8,37.5
'33350, 진천군,'100005, 99세,2019,X,X,X,33.3,X,X,X,33.3
'33350, 진천군,'101,100세이상,2019,5,X,X,25,5,X,X,25
'33350, 진천군,'102,15세미만,2019,11848,6100,5748,106.1,11494,5912,5582,105.9
'33350, 진천군,'103,15~64세,2019,62832,35789,27043,132.3,54354,29829,24525,121.6
'33350, 진천군,'104,65세이상,2019,12845,5418,7427,73,12619,5309,7310,72.6
'33350, 진천군,'126,평균연령,2019,41.8,40.3,43.5,,42.3,40.9,43.8,
'33350, 진천군,'127,중위연령,2019,41.9,40.3,44.2,,43.2,41.8,44.8,
'33360, 괴산군,'000,합계,2019,38808,20265,18543,109.3,37290,19300,17990,107.3
'33360, 괴산군,'005,0~4세,2019,581,305,276,110.5,577,301,276,109.1
'33360, 괴산군,'005001, 0세,2019,119,74,45,164.4,118,73,45,162.2
'33360, 괴산군,'005002, 1세,2019,101,55,46,119.6,101,55,46,119.6
'33360, 괴산군,'005003, 2세,2019,131,63,68,92.6,130,62,68,91.2
'33360, 괴산군,'005004, 3세,2019,115,63,52,121.2,114,62,52,119.2
'33360, 괴산군,'005005, 4세,2019,115,50,65,76.9,114,49,65,75.4
'33360, 괴산군,'010,5~9세,2019,785,388,397,97.7,777,382,395,96.7
'33360, 괴산군,'010001, 5세,2019,161,78,83,94,161,78,83,94
'33360, 괴산군,'010002, 6세,2019,132,60,72,83.3,130,59,71,83.1
'33360, 괴산군,'010003, 7세,2019,169,93,76,122.4,167,91,76,119.7
'33360, 괴산군,'010004, 8세,2019,149,67,82,81.7,148,66,82,80.5
'33360, 괴산군,'010005, 9세,2019,174,90,84,107.1,171,88,83,106
'33360, 괴산군,'015,10~14세,2019,901,431,470,91.7,896,430,466,92.3
'33360, 괴산군,'015001, 10세,2019,182,77,105,73.3,182,77,105,73.3
'33360, 괴산군,'015002, 11세,2019,190,95,95,100,190,95,95,100
'33360, 괴산군,'015003, 12세,2019,194,100,94,106.4,193,100,93,107.5
'33360, 괴산군,'015004, 13세,2019,161,75,86,87.2,161,75,86,87.2
'33360, 괴산군,'015005, 14세,2019,174,84,90,93.3,170,83,87,95.4
'33360, 괴산군,'020,15~19세,2019,1861,1075,786,136.8,1758,1017,741,137.2
'33360, 괴산군,'020001, 15세,2019,190,104,86,120.9,190,104,86,120.9
'33360, 괴산군,'020002, 16세,2019,186,108,78,138.5,186,108,78,138.5
'33360, 괴산군,'020003, 17세,2019,193,99,94,105.3,191,98,93,105.4
'33360, 괴산군,'020004, 18세,2019,411,227,184,123.4,394,214,180,118.9
'33360, 괴산군,'020005, 19세,2019,881,537,344,156.1,797,493,304,162.2
'33360, 괴산군,'025,20~24세,2019,3170,1946,1224,159,2894,1757,1137,154.5
'33360, 괴산군,'025001, 20세,2019,657,343,314,109.2,591,299,292,102.4
'33360, 괴산군,'025002, 21세,2019,627,337,290,116.2,582,308,274,112.4
'33360, 괴산군,'025003, 22세,2019,678,395,283,139.6,633,366,267,137.1
'33360, 괴산군,'025004, 23세,2019,656,471,185,254.6,594,426,168,253.6
'33360, 괴산군,'025005, 24세,2019,552,400,152,263.2,494,358,136,263.2
'33360, 괴산군,'030,25~29세,2019,1675,1044,631,165.5,1396,864,532,162.4
'33360, 괴산군,'030001, 25세,2019,400,290,110,263.6,346,252,94,268.1
'33360, 괴산군,'030002, 26세,2019,360,216,144,150,306,183,123,148.8
'33360, 괴산군,'030003, 27세,2019,319,180,139,129.5,267,150,117,128.2
'33360, 괴산군,'030004, 28세,2019,303,191,112,170.5,238,144,94,153.2
'33360, 괴산군,'030005, 29세,2019,293,167,126,132.5,239,135,104,129.8
'33360, 괴산군,'035,30~34세,2019,1334,784,550,142.5,1099,639,460,138.9
'33360, 괴산군,'035001, 30세,2019,267,156,111,140.5,214,127,87,146
'33360, 괴산군,'035002, 31세,2019,272,159,113,140.7,222,132,90,146.7
'33360, 괴산군,'035003, 32세,2019,249,145,104,139.4,208,118,90,131.1
'33360, 괴산군,'035004, 33세,2019,283,170,113,150.4,238,142,96,147.9
'33360, 괴산군,'035005, 34세,2019,263,154,109,141.3,217,120,97,123.7
'33360, 괴산군,'040,35~39세,2019,1544,901,643,140.1,1376,787,589,133.6
'33360, 괴산군,'040001, 35세,2019,284,166,118,140.7,251,144,107,134.6
'33360, 괴산군,'040002, 36세,2019,297,177,120,147.5,259,150,109,137.6
'33360, 괴산군,'040003, 37세,2019,328,182,146,124.7,286,152,134,113.4
'33360, 괴산군,'040004, 38세,2019,299,178,121,147.1,275,160,115,139.1
'33360, 괴산군,'040005, 39세,2019,336,198,138,143.5,305,181,124,146
'33360, 괴산군,'045,40~44세,2019,1617,916,701,130.7,1519,856,663,129.1
'33360, 괴산군,'045001, 40세,2019,305,158,147,107.5,280,143,137,104.4
'33360, 괴산군,'045002, 41세,2019,323,179,144,124.3,299,165,134,123.1
'33360, 괴산군,'045003, 42세,2019,302,166,136,122.1,283,154,129,119.4
'33360, 괴산군,'045004, 43세,2019,308,170,138,123.2,296,162,134,120.9
'33360, 괴산군,'045005, 44세,2019,379,243,136,178.7,361,232,129,179.8
'33360, 괴산군,'050,45~49세,2019,2190,1305,885,147.5,2108,1259,849,148.3
'33360, 괴산군,'050001, 45세,2019,393,231,162,142.6,374,221,153,144.4
'33360, 괴산군,'050002, 46세,2019,418,250,168,148.8,402,241,161,149.7
'33360, 괴산군,'050003, 47세,2019,395,240,155,154.8,381,230,151,152.3
'33360, 괴산군,'050004, 48세,2019,507,289,218,132.6,493,284,209,135.9
'33360, 괴산군,'050005, 49세,2019,477,295,182,162.1,458,283,175,161.7
'33360, 괴산군,'055,50~54세,2019,3086,1668,1418,117.6,3005,1616,1389,116.3
'33360, 괴산군,'055001, 50세,2019,561,307,254,120.9,541,292,249,117.3
'33360, 괴산군,'055002, 51세,2019,587,321,266,120.7,570,309,261,118.4
'33360, 괴산군,'055003, 52세,2019,606,327,279,117.2,587,316,271,116.6
'33360, 괴산군,'055004, 53세,2019,662,360,302,119.2,652,353,299,118.1
'33360, 괴산군,'055005, 54세,2019,670,353,317,111.4,655,346,309,112
'33360, 괴산군,'060,55~59세,2019,3960,2060,1900,108.4,3882,2017,1865,108.2
'33360, 괴산군,'060001, 55세,2019,647,336,311,108,630,324,306,105.9
'33360, 괴산군,'060002, 56세,2019,691,351,340,103.2,675,342,333,102.7
'33360, 괴산군,'060003, 57세,2019,776,388,388,100,763,383,380,100.8
'33360, 괴산군,'060004, 58세,2019,942,499,443,112.6,928,491,437,112.4
'33360, 괴산군,'060005, 59세,2019,904,486,418,116.3,886,477,409,116.6
'33360, 괴산군,'065,60~64세,2019,4387,2335,2052,113.8,4328,2298,2030,113.2
'33360, 괴산군,'065001, 60세,2019,880,463,417,111,865,455,410,111
'33360, 괴산군,'065002, 61세,2019,935,504,431,116.9,925,498,427,116.6
'33360, 괴산군,'065003, 62세,2019,857,457,400,114.3,845,449,396,113.4
'33360, 괴산군,'065004, 63세,2019,874,478,396,120.7,861,469,392,119.6
'33360, 괴산군,'065005, 64세,2019,841,433,408,106.1,832,427,405,105.4
'33360, 괴산군,'070,65~69세,2019,3219,1626,1593,102.1,3185,1601,1584,101.1
'33360, 괴산군,'070001, 65세,2019,785,399,386,103.4,776,391,385,101.6
'33360, 괴산군,'070002, 66세,2019,644,314,330,95.2,634,307,327,93.9
'33360, 괴산군,'070003, 67세,2019,706,375,331,113.3,702,371,331,112.1
'33360, 괴산군,'070004, 68세,2019,529,253,276,91.7,522,250,272,91.9
'33360, 괴산군,'070005, 69세,2019,555,285,270,105.6,551,282,269,104.8
'33360, 괴산군,'075,70~74세,2019,2605,1322,1283,103,2599,1317,1282,102.7
'33360, 괴산군,'075001, 70세,2019,560,294,266,110.5,559,293,266,110.2
'33360, 괴산군,'075002, 71세,2019,545,286,259,110.4,544,285,259,110
'33360, 괴산군,'075003, 72세,2019,568,287,281,102.1,567,286,281,101.8
'33360, 괴산군,'075004, 73세,2019,419,211,208,101.4,417,210,207,101.4
'33360, 괴산군,'075005, 74세,2019,513,244,269,90.7,512,243,269,90.3
'33360, 괴산군,'080,75~79세,2019,2590,1047,1543,67.9,2589,1047,1542,67.9
'33360, 괴산군,'080001, 75세,2019,454,183,271,67.5,454,183,271,67.5
'33360, 괴산군,'080002, 76세,2019,508,204,304,67.1,508,204,304,67.1
'33360, 괴산군,'080003, 77세,2019,592,232,360,64.4,592,232,360,64.4
'33360, 괴산군,'080004, 78세,2019,544,226,318,71.1,544,226,318,71.1
'33360, 괴산군,'080005, 79세,2019,492,202,290,69.7,491,202,289,69.9
'33360, 괴산군,'085,80~84세,2019,1980,761,1219,62.4,1979,761,1218,62.5
'33360, 괴산군,'085001, 80세,2019,478,197,281,70.1,478,197,281,70.1
'33360, 괴산군,'085002, 81세,2019,460,193,267,72.3,459,193,266,72.6
'33360, 괴산군,'085003, 82세,2019,384,134,250,53.6,384,134,250,53.6
'33360, 괴산군,'085004, 83세,2019,347,126,221,57,347,126,221,57
'33360, 괴산군,'085005, 84세,2019,311,111,200,55.5,311,111,200,55.5
'33360, 괴산군,'086,85세이상,2019,1323,351,972,36.1,1323,351,972,36.1
'33360, 괴산군,'090,85~89세,2019,962,267,695,38.4,962,267,695,38.4
'33360, 괴산군,'090001, 85세,2019,292,93,199,46.7,292,93,199,46.7
'33360, 괴산군,'090002, 86세,2019,231,55,176,31.3,231,55,176,31.3
'33360, 괴산군,'090003, 87세,2019,183,55,128,43,183,55,128,43
'33360, 괴산군,'090004, 88세,2019,138,36,102,35.3,138,36,102,35.3
'33360, 괴산군,'090005, 89세,2019,118,28,90,31.1,118,28,90,31.1
'33360, 괴산군,'095,90~94세,2019,280,66,214,30.8,280,66,214,30.8
'33360, 괴산군,'095001, 90세,2019,93,21,72,29.2,93,21,72,29.2
'33360, 괴산군,'095002, 91세,2019,77,19,58,32.8,77,19,58,32.8
'33360, 괴산군,'095003, 92세,2019,43,11,32,34.4,43,11,32,34.4
'33360, 괴산군,'095004, 93세,2019,30,7,23,30.4,30,7,23,30.4
'33360, 괴산군,'095005, 94세,2019,37,8,29,27.6,37,8,29,27.6
'33360, 괴산군,'100,95~99세,2019,64,13,51,25.5,64,13,51,25.5
'33360, 괴산군,'100001, 95세,2019,17,X,13,30.8,17,X,13,30.8
'33360, 괴산군,'100002, 96세,2019,21,X,18,16.7,21,X,18,16.7
'33360, 괴산군,'100003, 97세,2019,13,6,7,85.7,13,6,7,85.7
'33360, 괴산군,'100004, 98세,2019,8,X,8,0,8,X,8,0
'33360, 괴산군,'100005, 99세,2019,5,X,5,0,5,X,5,0
'33360, 괴산군,'101,100세이상,2019,17,5,12,41.7,17,5,12,41.7
'33360, 괴산군,'102,15세미만,2019,2267,1124,1143,98.3,2250,1113,1137,97.9
'33360, 괴산군,'103,15~64세,2019,24824,14034,10790,130.1,23365,13110,10255,127.8
'33360, 괴산군,'104,65세이상,2019,11717,5107,6610,77.3,11675,5077,6598,76.9
'33360, 괴산군,'126,평균연령,2019,51.4,49.1,54,,52.1,49.8,54.6,
'33360, 괴산군,'127,중위연령,2019,56,53.2,58.6,,56.9,54.3,59.1,
'33370, 음성군,'000,합계,2019,104823,58027,46796,124,90758,47851,42907,111.5
'33370, 음성군,'005,0~4세,2019,3069,1560,1509,103.4,2925,1488,1437,103.5
'33370, 음성군,'005001, 0세,2019,537,275,262,105,509,261,248,105.2
'33370, 음성군,'005002, 1세,2019,527,272,255,106.7,499,262,237,110.5
'33370, 음성군,'005003, 2세,2019,584,294,290,101.4,551,278,273,101.8
'33370, 음성군,'005004, 3세,2019,728,367,361,101.7,694,349,345,101.2
'33370, 음성군,'005005, 4세,2019,693,352,341,103.2,672,338,334,101.2
'33370, 음성군,'010,5~9세,2019,3753,1965,1788,109.9,3645,1911,1734,110.2
'33370, 음성군,'010001, 5세,2019,672,348,324,107.4,647,334,313,106.7
'33370, 음성군,'010002, 6세,2019,712,345,367,94,685,335,350,95.7
'33370, 음성군,'010003, 7세,2019,817,453,364,124.5,794,439,355,123.7
'33370, 음성군,'010004, 8세,2019,791,435,356,122.2,772,427,345,123.8
'33370, 음성군,'010005, 9세,2019,761,384,377,101.9,747,376,371,101.3
'33370, 음성군,'015,10~14세,2019,3689,1919,1770,108.4,3616,1879,1737,108.2
'33370, 음성군,'015001, 10세,2019,723,392,331,118.4,708,383,325,117.8
'33370, 음성군,'015002, 11세,2019,735,372,363,102.5,714,361,353,102.3
'33370, 음성군,'015003, 12세,2019,767,388,379,102.4,751,381,370,103
'33370, 음성군,'015004, 13세,2019,732,379,353,107.4,717,369,348,106
'33370, 음성군,'015005, 14세,2019,732,388,344,112.8,726,385,341,112.9
'33370, 음성군,'020,15~19세,2019,4642,2483,2159,115,4553,2423,2130,113.8
'33370, 음성군,'020001, 15세,2019,765,431,334,129,758,427,331,129
'33370, 음성군,'020002, 16세,2019,806,424,382,111,796,417,379,110
'33370, 음성군,'020003, 17세,2019,912,472,440,107.3,901,465,436,106.7
'33370, 음성군,'020004, 18세,2019,1014,524,490,106.9,989,511,478,106.9
'33370, 음성군,'020005, 19세,2019,1145,632,513,123.2,1109,603,506,119.2
'33370, 음성군,'025,20~24세,2019,6345,3900,2445,159.5,4940,2798,2142,130.6
'33370, 음성군,'025001, 20세,2019,1199,648,551,117.6,1096,576,520,110.8
'33370, 음성군,'025002, 21세,2019,1169,712,457,155.8,975,567,408,139
'33370, 음성군,'025003, 22세,2019,1237,744,493,150.9,971,527,444,118.7
'33370, 음성군,'025004, 23세,2019,1357,882,475,185.7,964,577,387,149.1
'33370, 음성군,'025005, 24세,2019,1383,914,469,194.9,934,551,383,143.9
'33370, 음성군,'030,25~29세,2019,7535,4954,2581,191.9,4695,2771,1924,144
'33370, 음성군,'030001, 25세,2019,1427,931,496,187.7,879,498,381,130.7
'33370, 음성군,'030002, 26세,2019,1530,1010,520,194.2,980,588,392,150
'33370, 음성군,'030003, 27세,2019,1606,1062,544,195.2,1008,603,405,148.9
'33370, 음성군,'030004, 28세,2019,1462,972,490,198.4,891,530,361,146.8
'33370, 음성군,'030005, 29세,2019,1510,979,531,184.4,937,552,385,143.4
'33370, 음성군,'035,30~34세,2019,7071,4533,2538,178.6,4433,2501,1932,129.5
'33370, 음성군,'035001, 30세,2019,1424,920,504,182.5,852,486,366,132.8
'33370, 음성군,'035002, 31세,2019,1406,900,506,177.9,845,486,359,135.4
'33370, 음성군,'035003, 32세,2019,1427,948,479,197.9,879,512,367,139.5
'33370, 음성군,'035004, 33세,2019,1401,891,510,174.7,909,515,394,130.7
'33370, 음성군,'035005, 34세,2019,1413,874,539,162.2,948,502,446,112.6
'33370, 음성군,'040,35~39세,2019,7554,4584,2970,154.3,5595,3078,2517,122.3
'33370, 음성군,'040001, 35세,2019,1391,893,498,179.3,969,567,402,141
'33370, 음성군,'040002, 36세,2019,1442,896,546,164.1,1028,574,454,126.4
'33370, 음성군,'040003, 37세,2019,1552,932,620,150.3,1164,629,535,117.6
'33370, 음성군,'040004, 38세,2019,1581,938,643,145.9,1211,656,555,118.2
'33370, 음성군,'040005, 39세,2019,1588,925,663,139.5,1223,652,571,114.2
'33370, 음성군,'045,40~44세,2019,7387,4358,3029,143.9,6101,3425,2676,128
'33370, 음성군,'045001, 40세,2019,1593,957,636,150.5,1257,714,543,131.5
'33370, 음성군,'045002, 41세,2019,1404,808,596,135.6,1133,613,520,117.9
'33370, 음성군,'045003, 42세,2019,1494,899,595,151.1,1236,706,530,133.2
'33370, 음성군,'045004, 43세,2019,1401,815,586,139.1,1180,653,527,123.9
'33370, 음성군,'045005, 44세,2019,1495,879,616,142.7,1295,739,556,132.9
'33370, 음성군,'050,45~49세,2019,8471,4879,3592,135.8,7397,4193,3204,130.9
'33370, 음성군,'050001, 45세,2019,1680,947,733,129.2,1474,818,656,124.7
'33370, 음성군,'050002, 46세,2019,1650,955,695,137.4,1451,820,631,130
'33370, 음성군,'050003, 47세,2019,1617,933,684,136.4,1390,794,596,133.2
'33370, 음성군,'050004, 48세,2019,1717,1000,717,139.5,1501,851,650,130.9
'33370, 음성군,'050005, 49세,2019,1807,1044,763,136.8,1581,910,671,135.6
'33370, 음성군,'055,50~54세,2019,9134,5123,4011,127.7,8138,4477,3661,122.3
'33370, 음성군,'055001, 50세,2019,1888,1078,810,133.1,1684,944,740,127.6
'33370, 음성군,'055002, 51세,2019,1914,1098,816,134.6,1689,946,743,127.3
'33370, 음성군,'055003, 52세,2019,1736,949,787,120.6,1534,828,706,117.3
'33370, 음성군,'055004, 53세,2019,1727,958,769,124.6,1544,838,706,118.7
'33370, 음성군,'055005, 54세,2019,1869,1040,829,125.5,1687,921,766,120.2
'33370, 음성군,'060,55~59세,2019,9328,5165,4163,124.1,8600,4725,3875,121.9
'33370, 음성군,'060001, 55세,2019,1627,903,724,124.7,1468,802,666,120.4
'33370, 음성군,'060002, 56세,2019,1720,977,743,131.5,1515,848,667,127.1
'33370, 음성군,'060003, 57세,2019,1916,1043,873,119.5,1761,949,812,116.9
'33370, 음성군,'060004, 58세,2019,2102,1186,916,129.5,1995,1123,872,128.8
'33370, 음성군,'060005, 59세,2019,1963,1056,907,116.4,1861,1003,858,116.9
'33370, 음성군,'065,60~64세,2019,8433,4463,3970,112.4,8010,4196,3814,110
'33370, 음성군,'065001, 60세,2019,1837,983,854,115.1,1751,934,817,114.3
'33370, 음성군,'065002, 61세,2019,1788,967,821,117.8,1697,906,791,114.5
'33370, 음성군,'065003, 62세,2019,1693,909,784,115.9,1594,847,747,113.4
'33370, 음성군,'065004, 63세,2019,1534,803,731,109.8,1468,758,710,106.8
'33370, 음성군,'065005, 64세,2019,1581,801,780,102.7,1500,751,749,100.3
'33370, 음성군,'070,65~69세,2019,5458,2829,2629,107.6,5268,2712,2556,106.1
'33370, 음성군,'070001, 65세,2019,1357,699,658,106.2,1289,651,638,102
'33370, 음성군,'070002, 66세,2019,1099,600,499,120.2,1054,575,479,120
'33370, 음성군,'070003, 67세,2019,1335,707,628,112.6,1305,691,614,112.5
'33370, 음성군,'070004, 68세,2019,788,387,401,96.5,768,375,393,95.4
'33370, 음성군,'070005, 69세,2019,879,436,443,98.4,852,420,432,97.2
'33370, 음성군,'075,70~74세,2019,4113,2025,2088,97,4045,1998,2047,97.6
'33370, 음성군,'075001, 70세,2019,937,469,468,100.2,920,462,458,100.9
'33370, 음성군,'075002, 71세,2019,867,436,431,101.2,852,428,424,100.9
'33370, 음성군,'075003, 72세,2019,878,430,448,96,862,424,438,96.8
'33370, 음성군,'075004, 73세,2019,700,346,354,97.7,690,341,349,97.7
'33370, 음성군,'075005, 74세,2019,731,344,387,88.9,721,343,378,90.7
'33370, 음성군,'080,75~79세,2019,3915,1699,2216,76.7,3894,1693,2201,76.9
'33370, 음성군,'080001, 75세,2019,759,340,419,81.1,753,339,414,81.9
'33370, 음성군,'080002, 76세,2019,738,330,408,80.9,734,328,406,80.8
'33370, 음성군,'080003, 77세,2019,946,422,524,80.5,945,422,523,80.7
'33370, 음성군,'080004, 78세,2019,756,322,434,74.2,751,320,431,74.2
'33370, 음성군,'080005, 79세,2019,716,285,431,66.1,711,284,427,66.5
'33370, 음성군,'085,80~84세,2019,2873,1040,1833,56.7,2860,1036,1824,56.8
'33370, 음성군,'085001, 80세,2019,688,284,404,70.3,683,283,400,70.8
'33370, 음성군,'085002, 81세,2019,580,203,377,53.8,579,203,376,54
'33370, 음성군,'085003, 82세,2019,551,193,358,53.9,544,190,354,53.7
'33370, 음성군,'085004, 83세,2019,530,192,338,56.8,530,192,338,56.8
'33370, 음성군,'085005, 84세,2019,524,168,356,47.2,524,168,356,47.2
'33370, 음성군,'086,85세이상,2019,2053,548,1505,36.4,2043,547,1496,36.6
'33370, 음성군,'090,85~89세,2019,1449,407,1042,39.1,1443,407,1036,39.3
'33370, 음성군,'090001, 85세,2019,416,127,289,43.9,412,127,285,44.6
'33370, 음성군,'090002, 86세,2019,317,98,219,44.7,317,98,219,44.7
'33370, 음성군,'090003, 87세,2019,285,77,208,37,284,77,207,37.2
'33370, 음성군,'090004, 88세,2019,227,58,169,34.3,226,58,168,34.5
'33370, 음성군,'090005, 89세,2019,204,47,157,29.9,204,47,157,29.9
'33370, 음성군,'095,90~94세,2019,489,117,372,31.5,487,116,371,31.3
'33370, 음성군,'095001, 90세,2019,161,37,124,29.8,159,36,123,29.3
'33370, 음성군,'095002, 91세,2019,133,32,101,31.7,133,32,101,31.7
'33370, 음성군,'095003, 92세,2019,80,25,55,45.5,80,25,55,45.5
'33370, 음성군,'095004, 93세,2019,58,11,47,23.4,58,11,47,23.4
'33370, 음성군,'095005, 94세,2019,57,12,45,26.7,57,12,45,26.7
'33370, 음성군,'100,95~99세,2019,99,22,77,28.6,97,22,75,29.3
'33370, 음성군,'100001, 95세,2019,28,6,22,27.3,27,6,21,28.6
'33370, 음성군,'100002, 96세,2019,33,5,28,17.9,33,5,28,17.9
'33370, 음성군,'100003, 97세,2019,15,6,9,66.7,15,6,9,66.7
'33370, 음성군,'100004, 98세,2019,15,X,11,36.4,14,X,10,40
'33370, 음성군,'100005, 99세,2019,8,X,7,14.3,8,X,7,14.3
'33370, 음성군,'101,100세이상,2019,16,X,14,14.3,16,X,14,14.3
'33370, 음성군,'102,15세미만,2019,10511,5444,5067,107.4,10186,5278,4908,107.5
'33370, 음성군,'103,15~64세,2019,75900,44442,31458,141.3,62462,34587,27875,124.1
'33370, 음성군,'104,65세이상,2019,18412,8141,10271,79.3,18110,7986,10124,78.9
'33370, 음성군,'126,평균연령,2019,44.6,43,46.6,,45.8,44.4,47.3,
'33370, 음성군,'127,중위연령,2019,45.8,43.6,48.7,,48.4,47,50,
'33380, 단양군,'000,합계,2019,28095,14146,13949,101.4,27781,14025,13756,102
'33380, 단양군,'005,0~4세,2019,537,280,257,108.9,537,280,257,108.9
'33380, 단양군,'005001, 0세,2019,84,51,33,154.5,84,51,33,154.5
'33380, 단양군,'005002, 1세,2019,105,56,49,114.3,105,56,49,114.3
'33380, 단양군,'005003, 2세,2019,109,56,53,105.7,109,56,53,105.7
'33380, 단양군,'005004, 3세,2019,112,49,63,77.8,112,49,63,77.8
'33380, 단양군,'005005, 4세,2019,127,68,59,115.3,127,68,59,115.3
'33380, 단양군,'010,5~9세,2019,720,390,330,118.2,720,390,330,118.2
'33380, 단양군,'010001, 5세,2019,132,73,59,123.7,132,73,59,123.7
'33380, 단양군,'010002, 6세,2019,114,55,59,93.2,114,55,59,93.2
'33380, 단양군,'010003, 7세,2019,160,84,76,110.5,160,84,76,110.5
'33380, 단양군,'010004, 8세,2019,161,88,73,120.5,161,88,73,120.5
'33380, 단양군,'010005, 9세,2019,153,90,63,142.9,153,90,63,142.9
'33380, 단양군,'015,10~14세,2019,951,510,441,115.6,951,510,441,115.6
'33380, 단양군,'015001, 10세,2019,158,86,72,119.4,158,86,72,119.4
'33380, 단양군,'015002, 11세,2019,200,103,97,106.2,200,103,97,106.2
'33380, 단양군,'015003, 12세,2019,200,104,96,108.3,200,104,96,108.3
'33380, 단양군,'015004, 13세,2019,190,96,94,102.1,190,96,94,102.1
'33380, 단양군,'015005, 14세,2019,203,121,82,147.6,203,121,82,147.6
'33380, 단양군,'020,15~19세,2019,1055,567,488,116.2,1050,566,484,116.9
'33380, 단양군,'020001, 15세,2019,227,131,96,136.5,227,131,96,136.5
'33380, 단양군,'020002, 16세,2019,240,121,119,101.7,240,121,119,101.7
'33380, 단양군,'020003, 17세,2019,223,116,107,108.4,223,116,107,108.4
'33380, 단양군,'020004, 18세,2019,235,126,109,115.6,234,126,108,116.7
'33380, 단양군,'020005, 19세,2019,130,73,57,128.1,126,72,54,133.3
'33380, 단양군,'025,20~24세,2019,965,590,375,157.3,936,583,353,165.2
'33380, 단양군,'025001, 20세,2019,170,128,42,304.8,169,128,41,312.2
'33380, 단양군,'025002, 21세,2019,198,132,66,200,195,132,63,209.5
'33380, 단양군,'025003, 22세,2019,184,104,80,130,178,104,74,140.5
'33380, 단양군,'025004, 23세,2019,211,126,85,148.2,204,121,83,145.8
'33380, 단양군,'025005, 24세,2019,202,100,102,98,190,98,92,106.5
'33380, 단양군,'030,25~29세,2019,1097,629,468,134.4,1045,607,438,138.6
'33380, 단양군,'030001, 25세,2019,244,142,102,139.2,235,140,95,147.4
'33380, 단양군,'030002, 26세,2019,204,117,87,134.5,194,111,83,133.7
'33380, 단양군,'030003, 27세,2019,237,132,105,125.7,228,126,102,123.5
'33380, 단양군,'030004, 28세,2019,201,112,89,125.8,188,108,80,135
'33380, 단양군,'030005, 29세,2019,211,126,85,148.2,200,122,78,156.4
'33380, 단양군,'035,30~34세,2019,931,509,422,120.6,874,484,390,124.1
'33380, 단양군,'035001, 30세,2019,209,114,95,120,194,109,85,128.2
'33380, 단양군,'035002, 31세,2019,168,94,74,127,162,90,72,125
'33380, 단양군,'035003, 32세,2019,202,104,98,106.1,184,97,87,111.5
'33380, 단양군,'035004, 33세,2019,157,88,69,127.5,152,85,67,126.9
'33380, 단양군,'035005, 34세,2019,195,109,86,126.7,182,103,79,130.4
'33380, 단양군,'040,35~39세,2019,1191,625,566,110.4,1158,612,546,112.1
'33380, 단양군,'040001, 35세,2019,189,100,89,112.4,180,97,83,116.9
'33380, 단양군,'040002, 36세,2019,226,108,118,91.5,218,106,112,94.6
'33380, 단양군,'040003, 37세,2019,248,130,118,110.2,243,128,115,111.3
'33380, 단양군,'040004, 38세,2019,255,129,126,102.4,250,127,123,103.3
'33380, 단양군,'040005, 39세,2019,273,158,115,137.4,267,154,113,136.3
'33380, 단양군,'045,40~44세,2019,1339,743,596,124.7,1305,729,576,126.6
'33380, 단양군,'045001, 40세,2019,260,142,118,120.3,252,139,113,123
'33380, 단양군,'045002, 41세,2019,269,152,117,129.9,259,147,112,131.3
'33380, 단양군,'045003, 42세,2019,251,139,112,124.1,246,138,108,127.8
'33380, 단양군,'045004, 43세,2019,272,152,120,126.7,265,150,115,130.4
'33380, 단양군,'045005, 44세,2019,287,158,129,122.5,283,155,128,121.1
'33380, 단양군,'050,45~49세,2019,2000,1081,919,117.6,1976,1073,903,118.8
'33380, 단양군,'050001, 45세,2019,338,174,164,106.1,334,173,161,107.5
'33380, 단양군,'050002, 46세,2019,394,213,181,117.7,390,212,178,119.1
'33380, 단양군,'050003, 47세,2019,390,220,170,129.4,384,219,165,132.7
'33380, 단양군,'050004, 48세,2019,431,213,218,97.7,426,212,214,99.1
'33380, 단양군,'050005, 49세,2019,447,261,186,140.3,442,257,185,138.9
'33380, 단양군,'055,50~54세,2019,2502,1312,1190,110.3,2472,1303,1169,111.5
'33380, 단양군,'055001, 50세,2019,473,271,202,134.2,468,269,199,135.2
'33380, 단양군,'055002, 51세,2019,511,250,261,95.8,503,246,257,95.7
'33380, 단양군,'055003, 52세,2019,457,226,231,97.8,453,226,227,99.6
'33380, 단양군,'055004, 53세,2019,517,280,237,118.1,509,278,231,120.3
'33380, 단양군,'055005, 54세,2019,544,285,259,110,539,284,255,111.4
'33380, 단양군,'060,55~59세,2019,3169,1622,1547,104.8,3142,1610,1532,105.1
'33380, 단양군,'060001, 55세,2019,498,272,226,120.4,496,272,224,121.4
'33380, 단양군,'060002, 56세,2019,525,281,244,115.2,516,277,239,115.9
'33380, 단양군,'060003, 57세,2019,638,343,295,116.3,627,337,290,116.2
'33380, 단양군,'060004, 58세,2019,780,406,374,108.6,778,405,373,108.6
'33380, 단양군,'060005, 59세,2019,728,320,408,78.4,725,319,406,78.6
'33380, 단양군,'065,60~64세,2019,3366,1728,1638,105.5,3355,1723,1632,105.6
'33380, 단양군,'065001, 60세,2019,682,340,342,99.4,682,340,342,99.4
'33380, 단양군,'065002, 61세,2019,682,343,339,101.2,678,341,337,101.2
'33380, 단양군,'065003, 62세,2019,757,405,352,115.1,756,405,351,115.4
'33380, 단양군,'065004, 63세,2019,612,324,288,112.5,609,322,287,112.2
'33380, 단양군,'065005, 64세,2019,633,316,317,99.7,630,315,315,100
'33380, 단양군,'070,65~69세,2019,2298,1154,1144,100.9,2291,1150,1141,100.8
'33380, 단양군,'070001, 65세,2019,576,305,271,112.5,573,303,270,112.2
'33380, 단양군,'070002, 66세,2019,434,218,216,100.9,432,217,215,100.9
'33380, 단양군,'070003, 67세,2019,554,284,270,105.2,554,284,270,105.2
'33380, 단양군,'070004, 68세,2019,341,167,174,96,340,166,174,95.4
'33380, 단양군,'070005, 69세,2019,393,180,213,84.5,392,180,212,84.9
'33380, 단양군,'075,70~74세,2019,1971,916,1055,86.8,1969,915,1054,86.8
'33380, 단양군,'075001, 70세,2019,456,237,219,108.2,454,236,218,108.3
'33380, 단양군,'075002, 71세,2019,461,215,246,87.4,461,215,246,87.4
'33380, 단양군,'075003, 72세,2019,416,191,225,84.9,416,191,225,84.9
'33380, 단양군,'075004, 73세,2019,297,124,173,71.7,297,124,173,71.7
'33380, 단양군,'075005, 74세,2019,341,149,192,77.6,341,149,192,77.6
'33380, 단양군,'080,75~79세,2019,1862,766,1096,69.9,1861,766,1095,70
'33380, 단양군,'080001, 75세,2019,365,142,223,63.7,365,142,223,63.7
'33380, 단양군,'080002, 76세,2019,366,157,209,75.1,366,157,209,75.1
'33380, 단양군,'080003, 77세,2019,421,165,256,64.5,420,165,255,64.7
'33380, 단양군,'080004, 78세,2019,377,177,200,88.5,377,177,200,88.5
'33380, 단양군,'080005, 79세,2019,333,125,208,60.1,333,125,208,60.1
'33380, 단양군,'085,80~84세,2019,1329,487,842,57.8,1328,487,841,57.9
'33380, 단양군,'085001, 80세,2019,343,145,198,73.2,343,145,198,73.2
'33380, 단양군,'085002, 81세,2019,308,98,210,46.7,308,98,210,46.7
'33380, 단양군,'085003, 82세,2019,246,98,148,66.2,246,98,148,66.2
'33380, 단양군,'085004, 83세,2019,226,82,144,56.9,226,82,144,56.9
'33380, 단양군,'085005, 84세,2019,206,64,142,45.1,205,64,141,45.4
'33380, 단양군,'086,85세이상,2019,812,237,575,41.2,811,237,574,41.3
'33380, 단양군,'090,85~89세,2019,587,185,402,46,587,185,402,46
'33380, 단양군,'090001, 85세,2019,172,56,116,48.3,172,56,116,48.3
'33380, 단양군,'090002, 86세,2019,135,47,88,53.4,135,47,88,53.4
'33380, 단양군,'090003, 87세,2019,113,32,81,39.5,113,32,81,39.5
'33380, 단양군,'090004, 88세,2019,77,26,51,51,77,26,51,51
'33380, 단양군,'090005, 89세,2019,90,24,66,36.4,90,24,66,36.4
'33380, 단양군,'095,90~94세,2019,173,41,132,31.1,172,41,131,31.3
'33380, 단양군,'095001, 90세,2019,60,19,41,46.3,60,19,41,46.3
'33380, 단양군,'095002, 91세,2019,42,5,37,13.5,42,5,37,13.5
'33380, 단양군,'095003, 92세,2019,32,X,28,14.3,32,X,28,14.3
'33380, 단양군,'095004, 93세,2019,20,9,11,81.8,20,9,11,81.8
'33380, 단양군,'095005, 94세,2019,19,X,15,26.7,18,X,14,28.6
'33380, 단양군,'100,95~99세,2019,43,10,33,30.3,43,10,33,30.3
'33380, 단양군,'100001, 95세,2019,14,8,6,133.3,14,8,6,133.3
'33380, 단양군,'100002, 96세,2019,12,X,11,9.1,12,X,11,9.1
'33380, 단양군,'100003, 97세,2019,9,X,8,12.5,9,X,8,12.5
'33380, 단양군,'100004, 98세,2019,8,X,8,0,8,X,8,0
'33380, 단양군,'100005, 99세,2019,X,X,X,,X,X,X,
'33380, 단양군,'101,100세이상,2019,9,X,8,12.5,9,X,8,12.5
'33380, 단양군,'102,15세미만,2019,2208,1180,1028,114.8,2208,1180,1028,114.8
'33380, 단양군,'103,15~64세,2019,17615,9406,8209,114.6,17313,9290,8023,115.8
'33380, 단양군,'104,65세이상,2019,8272,3560,4712,75.6,8260,3555,4705,75.6
'33380, 단양군,'126,평균연령,2019,52.1,50,54.2,,52.2,50.1,54.4,
'33380, 단양군,'127,중위연령,2019,56.5,54.4,58.4,,56.7,54.6,58.6,
'33390, 증평군,'000,합계,2019,37493,19247,18246,105.5,36359,18656,17703,105.4
'33390, 증평군,'005,0~4세,2019,1666,835,831,100.5,1646,830,816,101.7
'33390, 증평군,'005001, 0세,2019,279,142,137,103.6,278,141,137,102.9
'33390, 증평군,'005002, 1세,2019,307,144,163,88.3,303,143,160,89.4
'33390, 증평군,'005003, 2세,2019,340,177,163,108.6,335,176,159,110.7
'33390, 증평군,'005004, 3세,2019,385,193,192,100.5,378,191,187,102.1
'33390, 증평군,'005005, 4세,2019,355,179,176,101.7,352,179,173,103.5
'33390, 증평군,'010,5~9세,2019,1977,1002,975,102.8,1964,997,967,103.1
'33390, 증평군,'010001, 5세,2019,387,181,206,87.9,385,181,204,88.7
'33390, 증평군,'010002, 6세,2019,403,211,192,109.9,401,210,191,109.9
'33390, 증평군,'010003, 7세,2019,377,194,183,106,376,194,182,106.6
'33390, 증평군,'010004, 8세,2019,414,205,209,98.1,408,201,207,97.1
'33390, 증평군,'010005, 9세,2019,396,211,185,114.1,394,211,183,115.3
'33390, 증평군,'015,10~14세,2019,1677,884,793,111.5,1676,884,792,111.6
'33390, 증평군,'015001, 10세,2019,356,196,160,122.5,355,196,159,123.3
'33390, 증평군,'015002, 11세,2019,355,184,171,107.6,355,184,171,107.6
'33390, 증평군,'015003, 12세,2019,336,171,165,103.6,336,171,165,103.6
'33390, 증평군,'015004, 13세,2019,286,152,134,113.4,286,152,134,113.4
'33390, 증평군,'015005, 14세,2019,344,181,163,111,344,181,163,111
'33390, 증평군,'020,15~19세,2019,1706,853,853,100,1699,848,851,99.6
'33390, 증평군,'020001, 15세,2019,301,157,144,109,299,155,144,107.6
'33390, 증평군,'020002, 16세,2019,248,132,116,113.8,247,132,115,114.8
'33390, 증평군,'020003, 17세,2019,316,156,160,97.5,315,155,160,96.9
'33390, 증평군,'020004, 18세,2019,362,191,171,111.7,360,190,170,111.8
'33390, 증평군,'020005, 19세,2019,479,217,262,82.8,478,216,262,82.4
'33390, 증평군,'025,20~24세,2019,2393,1253,1140,109.9,2307,1206,1101,109.5
'33390, 증평군,'025001, 20세,2019,459,213,246,86.6,452,209,243,86
'33390, 증평군,'025002, 21세,2019,491,229,262,87.4,480,222,258,86
'33390, 증평군,'025003, 22세,2019,499,256,243,105.3,486,249,237,105.1
'33390, 증평군,'025004, 23세,2019,455,263,192,137,431,251,180,139.4
'33390, 증평군,'025005, 24세,2019,489,292,197,148.2,458,275,183,150.3
'33390, 증평군,'030,25~29세,2019,2485,1481,1004,147.5,2297,1373,924,148.6
'33390, 증평군,'030001, 25세,2019,517,313,204,153.4,474,287,187,153.5
'33390, 증평군,'030002, 26세,2019,542,328,214,153.3,512,309,203,152.2
'33390, 증평군,'030003, 27세,2019,473,277,196,141.3,436,254,182,139.6
'33390, 증평군,'030004, 28세,2019,513,310,203,152.7,478,292,186,157
'33390, 증평군,'030005, 29세,2019,440,253,187,135.3,397,231,166,139.2
'33390, 증평군,'035,30~34세,2019,2318,1271,1047,121.4,2131,1178,953,123.6
'33390, 증평군,'035001, 30세,2019,463,274,189,145,411,243,168,144.6
'33390, 증평군,'035002, 31세,2019,429,219,210,104.3,401,208,193,107.8
'33390, 증평군,'035003, 32세,2019,460,246,214,115,425,233,192,121.4
'33390, 증평군,'035004, 33세,2019,477,254,223,113.9,436,233,203,114.8
'33390, 증평군,'035005, 34세,2019,489,278,211,131.8,458,261,197,132.5
'33390, 증평군,'040,35~39세,2019,2856,1556,1300,119.7,2720,1486,1234,120.4
'33390, 증평군,'040001, 35세,2019,512,285,227,125.6,474,267,207,129
'33390, 증평군,'040002, 36세,2019,594,330,264,125,565,311,254,122.4
'33390, 증평군,'040003, 37세,2019,602,327,275,118.9,575,314,261,120.3
'33390, 증평군,'040004, 38세,2019,571,309,262,117.9,550,300,250,120
'33390, 증평군,'040005, 39세,2019,577,305,272,112.1,556,294,262,112.2
'33390, 증평군,'045,40~44세,2019,2717,1463,1254,116.7,2610,1412,1198,117.9
'33390, 증평군,'045001, 40세,2019,585,311,274,113.5,559,299,260,115
'33390, 증평군,'045002, 41세,2019,523,283,240,117.9,500,270,230,117.4
'33390, 증평군,'045003, 42세,2019,553,299,254,117.7,532,286,246,116.3
'33390, 증평군,'045004, 43세,2019,532,279,253,110.3,512,274,238,115.1
'33390, 증평군,'045005, 44세,2019,524,291,233,124.9,507,283,224,126.3
'33390, 증평군,'050,45~49세,2019,2935,1584,1351,117.2,2837,1530,1307,117.1
'33390, 증평군,'050001, 45세,2019,629,353,276,127.9,608,342,266,128.6
'33390, 증평군,'050002, 46세,2019,588,319,269,118.6,572,311,261,119.2
'33390, 증평군,'050003, 47세,2019,556,286,270,105.9,539,276,263,104.9
'33390, 증평군,'050004, 48세,2019,605,328,277,118.4,589,319,270,118.1
'33390, 증평군,'050005, 49세,2019,557,298,259,115.1,529,282,247,114.2
'33390, 증평군,'055,50~54세,2019,3095,1588,1507,105.4,2995,1543,1452,106.3
'33390, 증평군,'055001, 50세,2019,676,347,329,105.5,654,339,315,107.6
'33390, 증평군,'055002, 51세,2019,637,331,306,108.2,614,317,297,106.7
'33390, 증평군,'055003, 52세,2019,614,314,300,104.7,596,309,287,107.7
'33390, 증평군,'055004, 53세,2019,588,307,281,109.3,566,297,269,110.4
'33390, 증평군,'055005, 54세,2019,580,289,291,99.3,565,281,284,98.9
'33390, 증평군,'060,55~59세,2019,2959,1553,1406,110.5,2882,1511,1371,110.2
'33390, 증평군,'060001, 55세,2019,508,279,229,121.8,493,271,222,122.1
'33390, 증평군,'060002, 56세,2019,536,299,237,126.2,515,285,230,123.9
'33390, 증평군,'060003, 57세,2019,628,339,289,117.3,612,331,281,117.8
'33390, 증평군,'060004, 58세,2019,680,329,351,93.7,665,323,342,94.4
'33390, 증평군,'060005, 59세,2019,607,307,300,102.3,597,301,296,101.7
'33390, 증평군,'065,60~64세,2019,2711,1383,1328,104.1,2652,1348,1304,103.4
'33390, 증평군,'065001, 60세,2019,584,321,263,122.1,566,314,252,124.6
'33390, 증평군,'065002, 61세,2019,541,270,271,99.6,529,261,268,97.4
'33390, 증평군,'065003, 62세,2019,601,319,282,113.1,588,309,279,110.8
'33390, 증평군,'065004, 63세,2019,509,243,266,91.4,500,240,260,92.3
'33390, 증평군,'065005, 64세,2019,476,230,246,93.5,469,224,245,91.4
'33390, 증평군,'070,65~69세,2019,1828,895,933,95.9,1791,874,917,95.3
'33390, 증평군,'070001, 65세,2019,451,216,235,91.9,440,209,231,90.5
'33390, 증평군,'070002, 66세,2019,373,184,189,97.4,366,180,186,96.8
'33390, 증평군,'070003, 67세,2019,440,214,226,94.7,435,211,224,94.2
'33390, 증평군,'070004, 68세,2019,287,140,147,95.2,279,137,142,96.5
'33390, 증평군,'070005, 69세,2019,277,141,136,103.7,271,137,134,102.2
'33390, 증평군,'075,70~74세,2019,1357,639,718,89,1343,631,712,88.6
'33390, 증평군,'075001, 70세,2019,272,131,141,92.9,269,128,141,90.8
'33390, 증평군,'075002, 71세,2019,319,152,167,91,319,152,167,91
'33390, 증평군,'075003, 72세,2019,309,147,162,90.7,304,145,159,91.2
'33390, 증평군,'075004, 73세,2019,216,101,115,87.8,211,98,113,86.7
'33390, 증평군,'075005, 74세,2019,241,108,133,81.2,240,108,132,81.8
'33390, 증평군,'080,75~79세,2019,1277,522,755,69.1,1276,521,755,69
'33390, 증평군,'080001, 75세,2019,247,106,141,75.2,246,105,141,74.5
'33390, 증평군,'080002, 76세,2019,278,108,170,63.5,278,108,170,63.5
'33390, 증평군,'080003, 77세,2019,282,112,170,65.9,282,112,170,65.9
'33390, 증평군,'080004, 78세,2019,255,102,153,66.7,255,102,153,66.7
'33390, 증평군,'080005, 79세,2019,215,94,121,77.7,215,94,121,77.7
'33390, 증평군,'085,80~84세,2019,948,339,609,55.7,947,339,608,55.8
'33390, 증평군,'085001, 80세,2019,216,91,125,72.8,216,91,125,72.8
'33390, 증평군,'085002, 81세,2019,224,77,147,52.4,223,77,146,52.7
'33390, 증평군,'085003, 82세,2019,166,69,97,71.1,166,69,97,71.1
'33390, 증평군,'085004, 83세,2019,187,59,128,46.1,187,59,128,46.1
'33390, 증평군,'085005, 84세,2019,155,43,112,38.4,155,43,112,38.4
'33390, 증평군,'086,85세이상,2019,588,146,442,33,586,145,441,32.9
'33390, 증평군,'090,85~89세,2019,426,104,322,32.3,424,103,321,32.1
'33390, 증평군,'090001, 85세,2019,112,38,74,51.4,112,38,74,51.4
'33390, 증평군,'090002, 86세,2019,119,25,94,26.6,118,24,94,25.5
'33390, 증평군,'090003, 87세,2019,79,13,66,19.7,79,13,66,19.7
'33390, 증평군,'090004, 88세,2019,60,14,46,30.4,60,14,46,30.4
'33390, 증평군,'090005, 89세,2019,56,14,42,33.3,55,14,41,34.1
'33390, 증평군,'095,90~94세,2019,129,36,93,38.7,129,36,93,38.7
'33390, 증평군,'095001, 90세,2019,45,13,32,40.6,45,13,32,40.6
'33390, 증평군,'095002, 91세,2019,29,8,21,38.1,29,8,21,38.1
'33390, 증평군,'095003, 92세,2019,26,9,17,52.9,26,9,17,52.9
'33390, 증평군,'095004, 93세,2019,18,5,13,38.5,18,5,13,38.5
'33390, 증평군,'095005, 94세,2019,11,X,10,10,11,X,10,10
'33390, 증평군,'100,95~99세,2019,27,X,23,17.4,27,X,23,17.4
'33390, 증평군,'100001, 95세,2019,9,X,9,0,9,X,9,0
'33390, 증평군,'100002, 96세,2019,8,X,7,14.3,8,X,7,14.3
'33390, 증평군,'100003, 97세,2019,7,X,X,75,7,X,X,75
'33390, 증평군,'100004, 98세,2019,X,X,X,0,X,X,X,0
'33390, 증평군,'100005, 99세,2019,X,X,X,,X,X,X,
'33390, 증평군,'101,100세이상,2019,6,X,X,50,6,X,X,50
'33390, 증평군,'102,15세미만,2019,5320,2721,2599,104.7,5286,2711,2575,105.3
'33390, 증평군,'103,15~64세,2019,26175,13985,12190,114.7,25130,13435,11695,114.9
'33390, 증평군,'104,65세이상,2019,5998,2541,3457,73.5,5943,2510,3433,73.1
'33390, 증평군,'126,평균연령,2019,42.2,41,43.5,,42.3,41,43.6,
'33390, 증평군,'127,중위연령,2019,43,41.6,44.7,,43.3,41.8,45.1,
'34,충청남도,'000,합계,2019,2188649,1124678,1063971,105.7,2084631,1061585,1023046,103.8
'34,충청남도,'005,0~4세,2019,82712,42212,40500,104.2,80868,41295,39573,104.4
'34,충청남도,'005001, 0세,2019,13783,7029,6754,104.1,13461,6860,6601,103.9
'34,충청남도,'005002, 1세,2019,14920,7579,7341,103.2,14572,7415,7157,103.6
'34,충청남도,'005003, 2세,2019,16289,8398,7891,106.4,15877,8187,7690,106.5
'34,충청남도,'005004, 3세,2019,18318,9302,9016,103.2,17905,9102,8803,103.4
'34,충청남도,'005005, 4세,2019,19402,9904,9498,104.3,19053,9731,9322,104.4
'34,충청남도,'010,5~9세,2019,100919,51978,48941,106.2,99683,51323,48360,106.1
'34,충청남도,'010001, 5세,2019,19021,9756,9265,105.3,18699,9577,9122,105
'34,충청남도,'010002, 6세,2019,19562,9992,9570,104.4,19318,9859,9459,104.2
'34,충청남도,'010003, 7세,2019,21084,10809,10275,105.2,20820,10670,10150,105.1
'34,충청남도,'010004, 8세,2019,20928,10858,10070,107.8,20728,10765,9963,108
'34,충청남도,'010005, 9세,2019,20324,10563,9761,108.2,20118,10452,9666,108.1
'34,충청남도,'015,10~14세,2019,97767,50526,47241,107,97011,50113,46898,106.9
'34,충청남도,'015001, 10세,2019,19437,10043,9394,106.9,19251,9940,9311,106.8
'34,충청남도,'015002, 11세,2019,20360,10454,9906,105.5,20191,10363,9828,105.4
'34,충청남도,'015003, 12세,2019,20596,10717,9879,108.5,20442,10634,9808,108.4
'34,충청남도,'015004, 13세,2019,18978,9811,9167,107,18860,9749,9111,107
'34,충청남도,'015005, 14세,2019,18396,9501,8895,106.8,18267,9427,8840,106.6
'34,충청남도,'020,15~19세,2019,118253,61663,56590,109,115881,60573,55308,109.5
'34,충청남도,'020001, 15세,2019,19855,10299,9556,107.8,19701,10231,9470,108
'34,충청남도,'020002, 16세,2019,20359,10693,9666,110.6,20262,10640,9622,110.6
'34,충청남도,'020003, 17세,2019,20995,11150,9845,113.3,20850,11072,9778,113.2
'34,충청남도,'020004, 18세,2019,25554,13368,12186,109.7,24909,13091,11818,110.8
'34,충청남도,'020005, 19세,2019,31490,16153,15337,105.3,30159,15539,14620,106.3
'34,충청남도,'025,20~24세,2019,146308,79091,67217,117.7,133469,71675,61794,116
'34,충청남도,'025001, 20세,2019,29265,14527,14738,98.6,27422,13626,13796,98.8
'34,충청남도,'025002, 21세,2019,29542,15155,14387,105.3,27188,13896,13292,104.5
'34,충청남도,'025003, 22세,2019,30002,16024,13978,114.6,27434,14549,12885,112.9
'34,충청남도,'025004, 23세,2019,29321,16823,12498,134.6,26388,15046,11342,132.7
'34,충청남도,'025005, 24세,2019,28178,16562,11616,142.6,25037,14558,10479,138.9
'34,충청남도,'030,25~29세,2019,136534,78016,58518,133.3,119097,66494,52603,126.4
'34,충청남도,'030001, 25세,2019,27457,16059,11398,140.9,24079,13847,10232,135.3
'34,충청남도,'030002, 26세,2019,27653,15617,12036,129.8,24329,13385,10944,122.3
'34,충청남도,'030003, 27세,2019,28258,16033,12225,131.1,24751,13698,11053,123.9
'34,충청남도,'030004, 28세,2019,26502,15086,11416,132.1,22971,12768,10203,125.1
'34,충청남도,'030005, 29세,2019,26664,15221,11443,133,22967,12796,10171,125.8
'34,충청남도,'035,30~34세,2019,137629,76834,60795,126.4,119934,65204,54730,119.1
'34,충청남도,'035001, 30세,2019,26498,15197,11301,134.5,22864,12743,10121,125.9
'34,충청남도,'035002, 31세,2019,27194,15191,12003,126.6,23535,12792,10743,119.1
'34,충청남도,'035003, 32세,2019,27942,15462,12480,123.9,24225,13030,11195,116.4
'34,충청남도,'035004, 33세,2019,27820,15360,12460,123.3,24433,13181,11252,117.1
'34,충청남도,'035005, 34세,2019,28175,15624,12551,124.5,24877,13458,11419,117.9
'34,충청남도,'040,35~39세,2019,167421,90855,76566,118.7,153827,82016,71811,114.2
'34,충청남도,'040001, 35세,2019,29515,16066,13449,119.5,26452,14066,12386,113.6
'34,충청남도,'040002, 36세,2019,32275,17604,14671,120,29411,15722,13689,114.9
'34,충청남도,'040003, 37세,2019,35405,19149,16256,117.8,32590,17326,15264,113.5
'34,충청남도,'040004, 38세,2019,34591,18837,15754,119.6,32118,17271,14847,116.3
'34,충청남도,'040005, 39세,2019,35635,19199,16436,116.8,33256,17631,15625,112.8
'34,충청남도,'045,40~44세,2019,158686,85226,73460,116,149050,79096,69954,113.1
'34,충청남도,'045001, 40세,2019,33298,17984,15314,117.4,30953,16453,14500,113.5
'34,충청남도,'045002, 41세,2019,30697,16772,13925,120.4,28711,15500,13211,117.3
'34,충청남도,'045003, 42세,2019,31698,17012,14686,115.8,29860,15864,13996,113.3
'34,충청남도,'045004, 43세,2019,30915,16522,14393,114.8,29119,15387,13732,112.1
'34,충청남도,'045005, 44세,2019,32078,16936,15142,111.8,30407,15892,14515,109.5
'34,충청남도,'050,45~49세,2019,175448,94308,81140,116.2,166931,89161,77770,114.6
'34,충청남도,'050001, 45세,2019,35100,18861,16239,116.1,33447,17821,15626,114
'34,충청남도,'050002, 46세,2019,35005,18672,16333,114.3,33357,17682,15675,112.8
'34,충청남도,'050003, 47세,2019,33759,18237,15522,117.5,31958,17148,14810,115.8
'34,충청남도,'050004, 48세,2019,36837,19919,16918,117.7,35102,18871,16231,116.3
'34,충청남도,'050005, 49세,2019,34747,18619,16128,115.4,33067,17639,15428,114.3
'34,충청남도,'055,50~54세,2019,169756,89458,80298,111.4,162996,85764,77232,111
'34,충청남도,'055001, 50세,2019,36438,19289,17149,112.5,34935,18455,16480,112
'34,충청남도,'055002, 51세,2019,35854,18799,17055,110.2,34405,17980,16425,109.5
'34,충청남도,'055003, 52세,2019,32717,17133,15584,109.9,31492,16445,15047,109.3
'34,충청남도,'055004, 53세,2019,30231,16093,14138,113.8,28988,15436,13552,113.9
'34,충청남도,'055005, 54세,2019,34516,18144,16372,110.8,33176,17448,15728,110.9
'34,충청남도,'060,55~59세,2019,172052,89402,82650,108.2,166904,86733,80171,108.2
'34,충청남도,'060001, 55세,2019,30692,16125,14567,110.7,29510,15481,14029,110.3
'34,충청남도,'060002, 56세,2019,31972,16906,15066,112.2,30638,16218,14420,112.5
'34,충청남도,'060003, 57세,2019,33866,17856,16010,111.5,32838,17311,15527,111.5
'34,충청남도,'060004, 58세,2019,38300,19799,18501,107,37586,19435,18151,107.1
'34,충청남도,'060005, 59세,2019,37222,18716,18506,101.1,36332,18288,18044,101.4
'34,충청남도,'065,60~64세,2019,148630,74683,73947,101,145294,72967,72327,100.9
'34,충청남도,'065001, 60세,2019,32165,16104,16061,100.3,31450,15747,15703,100.3
'34,충청남도,'065002, 61세,2019,29765,14953,14812,101,29023,14566,14457,100.8
'34,충청남도,'065003, 62세,2019,29777,15281,14496,105.4,29054,14869,14185,104.8
'34,충청남도,'065004, 63세,2019,27692,13846,13846,100,27092,13551,13541,100.1
'34,충청남도,'065005, 64세,2019,29231,14499,14732,98.4,28675,14234,14441,98.6
'34,충청남도,'070,65~69세,2019,106388,51796,54592,94.9,104782,51007,53775,94.9
'34,충청남도,'070001, 65세,2019,24550,11967,12583,95.1,24071,11744,12327,95.3
'34,충청남도,'070002, 66세,2019,20213,9941,10272,96.8,19849,9755,10094,96.6
'34,충청남도,'070003, 67세,2019,23194,11249,11945,94.2,22882,11102,11780,94.2
'34,충청남도,'070004, 68세,2019,18038,8850,9188,96.3,17792,8714,9078,96
'34,충청남도,'070005, 69세,2019,20393,9789,10604,92.3,20188,9692,10496,92.3
'34,충청남도,'075,70~74세,2019,85117,40576,44541,91.1,84475,40317,44158,91.3
'34,충청남도,'075001, 70세,2019,20377,9873,10504,94,20164,9782,10382,94.2
'34,충청남도,'075002, 71세,2019,18971,9114,9857,92.5,18858,9064,9794,92.5
'34,충청남도,'075003, 72세,2019,18676,8873,9803,90.5,18535,8823,9712,90.8
'34,충청남도,'075004, 73세,2019,13461,6551,6910,94.8,13365,6515,6850,95.1
'34,충청남도,'075005, 74세,2019,13632,6165,7467,82.6,13553,6133,7420,82.7
'34,충청남도,'080,75~79세,2019,78007,32333,45674,70.8,77697,32218,45479,70.8
'34,충청남도,'080001, 75세,2019,15114,6485,8629,75.2,15036,6460,8576,75.3
'34,충청남도,'080002, 76세,2019,15227,6576,8651,76,15166,6550,8616,76
'34,충청남도,'080003, 77세,2019,19740,8088,11652,69.4,19681,8062,11619,69.4
'34,충청남도,'080004, 78세,2019,14523,5874,8649,67.9,14460,5853,8607,68
'34,충청남도,'080005, 79세,2019,13403,5310,8093,65.6,13354,5293,8061,65.7
'34,충청남도,'085,80~84세,2019,62787,23002,39785,57.8,62605,22954,39651,57.9
'34,충청남도,'085001, 80세,2019,14706,5644,9062,62.3,14668,5635,9033,62.4
'34,충청남도,'085002, 81세,2019,13385,4996,8389,59.6,13340,4985,8355,59.7
'34,충청남도,'085003, 82세,2019,12358,4592,7766,59.1,12312,4580,7732,59.2
'34,충청남도,'085004, 83세,2019,11569,4161,7408,56.2,11542,4151,7391,56.2
'34,충청남도,'085005, 84세,2019,10769,3609,7160,50.4,10743,3603,7140,50.5
'34,충청남도,'086,85세이상,2019,44235,12719,31516,40.4,44127,12675,31452,40.3
'34,충청남도,'090,85~89세,2019,31609,9854,21755,45.3,31533,9822,21711,45.2
'34,충청남도,'090001, 85세,2019,8847,3039,5808,52.3,8827,3029,5798,52.2
'34,충청남도,'090002, 86세,2019,7497,2412,5085,47.4,7480,2408,5072,47.5
'34,충청남도,'090003, 87세,2019,6712,2092,4620,45.3,6696,2083,4613,45.2
'34,충청남도,'090004, 88세,2019,4546,1262,3284,38.4,4534,1255,3279,38.3
'34,충청남도,'090005, 89세,2019,4007,1049,2958,35.5,3996,1047,2949,35.5
'34,충청남도,'095,90~94세,2019,10102,2396,7706,31.1,10078,2386,7692,31
'34,충청남도,'095001, 90세,2019,3293,826,2467,33.5,3284,822,2462,33.4
'34,충청남도,'095002, 91세,2019,2641,627,2014,31.1,2635,625,2010,31.1
'34,충청남도,'095003, 92세,2019,1877,457,1420,32.2,1871,454,1417,32
'34,충청남도,'095004, 93세,2019,1279,269,1010,26.6,1278,269,1009,26.7
'34,충청남도,'095005, 94세,2019,1012,217,795,27.3,1010,216,794,27.2
'34,충청남도,'100,95~99세,2019,2229,424,1805,23.5,2221,422,1799,23.5
'34,충청남도,'100001, 95세,2019,671,136,535,25.4,670,136,534,25.5
'34,충청남도,'100002, 96세,2019,665,125,540,23.1,663,125,538,23.2
'34,충청남도,'100003, 97세,2019,460,78,382,20.4,457,77,380,20.3
'34,충청남도,'100004, 98세,2019,263,58,205,28.3,263,58,205,28.3
'34,충청남도,'100005, 99세,2019,170,27,143,18.9,168,26,142,18.3
'34,충청남도,'101,100세이상,2019,295,45,250,18,295,45,250,18
'34,충청남도,'102,15세미만,2019,281398,144716,136682,105.9,277562,142731,134831,105.9
'34,충청남도,'103,15~64세,2019,1530717,819536,711181,115.2,1433383,759683,673700,112.8
'34,충청남도,'104,65세이상,2019,376534,160426,216108,74.2,373686,159171,214515,74.2
'34,충청남도,'126,평균연령,2019,42.8,41.4,44.3,,43.1,41.8,44.6,
'34,충청남도,'127,중위연령,2019,43.4,41.8,45.1,,44.1,42.6,45.7,
'34004, 읍부,'000,합계,2019,509047,262579,246468,106.5,487871,249601,238270,104.8
'34004, 읍부,'005,0~4세,2019,18843,9629,9214,104.5,18586,9481,9105,104.1
'34004, 읍부,'005001, 0세,2019,3151,1620,1531,105.8,3105,1591,1514,105.1
'34004, 읍부,'005002, 1세,2019,3371,1710,1661,103,3325,1686,1639,102.9
'34004, 읍부,'005003, 2세,2019,3702,1882,1820,103.4,3641,1852,1789,103.5
'34004, 읍부,'005004, 3세,2019,4109,2089,2020,103.4,4056,2055,2001,102.7
'34004, 읍부,'005005, 4세,2019,4510,2328,2182,106.7,4459,2297,2162,106.2
'34004, 읍부,'010,5~9세,2019,23794,12334,11460,107.6,23591,12213,11378,107.3
'34004, 읍부,'010001, 5세,2019,4364,2230,2134,104.5,4308,2196,2112,104
'34004, 읍부,'010002, 6세,2019,4548,2376,2172,109.4,4510,2352,2158,109
'34004, 읍부,'010003, 7세,2019,5011,2571,2440,105.4,4979,2555,2424,105.4
'34004, 읍부,'010004, 8세,2019,4949,2577,2372,108.6,4915,2560,2355,108.7
'34004, 읍부,'010005, 9세,2019,4922,2580,2342,110.2,4879,2550,2329,109.5
'34004, 읍부,'015,10~14세,2019,23902,12359,11543,107.1,23778,12288,11490,106.9
'34004, 읍부,'015001, 10세,2019,4781,2510,2271,110.5,4748,2492,2256,110.5
'34004, 읍부,'015002, 11세,2019,4970,2570,2400,107.1,4943,2553,2390,106.8
'34004, 읍부,'015003, 12세,2019,5105,2622,2483,105.6,5081,2608,2473,105.5
'34004, 읍부,'015004, 13세,2019,4580,2367,2213,107,4567,2361,2206,107
'34004, 읍부,'015005, 14세,2019,4466,2290,2176,105.2,4439,2274,2165,105
'34004, 읍부,'020,15~19세,2019,29307,15238,14069,108.3,28777,14992,13785,108.8
'34004, 읍부,'020001, 15세,2019,4908,2476,2432,101.8,4870,2461,2409,102.2
'34004, 읍부,'020002, 16세,2019,5449,2836,2613,108.5,5429,2826,2603,108.6
'34004, 읍부,'020003, 17세,2019,5651,2926,2725,107.4,5618,2905,2713,107.1
'34004, 읍부,'020004, 18세,2019,6267,3303,2964,111.4,6113,3229,2884,112
'34004, 읍부,'020005, 19세,2019,7032,3697,3335,110.9,6747,3571,3176,112.4
'34004, 읍부,'025,20~24세,2019,31590,17747,13843,128.2,29110,16285,12825,127
'34004, 읍부,'025001, 20세,2019,6466,3307,3159,104.7,6173,3175,2998,105.9
'34004, 읍부,'025002, 21세,2019,6419,3454,2965,116.5,5972,3233,2739,118
'34004, 읍부,'025003, 22세,2019,6464,3594,2870,125.2,5938,3286,2652,123.9
'34004, 읍부,'025004, 23세,2019,6310,3775,2535,148.9,5722,3399,2323,146.3
'34004, 읍부,'025005, 24세,2019,5931,3617,2314,156.3,5305,3192,2113,151.1
'34004, 읍부,'030,25~29세,2019,28611,16608,12003,138.4,25013,14258,10755,132.6
'34004, 읍부,'030001, 25세,2019,5698,3441,2257,152.5,5048,3003,2045,146.8
'34004, 읍부,'030002, 26세,2019,5762,3277,2485,131.9,5045,2805,2240,125.2
'34004, 읍부,'030003, 27세,2019,5917,3414,2503,136.4,5156,2909,2247,129.5
'34004, 읍부,'030004, 28세,2019,5630,3246,2384,136.2,4923,2807,2116,132.7
'34004, 읍부,'030005, 29세,2019,5604,3230,2374,136.1,4841,2734,2107,129.8
'34004, 읍부,'035,30~34세,2019,29719,16601,13118,126.6,25919,14055,11864,118.5
'34004, 읍부,'035001, 30세,2019,5750,3298,2452,134.5,4947,2755,2192,125.7
'34004, 읍부,'035002, 31세,2019,5841,3268,2573,127,5065,2735,2330,117.4
'34004, 읍부,'035003, 32세,2019,5941,3254,2687,121.1,5178,2748,2430,113.1
'34004, 읍부,'035004, 33세,2019,6041,3377,2664,126.8,5306,2887,2419,119.3
'34004, 읍부,'035005, 34세,2019,6146,3404,2742,124.1,5423,2930,2493,117.5
'34004, 읍부,'040,35~39세,2019,38034,20643,17391,118.7,35188,18766,16422,114.3
'34004, 읍부,'040001, 35세,2019,6602,3605,2997,120.3,5969,3182,2787,114.2
'34004, 읍부,'040002, 36세,2019,7246,3949,3297,119.8,6627,3529,3098,113.9
'34004, 읍부,'040003, 37세,2019,7970,4230,3740,113.1,7398,3846,3552,108.3
'34004, 읍부,'040004, 38세,2019,7875,4351,3524,123.5,7360,4034,3326,121.3
'34004, 읍부,'040005, 39세,2019,8341,4508,3833,117.6,7834,4175,3659,114.1
'34004, 읍부,'045,40~44세,2019,37678,20161,17517,115.1,35743,18930,16813,112.6
'34004, 읍부,'045001, 40세,2019,7698,4129,3569,115.7,7252,3843,3409,112.7
'34004, 읍부,'045002, 41세,2019,7240,3915,3325,117.7,6849,3657,3192,114.6
'34004, 읍부,'045003, 42세,2019,7625,4078,3547,115,7247,3836,3411,112.5
'34004, 읍부,'045004, 43세,2019,7348,3938,3410,115.5,6979,3704,3275,113.1
'34004, 읍부,'045005, 44세,2019,7767,4101,3666,111.9,7416,3890,3526,110.3
'34004, 읍부,'050,45~49세,2019,42343,23026,19317,119.2,40618,21971,18647,117.8
'34004, 읍부,'050001, 45세,2019,8351,4503,3848,117,8013,4284,3729,114.9
'34004, 읍부,'050002, 46세,2019,8469,4580,3889,117.8,8129,4377,3752,116.7
'34004, 읍부,'050003, 47세,2019,8273,4565,3708,123.1,7912,4342,3570,121.6
'34004, 읍부,'050004, 48세,2019,8754,4765,3989,119.5,8425,4563,3862,118.2
'34004, 읍부,'050005, 49세,2019,8496,4613,3883,118.8,8139,4405,3734,118
'34004, 읍부,'055,50~54세,2019,40036,21460,18576,115.5,38677,20727,17950,115.5
'34004, 읍부,'055001, 50세,2019,8705,4695,4010,117.1,8398,4529,3869,117.1
'34004, 읍부,'055002, 51세,2019,8421,4544,3877,117.2,8128,4373,3755,116.5
'34004, 읍부,'055003, 52세,2019,7660,4096,3564,114.9,7413,3961,3452,114.7
'34004, 읍부,'055004, 53세,2019,7108,3807,3301,115.3,6868,3680,3188,115.4
'34004, 읍부,'055005, 54세,2019,8142,4318,3824,112.9,7870,4184,3686,113.5
'34004, 읍부,'060,55~59세,2019,40436,21040,19396,108.5,39395,20516,18879,108.7
'34004, 읍부,'060001, 55세,2019,7225,3822,3403,112.3,6994,3702,3292,112.5
'34004, 읍부,'060002, 56세,2019,7453,3946,3507,112.5,7210,3835,3375,113.6
'34004, 읍부,'060003, 57세,2019,7861,4179,3682,113.5,7632,4056,3576,113.4
'34004, 읍부,'060004, 58세,2019,9068,4654,4414,105.4,8921,4574,4347,105.2
'34004, 읍부,'060005, 59세,2019,8829,4439,4390,101.1,8638,4349,4289,101.4
'34004, 읍부,'065,60~64세,2019,35493,17648,17845,98.9,34822,17307,17515,98.8
'34004, 읍부,'065001, 60세,2019,7610,3759,3851,97.6,7453,3683,3770,97.7
'34004, 읍부,'065002, 61세,2019,7074,3521,3553,99.1,6919,3437,3482,98.7
'34004, 읍부,'065003, 62세,2019,7279,3741,3538,105.7,7133,3664,3469,105.6
'34004, 읍부,'065004, 63세,2019,6569,3264,3305,98.8,6454,3207,3247,98.8
'34004, 읍부,'065005, 64세,2019,6961,3363,3598,93.5,6863,3316,3547,93.5
'34004, 읍부,'070,65~69세,2019,25882,12363,13519,91.4,25544,12188,13356,91.3
'34004, 읍부,'070001, 65세,2019,5983,2872,3111,92.3,5871,2821,3050,92.5
'34004, 읍부,'070002, 66세,2019,4842,2351,2491,94.4,4781,2318,2463,94.1
'34004, 읍부,'070003, 67세,2019,5615,2659,2956,90,5558,2629,2929,89.8
'34004, 읍부,'070004, 68세,2019,4482,2149,2333,92.1,4417,2116,2301,92
'34004, 읍부,'070005, 69세,2019,4960,2332,2628,88.7,4917,2304,2613,88.2
'34004, 읍부,'075,70~74세,2019,20931,10001,10930,91.5,20794,9953,10841,91.8
'34004, 읍부,'075001, 70세,2019,4925,2357,2568,91.8,4875,2337,2538,92.1
'34004, 읍부,'075002, 71세,2019,4693,2241,2452,91.4,4676,2236,2440,91.6
'34004, 읍부,'075003, 72세,2019,4615,2205,2410,91.5,4584,2197,2387,92
'34004, 읍부,'075004, 73세,2019,3372,1647,1725,95.5,3348,1637,1711,95.7
'34004, 읍부,'075005, 74세,2019,3326,1551,1775,87.4,3311,1546,1765,87.6
'34004, 읍부,'080,75~79세,2019,18292,7679,10613,72.4,18221,7646,10575,72.3
'34004, 읍부,'080001, 75세,2019,3604,1557,2047,76.1,3587,1553,2034,76.4
'34004, 읍부,'080002, 76세,2019,3683,1589,2094,75.9,3669,1581,2088,75.7
'34004, 읍부,'080003, 77세,2019,4563,1909,2654,71.9,4550,1901,2649,71.8
'34004, 읍부,'080004, 78세,2019,3367,1380,1987,69.5,3354,1373,1981,69.3
'34004, 읍부,'080005, 79세,2019,3075,1244,1831,67.9,3061,1238,1823,67.9
'34004, 읍부,'085,80~84세,2019,14230,5220,9010,57.9,14190,5209,8981,58
'34004, 읍부,'085001, 80세,2019,3402,1309,2093,62.5,3397,1307,2090,62.5
'34004, 읍부,'085002, 81세,2019,3028,1152,1876,61.4,3020,1150,1870,61.5
'34004, 읍부,'085003, 82세,2019,2787,1015,1772,57.3,2773,1010,1763,57.3
'34004, 읍부,'085004, 83세,2019,2588,944,1644,57.4,2579,943,1636,57.6
'34004, 읍부,'085005, 84세,2019,2425,800,1625,49.2,2421,799,1622,49.3
'34004, 읍부,'086,85세이상,2019,9926,2822,7104,39.7,9905,2816,7089,39.7
'34004, 읍부,'090,85~89세,2019,7023,2156,4867,44.3,7012,2154,4858,44.3
'34004, 읍부,'090001, 85세,2019,1949,645,1304,49.5,1946,645,1301,49.6
'34004, 읍부,'090002, 86세,2019,1679,539,1140,47.3,1676,538,1138,47.3
'34004, 읍부,'090003, 87세,2019,1515,459,1056,43.5,1514,459,1055,43.5
'34004, 읍부,'090004, 88세,2019,994,272,722,37.7,992,271,721,37.6
'34004, 읍부,'090005, 89세,2019,886,241,645,37.4,884,241,643,37.5
'34004, 읍부,'095,90~94세,2019,2297,550,1747,31.5,2291,546,1745,31.3
'34004, 읍부,'095001, 90세,2019,749,202,547,36.9,748,202,546,37
'34004, 읍부,'095002, 91세,2019,593,135,458,29.5,590,133,457,29.1
'34004, 읍부,'095003, 92세,2019,425,101,324,31.2,423,99,324,30.6
'34004, 읍부,'095004, 93세,2019,288,66,222,29.7,288,66,222,29.7
'34004, 읍부,'095005, 94세,2019,242,46,196,23.5,242,46,196,23.5
'34004, 읍부,'100,95~99세,2019,539,107,432,24.8,535,107,428,25
'34004, 읍부,'100001, 95세,2019,170,35,135,25.9,170,35,135,25.9
'34004, 읍부,'100002, 96세,2019,164,32,132,24.2,163,32,131,24.4
'34004, 읍부,'100003, 97세,2019,102,15,87,17.2,100,15,85,17.6
'34004, 읍부,'100004, 98세,2019,70,19,51,37.3,70,19,51,37.3
'34004, 읍부,'100005, 99세,2019,33,6,27,22.2,32,6,26,23.1
'34004, 읍부,'101,100세이상,2019,67,9,58,15.5,67,9,58,15.5
'34004, 읍부,'102,15세미만,2019,66539,34322,32217,106.5,65955,33982,31973,106.3
'34004, 읍부,'103,15~64세,2019,353247,190172,163075,116.6,333262,177807,155455,114.4
'34004, 읍부,'104,65세이상,2019,89261,38085,51176,74.4,88654,37812,50842,74.4
'34004, 읍부,'126,평균연령,2019,43.1,41.6,44.6,,43.3,41.9,44.8,
'34004, 읍부,'127,중위연령,2019,44.1,42.5,45.8,,44.8,43.3,46.3,
'34005, 면부,'000,합계,2019,671818,352947,318871,110.7,621192,319076,302116,105.6
'34005, 면부,'005,0~4세,2019,16539,8462,8077,104.8,15823,8133,7690,105.8
'34005, 면부,'005001, 0세,2019,2677,1360,1317,103.3,2557,1312,1245,105.4
'34005, 면부,'005002, 1세,2019,3003,1513,1490,101.5,2860,1448,1412,102.5
'34005, 면부,'005003, 2세,2019,3243,1671,1572,106.3,3098,1598,1500,106.5
'34005, 면부,'005004, 3세,2019,3714,1900,1814,104.7,3537,1822,1715,106.2
'34005, 면부,'005005, 4세,2019,3902,2018,1884,107.1,3771,1953,1818,107.4
'34005, 면부,'010,5~9세,2019,20740,10676,10064,106.1,20240,10416,9824,106
'34005, 면부,'010001, 5세,2019,3975,1997,1978,101,3844,1922,1922,100
'34005, 면부,'010002, 6세,2019,3910,1996,1914,104.3,3814,1942,1872,103.7
'34005, 면부,'010003, 7세,2019,4280,2240,2040,109.8,4176,2187,1989,110
'34005, 면부,'010004, 8세,2019,4339,2257,2082,108.4,4253,2218,2035,109
'34005, 면부,'010005, 9세,2019,4236,2186,2050,106.6,4153,2147,2006,107
'34005, 면부,'015,10~14세,2019,20352,10519,9833,107,20024,10340,9684,106.8
'34005, 면부,'015001, 10세,2019,4039,2104,1935,108.7,3957,2059,1898,108.5
'34005, 면부,'015002, 11세,2019,4236,2149,2087,103,4160,2110,2050,102.9
'34005, 면부,'015003, 12세,2019,4200,2236,1964,113.8,4133,2202,1931,114
'34005, 면부,'015004, 13세,2019,4024,2054,1970,104.3,3970,2021,1949,103.7
'34005, 면부,'015005, 14세,2019,3853,1976,1877,105.3,3804,1948,1856,105
'34005, 면부,'020,15~19세,2019,28494,15279,13215,115.6,27608,14838,12770,116.2
'34005, 면부,'020001, 15세,2019,4082,2135,1947,109.7,4024,2109,1915,110.1
'34005, 면부,'020002, 16세,2019,4386,2336,2050,114,4341,2309,2032,113.6
'34005, 면부,'020003, 17세,2019,4191,2280,1911,119.3,4135,2248,1887,119.1
'34005, 면부,'020004, 18세,2019,6102,3262,2840,114.9,5872,3151,2721,115.8
'34005, 면부,'020005, 19세,2019,9733,5266,4467,117.9,9236,5021,4215,119.1
'34005, 면부,'025,20~24세,2019,42017,24141,17876,135,34671,19584,15087,129.8
'34005, 면부,'025001, 20세,2019,8548,4190,4358,96.1,7613,3690,3923,94.1
'34005, 면부,'025002, 21세,2019,8371,4265,4106,103.9,7023,3497,3526,99.2
'34005, 면부,'025003, 22세,2019,8641,5003,3638,137.5,7166,4108,3058,134.3
'34005, 면부,'025004, 23세,2019,8357,5316,3041,174.8,6659,4219,2440,172.9
'34005, 면부,'025005, 24세,2019,8100,5367,2733,196.4,6210,4070,2140,190.2
'34005, 면부,'030,25~29세,2019,36906,23408,13498,173.4,26846,16122,10724,150.3
'34005, 면부,'030001, 25세,2019,7578,4924,2654,185.5,5553,3482,2071,168.1
'34005, 면부,'030002, 26세,2019,7405,4645,2760,168.3,5454,3211,2243,143.2
'34005, 면부,'030003, 27세,2019,7512,4757,2755,172.7,5480,3286,2194,149.8
'34005, 면부,'030004, 28세,2019,7073,4464,2609,171.1,5077,3005,2072,145
'34005, 면부,'030005, 29세,2019,7338,4618,2720,169.8,5282,3138,2144,146.4
'34005, 면부,'035,30~34세,2019,35488,22120,13368,165.5,26144,15338,10806,141.9
'34005, 면부,'035001, 30세,2019,7051,4546,2505,181.5,5095,3074,2021,152.1
'34005, 면부,'035002, 31세,2019,7098,4379,2719,161.1,5115,2964,2151,137.8
'34005, 면부,'035003, 32세,2019,7290,4539,2751,165,5331,3114,2217,140.5
'34005, 면부,'035004, 33세,2019,6956,4299,2657,161.8,5229,3078,2151,143.1
'34005, 면부,'035005, 34세,2019,7093,4357,2736,159.2,5374,3108,2266,137.2
'34005, 면부,'040,35~39세,2019,39760,23833,15927,149.6,32745,18851,13894,135.7
'34005, 면부,'040001, 35세,2019,7201,4334,2867,151.2,5617,3183,2434,130.8
'34005, 면부,'040002, 36세,2019,7709,4631,3078,150.5,6204,3551,2653,133.8
'34005, 면부,'040003, 37세,2019,8433,5123,3310,154.8,6976,4096,2880,142.2
'34005, 면부,'040004, 38세,2019,8152,4845,3307,146.5,6857,3941,2916,135.2
'34005, 면부,'040005, 39세,2019,8265,4900,3365,145.6,7091,4080,3011,135.5
'34005, 면부,'045,40~44세,2019,37846,22582,15264,147.9,33165,19370,13795,140.4
'34005, 면부,'045001, 40세,2019,7850,4679,3171,147.6,6691,3864,2827,136.7
'34005, 면부,'045002, 41세,2019,7285,4384,2901,151.1,6301,3715,2586,143.7
'34005, 면부,'045003, 42세,2019,7480,4482,2998,149.5,6563,3855,2708,142.4
'34005, 면부,'045004, 43세,2019,7506,4471,3035,147.3,6643,3887,2756,141
'34005, 면부,'045005, 44세,2019,7725,4566,3159,144.5,6967,4049,2918,138.8
'34005, 면부,'050,45~49세,2019,43972,25988,17984,144.5,40288,23561,16727,140.9
'34005, 면부,'050001, 45세,2019,8572,5150,3422,150.5,7797,4629,3168,146.1
'34005, 면부,'050002, 46세,2019,8622,5071,3551,142.8,7917,4602,3315,138.8
'34005, 면부,'050003, 47세,2019,8527,5057,3470,145.7,7733,4525,3208,141.1
'34005, 면부,'050004, 48세,2019,9404,5553,3851,144.2,8663,5070,3593,141.1
'34005, 면부,'050005, 49세,2019,8847,5157,3690,139.8,8178,4735,3443,137.5
'34005, 면부,'055,50~54세,2019,48420,26900,21520,125,45852,25363,20489,123.8
'34005, 면부,'055001, 50세,2019,9784,5540,4244,130.5,9199,5188,4011,129.3
'34005, 면부,'055002, 51세,2019,9875,5507,4368,126.1,9316,5166,4150,124.5
'34005, 면부,'055003, 52세,2019,9300,5145,4155,123.8,8805,4834,3971,121.7
'34005, 면부,'055004, 53세,2019,8935,4916,4019,122.3,8464,4637,3827,121.2
'34005, 면부,'055005, 54세,2019,10526,5792,4734,122.3,10068,5538,4530,122.3
'34005, 면부,'060,55~59세,2019,59281,31050,28231,110,57522,30055,27467,109.4
'34005, 면부,'060001, 55세,2019,9768,5197,4571,113.7,9351,4943,4408,112.1
'34005, 면부,'060002, 56세,2019,10361,5599,4762,117.6,9900,5332,4568,116.7
'34005, 면부,'060003, 57세,2019,11633,6141,5492,111.8,11265,5938,5327,111.5
'34005, 면부,'060004, 58세,2019,13725,7108,6617,107.4,13491,6986,6505,107.4
'34005, 면부,'060005, 59세,2019,13794,7005,6789,103.2,13515,6856,6659,103
'34005, 면부,'065,60~64세,2019,58976,30023,28953,103.7,58000,29469,28531,103.3
'34005, 면부,'065001, 60세,2019,12118,6188,5930,104.4,11909,6073,5836,104.1
'34005, 면부,'065002, 61세,2019,11558,5806,5752,100.9,11328,5681,5647,100.6
'34005, 면부,'065003, 62세,2019,11700,6038,5662,106.6,11508,5909,5599,105.5
'34005, 면부,'065004, 63세,2019,11427,5807,5620,103.3,11262,5725,5537,103.4
'34005, 면부,'065005, 64세,2019,12173,6184,5989,103.3,11993,6081,5912,102.9
'34005, 면부,'070,65~69세,2019,46583,23085,23498,98.2,46165,22883,23282,98.3
'34005, 면부,'070001, 65세,2019,10478,5196,5282,98.4,10351,5135,5216,98.4
'34005, 면부,'070002, 66세,2019,8748,4344,4404,98.6,8650,4296,4354,98.7
'34005, 면부,'070003, 67세,2019,9970,4937,5033,98.1,9890,4904,4986,98.4
'34005, 면부,'070004, 68세,2019,8088,4011,4077,98.4,8038,3981,4057,98.1
'34005, 면부,'070005, 69세,2019,9299,4597,4702,97.8,9236,4567,4669,97.8
'34005, 면부,'075,70~74세,2019,39015,18925,20090,94.2,38851,18855,19996,94.3
'34005, 면부,'075001, 70세,2019,9318,4627,4691,98.6,9270,4608,4662,98.8
'34005, 면부,'075002, 71세,2019,8667,4262,4405,96.8,8634,4246,4388,96.8
'34005, 면부,'075003, 72세,2019,8549,4144,4405,94.1,8520,4133,4387,94.2
'34005, 면부,'075004, 73세,2019,6059,2981,3078,96.8,6034,2969,3065,96.9
'34005, 면부,'075005, 74세,2019,6422,2911,3511,82.9,6393,2899,3494,83
'34005, 면부,'080,75~79세,2019,39301,16307,22994,70.9,39214,16277,22937,71
'34005, 면부,'080001, 75세,2019,7291,3149,4142,76,7275,3144,4131,76.1
'34005, 면부,'080002, 76세,2019,7487,3230,4257,75.9,7473,3222,4251,75.8
'34005, 면부,'080003, 77세,2019,10093,4151,5942,69.9,10074,4146,5928,69.9
'34005, 면부,'080004, 78세,2019,7453,3012,4441,67.8,7427,3005,4422,68
'34005, 면부,'080005, 79세,2019,6977,2765,4212,65.6,6965,2760,4205,65.6
'34005, 면부,'085,80~84세,2019,33840,12509,21331,58.6,33785,12496,21289,58.7
'34005, 면부,'085001, 80세,2019,7766,2973,4793,62,7751,2970,4781,62.1
'34005, 면부,'085002, 81세,2019,7172,2666,4506,59.2,7159,2662,4497,59.2
'34005, 면부,'085003, 82세,2019,6599,2503,4096,61.1,6588,2501,4087,61.2
'34005, 면부,'085004, 83세,2019,6380,2349,4031,58.3,6373,2345,4028,58.2
'34005, 면부,'085005, 84세,2019,5923,2018,3905,51.7,5914,2018,3896,51.8
'34005, 면부,'086,85세이상,2019,24288,7140,17148,41.6,24249,7125,17124,41.6
'34005, 면부,'090,85~89세,2019,17552,5587,11965,46.7,17525,5577,11948,46.7
'34005, 면부,'090001, 85세,2019,4943,1708,3235,52.8,4939,1706,3233,52.8
'34005, 면부,'090002, 86세,2019,4164,1369,2795,49,4155,1367,2788,49
'34005, 면부,'090003, 87세,2019,3705,1189,2516,47.3,3700,1186,2514,47.2
'34005, 면부,'090004, 88세,2019,2548,734,1814,40.5,2543,731,1812,40.3
'34005, 면부,'090005, 89세,2019,2192,587,1605,36.6,2188,587,1601,36.7
'34005, 면부,'095,90~94세,2019,5413,1314,4099,32.1,5405,1311,4094,32
'34005, 면부,'095001, 90세,2019,1787,442,1345,32.9,1784,441,1343,32.8
'34005, 면부,'095002, 91세,2019,1426,342,1084,31.5,1425,342,1083,31.6
'34005, 면부,'095003, 92세,2019,1004,269,735,36.6,1002,268,734,36.5
'34005, 면부,'095004, 93세,2019,673,136,537,25.3,672,136,536,25.4
'34005, 면부,'095005, 94세,2019,523,125,398,31.4,522,124,398,31.2
'34005, 면부,'100,95~99세,2019,1172,222,950,23.4,1168,220,948,23.2
'34005, 면부,'100001, 95세,2019,342,67,275,24.4,341,67,274,24.5
'34005, 면부,'100002, 96세,2019,350,69,281,24.6,349,69,280,24.6
'34005, 면부,'100003, 97세,2019,259,42,217,19.4,258,41,217,18.9
'34005, 면부,'100004, 98세,2019,137,32,105,30.5,137,32,105,30.5
'34005, 면부,'100005, 99세,2019,84,12,72,16.7,83,11,72,15.3
'34005, 면부,'101,100세이상,2019,151,17,134,12.7,151,17,134,12.7
'34005, 면부,'102,15세미만,2019,57631,29657,27974,106,56087,28889,27198,106.2
'34005, 면부,'103,15~64세,2019,431160,245324,185836,132,382841,212551,170290,124.8
'34005, 면부,'104,65세이상,2019,183027,77966,105061,74.2,182264,77636,104628,74.2
'34005, 면부,'126,평균연령,2019,48.9,46.6,51.5,,50.1,47.8,52.5,
'34005, 면부,'127,중위연령,2019,51.4,48,55.6,,53.7,50.6,57.1,
'34003, 동부,'000,합계,2019,1007784,509152,498632,102.1,975568,492908,482660,102.1
'34003, 동부,'005,0~4세,2019,47330,24121,23209,103.9,46459,23681,22778,104
'34003, 동부,'005001, 0세,2019,7955,4049,3906,103.7,7799,3957,3842,103
'34003, 동부,'005002, 1세,2019,8546,4356,4190,104,8387,4281,4106,104.3
'34003, 동부,'005003, 2세,2019,9344,4845,4499,107.7,9138,4737,4401,107.6
'34003, 동부,'005004, 3세,2019,10495,5313,5182,102.5,10312,5225,5087,102.7
'34003, 동부,'005005, 4세,2019,10990,5558,5432,102.3,10823,5481,5342,102.6
'34003, 동부,'010,5~9세,2019,56385,28968,27417,105.7,55852,28694,27158,105.7
'34003, 동부,'010001, 5세,2019,10682,5529,5153,107.3,10547,5459,5088,107.3
'34003, 동부,'010002, 6세,2019,11104,5620,5484,102.5,10994,5565,5429,102.5
'34003, 동부,'010003, 7세,2019,11793,5998,5795,103.5,11665,5928,5737,103.3
'34003, 동부,'010004, 8세,2019,11640,6024,5616,107.3,11560,5987,5573,107.4
'34003, 동부,'010005, 9세,2019,11166,5797,5369,108,11086,5755,5331,108
'34003, 동부,'015,10~14세,2019,53513,27648,25865,106.9,53209,27485,25724,106.8
'34003, 동부,'015001, 10세,2019,10617,5429,5188,104.6,10546,5389,5157,104.5
'34003, 동부,'015002, 11세,2019,11154,5735,5419,105.8,11088,5700,5388,105.8
'34003, 동부,'015003, 12세,2019,11291,5859,5432,107.9,11228,5824,5404,107.8
'34003, 동부,'015004, 13세,2019,10374,5390,4984,108.1,10323,5367,4956,108.3
'34003, 동부,'015005, 14세,2019,10077,5235,4842,108.1,10024,5205,4819,108
'34003, 동부,'020,15~19세,2019,60452,31146,29306,106.3,59496,30743,28753,106.9
'34003, 동부,'020001, 15세,2019,10865,5688,5177,109.9,10807,5661,5146,110
'34003, 동부,'020002, 16세,2019,10524,5521,5003,110.4,10492,5505,4987,110.4
'34003, 동부,'020003, 17세,2019,11153,5944,5209,114.1,11097,5919,5178,114.3
'34003, 동부,'020004, 18세,2019,13185,6803,6382,106.6,12924,6711,6213,108
'34003, 동부,'020005, 19세,2019,14725,7190,7535,95.4,14176,6947,7229,96.1
'34003, 동부,'025,20~24세,2019,72701,37203,35498,104.8,69688,35806,33882,105.7
'34003, 동부,'025001, 20세,2019,14251,7030,7221,97.4,13636,6761,6875,98.3
'34003, 동부,'025002, 21세,2019,14752,7436,7316,101.6,14193,7166,7027,102
'34003, 동부,'025003, 22세,2019,14897,7427,7470,99.4,14330,7155,7175,99.7
'34003, 동부,'025004, 23세,2019,14654,7732,6922,111.7,14007,7428,6579,112.9
'34003, 동부,'025005, 24세,2019,14147,7578,6569,115.4,13522,7296,6226,117.2
'34003, 동부,'030,25~29세,2019,71017,38000,33017,115.1,67238,36114,31124,116
'34003, 동부,'030001, 25세,2019,14181,7694,6487,118.6,13478,7362,6116,120.4
'34003, 동부,'030002, 26세,2019,14486,7695,6791,113.3,13830,7369,6461,114.1
'34003, 동부,'030003, 27세,2019,14829,7862,6967,112.8,14115,7503,6612,113.5
'34003, 동부,'030004, 28세,2019,13799,7376,6423,114.8,12971,6956,6015,115.6
'34003, 동부,'030005, 29세,2019,13722,7373,6349,116.1,12844,6924,5920,117
'34003, 동부,'035,30~34세,2019,72422,38113,34309,111.1,67871,35811,32060,111.7
'34003, 동부,'035001, 30세,2019,13697,7353,6344,115.9,12822,6914,5908,117
'34003, 동부,'035002, 31세,2019,14255,7544,6711,112.4,13355,7093,6262,113.3
'34003, 동부,'035003, 32세,2019,14711,7669,7042,108.9,13716,7168,6548,109.5
'34003, 동부,'035004, 33세,2019,14823,7684,7139,107.6,13898,7216,6682,108
'34003, 동부,'035005, 34세,2019,14936,7863,7073,111.2,14080,7420,6660,111.4
'34003, 동부,'040,35~39세,2019,89627,46379,43248,107.2,85894,44399,41495,107
'34003, 동부,'040001, 35세,2019,15712,8127,7585,107.1,14866,7701,7165,107.5
'34003, 동부,'040002, 36세,2019,17320,9024,8296,108.8,16580,8642,7938,108.9
'34003, 동부,'040003, 37세,2019,19002,9796,9206,106.4,18216,9384,8832,106.3
'34003, 동부,'040004, 38세,2019,18564,9641,8923,108,17901,9296,8605,108
'34003, 동부,'040005, 39세,2019,19029,9791,9238,106,18331,9376,8955,104.7
'34003, 동부,'045,40~44세,2019,83162,42483,40679,104.4,80142,40796,39346,103.7
'34003, 동부,'045001, 40세,2019,17750,9176,8574,107,17010,8746,8264,105.8
'34003, 동부,'045002, 41세,2019,16172,8473,7699,110.1,15561,8128,7433,109.4
'34003, 동부,'045003, 42세,2019,16593,8452,8141,103.8,16050,8173,7877,103.8
'34003, 동부,'045004, 43세,2019,16061,8113,7948,102.1,15497,7796,7701,101.2
'34003, 동부,'045005, 44세,2019,16586,8269,8317,99.4,16024,7953,8071,98.5
'34003, 동부,'050,45~49세,2019,89133,45294,43839,103.3,86025,43629,42396,102.9
'34003, 동부,'050001, 45세,2019,18177,9208,8969,102.7,17637,8908,8729,102.1
'34003, 동부,'050002, 46세,2019,17914,9021,8893,101.4,17311,8703,8608,101.1
'34003, 동부,'050003, 47세,2019,16959,8615,8344,103.2,16313,8281,8032,103.1
'34003, 동부,'050004, 48세,2019,18679,9601,9078,105.8,18014,9238,8776,105.3
'34003, 동부,'050005, 49세,2019,17404,8849,8555,103.4,16750,8499,8251,103
'34003, 동부,'055,50~54세,2019,81300,41098,40202,102.2,78467,39674,38793,102.3
'34003, 동부,'055001, 50세,2019,17949,9054,8895,101.8,17338,8738,8600,101.6
'34003, 동부,'055002, 51세,2019,17558,8748,8810,99.3,16961,8441,8520,99.1
'34003, 동부,'055003, 52세,2019,15757,7892,7865,100.3,15274,7650,7624,100.3
'34003, 동부,'055004, 53세,2019,14188,7370,6818,108.1,13656,7119,6537,108.9
'34003, 동부,'055005, 54세,2019,15848,8034,7814,102.8,15238,7726,7512,102.8
'34003, 동부,'060,55~59세,2019,72335,37312,35023,106.5,69987,36162,33825,106.9
'34003, 동부,'060001, 55세,2019,13699,7106,6593,107.8,13165,6836,6329,108
'34003, 동부,'060002, 56세,2019,14158,7361,6797,108.3,13528,7051,6477,108.9
'34003, 동부,'060003, 57세,2019,14372,7536,6836,110.2,13941,7317,6624,110.5
'34003, 동부,'060004, 58세,2019,15507,8037,7470,107.6,15174,7875,7299,107.9
'34003, 동부,'060005, 59세,2019,14599,7272,7327,99.2,14179,7083,7096,99.8
'34003, 동부,'065,60~64세,2019,54161,27012,27149,99.5,52472,26191,26281,99.7
'34003, 동부,'065001, 60세,2019,12437,6157,6280,98,12088,5991,6097,98.3
'34003, 동부,'065002, 61세,2019,11133,5626,5507,102.2,10776,5448,5328,102.3
'34003, 동부,'065003, 62세,2019,10798,5502,5296,103.9,10413,5296,5117,103.5
'34003, 동부,'065004, 63세,2019,9696,4775,4921,97,9376,4619,4757,97.1
'34003, 동부,'065005, 64세,2019,10097,4952,5145,96.2,9819,4837,4982,97.1
'34003, 동부,'070,65~69세,2019,33923,16348,17575,93,33073,15936,17137,93
'34003, 동부,'070001, 65세,2019,8089,3899,4190,93.1,7849,3788,4061,93.3
'34003, 동부,'070002, 66세,2019,6623,3246,3377,96.1,6418,3141,3277,95.8
'34003, 동부,'070003, 67세,2019,7609,3653,3956,92.3,7434,3569,3865,92.3
'34003, 동부,'070004, 68세,2019,5468,2690,2778,96.8,5337,2617,2720,96.2
'34003, 동부,'070005, 69세,2019,6134,2860,3274,87.4,6035,2821,3214,87.8
'34003, 동부,'075,70~74세,2019,25171,11650,13521,86.2,24830,11509,13321,86.4
'34003, 동부,'075001, 70세,2019,6134,2889,3245,89,6019,2837,3182,89.2
'34003, 동부,'075002, 71세,2019,5611,2611,3000,87,5548,2582,2966,87.1
'34003, 동부,'075003, 72세,2019,5512,2524,2988,84.5,5431,2493,2938,84.9
'34003, 동부,'075004, 73세,2019,4030,1923,2107,91.3,3983,1909,2074,92
'34003, 동부,'075005, 74세,2019,3884,1703,2181,78.1,3849,1688,2161,78.1
'34003, 동부,'080,75~79세,2019,20414,8347,12067,69.2,20262,8295,11967,69.3
'34003, 동부,'080001, 75세,2019,4219,1779,2440,72.9,4174,1763,2411,73.1
'34003, 동부,'080002, 76세,2019,4057,1757,2300,76.4,4024,1747,2277,76.7
'34003, 동부,'080003, 77세,2019,5084,2028,3056,66.4,5057,2015,3042,66.2
'34003, 동부,'080004, 78세,2019,3703,1482,2221,66.7,3679,1475,2204,66.9
'34003, 동부,'080005, 79세,2019,3351,1301,2050,63.5,3328,1295,2033,63.7
'34003, 동부,'085,80~84세,2019,14717,5273,9444,55.8,14630,5249,9381,56
'34003, 동부,'085001, 80세,2019,3538,1362,2176,62.6,3520,1358,2162,62.8
'34003, 동부,'085002, 81세,2019,3185,1178,2007,58.7,3161,1173,1988,59
'34003, 동부,'085003, 82세,2019,2972,1074,1898,56.6,2951,1069,1882,56.8
'34003, 동부,'085004, 83세,2019,2601,868,1733,50.1,2590,863,1727,50
'34003, 동부,'085005, 84세,2019,2421,791,1630,48.5,2408,786,1622,48.5
'34003, 동부,'086,85세이상,2019,10021,2757,7264,38,9973,2734,7239,37.8
'34003, 동부,'090,85~89세,2019,7034,2111,4923,42.9,6996,2091,4905,42.6
'34003, 동부,'090001, 85세,2019,1955,686,1269,54.1,1942,678,1264,53.6
'34003, 동부,'090002, 86세,2019,1654,504,1150,43.8,1649,503,1146,43.9
'34003, 동부,'090003, 87세,2019,1492,444,1048,42.4,1482,438,1044,42
'34003, 동부,'090004, 88세,2019,1004,256,748,34.2,999,253,746,33.9
'34003, 동부,'090005, 89세,2019,929,221,708,31.2,924,219,705,31.1
'34003, 동부,'095,90~94세,2019,2392,532,1860,28.6,2382,529,1853,28.5
'34003, 동부,'095001, 90세,2019,757,182,575,31.7,752,179,573,31.2
'34003, 동부,'095002, 91세,2019,622,150,472,31.8,620,150,470,31.9
'34003, 동부,'095003, 92세,2019,448,87,361,24.1,446,87,359,24.2
'34003, 동부,'095004, 93세,2019,318,67,251,26.7,318,67,251,26.7
'34003, 동부,'095005, 94세,2019,247,46,201,22.9,246,46,200,23
'34003, 동부,'100,95~99세,2019,518,95,423,22.5,518,95,423,22.5
'34003, 동부,'100001, 95세,2019,159,34,125,27.2,159,34,125,27.2
'34003, 동부,'100002, 96세,2019,151,24,127,18.9,151,24,127,18.9
'34003, 동부,'100003, 97세,2019,99,21,78,26.9,99,21,78,26.9
'34003, 동부,'100004, 98세,2019,56,7,49,14.3,56,7,49,14.3
'34003, 동부,'100005, 99세,2019,53,9,44,20.5,53,9,44,20.5
'34003, 동부,'101,100세이상,2019,77,19,58,32.8,77,19,58,32.8
'34003, 동부,'102,15세미만,2019,157228,80737,76491,105.6,155520,79860,75660,105.6
'34003, 동부,'103,15~64세,2019,746310,384040,362270,106,717280,369325,347955,106.1
'34003, 동부,'104,65세이상,2019,104246,44375,59871,74.1,102768,43723,59045,74.1
'34003, 동부,'126,평균연령,2019,38.7,37.8,39.5,,38.6,37.8,39.5,
'34003, 동부,'127,중위연령,2019,39,38.3,39.7,,39,38.3,39.8,
'34010, 천안시,'000,합계,2019,679743,348353,331390,105.1,649584,330692,318892,103.7
'34010, 천안시,'005,0~4세,2019,30225,15465,14760,104.8,29597,15149,14448,104.9
'34010, 천안시,'005001, 0세,2019,5050,2561,2489,102.9,4938,2501,2437,102.6
'34010, 천안시,'005002, 1세,2019,5592,2862,2730,104.8,5469,2809,2660,105.6
'34010, 천안시,'005003, 2세,2019,5904,3067,2837,108.1,5764,2991,2773,107.9
'34010, 천안시,'005004, 3세,2019,6676,3386,3290,102.9,6545,3315,3230,102.6
'34010, 천안시,'005005, 4세,2019,7003,3589,3414,105.1,6881,3533,3348,105.5
'34010, 천안시,'010,5~9세,2019,34969,17920,17049,105.1,34578,17713,16865,105
'34010, 천안시,'010001, 5세,2019,6727,3448,3279,105.2,6631,3400,3231,105.2
'34010, 천안시,'010002, 6세,2019,6869,3487,3382,103.1,6796,3443,3353,102.7
'34010, 천안시,'010003, 7세,2019,7382,3738,3644,102.6,7296,3694,3602,102.6
'34010, 천안시,'010004, 8세,2019,7125,3679,3446,106.8,7062,3651,3411,107
'34010, 천안시,'010005, 9세,2019,6866,3568,3298,108.2,6793,3525,3268,107.9
'34010, 천안시,'015,10~14세,2019,32946,17098,15848,107.9,32733,16992,15741,107.9
'34010, 천안시,'015001, 10세,2019,6566,3398,3168,107.3,6518,3375,3143,107.4
'34010, 천안시,'015002, 11세,2019,6893,3584,3309,108.3,6849,3560,3289,108.2
'34010, 천안시,'015003, 12세,2019,6949,3589,3360,106.8,6904,3566,3338,106.8
'34010, 천안시,'015004, 13세,2019,6323,3318,3005,110.4,6288,3303,2985,110.7
'34010, 천안시,'015005, 14세,2019,6215,3209,3006,106.8,6174,3188,2986,106.8
'34010, 천안시,'020,15~19세,2019,40851,20985,19866,105.6,39814,20537,19277,106.5
'34010, 천안시,'020001, 15세,2019,6674,3517,3157,111.4,6629,3492,3137,111.3
'34010, 천안시,'020002, 16세,2019,6511,3410,3101,110,6485,3396,3089,109.9
'34010, 천안시,'020003, 17세,2019,6792,3588,3204,112,6739,3559,3180,111.9
'34010, 천안시,'020004, 18세,2019,8961,4580,4381,104.5,8664,4460,4204,106.1
'34010, 천안시,'020005, 19세,2019,11913,5890,6023,97.8,11297,5630,5667,99.3
'34010, 천안시,'025,20~24세,2019,55397,28447,26950,105.6,51911,26492,25419,104.2
'34010, 천안시,'025001, 20세,2019,10918,5062,5856,86.4,10271,4778,5493,87
'34010, 천안시,'025002, 21세,2019,10861,5287,5574,94.9,10213,4929,5284,93.3
'34010, 천안시,'025003, 22세,2019,11378,5777,5601,103.1,10696,5389,5307,101.5
'34010, 천안시,'025004, 23세,2019,11374,6248,5126,121.9,10618,5802,4816,120.5
'34010, 천안시,'025005, 24세,2019,10866,6073,4793,126.7,10113,5594,4519,123.8
'34010, 천안시,'030,25~29세,2019,52281,28431,23850,119.2,47784,25523,22261,114.7
'34010, 천안시,'030001, 25세,2019,10463,5842,4621,126.4,9632,5311,4321,122.9
'34010, 천안시,'030002, 26세,2019,10804,5782,5022,115.1,9972,5242,4730,110.8
'34010, 천안시,'030003, 27세,2019,11054,5964,5090,117.2,10154,5373,4781,112.4
'34010, 천안시,'030004, 28세,2019,10001,5422,4579,118.4,9085,4840,4245,114
'34010, 천안시,'030005, 29세,2019,9959,5421,4538,119.5,8941,4757,4184,113.7
'34010, 천안시,'035,30~34세,2019,52218,28290,23928,118.2,47417,25240,22177,113.8
'34010, 천안시,'035001, 30세,2019,9969,5463,4506,121.2,8988,4811,4177,115.2
'34010, 천안시,'035002, 31세,2019,10379,5631,4748,118.6,9437,5034,4403,114.3
'34010, 천안시,'035003, 32세,2019,10687,5697,4990,114.2,9633,5045,4588,110
'34010, 천안시,'035004, 33세,2019,10593,5762,4831,119.3,9643,5166,4477,115.4
'34010, 천안시,'035005, 34세,2019,10590,5737,4853,118.2,9716,5184,4532,114.4
'34010, 천안시,'040,35~39세,2019,60911,32564,28347,114.9,57187,30197,26990,111.9
'34010, 천안시,'040001, 35세,2019,10954,5917,5037,117.5,10100,5372,4728,113.6
'34010, 천안시,'040002, 36세,2019,11928,6355,5573,114,11167,5872,5295,110.9
'34010, 천안시,'040003, 37세,2019,12897,6857,6040,113.5,12138,6377,5761,110.7
'34010, 천안시,'040004, 38세,2019,12450,6702,5748,116.6,11795,6290,5505,114.3
'34010, 천안시,'040005, 39세,2019,12682,6733,5949,113.2,11987,6286,5701,110.3
'34010, 천안시,'045,40~44세,2019,54905,28731,26174,109.8,52182,27029,25153,107.5
'34010, 천안시,'045001, 40세,2019,11711,6228,5483,113.6,11057,5800,5257,110.3
'34010, 천안시,'045002, 41세,2019,10699,5787,4912,117.8,10161,5447,4714,115.5
'34010, 천안시,'045003, 42세,2019,10888,5699,5189,109.8,10367,5388,4979,108.2
'34010, 천안시,'045004, 43세,2019,10634,5487,5147,106.6,10120,5178,4942,104.8
'34010, 천안시,'045005, 44세,2019,10973,5530,5443,101.6,10477,5216,5261,99.1
'34010, 천안시,'050,45~49세,2019,58466,29990,28476,105.3,55913,28493,27420,103.9
'34010, 천안시,'050001, 45세,2019,11852,6085,5767,105.5,11381,5791,5590,103.6
'34010, 천안시,'050002, 46세,2019,11540,5956,5584,106.7,11037,5668,5369,105.6
'34010, 천안시,'050003, 47세,2019,11239,5704,5535,103.1,10682,5382,5300,101.5
'34010, 천안시,'050004, 48세,2019,12175,6274,5901,106.3,11660,5968,5692,104.8
'34010, 천안시,'050005, 49세,2019,11660,5971,5689,105,11153,5684,5469,103.9
'34010, 천안시,'055,50~54세,2019,54474,27705,26769,103.5,52221,26475,25746,102.8
'34010, 천안시,'055001, 50세,2019,11928,6055,5873,103.1,11425,5786,5639,102.6
'34010, 천안시,'055002, 51세,2019,11756,5964,5792,103,11266,5680,5586,101.7
'34010, 천안시,'055003, 52세,2019,10494,5221,5273,99,10120,5009,5111,98
'34010, 천안시,'055004, 53세,2019,9653,4993,4660,107.1,9232,4768,4464,106.8
'34010, 천안시,'055005, 54세,2019,10643,5472,5171,105.8,10178,5232,4946,105.8
'34010, 천안시,'060,55~59세,2019,49104,25589,23515,108.8,47393,24713,22680,109
'34010, 천안시,'060001, 55세,2019,9291,4762,4529,105.1,8926,4575,4351,105.1
'34010, 천안시,'060002, 56세,2019,9600,5030,4570,110.1,9141,4786,4355,109.9
'34010, 천안시,'060003, 57세,2019,9750,5209,4541,114.7,9395,5027,4368,115.1
'34010, 천안시,'060004, 58세,2019,10516,5488,5028,109.1,10290,5368,4922,109.1
'34010, 천안시,'060005, 59세,2019,9947,5100,4847,105.2,9641,4957,4684,105.8
'34010, 천안시,'065,60~64세,2019,36006,18345,17661,103.9,34816,17759,17057,104.1
'34010, 천안시,'065001, 60세,2019,8419,4233,4186,101.1,8163,4113,4050,101.6
'34010, 천안시,'065002, 61세,2019,7455,3867,3588,107.8,7194,3728,3466,107.6
'34010, 천안시,'065003, 62세,2019,7160,3740,3420,109.4,6901,3602,3299,109.2
'34010, 천안시,'065004, 63세,2019,6330,3194,3136,101.8,6124,3103,3021,102.7
'34010, 천안시,'065005, 64세,2019,6642,3311,3331,99.4,6434,3213,3221,99.8
'34010, 천안시,'070,65~69세,2019,21792,10716,11076,96.7,21232,10432,10800,96.6
'34010, 천안시,'070001, 65세,2019,5257,2596,2661,97.6,5091,2513,2578,97.5
'34010, 천안시,'070002, 66세,2019,4320,2180,2140,101.9,4179,2108,2071,101.8
'34010, 천안시,'070003, 67세,2019,4955,2439,2516,96.9,4846,2378,2468,96.4
'34010, 천안시,'070004, 68세,2019,3464,1725,1739,99.2,3379,1684,1695,99.4
'34010, 천안시,'070005, 69세,2019,3796,1776,2020,87.9,3737,1749,1988,88
'34010, 천안시,'075,70~74세,2019,15825,7474,8351,89.5,15619,7402,8217,90.1
'34010, 천안시,'075001, 70세,2019,3794,1796,1998,89.9,3728,1772,1956,90.6
'34010, 천안시,'075002, 71세,2019,3540,1719,1821,94.4,3496,1701,1795,94.8
'34010, 천안시,'075003, 72세,2019,3495,1599,1896,84.3,3446,1585,1861,85.2
'34010, 천안시,'075004, 73세,2019,2537,1229,1308,94,2510,1220,1290,94.6
'34010, 천안시,'075005, 74세,2019,2459,1131,1328,85.2,2439,1124,1315,85.5
'34010, 천안시,'080,75~79세,2019,13113,5375,7738,69.5,13019,5342,7677,69.6
'34010, 천안시,'080001, 75세,2019,2688,1154,1534,75.2,2662,1146,1516,75.6
'34010, 천안시,'080002, 76세,2019,2618,1097,1521,72.1,2602,1091,1511,72.2
'34010, 천안시,'080003, 77세,2019,3164,1282,1882,68.1,3146,1275,1871,68.1
'34010, 천안시,'080004, 78세,2019,2388,947,1441,65.7,2374,943,1431,65.9
'34010, 천안시,'080005, 79세,2019,2255,895,1360,65.8,2235,887,1348,65.8
'34010, 천안시,'085,80~84세,2019,9536,3394,6142,55.3,9478,3380,6098,55.4
'34010, 천안시,'085001, 80세,2019,2325,879,1446,60.8,2316,877,1439,60.9
'34010, 천안시,'085002, 81세,2019,2048,767,1281,59.9,2029,762,1267,60.1
'34010, 천안시,'085003, 82세,2019,1906,676,1230,55,1892,673,1219,55.2
'34010, 천안시,'085004, 83세,2019,1676,571,1105,51.7,1669,568,1101,51.6
'34010, 천안시,'085005, 84세,2019,1581,501,1080,46.4,1572,500,1072,46.6
'34010, 천안시,'086,85세이상,2019,6724,1834,4890,37.5,6690,1824,4866,37.5
'34010, 천안시,'090,85~89세,2019,4676,1403,3273,42.9,4650,1393,3257,42.8
'34010, 천안시,'090001, 85세,2019,1327,453,874,51.8,1318,449,869,51.7
'34010, 천안시,'090002, 86세,2019,1085,324,761,42.6,1080,323,757,42.7
'34010, 천안시,'090003, 87세,2019,976,288,688,41.9,971,286,685,41.8
'34010, 천안시,'090004, 88세,2019,680,170,510,33.3,675,168,507,33.1
'34010, 천안시,'090005, 89세,2019,608,168,440,38.2,606,167,439,38
'34010, 천안시,'095,90~94세,2019,1623,344,1279,26.9,1615,344,1271,27.1
'34010, 천안시,'095001, 90세,2019,513,123,390,31.5,510,123,387,31.8
'34010, 천안시,'095002, 91세,2019,409,88,321,27.4,407,88,319,27.6
'34010, 천안시,'095003, 92세,2019,315,59,256,23,314,59,255,23.1
'34010, 천안시,'095004, 93세,2019,213,37,176,21,212,37,175,21.1
'34010, 천안시,'095005, 94세,2019,173,37,136,27.2,172,37,135,27.4
'34010, 천안시,'100,95~99세,2019,380,81,299,27.1,380,81,299,27.1
'34010, 천안시,'100001, 95세,2019,104,26,78,33.3,104,26,78,33.3
'34010, 천안시,'100002, 96세,2019,112,20,92,21.7,112,20,92,21.7
'34010, 천안시,'100003, 97세,2019,87,16,71,22.5,87,16,71,22.5
'34010, 천안시,'100004, 98세,2019,45,13,32,40.6,45,13,32,40.6
'34010, 천안시,'100005, 99세,2019,32,6,26,23.1,32,6,26,23.1
'34010, 천안시,'101,100세이상,2019,45,6,39,15.4,45,6,39,15.4
'34010, 천안시,'102,15세미만,2019,98140,50483,47657,105.9,96908,49854,47054,106
'34010, 천안시,'103,15~64세,2019,514613,269077,245536,109.6,486638,252458,234180,107.8
'34010, 천안시,'104,65세이상,2019,66990,28793,38197,75.4,66038,28380,37658,75.4
'34010, 천안시,'126,평균연령,2019,38.5,37.8,39.3,,38.6,37.8,39.4,
'34010, 천안시,'127,중위연령,2019,38.4,37.8,39.2,,38.6,38,39.3,
'34011, 동남구,'000,합계,2019,279153,142402,136751,104.1,265485,134436,131049,102.6
'34011, 동남구,'005,0~4세,2019,9705,5018,4687,107.1,9417,4866,4551,106.9
'34011, 동남구,'005001, 0세,2019,1629,816,813,100.4,1581,788,793,99.4
'34011, 동남구,'005002, 1세,2019,1746,892,854,104.4,1689,872,817,106.7
'34011, 동남구,'005003, 2세,2019,1798,947,851,111.3,1738,912,826,110.4
'34011, 동남구,'005004, 3세,2019,2176,1155,1021,113.1,2113,1116,997,111.9
'34011, 동남구,'005005, 4세,2019,2356,1208,1148,105.2,2296,1178,1118,105.4
'34011, 동남구,'010,5~9세,2019,12369,6379,5990,106.5,12202,6298,5904,106.7
'34011, 동남구,'010001, 5세,2019,2271,1178,1093,107.8,2238,1167,1071,109
'34011, 동남구,'010002, 6세,2019,2390,1226,1164,105.3,2360,1207,1153,104.7
'34011, 동남구,'010003, 7세,2019,2558,1303,1255,103.8,2513,1276,1237,103.2
'34011, 동남구,'010004, 8세,2019,2633,1376,1257,109.5,2603,1364,1239,110.1
'34011, 동남구,'010005, 9세,2019,2517,1296,1221,106.1,2488,1284,1204,106.6
'34011, 동남구,'015,10~14세,2019,12745,6631,6114,108.5,12650,6583,6067,108.5
'34011, 동남구,'015001, 10세,2019,2532,1327,1205,110.1,2511,1317,1194,110.3
'34011, 동남구,'015002, 11세,2019,2649,1354,1295,104.6,2631,1345,1286,104.6
'34011, 동남구,'015003, 12세,2019,2698,1406,1292,108.8,2678,1394,1284,108.6
'34011, 동남구,'015004, 13세,2019,2446,1301,1145,113.6,2429,1293,1136,113.8
'34011, 동남구,'015005, 14세,2019,2420,1243,1177,105.6,2401,1234,1167,105.7
'34011, 동남구,'020,15~19세,2019,18703,9750,8953,108.9,18193,9535,8658,110.1
'34011, 동남구,'020001, 15세,2019,2617,1396,1221,114.3,2598,1387,1211,114.5
'34011, 동남구,'020002, 16세,2019,2837,1583,1254,126.2,2827,1578,1249,126.3
'34011, 동남구,'020003, 17세,2019,2957,1646,1311,125.6,2930,1636,1294,126.4
'34011, 동남구,'020004, 18세,2019,4186,2187,1999,109.4,4023,2126,1897,112.1
'34011, 동남구,'020005, 19세,2019,6106,2938,3168,92.7,5815,2808,3007,93.4
'34011, 동남구,'025,20~24세,2019,26014,13160,12854,102.4,24377,12250,12127,101
'34011, 동남구,'025001, 20세,2019,5436,2356,3080,76.5,5119,2207,2912,75.8
'34011, 동남구,'025002, 21세,2019,5248,2370,2878,82.3,4947,2201,2746,80.2
'34011, 동남구,'025003, 22세,2019,5417,2719,2698,100.8,5102,2547,2555,99.7
'34011, 동남구,'025004, 23세,2019,5218,2917,2301,126.8,4872,2721,2151,126.5
'34011, 동남구,'025005, 24세,2019,4695,2798,1897,147.5,4337,2574,1763,146
'34011, 동남구,'030,25~29세,2019,19668,11079,8589,129,17633,9766,7867,124.1
'34011, 동남구,'030001, 25세,2019,4316,2489,1827,136.2,3920,2245,1675,134
'34011, 동남구,'030002, 26세,2019,4127,2308,1819,126.9,3769,2072,1697,122.1
'34011, 동남구,'030003, 27세,2019,3990,2259,1731,130.5,3599,1993,1606,124.1
'34011, 동남구,'030004, 28세,2019,3736,2054,1682,122.1,3309,1791,1518,118
'34011, 동남구,'030005, 29세,2019,3499,1969,1530,128.7,3036,1665,1371,121.4
'34011, 동남구,'035,30~34세,2019,16945,9351,7594,123.1,14903,8057,6846,117.7
'34011, 동남구,'035001, 30세,2019,3393,1909,1484,128.6,2987,1635,1352,120.9
'34011, 동남구,'035002, 31세,2019,3296,1824,1472,123.9,2894,1570,1324,118.6
'34011, 동남구,'035003, 32세,2019,3422,1886,1536,122.8,2955,1594,1361,117.1
'34011, 동남구,'035004, 33세,2019,3325,1826,1499,121.8,2931,1573,1358,115.8
'34011, 동남구,'035005, 34세,2019,3509,1906,1603,118.9,3136,1685,1451,116.1
'34011, 동남구,'040,35~39세,2019,20907,10952,9955,110,19334,9953,9381,106.1
'34011, 동남구,'040001, 35세,2019,3637,1909,1728,110.5,3282,1681,1601,105
'34011, 동남구,'040002, 36세,2019,3879,2050,1829,112.1,3581,1851,1730,107
'34011, 동남구,'040003, 37세,2019,4430,2294,2136,107.4,4087,2093,1994,105
'34011, 동남구,'040004, 38세,2019,4320,2304,2016,114.3,4056,2127,1929,110.3
'34011, 동남구,'040005, 39세,2019,4641,2395,2246,106.6,4328,2201,2127,103.5
'34011, 동남구,'045,40~44세,2019,21233,11083,10150,109.2,20052,10340,9712,106.5
'34011, 동남구,'045001, 40세,2019,4382,2244,2138,105,4110,2060,2050,100.5
'34011, 동남구,'045002, 41세,2019,4059,2207,1852,119.2,3817,2052,1765,116.3
'34011, 동남구,'045003, 42세,2019,4234,2221,2013,110.3,4009,2084,1925,108.3
'34011, 동남구,'045004, 43세,2019,4131,2147,1984,108.2,3917,2026,1891,107.1
'34011, 동남구,'045005, 44세,2019,4427,2264,2163,104.7,4199,2118,2081,101.8
'34011, 동남구,'050,45~49세,2019,23473,12112,11361,106.6,22302,11421,10881,105
'34011, 동남구,'050001, 45세,2019,4782,2464,2318,106.3,4574,2334,2240,104.2
'34011, 동남구,'050002, 46세,2019,4642,2442,2200,111,4413,2306,2107,109.4
'34011, 동남구,'050003, 47세,2019,4432,2282,2150,106.1,4177,2146,2031,105.7
'34011, 동남구,'050004, 48세,2019,4874,2500,2374,105.3,4633,2352,2281,103.1
'34011, 동남구,'050005, 49세,2019,4743,2424,2319,104.5,4505,2283,2222,102.7
'34011, 동남구,'055,50~54세,2019,22784,11586,11198,103.5,21703,10985,10718,102.5
'34011, 동남구,'055001, 50세,2019,4897,2500,2397,104.3,4643,2360,2283,103.4
'34011, 동남구,'055002, 51세,2019,4775,2385,2390,99.8,4541,2252,2289,98.4
'34011, 동남구,'055003, 52세,2019,4425,2213,2212,100,4249,2109,2140,98.6
'34011, 동남구,'055004, 53세,2019,4102,2136,1966,108.6,3901,2023,1878,107.7
'34011, 동남구,'055005, 54세,2019,4585,2352,2233,105.3,4369,2241,2128,105.3
'34011, 동남구,'060,55~59세,2019,22295,11474,10821,106,21424,11032,10392,106.2
'34011, 동남구,'060001, 55세,2019,4066,2051,2015,101.8,3887,1969,1918,102.7
'34011, 동남구,'060002, 56세,2019,4220,2203,2017,109.2,3974,2068,1906,108.5
'34011, 동남구,'060003, 57세,2019,4360,2258,2102,107.4,4189,2171,2018,107.6
'34011, 동남구,'060004, 58세,2019,4978,2586,2392,108.1,4860,2521,2339,107.8
'34011, 동남구,'060005, 59세,2019,4671,2376,2295,103.5,4514,2303,2211,104.2
'34011, 동남구,'065,60~64세,2019,17364,8742,8622,101.4,16799,8459,8340,101.4
'34011, 동남구,'065001, 60세,2019,3938,1989,1949,102.1,3806,1931,1875,103
'34011, 동남구,'065002, 61세,2019,3561,1812,1749,103.6,3445,1745,1700,102.6
'34011, 동남구,'065003, 62세,2019,3448,1779,1669,106.6,3322,1702,1620,105.1
'34011, 동남구,'065004, 63세,2019,3142,1538,1604,95.9,3051,1502,1549,97
'34011, 동남구,'065005, 64세,2019,3275,1624,1651,98.4,3175,1579,1596,98.9
'34011, 동남구,'070,65~69세,2019,11121,5507,5614,98.1,10860,5373,5487,97.9
'34011, 동남구,'070001, 65세,2019,2633,1308,1325,98.7,2565,1277,1288,99.1
'34011, 동남구,'070002, 66세,2019,2191,1107,1084,102.1,2128,1074,1054,101.9
'34011, 동남구,'070003, 67세,2019,2513,1232,1281,96.2,2458,1199,1259,95.2
'34011, 동남구,'070004, 68세,2019,1788,914,874,104.6,1740,889,851,104.5
'34011, 동남구,'070005, 69세,2019,1996,946,1050,90.1,1969,934,1035,90.2
'34011, 동남구,'075,70~74세,2019,8114,3886,4228,91.9,8020,3854,4166,92.5
'34011, 동남구,'075001, 70세,2019,1944,948,996,95.2,1918,940,978,96.1
'34011, 동남구,'075002, 71세,2019,1808,887,921,96.3,1785,877,908,96.6
'34011, 동남구,'075003, 72세,2019,1814,844,970,87,1785,837,948,88.3
'34011, 동남구,'075004, 73세,2019,1252,600,652,92,1243,597,646,92.4
'34011, 동남구,'075005, 74세,2019,1296,607,689,88.1,1289,603,686,87.9
'34011, 동남구,'080,75~79세,2019,6862,2842,4020,70.7,6812,2828,3984,71
'34011, 동남구,'080001, 75세,2019,1421,616,805,76.5,1412,614,798,76.9
'34011, 동남구,'080002, 76세,2019,1341,557,784,71,1334,556,778,71.5
'34011, 동남구,'080003, 77세,2019,1638,667,971,68.7,1625,662,963,68.7
'34011, 동남구,'080004, 78세,2019,1265,515,750,68.7,1256,513,743,69
'34011, 동남구,'080005, 79세,2019,1197,487,710,68.6,1185,483,702,68.8
'34011, 동남구,'085,80~84세,2019,5137,1859,3278,56.7,5108,1852,3256,56.9
'34011, 동남구,'085001, 80세,2019,1218,476,742,64.2,1213,476,737,64.6
'34011, 동남구,'085002, 81세,2019,1093,409,684,59.8,1087,407,680,59.9
'34011, 동남구,'085003, 82세,2019,1043,378,665,56.8,1034,377,657,57.4
'34011, 동남구,'085004, 83세,2019,901,306,595,51.4,898,303,595,50.9
'34011, 동남구,'085005, 84세,2019,882,290,592,49,876,289,587,49.2
'34011, 동남구,'086,85세이상,2019,3714,991,2723,36.4,3696,984,2712,36.3
'34011, 동남구,'090,85~89세,2019,2573,763,1810,42.2,2558,756,1802,42
'34011, 동남구,'090001, 85세,2019,694,230,464,49.6,688,227,461,49.2
'34011, 동남구,'090002, 86세,2019,604,176,428,41.1,602,175,427,41
'34011, 동남구,'090003, 87세,2019,556,157,399,39.3,552,155,397,39
'34011, 동남구,'090004, 88세,2019,382,100,282,35.5,381,100,281,35.6
'34011, 동남구,'090005, 89세,2019,337,100,237,42.2,335,99,236,41.9
'34011, 동남구,'095,90~94세,2019,893,175,718,24.4,890,175,715,24.5
'34011, 동남구,'095001, 90세,2019,287,70,217,32.3,286,70,216,32.4
'34011, 동남구,'095002, 91세,2019,219,37,182,20.3,218,37,181,20.4
'34011, 동남구,'095003, 92세,2019,171,29,142,20.4,171,29,142,20.4
'34011, 동남구,'095004, 93세,2019,122,18,104,17.3,122,18,104,17.3
'34011, 동남구,'095005, 94세,2019,94,21,73,28.8,93,21,72,29.2
'34011, 동남구,'100,95~99세,2019,222,50,172,29.1,222,50,172,29.1
'34011, 동남구,'100001, 95세,2019,50,13,37,35.1,50,13,37,35.1
'34011, 동남구,'100002, 96세,2019,64,12,52,23.1,64,12,52,23.1
'34011, 동남구,'100003, 97세,2019,59,11,48,22.9,59,11,48,22.9
'34011, 동남구,'100004, 98세,2019,28,9,19,47.4,28,9,19,47.4
'34011, 동남구,'100005, 99세,2019,21,5,16,31.3,21,5,16,31.3
'34011, 동남구,'101,100세이상,2019,26,X,23,13,26,X,23,13
'34011, 동남구,'102,15세미만,2019,34819,18028,16791,107.4,34269,17747,16522,107.4
'34011, 동남구,'103,15~64세,2019,209386,109289,100097,109.2,196720,101798,94922,107.2
'34011, 동남구,'104,65세이상,2019,34948,15085,19863,75.9,34496,14891,19605,76
'34011, 동남구,'126,평균연령,2019,40.4,39.4,41.4,,40.5,39.5,41.6,
'34011, 동남구,'127,중위연령,2019,40.6,39.5,41.8,,41,40,42.2,
'34012, 서북구,'000,합계,2019,400590,205951,194639,105.8,384099,196256,187843,104.5
'34012, 서북구,'005,0~4세,2019,20520,10447,10073,103.7,20180,10283,9897,103.9
'34012, 서북구,'005001, 0세,2019,3421,1745,1676,104.1,3357,1713,1644,104.2
'34012, 서북구,'005002, 1세,2019,3846,1970,1876,105,3780,1937,1843,105.1
'34012, 서북구,'005003, 2세,2019,4106,2120,1986,106.7,4026,2079,1947,106.8
'34012, 서북구,'005004, 3세,2019,4500,2231,2269,98.3,4432,2199,2233,98.5
'34012, 서북구,'005005, 4세,2019,4647,2381,2266,105.1,4585,2355,2230,105.6
'34012, 서북구,'010,5~9세,2019,22600,11541,11059,104.4,22376,11415,10961,104.1
'34012, 서북구,'010001, 5세,2019,4456,2270,2186,103.8,4393,2233,2160,103.4
'34012, 서북구,'010002, 6세,2019,4479,2261,2218,101.9,4436,2236,2200,101.6
'34012, 서북구,'010003, 7세,2019,4824,2435,2389,101.9,4783,2418,2365,102.2
'34012, 서북구,'010004, 8세,2019,4492,2303,2189,105.2,4459,2287,2172,105.3
'34012, 서북구,'010005, 9세,2019,4349,2272,2077,109.4,4305,2241,2064,108.6
'34012, 서북구,'015,10~14세,2019,20201,10467,9734,107.5,20083,10409,9674,107.6
'34012, 서북구,'015001, 10세,2019,4034,2071,1963,105.5,4007,2058,1949,105.6
'34012, 서북구,'015002, 11세,2019,4244,2230,2014,110.7,4218,2215,2003,110.6
'34012, 서북구,'015003, 12세,2019,4251,2183,2068,105.6,4226,2172,2054,105.7
'34012, 서북구,'015004, 13세,2019,3877,2017,1860,108.4,3859,2010,1849,108.7
'34012, 서북구,'015005, 14세,2019,3795,1966,1829,107.5,3773,1954,1819,107.4
'34012, 서북구,'020,15~19세,2019,22148,11235,10913,103,21621,11002,10619,103.6
'34012, 서북구,'020001, 15세,2019,4057,2121,1936,109.6,4031,2105,1926,109.3
'34012, 서북구,'020002, 16세,2019,3674,1827,1847,98.9,3658,1818,1840,98.8
'34012, 서북구,'020003, 17세,2019,3835,1942,1893,102.6,3809,1923,1886,102
'34012, 서북구,'020004, 18세,2019,4775,2393,2382,100.5,4641,2334,2307,101.2
'34012, 서북구,'020005, 19세,2019,5807,2952,2855,103.4,5482,2822,2660,106.1
'34012, 서북구,'025,20~24세,2019,29383,15287,14096,108.4,27534,14242,13292,107.1
'34012, 서북구,'025001, 20세,2019,5482,2706,2776,97.5,5152,2571,2581,99.6
'34012, 서북구,'025002, 21세,2019,5613,2917,2696,108.2,5266,2728,2538,107.5
'34012, 서북구,'025003, 22세,2019,5961,3058,2903,105.3,5594,2842,2752,103.3
'34012, 서북구,'025004, 23세,2019,6156,3331,2825,117.9,5746,3081,2665,115.6
'34012, 서북구,'025005, 24세,2019,6171,3275,2896,113.1,5776,3020,2756,109.6
'34012, 서북구,'030,25~29세,2019,32613,17352,15261,113.7,30151,15757,14394,109.5
'34012, 서북구,'030001, 25세,2019,6147,3353,2794,120,5712,3066,2646,115.9
'34012, 서북구,'030002, 26세,2019,6677,3474,3203,108.5,6203,3170,3033,104.5
'34012, 서북구,'030003, 27세,2019,7064,3705,3359,110.3,6555,3380,3175,106.5
'34012, 서북구,'030004, 28세,2019,6265,3368,2897,116.3,5776,3049,2727,111.8
'34012, 서북구,'030005, 29세,2019,6460,3452,3008,114.8,5905,3092,2813,109.9
'34012, 서북구,'035,30~34세,2019,35273,18939,16334,115.9,32514,17183,15331,112.1
'34012, 서북구,'035001, 30세,2019,6576,3554,3022,117.6,6001,3176,2825,112.4
'34012, 서북구,'035002, 31세,2019,7083,3807,3276,116.2,6543,3464,3079,112.5
'34012, 서북구,'035003, 32세,2019,7265,3811,3454,110.3,6678,3451,3227,106.9
'34012, 서북구,'035004, 33세,2019,7268,3936,3332,118.1,6712,3593,3119,115.2
'34012, 서북구,'035005, 34세,2019,7081,3831,3250,117.9,6580,3499,3081,113.6
'34012, 서북구,'040,35~39세,2019,40004,21612,18392,117.5,37853,20244,17609,115
'34012, 서북구,'040001, 35세,2019,7317,4008,3309,121.1,6818,3691,3127,118
'34012, 서북구,'040002, 36세,2019,8049,4305,3744,115,7586,4021,3565,112.8
'34012, 서북구,'040003, 37세,2019,8467,4563,3904,116.9,8051,4284,3767,113.7
'34012, 서북구,'040004, 38세,2019,8130,4398,3732,117.8,7739,4163,3576,116.4
'34012, 서북구,'040005, 39세,2019,8041,4338,3703,117.1,7659,4085,3574,114.3
'34012, 서북구,'045,40~44세,2019,33672,17648,16024,110.1,32130,16689,15441,108.1
'34012, 서북구,'045001, 40세,2019,7329,3984,3345,119.1,6947,3740,3207,116.6
'34012, 서북구,'045002, 41세,2019,6640,3580,3060,117,6344,3395,2949,115.1
'34012, 서북구,'045003, 42세,2019,6654,3478,3176,109.5,6358,3304,3054,108.2
'34012, 서북구,'045004, 43세,2019,6503,3340,3163,105.6,6203,3152,3051,103.3
'34012, 서북구,'045005, 44세,2019,6546,3266,3280,99.6,6278,3098,3180,97.4
'34012, 서북구,'050,45~49세,2019,34993,17878,17115,104.5,33611,17072,16539,103.2
'34012, 서북구,'050001, 45세,2019,7070,3621,3449,105,6807,3457,3350,103.2
'34012, 서북구,'050002, 46세,2019,6898,3514,3384,103.8,6624,3362,3262,103.1
'34012, 서북구,'050003, 47세,2019,6807,3422,3385,101.1,6505,3236,3269,99
'34012, 서북구,'050004, 48세,2019,7301,3774,3527,107,7027,3616,3411,106
'34012, 서북구,'050005, 49세,2019,6917,3547,3370,105.3,6648,3401,3247,104.7
'34012, 서북구,'055,50~54세,2019,31690,16119,15571,103.5,30518,15490,15028,103.1
'34012, 서북구,'055001, 50세,2019,7031,3555,3476,102.3,6782,3426,3356,102.1
'34012, 서북구,'055002, 51세,2019,6981,3579,3402,105.2,6725,3428,3297,104
'34012, 서북구,'055003, 52세,2019,6069,3008,3061,98.3,5871,2900,2971,97.6
'34012, 서북구,'055004, 53세,2019,5551,2857,2694,106.1,5331,2745,2586,106.1
'34012, 서북구,'055005, 54세,2019,6058,3120,2938,106.2,5809,2991,2818,106.1
'34012, 서북구,'060,55~59세,2019,26809,14115,12694,111.2,25969,13681,12288,111.3
'34012, 서북구,'060001, 55세,2019,5225,2711,2514,107.8,5039,2606,2433,107.1
'34012, 서북구,'060002, 56세,2019,5380,2827,2553,110.7,5167,2718,2449,111
'34012, 서북구,'060003, 57세,2019,5390,2951,2439,121,5206,2856,2350,121.5
'34012, 서북구,'060004, 58세,2019,5538,2902,2636,110.1,5430,2847,2583,110.2
'34012, 서북구,'060005, 59세,2019,5276,2724,2552,106.7,5127,2654,2473,107.3
'34012, 서북구,'065,60~64세,2019,18642,9603,9039,106.2,18017,9300,8717,106.7
'34012, 서북구,'065001, 60세,2019,4481,2244,2237,100.3,4357,2182,2175,100.3
'34012, 서북구,'065002, 61세,2019,3894,2055,1839,111.7,3749,1983,1766,112.3
'34012, 서북구,'065003, 62세,2019,3712,1961,1751,112,3579,1900,1679,113.2
'34012, 서북구,'065004, 63세,2019,3188,1656,1532,108.1,3073,1601,1472,108.8
'34012, 서북구,'065005, 64세,2019,3367,1687,1680,100.4,3259,1634,1625,100.6
'34012, 서북구,'070,65~69세,2019,10671,5209,5462,95.4,10372,5059,5313,95.2
'34012, 서북구,'070001, 65세,2019,2624,1288,1336,96.4,2526,1236,1290,95.8
'34012, 서북구,'070002, 66세,2019,2129,1073,1056,101.6,2051,1034,1017,101.7
'34012, 서북구,'070003, 67세,2019,2442,1207,1235,97.7,2388,1179,1209,97.5
'34012, 서북구,'070004, 68세,2019,1676,811,865,93.8,1639,795,844,94.2
'34012, 서북구,'070005, 69세,2019,1800,830,970,85.6,1768,815,953,85.5
'34012, 서북구,'075,70~74세,2019,7711,3588,4123,87,7599,3548,4051,87.6
'34012, 서북구,'075001, 70세,2019,1850,848,1002,84.6,1810,832,978,85.1
'34012, 서북구,'075002, 71세,2019,1732,832,900,92.4,1711,824,887,92.9
'34012, 서북구,'075003, 72세,2019,1681,755,926,81.5,1661,748,913,81.9
'34012, 서북구,'075004, 73세,2019,1285,629,656,95.9,1267,623,644,96.7
'34012, 서북구,'075005, 74세,2019,1163,524,639,82,1150,521,629,82.8
'34012, 서북구,'080,75~79세,2019,6251,2533,3718,68.1,6207,2514,3693,68.1
'34012, 서북구,'080001, 75세,2019,1267,538,729,73.8,1250,532,718,74.1
'34012, 서북구,'080002, 76세,2019,1277,540,737,73.3,1268,535,733,73
'34012, 서북구,'080003, 77세,2019,1526,615,911,67.5,1521,613,908,67.5
'34012, 서북구,'080004, 78세,2019,1123,432,691,62.5,1118,430,688,62.5
'34012, 서북구,'080005, 79세,2019,1058,408,650,62.8,1050,404,646,62.5
'34012, 서북구,'085,80~84세,2019,4399,1535,2864,53.6,4370,1528,2842,53.8
'34012, 서북구,'085001, 80세,2019,1107,403,704,57.2,1103,401,702,57.1
'34012, 서북구,'085002, 81세,2019,955,358,597,60,942,355,587,60.5
'34012, 서북구,'085003, 82세,2019,863,298,565,52.7,858,296,562,52.7
'34012, 서북구,'085004, 83세,2019,775,265,510,52,771,265,506,52.4
'34012, 서북구,'085005, 84세,2019,699,211,488,43.2,696,211,485,43.5
'34012, 서북구,'086,85세이상,2019,3010,843,2167,38.9,2994,840,2154,39
'34012, 서북구,'090,85~89세,2019,2103,640,1463,43.7,2092,637,1455,43.8
'34012, 서북구,'090001, 85세,2019,633,223,410,54.4,630,222,408,54.4
'34012, 서북구,'090002, 86세,2019,481,148,333,44.4,478,148,330,44.8
'34012, 서북구,'090003, 87세,2019,420,131,289,45.3,419,131,288,45.5
'34012, 서북구,'090004, 88세,2019,298,70,228,30.7,294,68,226,30.1
'34012, 서북구,'090005, 89세,2019,271,68,203,33.5,271,68,203,33.5
'34012, 서북구,'095,90~94세,2019,730,169,561,30.1,725,169,556,30.4
'34012, 서북구,'095001, 90세,2019,226,53,173,30.6,224,53,171,31
'34012, 서북구,'095002, 91세,2019,190,51,139,36.7,189,51,138,37
'34012, 서북구,'095003, 92세,2019,144,30,114,26.3,143,30,113,26.5
'34012, 서북구,'095004, 93세,2019,91,19,72,26.4,90,19,71,26.8
'34012, 서북구,'095005, 94세,2019,79,16,63,25.4,79,16,63,25.4
'34012, 서북구,'100,95~99세,2019,158,31,127,24.4,158,31,127,24.4
'34012, 서북구,'100001, 95세,2019,54,13,41,31.7,54,13,41,31.7
'34012, 서북구,'100002, 96세,2019,48,8,40,20,48,8,40,20
'34012, 서북구,'100003, 97세,2019,28,5,23,21.7,28,5,23,21.7
'34012, 서북구,'100004, 98세,2019,17,X,13,30.8,17,X,13,30.8
'34012, 서북구,'100005, 99세,2019,11,X,10,10,11,X,10,10
'34012, 서북구,'101,100세이상,2019,19,X,16,18.8,19,X,16,18.8
'34012, 서북구,'102,15세미만,2019,63321,32455,30866,105.1,62639,32107,30532,105.2
'34012, 서북구,'103,15~64세,2019,305227,159788,145439,109.9,289918,150660,139258,108.2
'34012, 서북구,'104,65세이상,2019,32042,13708,18334,74.8,31542,13489,18053,74.7
'34012, 서북구,'126,평균연령,2019,37.2,36.7,37.9,,37.3,36.7,37.9,
'34012, 서북구,'127,중위연령,2019,37.3,36.9,37.7,,37.4,37,37.8,
'34020, 공주시,'000,합계,2019,109877,54485,55392,98.4,106959,52984,53975,98.2
'34020, 공주시,'005,0~4세,2019,2591,1312,1279,102.6,2576,1305,1271,102.7
'34020, 공주시,'005001, 0세,2019,544,268,276,97.1,540,266,274,97.1
'34020, 공주시,'005002, 1세,2019,414,221,193,114.5,413,220,193,114
'34020, 공주시,'005003, 2세,2019,508,260,248,104.8,506,260,246,105.7
'34020, 공주시,'005004, 3세,2019,518,264,254,103.9,516,264,252,104.8
'34020, 공주시,'005005, 4세,2019,607,299,308,97.1,601,295,306,96.4
'34020, 공주시,'010,5~9세,2019,3501,1860,1641,113.3,3489,1851,1638,113
'34020, 공주시,'010001, 5세,2019,606,338,268,126.1,601,333,268,124.3
'34020, 공주시,'010002, 6세,2019,691,372,319,116.6,691,372,319,116.6
'34020, 공주시,'010003, 7세,2019,729,380,349,108.9,728,379,349,108.6
'34020, 공주시,'010004, 8세,2019,754,389,365,106.6,748,386,362,106.6
'34020, 공주시,'010005, 9세,2019,721,381,340,112.1,721,381,340,112.1
'34020, 공주시,'015,10~14세,2019,3724,1900,1824,104.2,3719,1899,1820,104.3
'34020, 공주시,'015001, 10세,2019,720,366,354,103.4,719,365,354,103.1
'34020, 공주시,'015002, 11세,2019,733,367,366,100.3,731,367,364,100.8
'34020, 공주시,'015003, 12세,2019,796,418,378,110.6,795,418,377,110.9
'34020, 공주시,'015004, 13세,2019,747,373,374,99.7,747,373,374,99.7
'34020, 공주시,'015005, 14세,2019,728,376,352,106.8,727,376,351,107.1
'34020, 공주시,'020,15~19세,2019,7027,3641,3386,107.5,6930,3615,3315,109
'34020, 공주시,'020001, 15세,2019,841,436,405,107.7,840,435,405,107.4
'34020, 공주시,'020002, 16세,2019,1240,732,508,144.1,1240,732,508,144.1
'34020, 공주시,'020003, 17세,2019,1363,796,567,140.4,1359,794,565,140.5
'34020, 공주시,'020004, 18세,2019,1606,847,759,111.6,1565,841,724,116.2
'34020, 공주시,'020005, 19세,2019,1977,830,1147,72.4,1926,813,1113,73
'34020, 공주시,'025,20~24세,2019,9086,4343,4743,91.6,8588,4096,4492,91.2
'34020, 공주시,'025001, 20세,2019,1930,804,1126,71.4,1843,771,1072,71.9
'34020, 공주시,'025002, 21세,2019,2013,832,1181,70.4,1930,797,1133,70.3
'34020, 공주시,'025003, 22세,2019,1994,904,1090,82.9,1893,855,1038,82.4
'34020, 공주시,'025004, 23세,2019,1683,921,762,120.9,1580,863,717,120.4
'34020, 공주시,'025005, 24세,2019,1466,882,584,151,1342,810,532,152.3
'34020, 공주시,'030,25~29세,2019,5911,3416,2495,136.9,5294,3080,2214,139.1
'34020, 공주시,'030001, 25세,2019,1407,862,545,158.2,1276,790,486,162.6
'34020, 공주시,'030002, 26세,2019,1220,691,529,130.6,1090,622,468,132.9
'34020, 공주시,'030003, 27세,2019,1160,666,494,134.8,1036,595,441,134.9
'34020, 공주시,'030004, 28세,2019,1074,612,462,132.5,956,551,405,136
'34020, 공주시,'030005, 29세,2019,1050,585,465,125.8,936,522,414,126.1
'34020, 공주시,'035,30~34세,2019,4848,2644,2204,120,4395,2409,1986,121.3
'34020, 공주시,'035001, 30세,2019,1009,579,430,134.7,903,519,384,135.2
'34020, 공주시,'035002, 31세,2019,979,532,447,119,878,476,402,118.4
'34020, 공주시,'035003, 32세,2019,968,531,437,121.5,876,483,393,122.9
'34020, 공주시,'035004, 33세,2019,956,503,453,111,879,466,413,112.8
'34020, 공주시,'035005, 34세,2019,936,499,437,114.2,859,465,394,118
'34020, 공주시,'040,35~39세,2019,5655,2954,2701,109.4,5328,2780,2548,109.1
'34020, 공주시,'040001, 35세,2019,949,517,432,119.7,876,476,400,119
'34020, 공주시,'040002, 36세,2019,1129,591,538,109.9,1062,555,507,109.5
'34020, 공주시,'040003, 37세,2019,1105,570,535,106.5,1035,534,501,106.6
'34020, 공주시,'040004, 38세,2019,1211,630,581,108.4,1149,600,549,109.3
'34020, 공주시,'040005, 39세,2019,1261,646,615,105,1206,615,591,104.1
'34020, 공주시,'045,40~44세,2019,6021,3225,2796,115.3,5800,3098,2702,114.7
'34020, 공주시,'045001, 40세,2019,1194,613,581,105.5,1137,583,554,105.2
'34020, 공주시,'045002, 41세,2019,1189,661,528,125.2,1139,636,503,126.4
'34020, 공주시,'045003, 42세,2019,1179,630,549,114.8,1149,608,541,112.4
'34020, 공주시,'045004, 43세,2019,1163,617,546,113,1129,598,531,112.6
'34020, 공주시,'045005, 44세,2019,1296,704,592,118.9,1246,673,573,117.5
'34020, 공주시,'050,45~49세,2019,7496,3851,3645,105.7,7328,3770,3558,106
'34020, 공주시,'050001, 45세,2019,1438,759,679,111.8,1414,749,665,112.6
'34020, 공주시,'050002, 46세,2019,1493,750,743,100.9,1463,735,728,101
'34020, 공주시,'050003, 47세,2019,1340,681,659,103.3,1309,665,644,103.3
'34020, 공주시,'050004, 48세,2019,1617,851,766,111.1,1579,831,748,111.1
'34020, 공주시,'050005, 49세,2019,1608,810,798,101.5,1563,790,773,102.2
'34020, 공주시,'055,50~54세,2019,8553,4448,4105,108.4,8357,4337,4020,107.9
'34020, 공주시,'055001, 50세,2019,1743,915,828,110.5,1717,894,823,108.6
'34020, 공주시,'055002, 51세,2019,1811,953,858,111.1,1761,926,835,110.9
'34020, 공주시,'055003, 52세,2019,1700,898,802,112,1656,874,782,111.8
'34020, 공주시,'055004, 53세,2019,1452,757,695,108.9,1420,740,680,108.8
'34020, 공주시,'055005, 54세,2019,1847,925,922,100.3,1803,903,900,100.3
'34020, 공주시,'060,55~59세,2019,10072,5108,4964,102.9,9952,5052,4900,103.1
'34020, 공주시,'060001, 55세,2019,1701,882,819,107.7,1670,863,807,106.9
'34020, 공주시,'060002, 56세,2019,1788,894,894,100,1760,885,875,101.1
'34020, 공주시,'060003, 57세,2019,1988,1022,966,105.8,1969,1014,955,106.2
'34020, 공주시,'060004, 58세,2019,2391,1230,1161,105.9,2370,1220,1150,106.1
'34020, 공주시,'060005, 59세,2019,2204,1080,1124,96.1,2183,1070,1113,96.1
'34020, 공주시,'065,60~64세,2019,9668,4837,4831,100.1,9578,4789,4789,100
'34020, 공주시,'065001, 60세,2019,2032,991,1041,95.2,2016,982,1034,95
'34020, 공주시,'065002, 61세,2019,1915,944,971,97.2,1890,934,956,97.7
'34020, 공주시,'065003, 62세,2019,1926,971,955,101.7,1912,961,951,101.1
'34020, 공주시,'065004, 63세,2019,1794,922,872,105.7,1782,916,866,105.8
'34020, 공주시,'065005, 64세,2019,2001,1009,992,101.7,1978,996,982,101.4
'34020, 공주시,'070,65~69세,2019,7018,3478,3540,98.2,6966,3451,3515,98.2
'34020, 공주시,'070001, 65세,2019,1567,742,825,89.9,1557,737,820,89.9
'34020, 공주시,'070002, 66세,2019,1338,659,679,97.1,1323,650,673,96.6
'34020, 공주시,'070003, 67세,2019,1566,787,779,101,1553,780,773,100.9
'34020, 공주시,'070004, 68세,2019,1151,586,565,103.7,1147,584,563,103.7
'34020, 공주시,'070005, 69세,2019,1396,704,692,101.7,1386,700,686,102
'34020, 공주시,'075,70~74세,2019,5519,2642,2877,91.8,5494,2635,2859,92.2
'34020, 공주시,'075001, 70세,2019,1328,660,668,98.8,1320,659,661,99.7
'34020, 공주시,'075002, 71세,2019,1248,593,655,90.5,1240,590,650,90.8
'34020, 공주시,'075003, 72세,2019,1165,587,578,101.6,1160,584,576,101.4
'34020, 공주시,'075004, 73세,2019,857,403,454,88.8,855,403,452,89.2
'34020, 공주시,'075005, 74세,2019,921,399,522,76.4,919,399,520,76.7
'34020, 공주시,'080,75~79세,2019,5356,2206,3150,70,5343,2201,3142,70.1
'34020, 공주시,'080001, 75세,2019,1037,420,617,68.1,1035,420,615,68.3
'34020, 공주시,'080002, 76세,2019,925,400,525,76.2,921,398,523,76.1
'34020, 공주시,'080003, 77세,2019,1411,570,841,67.8,1408,568,840,67.6
'34020, 공주시,'080004, 78세,2019,1032,444,588,75.5,1030,443,587,75.5
'34020, 공주시,'080005, 79세,2019,951,372,579,64.2,949,372,577,64.5
'34020, 공주시,'085,80~84세,2019,4451,1620,2831,57.2,4445,1617,2828,57.2
'34020, 공주시,'085001, 80세,2019,1074,398,676,58.9,1073,398,675,59
'34020, 공주시,'085002, 81세,2019,906,329,577,57,905,329,576,57.1
'34020, 공주시,'085003, 82세,2019,891,337,554,60.8,890,337,553,60.9
'34020, 공주시,'085004, 83세,2019,811,277,534,51.9,809,275,534,51.5
'34020, 공주시,'085005, 84세,2019,769,279,490,56.9,768,278,490,56.7
'34020, 공주시,'086,85세이상,2019,3380,1000,2380,42,3377,999,2378,42
'34020, 공주시,'090,85~89세,2019,2442,768,1674,45.9,2440,767,1673,45.8
'34020, 공주시,'090001, 85세,2019,678,228,450,50.7,678,228,450,50.7
'34020, 공주시,'090002, 86세,2019,563,193,370,52.2,563,193,370,52.2
'34020, 공주시,'090003, 87세,2019,498,147,351,41.9,497,147,350,42
'34020, 공주시,'090004, 88세,2019,396,114,282,40.4,395,113,282,40.1
'34020, 공주시,'090005, 89세,2019,307,86,221,38.9,307,86,221,38.9
'34020, 공주시,'095,90~94세,2019,761,194,567,34.2,760,194,566,34.3
'34020, 공주시,'095001, 90세,2019,277,66,211,31.3,277,66,211,31.3
'34020, 공주시,'095002, 91세,2019,190,51,139,36.7,190,51,139,36.7
'34020, 공주시,'095003, 92세,2019,126,33,93,35.5,125,33,92,35.9
'34020, 공주시,'095004, 93세,2019,100,29,71,40.8,100,29,71,40.8
'34020, 공주시,'095005, 94세,2019,68,15,53,28.3,68,15,53,28.3
'34020, 공주시,'100,95~99세,2019,154,32,122,26.2,154,32,122,26.2
'34020, 공주시,'100001, 95세,2019,42,9,33,27.3,42,9,33,27.3
'34020, 공주시,'100002, 96세,2019,48,14,34,41.2,48,14,34,41.2
'34020, 공주시,'100003, 97세,2019,34,X,30,13.3,34,X,30,13.3
'34020, 공주시,'100004, 98세,2019,19,5,14,35.7,19,5,14,35.7
'34020, 공주시,'100005, 99세,2019,11,X,11,0,11,X,11,0
'34020, 공주시,'101,100세이상,2019,23,6,17,35.3,23,6,17,35.3
'34020, 공주시,'102,15세미만,2019,9816,5072,4744,106.9,9784,5055,4729,106.9
'34020, 공주시,'103,15~64세,2019,74337,38467,35870,107.2,71550,37026,34524,107.2
'34020, 공주시,'104,65세이상,2019,25724,10946,14778,74.1,25625,10903,14722,74.1
'34020, 공주시,'126,평균연령,2019,46.8,45.2,48.3,,47.1,45.5,48.7,
'34020, 공주시,'127,중위연령,2019,49.4,47.6,51.2,,50,48.3,51.7,
'34030, 보령시,'000,합계,2019,99320,51427,47893,107.4,95202,48314,46888,103
'34030, 보령시,'005,0~4세,2019,2764,1385,1379,100.4,2754,1378,1376,100.1
'34030, 보령시,'005001, 0세,2019,461,222,239,92.9,461,222,239,92.9
'34030, 보령시,'005002, 1세,2019,459,226,233,97,457,224,233,96.1
'34030, 보령시,'005003, 2세,2019,567,294,273,107.7,566,293,273,107.3
'34030, 보령시,'005004, 3세,2019,623,324,299,108.4,618,321,297,108.1
'34030, 보령시,'005005, 4세,2019,654,319,335,95.2,652,318,334,95.2
'34030, 보령시,'010,5~9세,2019,3754,1884,1870,100.7,3736,1877,1859,101
'34030, 보령시,'010001, 5세,2019,678,332,346,96,674,331,343,96.5
'34030, 보령시,'010002, 6세,2019,706,363,343,105.8,700,361,339,106.5
'34030, 보령시,'010003, 7세,2019,729,372,357,104.2,725,370,355,104.2
'34030, 보령시,'010004, 8세,2019,842,409,433,94.5,840,409,431,94.9
'34030, 보령시,'010005, 9세,2019,799,408,391,104.3,797,406,391,103.8
'34030, 보령시,'015,10~14세,2019,3896,2024,1872,108.1,3887,2020,1867,108.2
'34030, 보령시,'015001, 10세,2019,744,380,364,104.4,743,380,363,104.7
'34030, 보령시,'015002, 11세,2019,822,400,422,94.8,818,398,420,94.8
'34030, 보령시,'015003, 12세,2019,780,404,376,107.4,779,403,376,107.2
'34030, 보령시,'015004, 13세,2019,777,412,365,112.9,775,412,363,113.5
'34030, 보령시,'015005, 14세,2019,773,428,345,124.1,772,427,345,123.8
'34030, 보령시,'020,15~19세,2019,3804,2081,1723,120.8,3762,2060,1702,121
'34030, 보령시,'020001, 15세,2019,808,426,382,111.5,803,422,381,110.8
'34030, 보령시,'020002, 16세,2019,678,362,316,114.6,675,361,314,115
'34030, 보령시,'020003, 17세,2019,758,407,351,116,756,407,349,116.6
'34030, 보령시,'020004, 18세,2019,826,448,378,118.5,820,446,374,119.3
'34030, 보령시,'020005, 19세,2019,734,438,296,148,708,424,284,149.3
'34030, 보령시,'025,20~24세,2019,4944,3168,1776,178.4,4502,2811,1691,166.2
'34030, 보령시,'025001, 20세,2019,908,603,305,197.7,868,574,294,195.2
'34030, 보령시,'025002, 21세,2019,962,654,308,212.3,896,604,292,206.8
'34030, 보령시,'025003, 22세,2019,947,617,330,187,860,542,318,170.4
'34030, 보령시,'025004, 23세,2019,1067,673,394,170.8,962,584,378,154.5
'34030, 보령시,'025005, 24세,2019,1060,621,439,141.5,916,507,409,124
'34030, 보령시,'030,25~29세,2019,4991,3157,1834,172.1,4096,2424,1672,145
'34030, 보령시,'030001, 25세,2019,1018,639,379,168.6,862,508,354,143.5
'34030, 보령시,'030002, 26세,2019,1009,668,341,195.9,846,537,309,173.8
'34030, 보령시,'030003, 27세,2019,1007,655,352,186.1,806,492,314,156.7
'34030, 보령시,'030004, 28세,2019,1003,606,397,152.6,820,460,360,127.8
'34030, 보령시,'030005, 29세,2019,954,589,365,161.4,762,427,335,127.5
'34030, 보령시,'035,30~34세,2019,4905,2898,2007,144.4,4048,2204,1844,119.5
'34030, 보령시,'035001, 30세,2019,958,609,349,174.5,774,454,320,141.9
'34030, 보령시,'035002, 31세,2019,940,570,370,154.1,769,430,339,126.8
'34030, 보령시,'035003, 32세,2019,1009,571,438,130.4,829,428,401,106.7
'34030, 보령시,'035004, 33세,2019,971,563,408,138,810,432,378,114.3
'34030, 보령시,'035005, 34세,2019,1027,585,442,132.4,866,460,406,113.3
'34030, 보령시,'040,35~39세,2019,6190,3503,2687,130.4,5547,2988,2559,116.8
'34030, 보령시,'040001, 35세,2019,1054,597,457,130.6,930,496,434,114.3
'34030, 보령시,'040002, 36세,2019,1180,673,507,132.7,1036,561,475,118.1
'34030, 보령시,'040003, 37세,2019,1317,751,566,132.7,1181,641,540,118.7
'34030, 보령시,'040004, 38세,2019,1262,704,558,126.2,1141,605,536,112.9
'34030, 보령시,'040005, 39세,2019,1377,778,599,129.9,1259,685,574,119.3
'34030, 보령시,'045,40~44세,2019,6498,3626,2872,126.3,6067,3302,2765,119.4
'34030, 보령시,'045001, 40세,2019,1328,734,594,123.6,1226,658,568,115.8
'34030, 보령시,'045002, 41세,2019,1196,662,534,124,1098,587,511,114.9
'34030, 보령시,'045003, 42세,2019,1295,758,537,141.2,1223,705,518,136.1
'34030, 보령시,'045004, 43세,2019,1301,714,587,121.6,1226,657,569,115.5
'34030, 보령시,'045005, 44세,2019,1378,758,620,122.3,1294,695,599,116
'34030, 보령시,'050,45~49세,2019,7797,4299,3498,122.9,7467,4065,3402,119.5
'34030, 보령시,'050001, 45세,2019,1574,869,705,123.3,1495,813,682,119.2
'34030, 보령시,'050002, 46세,2019,1596,900,696,129.3,1517,838,679,123.4
'34030, 보령시,'050003, 47세,2019,1496,820,676,121.3,1425,773,652,118.6
'34030, 보령시,'050004, 48세,2019,1617,897,720,124.6,1572,863,709,121.7
'34030, 보령시,'050005, 49세,2019,1514,813,701,116,1458,778,680,114.4
'34030, 보령시,'055,50~54세,2019,7928,4225,3703,114.1,7754,4127,3627,113.8
'34030, 보령시,'055001, 50세,2019,1602,849,753,112.7,1558,823,735,112
'34030, 보령시,'055002, 51세,2019,1719,924,795,116.2,1681,907,774,117.2
'34030, 보령시,'055003, 52세,2019,1531,802,729,110,1496,780,716,108.9
'34030, 보령시,'055004, 53세,2019,1430,801,629,127.3,1403,785,618,127
'34030, 보령시,'055005, 54세,2019,1646,849,797,106.5,1616,832,784,106.1
'34030, 보령시,'060,55~59세,2019,9160,4689,4471,104.9,9022,4627,4395,105.3
'34030, 보령시,'060001, 55세,2019,1632,849,783,108.4,1595,831,764,108.8
'34030, 보령시,'060002, 56세,2019,1558,808,750,107.7,1522,794,728,109.1
'34030, 보령시,'060003, 57세,2019,1781,922,859,107.3,1749,905,844,107.2
'34030, 보령시,'060004, 58세,2019,2156,1111,1045,106.3,2141,1103,1038,106.3
'34030, 보령시,'060005, 59세,2019,2033,999,1034,96.6,2015,994,1021,97.4
'34030, 보령시,'065,60~64세,2019,8806,4370,4436,98.5,8735,4337,4398,98.6
'34030, 보령시,'065001, 60세,2019,1825,889,936,95,1810,884,926,95.5
'34030, 보령시,'065002, 61세,2019,1742,835,907,92.1,1727,830,897,92.5
'34030, 보령시,'065003, 62세,2019,1740,902,838,107.6,1726,892,834,107
'34030, 보령시,'065004, 63세,2019,1657,837,820,102.1,1647,831,816,101.8
'34030, 보령시,'065005, 64세,2019,1842,907,935,97,1825,900,925,97.3
'34030, 보령시,'070,65~69세,2019,6807,3219,3588,89.7,6780,3209,3571,89.9
'34030, 보령시,'070001, 65세,2019,1607,777,830,93.6,1600,776,824,94.2
'34030, 보령시,'070002, 66세,2019,1227,569,658,86.5,1219,566,653,86.7
'34030, 보령시,'070003, 67세,2019,1415,642,773,83.1,1412,640,772,82.9
'34030, 보령시,'070004, 68세,2019,1229,603,626,96.3,1224,600,624,96.2
'34030, 보령시,'070005, 69세,2019,1329,628,701,89.6,1325,627,698,89.8
'34030, 보령시,'075,70~74세,2019,5618,2591,3027,85.6,5603,2585,3018,85.7
'34030, 보령시,'075001, 70세,2019,1377,661,716,92.3,1372,660,712,92.7
'34030, 보령시,'075002, 71세,2019,1248,591,657,90,1246,590,656,89.9
'34030, 보령시,'075003, 72세,2019,1235,549,686,80,1231,548,683,80.2
'34030, 보령시,'075004, 73세,2019,863,416,447,93.1,862,415,447,92.8
'34030, 보령시,'075005, 74세,2019,895,374,521,71.8,892,372,520,71.5
'34030, 보령시,'080,75~79세,2019,4987,2106,2881,73.1,4982,2104,2878,73.1
'34030, 보령시,'080001, 75세,2019,1005,437,568,76.9,1005,437,568,76.9
'34030, 보령시,'080002, 76세,2019,996,464,532,87.2,994,463,531,87.2
'34030, 보령시,'080003, 77세,2019,1197,471,726,64.9,1196,470,726,64.7
'34030, 보령시,'080004, 78세,2019,933,381,552,69,931,381,550,69.3
'34030, 보령시,'080005, 79세,2019,856,353,503,70.2,856,353,503,70.2
'34030, 보령시,'085,80~84세,2019,3906,1467,2439,60.1,3899,1463,2436,60.1
'34030, 보령시,'085001, 80세,2019,903,359,544,66,901,358,543,65.9
'34030, 보령시,'085002, 81세,2019,871,326,545,59.8,869,324,545,59.4
'34030, 보령시,'085003, 82세,2019,745,305,440,69.3,744,305,439,69.5
'34030, 보령시,'085004, 83세,2019,715,251,464,54.1,714,251,463,54.2
'34030, 보령시,'085005, 84세,2019,672,226,446,50.7,671,225,446,50.4
'34030, 보령시,'086,85세이상,2019,2565,735,1830,40.2,2561,733,1828,40.1
'34030, 보령시,'090,85~89세,2019,1815,566,1249,45.3,1811,564,1247,45.2
'34030, 보령시,'090001, 85세,2019,499,169,330,51.2,499,169,330,51.2
'34030, 보령시,'090002, 86세,2019,419,161,258,62.4,419,161,258,62.4
'34030, 보령시,'090003, 87세,2019,381,103,278,37.1,379,101,278,36.3
'34030, 보령시,'090004, 88세,2019,274,85,189,45,273,85,188,45.2
'34030, 보령시,'090005, 89세,2019,242,48,194,24.7,241,48,193,24.9
'34030, 보령시,'095,90~94세,2019,595,140,455,30.8,595,140,455,30.8
'34030, 보령시,'095001, 90세,2019,203,51,152,33.6,203,51,152,33.6
'34030, 보령시,'095002, 91세,2019,151,36,115,31.3,151,36,115,31.3
'34030, 보령시,'095003, 92세,2019,107,30,77,39,107,30,77,39
'34030, 보령시,'095004, 93세,2019,79,16,63,25.4,79,16,63,25.4
'34030, 보령시,'095005, 94세,2019,55,7,48,14.6,55,7,48,14.6
'34030, 보령시,'100,95~99세,2019,140,26,114,22.8,140,26,114,22.8
'34030, 보령시,'100001, 95세,2019,43,12,31,38.7,43,12,31,38.7
'34030, 보령시,'100002, 96세,2019,49,7,42,16.7,49,7,42,16.7
'34030, 보령시,'100003, 97세,2019,25,X,21,19,25,X,21,19
'34030, 보령시,'100004, 98세,2019,15,X,13,15.4,15,X,13,15.4
'34030, 보령시,'100005, 99세,2019,8,X,7,14.3,8,X,7,14.3
'34030, 보령시,'101,100세이상,2019,15,X,12,25,15,X,12,25
'34030, 보령시,'102,15세미만,2019,10414,5293,5121,103.4,10377,5275,5102,103.4
'34030, 보령시,'103,15~64세,2019,65023,36016,29007,124.2,61000,32945,28055,117.4
'34030, 보령시,'104,65세이상,2019,23883,10118,13765,73.5,23825,10094,13731,73.5
'34030, 보령시,'126,평균연령,2019,47.7,45.5,50,,48.2,46.2,50.2,
'34030, 보령시,'127,중위연령,2019,50.1,47.3,53.2,,51.1,48.8,53.8,
'34040, 아산시,'000,합계,2019,347032,182818,164214,111.3,318633,165184,153449,107.6
'34040, 아산시,'005,0~4세,2019,16471,8393,8078,103.9,15673,8020,7653,104.8
'34040, 아산시,'005001, 0세,2019,2547,1317,1230,107.1,2408,1250,1158,107.9
'34040, 아산시,'005002, 1세,2019,2919,1461,1458,100.2,2770,1391,1379,100.9
'34040, 아산시,'005003, 2세,2019,3263,1661,1602,103.7,3092,1576,1516,104
'34040, 아산시,'005004, 3세,2019,3827,1924,1903,101.1,3632,1840,1792,102.7
'34040, 아산시,'005005, 4세,2019,3915,2030,1885,107.7,3771,1963,1808,108.6
'34040, 아산시,'010,5~9세,2019,19820,10216,9604,106.4,19273,9925,9348,106.2
'34040, 아산시,'010001, 5세,2019,3721,1914,1807,105.9,3586,1834,1752,104.7
'34040, 아산시,'010002, 6세,2019,3896,2010,1886,106.6,3782,1945,1837,105.9
'34040, 아산시,'010003, 7세,2019,4186,2140,2046,104.6,4069,2082,1987,104.8
'34040, 아산시,'010004, 8세,2019,4130,2124,2006,105.9,4039,2080,1959,106.2
'34040, 아산시,'010005, 9세,2019,3887,2028,1859,109.1,3797,1984,1813,109.4
'34040, 아산시,'015,10~14세,2019,17499,8992,8507,105.7,17160,8797,8363,105.2
'34040, 아산시,'015001, 10세,2019,3689,1898,1791,106,3606,1849,1757,105.2
'34040, 아산시,'015002, 11세,2019,3748,1875,1873,100.1,3667,1830,1837,99.6
'34040, 아산시,'015003, 12세,2019,3591,1882,1709,110.1,3527,1849,1678,110.2
'34040, 아산시,'015004, 13세,2019,3340,1698,1642,103.4,3276,1658,1618,102.5
'34040, 아산시,'015005, 14세,2019,3131,1639,1492,109.9,3084,1611,1473,109.4
'34040, 아산시,'020,15~19세,2019,20380,10379,10001,103.8,19726,10067,9659,104.2
'34040, 아산시,'020001, 15세,2019,3289,1632,1657,98.5,3234,1609,1625,99
'34040, 아산시,'020002, 16세,2019,3380,1685,1695,99.4,3339,1660,1679,98.9
'34040, 아산시,'020003, 17세,2019,3370,1657,1713,96.7,3321,1632,1689,96.6
'34040, 아산시,'020004, 18세,2019,4160,2136,2024,105.5,3984,2050,1934,106
'34040, 아산시,'020005, 19세,2019,6181,3269,2912,112.3,5848,3116,2732,114.1
'34040, 아산시,'025,20~24세,2019,24914,13592,11322,120,21540,11640,9900,117.6
'34040, 아산시,'025001, 20세,2019,5016,2415,2601,92.8,4500,2151,2349,91.6
'34040, 아산시,'025002, 21세,2019,5174,2529,2645,95.6,4490,2200,2290,96.1
'34040, 아산시,'025003, 22세,2019,5153,2806,2347,119.6,4466,2402,2064,116.4
'34040, 아산시,'025004, 23세,2019,4970,2969,2001,148.4,4243,2516,1727,145.7
'34040, 아산시,'025005, 24세,2019,4601,2873,1728,166.3,3841,2371,1470,161.3
'34040, 아산시,'030,25~29세,2019,24351,13994,10357,135.1,20163,11047,9116,121.2
'34040, 아산시,'030001, 25세,2019,4635,2746,1889,145.4,3831,2187,1644,133
'34040, 아산시,'030002, 26세,2019,4845,2710,2135,126.9,4055,2143,1912,112.1
'34040, 아산시,'030003, 27세,2019,5095,2887,2208,130.8,4287,2314,1973,117.3
'34040, 아산시,'030004, 28세,2019,4845,2826,2019,140,3986,2222,1764,126
'34040, 아산시,'030005, 29세,2019,4931,2825,2106,134.1,4004,2181,1823,119.6
'34040, 아산시,'035,30~34세,2019,26954,15287,11667,131,22062,11920,10142,117.5
'34040, 아산시,'035001, 30세,2019,5042,2970,2072,143.3,4061,2280,1781,128
'34040, 아산시,'035002, 31세,2019,5237,2905,2332,124.6,4203,2205,1998,110.4
'34040, 아산시,'035003, 32세,2019,5507,3155,2352,134.1,4469,2451,2018,121.5
'34040, 아산시,'035004, 33세,2019,5525,3047,2478,123,4578,2396,2182,109.8
'34040, 아산시,'035005, 34세,2019,5643,3210,2433,131.9,4751,2588,2163,119.6
'34040, 아산시,'040,35~39세,2019,33747,18688,15059,124.1,29947,16138,13809,116.9
'34040, 아산시,'040001, 35세,2019,5905,3217,2688,119.7,5072,2655,2417,109.8
'34040, 아산시,'040002, 36세,2019,6455,3545,2910,121.8,5625,2988,2637,113.3
'34040, 아산시,'040003, 37세,2019,7283,4063,3220,126.2,6512,3536,2976,118.8
'34040, 아산시,'040004, 38세,2019,7027,3949,3078,128.3,6302,3481,2821,123.4
'34040, 아산시,'040005, 39세,2019,7077,3914,3163,123.7,6436,3478,2958,117.6
'34040, 아산시,'045,40~44세,2019,29554,16331,13223,123.5,26818,14544,12274,118.5
'34040, 아산시,'045001, 40세,2019,6694,3766,2928,128.6,5984,3285,2699,121.7
'34040, 아산시,'045002, 41세,2019,5841,3260,2581,126.3,5299,2913,2386,122.1
'34040, 아산시,'045003, 42세,2019,5926,3296,2630,125.3,5391,2950,2441,120.9
'34040, 아산시,'045004, 43세,2019,5615,3050,2565,118.9,5093,2712,2381,113.9
'34040, 아산시,'045005, 44세,2019,5478,2959,2519,117.5,5051,2684,2367,113.4
'34040, 아산시,'050,45~49세,2019,28983,16183,12800,126.4,26577,14689,11888,123.6
'34040, 아산시,'050001, 45세,2019,5924,3272,2652,123.4,5434,2961,2473,119.7
'34040, 아산시,'050002, 46세,2019,5819,3180,2639,120.5,5395,2923,2472,118.2
'34040, 아산시,'050003, 47세,2019,5632,3211,2421,132.6,5117,2894,2223,130.2
'34040, 아산시,'050004, 48세,2019,6060,3398,2662,127.6,5564,3094,2470,125.3
'34040, 아산시,'050005, 49세,2019,5548,3122,2426,128.7,5067,2817,2250,125.2
'34040, 아산시,'055,50~54세,2019,24928,13443,11485,117,23157,12481,10676,116.9
'34040, 아산시,'055001, 50세,2019,5629,3032,2597,116.8,5227,2811,2416,116.3
'34040, 아산시,'055002, 51세,2019,5189,2706,2483,109,4836,2516,2320,108.4
'34040, 아산시,'055003, 52세,2019,4727,2577,2150,119.9,4405,2393,2012,118.9
'34040, 아산시,'055004, 53세,2019,4526,2481,2045,121.3,4190,2311,1879,123
'34040, 아산시,'055005, 54세,2019,4857,2647,2210,119.8,4499,2450,2049,119.6
'34040, 아산시,'060,55~59세,2019,22425,11938,10487,113.8,21110,11276,9834,114.7
'34040, 아산시,'060001, 55세,2019,4124,2221,1903,116.7,3831,2065,1766,116.9
'34040, 아산시,'060002, 56세,2019,4361,2374,1987,119.5,4005,2194,1811,121.1
'34040, 아산시,'060003, 57세,2019,4486,2398,2088,114.8,4229,2262,1967,115
'34040, 아산시,'060004, 58세,2019,4794,2535,2259,112.2,4621,2456,2165,113.4
'34040, 아산시,'060005, 59세,2019,4660,2410,2250,107.1,4424,2299,2125,108.2
'34040, 아산시,'065,60~64세,2019,17627,8764,8863,98.9,16795,8333,8462,98.5
'34040, 아산시,'065001, 60세,2019,3916,1972,1944,101.4,3750,1889,1861,101.5
'34040, 아산시,'065002, 61세,2019,3526,1778,1748,101.7,3344,1682,1662,101.2
'34040, 아산시,'065003, 62세,2019,3552,1769,1783,99.2,3361,1652,1709,96.7
'34040, 아산시,'065004, 63세,2019,3249,1596,1653,96.6,3096,1527,1569,97.3
'34040, 아산시,'065005, 64세,2019,3384,1649,1735,95,3244,1583,1661,95.3
'34040, 아산시,'070,65~69세,2019,11854,5605,6249,89.7,11436,5429,6007,90.4
'34040, 아산시,'070001, 65세,2019,2752,1314,1438,91.4,2619,1259,1360,92.6
'34040, 아산시,'070002, 66세,2019,2359,1149,1210,95,2279,1112,1167,95.3
'34040, 아산시,'070003, 67세,2019,2644,1242,1402,88.6,2557,1212,1345,90.1
'34040, 아산시,'070004, 68세,2019,1925,908,1017,89.3,1860,873,987,88.4
'34040, 아산시,'070005, 69세,2019,2174,992,1182,83.9,2121,973,1148,84.8
'34040, 아산시,'075,70~74세,2019,9266,4265,5001,85.3,9094,4180,4914,85.1
'34040, 아산시,'075001, 70세,2019,2121,1006,1115,90.2,2061,976,1085,90
'34040, 아산시,'075002, 71세,2019,2091,988,1103,89.6,2062,974,1088,89.5
'34040, 아산시,'075003, 72세,2019,2043,942,1101,85.6,2012,923,1089,84.8
'34040, 아산시,'075004, 73세,2019,1514,685,829,82.6,1486,672,814,82.6
'34040, 아산시,'075005, 74세,2019,1497,644,853,75.5,1473,635,838,75.8
'34040, 아산시,'080,75~79세,2019,8019,3320,4699,70.7,7942,3293,4649,70.8
'34040, 아산시,'080001, 75세,2019,1593,691,902,76.6,1574,685,889,77.1
'34040, 아산시,'080002, 76세,2019,1616,671,945,71,1602,667,935,71.3
'34040, 아산시,'080003, 77세,2019,1974,811,1163,69.7,1959,804,1155,69.6
'34040, 아산시,'080004, 78세,2019,1484,624,860,72.6,1465,617,848,72.8
'34040, 아산시,'080005, 79세,2019,1352,523,829,63.1,1342,520,822,63.3
'34040, 아산시,'085,80~84세,2019,6160,2288,3872,59.1,6106,2276,3830,59.4
'34040, 아산시,'085001, 80세,2019,1485,570,915,62.3,1469,566,903,62.7
'34040, 아산시,'085002, 81세,2019,1274,490,784,62.5,1265,488,777,62.8
'34040, 아산시,'085003, 82세,2019,1284,459,825,55.6,1270,456,814,56
'34040, 아산시,'085004, 83세,2019,1100,413,687,60.1,1092,410,682,60.1
'34040, 아산시,'085005, 84세,2019,1017,356,661,53.9,1010,356,654,54.4
'34040, 아산시,'086,85세이상,2019,4080,1140,2940,38.8,4054,1129,2925,38.6
'34040, 아산시,'090,85~89세,2019,2967,896,2071,43.3,2949,887,2062,43
'34040, 아산시,'090001, 85세,2019,815,260,555,46.8,808,255,553,46.1
'34040, 아산시,'090002, 86세,2019,720,208,512,40.6,717,208,509,40.9
'34040, 아산시,'090003, 87세,2019,630,221,409,54,626,218,408,53.4
'34040, 아산시,'090004, 88세,2019,426,116,310,37.4,424,115,309,37.2
'34040, 아산시,'090005, 89세,2019,376,91,285,31.9,374,91,283,32.2
'34040, 아산시,'095,90~94세,2019,878,196,682,28.7,875,195,680,28.7
'34040, 아산시,'095001, 90세,2019,281,65,216,30.1,280,65,215,30.2
'34040, 아산시,'095002, 91세,2019,253,60,193,31.1,251,59,192,30.7
'34040, 아산시,'095003, 92세,2019,154,32,122,26.2,154,32,122,26.2
'34040, 아산시,'095004, 93세,2019,109,22,87,25.3,109,22,87,25.3
'34040, 아산시,'095005, 94세,2019,81,17,64,26.6,81,17,64,26.6
'34040, 아산시,'100,95~99세,2019,203,45,158,28.5,198,44,154,28.6
'34040, 아산시,'100001, 95세,2019,66,16,50,32,65,16,49,32.7
'34040, 아산시,'100002, 96세,2019,55,11,44,25,54,11,43,25.6
'34040, 아산시,'100003, 97세,2019,39,7,32,21.9,36,6,30,20
'34040, 아산시,'100004, 98세,2019,27,5,22,22.7,27,5,22,22.7
'34040, 아산시,'100005, 99세,2019,16,6,10,60,16,6,10,60
'34040, 아산시,'101,100세이상,2019,32,X,29,10.3,32,X,29,10.3
'34040, 아산시,'102,15세미만,2019,53790,27601,26189,105.4,52106,26742,25364,105.4
'34040, 아산시,'103,15~64세,2019,253863,138599,115264,120.2,227895,122135,105760,115.5
'34040, 아산시,'104,65세이상,2019,39379,16618,22761,73,38632,16307,22325,73
'34040, 아산시,'126,평균연령,2019,38.7,37.9,39.7,,39,38.1,39.9,
'34040, 아산시,'127,중위연령,2019,38.5,37.9,39.2,,39,38.6,39.6,
'34050, 서산시,'000,합계,2019,175204,91088,84116,108.3,168621,87440,81181,107.7
'34050, 서산시,'005,0~4세,2019,7403,3780,3623,104.3,7254,3706,3548,104.5
'34050, 서산시,'005001, 0세,2019,1269,647,622,104,1241,629,612,102.8
'34050, 서산시,'005002, 1세,2019,1376,686,690,99.4,1352,676,676,100
'34050, 서산시,'005003, 2세,2019,1424,745,679,109.7,1389,728,661,110.1
'34050, 서산시,'005004, 3세,2019,1624,837,787,106.4,1592,824,768,107.3
'34050, 서산시,'005005, 4세,2019,1710,865,845,102.4,1680,849,831,102.2
'34050, 서산시,'010,5~9세,2019,8766,4538,4228,107.3,8677,4500,4177,107.7
'34050, 서산시,'010001, 5세,2019,1718,904,814,111.1,1692,895,797,112.3
'34050, 서산시,'010002, 6세,2019,1693,827,866,95.5,1672,818,854,95.8
'34050, 서산시,'010003, 7세,2019,1843,972,871,111.6,1825,962,863,111.5
'34050, 서산시,'010004, 8세,2019,1759,936,823,113.7,1747,932,815,114.4
'34050, 서산시,'010005, 9세,2019,1753,899,854,105.3,1741,893,848,105.3
'34050, 서산시,'015,10~14세,2019,8309,4304,4005,107.5,8256,4275,3981,107.4
'34050, 서산시,'015001, 10세,2019,1670,884,786,112.5,1660,878,782,112.3
'34050, 서산시,'015002, 11세,2019,1744,904,840,107.6,1730,898,832,107.9
'34050, 서산시,'015003, 12세,2019,1827,939,888,105.7,1814,933,881,105.9
'34050, 서산시,'015004, 13세,2019,1598,809,789,102.5,1594,807,787,102.5
'34050, 서산시,'015005, 14세,2019,1470,768,702,109.4,1458,759,699,108.6
'34050, 서산시,'020,15~19세,2019,8558,4659,3899,119.5,8407,4586,3821,120
'34050, 서산시,'020001, 15세,2019,1704,925,779,118.7,1691,921,770,119.6
'34050, 서산시,'020002, 16세,2019,1556,851,705,120.7,1552,849,703,120.8
'34050, 서산시,'020003, 17세,2019,1571,893,678,131.7,1562,887,675,131.4
'34050, 서산시,'020004, 18세,2019,1860,958,902,106.2,1823,945,878,107.6
'34050, 서산시,'020005, 19세,2019,1867,1032,835,123.6,1779,984,795,123.8
'34050, 서산시,'025,20~24세,2019,9016,5208,3808,136.8,8137,4736,3401,139.3
'34050, 서산시,'025001, 20세,2019,1850,1096,754,145.4,1692,1023,669,152.9
'34050, 서산시,'025002, 21세,2019,1834,1073,761,141,1666,989,677,146.1
'34050, 서산시,'025003, 22세,2019,1793,986,807,122.2,1624,910,714,127.5
'34050, 서산시,'025004, 23세,2019,1735,993,742,133.8,1538,877,661,132.7
'34050, 서산시,'025005, 24세,2019,1804,1060,744,142.5,1617,937,680,137.8
'34050, 서산시,'030,25~29세,2019,10193,6058,4135,146.5,9372,5581,3791,147.2
'34050, 서산시,'030001, 25세,2019,1941,1137,804,141.4,1779,1047,732,143
'34050, 서산시,'030002, 26세,2019,1996,1227,769,159.6,1850,1139,711,160.2
'34050, 서산시,'030003, 27세,2019,2100,1260,840,150,1928,1160,768,151
'34050, 서산시,'030004, 28세,2019,2022,1183,839,141,1846,1080,766,141
'34050, 서산시,'030005, 29세,2019,2134,1251,883,141.7,1969,1155,814,141.9
'34050, 서산시,'035,30~34세,2019,10944,6248,4696,133,10011,5722,4289,133.4
'34050, 서산시,'035001, 30세,2019,2237,1333,904,147.5,2065,1231,834,147.6
'34050, 서산시,'035002, 31세,2019,2156,1233,923,133.6,1958,1120,838,133.7
'34050, 서산시,'035003, 32세,2019,2216,1287,929,138.5,2018,1174,844,139.1
'34050, 서산시,'035004, 33세,2019,2171,1197,974,122.9,1999,1111,888,125.1
'34050, 서산시,'035005, 34세,2019,2164,1198,966,124,1971,1086,885,122.7
'34050, 서산시,'040,35~39세,2019,13460,7234,6226,116.2,12583,6717,5866,114.5
'34050, 서산시,'040001, 35세,2019,2407,1294,1113,116.3,2196,1178,1018,115.7
'34050, 서산시,'040002, 36세,2019,2557,1385,1172,118.2,2386,1281,1105,115.9
'34050, 서산시,'040003, 37세,2019,2845,1519,1326,114.6,2662,1414,1248,113.3
'34050, 서산시,'040004, 38세,2019,2735,1465,1270,115.4,2573,1370,1203,113.9
'34050, 서산시,'040005, 39세,2019,2916,1571,1345,116.8,2766,1474,1292,114.1
'34050, 서산시,'045,40~44세,2019,13269,7026,6243,112.5,12600,6624,5976,110.8
'34050, 서산시,'045001, 40세,2019,2741,1475,1266,116.5,2590,1375,1215,113.2
'34050, 서산시,'045002, 41세,2019,2682,1436,1246,115.2,2546,1356,1190,113.9
'34050, 서산시,'045003, 42세,2019,2618,1363,1255,108.6,2491,1291,1200,107.6
'34050, 서산시,'045004, 43세,2019,2543,1385,1158,119.6,2410,1303,1107,117.7
'34050, 서산시,'045005, 44세,2019,2685,1367,1318,103.7,2563,1299,1264,102.8
'34050, 서산시,'050,45~49세,2019,14729,7990,6739,118.6,14144,7659,6485,118.1
'34050, 서산시,'050001, 45세,2019,2906,1591,1315,121,2787,1519,1268,119.8
'34050, 서산시,'050002, 46세,2019,3036,1624,1412,115,2914,1552,1362,114
'34050, 서산시,'050003, 47세,2019,2838,1534,1304,117.6,2724,1472,1252,117.6
'34050, 서산시,'050004, 48세,2019,3099,1708,1391,122.8,2982,1643,1339,122.7
'34050, 서산시,'050005, 49세,2019,2850,1533,1317,116.4,2737,1473,1264,116.5
'34050, 서산시,'055,50~54세,2019,14346,7662,6684,114.6,13855,7411,6444,115
'34050, 서산시,'055001, 50세,2019,3120,1677,1443,116.2,3015,1621,1394,116.3
'34050, 서산시,'055002, 51세,2019,3009,1558,1451,107.4,2919,1509,1410,107
'34050, 서산시,'055003, 52세,2019,2723,1478,1245,118.7,2609,1422,1187,119.8
'34050, 서산시,'055004, 53세,2019,2600,1384,1216,113.8,2506,1337,1169,114.4
'34050, 서산시,'055005, 54세,2019,2894,1565,1329,117.8,2806,1522,1284,118.5
'34050, 서산시,'060,55~59세,2019,14144,7438,6706,110.9,13761,7220,6541,110.4
'34050, 서산시,'060001, 55세,2019,2472,1326,1146,115.7,2382,1273,1109,114.8
'34050, 서산시,'060002, 56세,2019,2619,1412,1207,117,2518,1351,1167,115.8
'34050, 서산시,'060003, 57세,2019,2785,1488,1297,114.7,2715,1447,1268,114.1
'34050, 서산시,'060004, 58세,2019,3181,1659,1522,109,3120,1634,1486,110
'34050, 서산시,'060005, 59세,2019,3087,1553,1534,101.2,3026,1515,1511,100.3
'34050, 서산시,'065,60~64세,2019,11607,5792,5815,99.6,11349,5667,5682,99.7
'34050, 서산시,'065001, 60세,2019,2582,1290,1292,99.8,2520,1259,1261,99.8
'34050, 서산시,'065002, 61세,2019,2361,1207,1154,104.6,2308,1183,1125,105.2
'34050, 서산시,'065003, 62세,2019,2321,1165,1156,100.8,2270,1140,1130,100.9
'34050, 서산시,'065004, 63세,2019,2185,1091,1094,99.7,2133,1060,1073,98.8
'34050, 서산시,'065005, 64세,2019,2158,1039,1119,92.9,2118,1025,1093,93.8
'34050, 서산시,'070,65~69세,2019,8466,4185,4281,97.8,8330,4114,4216,97.6
'34050, 서산시,'070001, 65세,2019,1874,912,962,94.8,1831,888,943,94.2
'34050, 서산시,'070002, 66세,2019,1595,805,790,101.9,1568,791,777,101.8
'34050, 서산시,'070003, 67세,2019,1877,920,957,96.1,1849,909,940,96.7
'34050, 서산시,'070004, 68세,2019,1457,736,721,102.1,1436,721,715,100.8
'34050, 서산시,'070005, 69세,2019,1663,812,851,95.4,1646,805,841,95.7
'34050, 서산시,'075,70~74세,2019,7006,3430,3576,95.9,6938,3400,3538,96.1
'34050, 서산시,'075001, 70세,2019,1749,886,863,102.7,1729,875,854,102.5
'34050, 서산시,'075002, 71세,2019,1555,780,775,100.6,1544,775,769,100.8
'34050, 서산시,'075003, 72세,2019,1450,667,783,85.2,1431,661,770,85.8
'34050, 서산시,'075004, 73세,2019,1177,592,585,101.2,1167,587,580,101.2
'34050, 서산시,'075005, 74세,2019,1075,505,570,88.6,1067,502,565,88.8
'34050, 서산시,'080,75~79세,2019,6221,2658,3563,74.6,6192,2647,3545,74.7
'34050, 서산시,'080001, 75세,2019,1191,535,656,81.6,1182,531,651,81.6
'34050, 서산시,'080002, 76세,2019,1227,577,650,88.8,1219,574,645,89
'34050, 서산시,'080003, 77세,2019,1700,684,1016,67.3,1694,683,1011,67.6
'34050, 서산시,'080004, 78세,2019,1104,458,646,70.9,1102,458,644,71.1
'34050, 서산시,'080005, 79세,2019,999,404,595,67.9,995,401,594,67.5
'34050, 서산시,'085,80~84세,2019,5013,1864,3149,59.2,5007,1863,3144,59.3
'34050, 서산시,'085001, 80세,2019,1115,443,672,65.9,1114,443,671,66
'34050, 서산시,'085002, 81세,2019,1122,443,679,65.2,1121,443,678,65.3
'34050, 서산시,'085003, 82세,2019,957,361,596,60.6,956,360,596,60.4
'34050, 서산시,'085004, 83세,2019,925,313,612,51.1,923,313,610,51.3
'34050, 서산시,'085005, 84세,2019,894,304,590,51.5,893,304,589,51.6
'34050, 서산시,'086,85세이상,2019,3754,1014,2740,37,3748,1012,2736,37
'34050, 서산시,'090,85~89세,2019,2668,797,1871,42.6,2663,796,1867,42.6
'34050, 서산시,'090001, 85세,2019,730,247,483,51.1,729,247,482,51.2
'34050, 서산시,'090002, 86세,2019,660,200,460,43.5,658,200,458,43.7
'34050, 서산시,'090003, 87세,2019,602,183,419,43.7,600,182,418,43.5
'34050, 서산시,'090004, 88세,2019,371,94,277,33.9,371,94,277,33.9
'34050, 서산시,'090005, 89세,2019,305,73,232,31.5,305,73,232,31.5
'34050, 서산시,'095,90~94세,2019,848,177,671,26.4,847,176,671,26.2
'34050, 서산시,'095001, 90세,2019,281,71,210,33.8,281,71,210,33.8
'34050, 서산시,'095002, 91세,2019,208,37,171,21.6,208,37,171,21.6
'34050, 서산시,'095003, 92세,2019,146,36,110,32.7,145,35,110,31.8
'34050, 서산시,'095004, 93세,2019,117,17,100,17,117,17,100,17
'34050, 서산시,'095005, 94세,2019,96,16,80,20,96,16,80,20
'34050, 서산시,'100,95~99세,2019,204,35,169,20.7,204,35,169,20.7
'34050, 서산시,'100001, 95세,2019,85,16,69,23.2,85,16,69,23.2
'34050, 서산시,'100002, 96세,2019,46,6,40,15,46,6,40,15
'34050, 서산시,'100003, 97세,2019,39,7,32,21.9,39,7,32,21.9
'34050, 서산시,'100004, 98세,2019,20,X,17,17.6,20,X,17,17.6
'34050, 서산시,'100005, 99세,2019,14,X,11,27.3,14,X,11,27.3
'34050, 서산시,'101,100세이상,2019,34,5,29,17.2,34,5,29,17.2
'34050, 서산시,'102,15세미만,2019,24478,12622,11856,106.5,24187,12481,11706,106.6
'34050, 서산시,'103,15~64세,2019,120266,65315,54951,118.9,114219,61923,52296,118.4
'34050, 서산시,'104,65세이상,2019,30460,13151,17309,76,30215,13036,17179,75.9
'34050, 서산시,'126,평균연령,2019,43.1,41.6,44.7,,43.3,41.7,44.9,
'34050, 서산시,'127,중위연령,2019,44.1,42.4,45.9,,44.6,42.9,46.3,
'34060, 논산시,'000,합계,2019,122111,61167,60944,100.4,116166,58076,58090,100
'34060, 논산시,'005,0~4세,2019,3477,1782,1695,105.1,3439,1761,1678,104.9
'34060, 논산시,'005001, 0세,2019,612,295,317,93.1,604,289,315,91.7
'34060, 논산시,'005002, 1세,2019,623,340,283,120.1,618,336,282,119.1
'34060, 논산시,'005003, 2세,2019,671,347,324,107.1,663,344,319,107.8
'34060, 논산시,'005004, 3세,2019,765,396,369,107.3,754,390,364,107.1
'34060, 논산시,'005005, 4세,2019,806,404,402,100.5,800,402,398,101
'34060, 논산시,'010,5~9세,2019,4239,2181,2058,106,4207,2165,2042,106
'34060, 논산시,'010001, 5세,2019,795,405,390,103.8,785,401,384,104.4
'34060, 논산시,'010002, 6세,2019,803,407,396,102.8,797,404,393,102.8
'34060, 논산시,'010003, 7세,2019,880,445,435,102.3,873,441,432,102.1
'34060, 논산시,'010004, 8세,2019,872,465,407,114.3,867,462,405,114.1
'34060, 논산시,'010005, 9세,2019,889,459,430,106.7,885,457,428,106.8
'34060, 논산시,'015,10~14세,2019,4698,2407,2291,105.1,4664,2387,2277,104.8
'34060, 논산시,'015001, 10세,2019,880,448,432,103.7,870,442,428,103.3
'34060, 논산시,'015002, 11세,2019,986,494,492,100.4,980,489,491,99.6
'34060, 논산시,'015003, 12세,2019,991,539,452,119.2,985,534,451,118.4
'34060, 논산시,'015004, 13세,2019,941,467,474,98.5,939,466,473,98.5
'34060, 논산시,'015005, 14세,2019,900,459,441,104.1,890,456,434,105.1
'34060, 논산시,'020,15~19세,2019,6917,3793,3124,121.4,6835,3755,3080,121.9
'34060, 논산시,'020001, 15세,2019,1058,541,517,104.6,1048,538,510,105.5
'34060, 논산시,'020002, 16세,2019,1352,748,604,123.8,1350,748,602,124.3
'34060, 논산시,'020003, 17세,2019,1420,814,606,134.3,1414,811,603,134.5
'34060, 논산시,'020004, 18세,2019,1520,858,662,129.6,1501,850,651,130.6
'34060, 논산시,'020005, 19세,2019,1567,832,735,113.2,1522,808,714,113.2
'34060, 논산시,'025,20~24세,2019,7860,4283,3577,119.7,6845,3805,3040,125.2
'34060, 논산시,'025001, 20세,2019,1516,777,739,105.1,1439,733,706,103.8
'34060, 논산시,'025002, 21세,2019,1596,858,738,116.3,1426,773,653,118.4
'34060, 논산시,'025003, 22세,2019,1639,903,736,122.7,1433,814,619,131.5
'34060, 논산시,'025004, 23세,2019,1608,891,717,124.3,1339,766,573,133.7
'34060, 논산시,'025005, 24세,2019,1501,854,647,132,1208,719,489,147
'34060, 논산시,'030,25~29세,2019,6755,3790,2965,127.8,5390,3101,2289,135.5
'34060, 논산시,'030001, 25세,2019,1437,805,632,127.4,1144,656,488,134.4
'34060, 논산시,'030002, 26세,2019,1368,773,595,129.9,1093,625,468,133.5
'34060, 논산시,'030003, 27세,2019,1396,757,639,118.5,1092,607,485,125.2
'34060, 논산시,'030004, 28세,2019,1263,704,559,125.9,1013,575,438,131.3
'34060, 논산시,'030005, 29세,2019,1291,751,540,139.1,1048,638,410,155.6
'34060, 논산시,'035,30~34세,2019,5910,3167,2743,115.5,4880,2594,2286,113.5
'34060, 논산시,'035001, 30세,2019,1188,660,528,125,965,538,427,126
'34060, 논산시,'035002, 31세,2019,1240,682,558,122.2,1008,554,454,122
'34060, 논산시,'035003, 32세,2019,1137,601,536,112.1,935,478,457,104.6
'34060, 논산시,'035004, 33세,2019,1218,641,577,111.1,1020,537,483,111.2
'34060, 논산시,'035005, 34세,2019,1127,583,544,107.2,952,487,465,104.7
'34060, 논산시,'040,35~39세,2019,6837,3579,3258,109.9,6055,3169,2886,109.8
'34060, 논산시,'040001, 35세,2019,1198,626,572,109.4,1011,522,489,106.7
'34060, 논산시,'040002, 36세,2019,1348,719,629,114.3,1196,635,561,113.2
'34060, 논산시,'040003, 37세,2019,1382,746,636,117.3,1209,659,550,119.8
'34060, 논산시,'040004, 38세,2019,1445,730,715,102.1,1303,661,642,103
'34060, 논산시,'040005, 39세,2019,1464,758,706,107.4,1336,692,644,107.5
'34060, 논산시,'045,40~44세,2019,7090,3749,3341,112.2,6611,3489,3122,111.8
'34060, 논산시,'045001, 40세,2019,1395,740,655,113,1278,674,604,111.6
'34060, 논산시,'045002, 41세,2019,1272,677,595,113.8,1170,624,546,114.3
'34060, 논산시,'045003, 42세,2019,1469,733,736,99.6,1387,691,696,99.3
'34060, 논산시,'045004, 43세,2019,1386,766,620,123.5,1293,710,583,121.8
'34060, 논산시,'045005, 44세,2019,1568,833,735,113.3,1483,790,693,114
'34060, 논산시,'050,45~49세,2019,8750,4706,4044,116.4,8397,4513,3884,116.2
'34060, 논산시,'050001, 45세,2019,1694,949,745,127.4,1636,911,725,125.7
'34060, 논산시,'050002, 46세,2019,1698,893,805,110.9,1625,858,767,111.9
'34060, 논산시,'050003, 47세,2019,1715,914,801,114.1,1645,874,771,113.4
'34060, 논산시,'050004, 48세,2019,1904,987,917,107.6,1826,948,878,108
'34060, 논산시,'050005, 49세,2019,1739,963,776,124.1,1665,922,743,124.1
'34060, 논산시,'055,50~54세,2019,9263,4815,4448,108.3,8984,4664,4320,108
'34060, 논산시,'055001, 50세,2019,1865,982,883,111.2,1804,948,856,110.7
'34060, 논산시,'055002, 51세,2019,1928,1035,893,115.9,1863,996,867,114.9
'34060, 논산시,'055003, 52세,2019,1809,943,866,108.9,1754,909,845,107.6
'34060, 논산시,'055004, 53세,2019,1679,882,797,110.7,1628,861,767,112.3
'34060, 논산시,'055005, 54세,2019,1982,973,1009,96.4,1935,950,985,96.4
'34060, 논산시,'060,55~59세,2019,10568,5409,5159,104.8,10359,5298,5061,104.7
'34060, 논산시,'060001, 55세,2019,1828,960,868,110.6,1773,932,841,110.8
'34060, 논산시,'060002, 56세,2019,1928,1027,901,114,1870,999,871,114.7
'34060, 논산시,'060003, 57세,2019,2047,1040,1007,103.3,2014,1019,995,102.4
'34060, 논산시,'060004, 58세,2019,2353,1187,1166,101.8,2325,1169,1156,101.1
'34060, 논산시,'060005, 59세,2019,2412,1195,1217,98.2,2377,1179,1198,98.4
'34060, 논산시,'065,60~64세,2019,10449,5314,5135,103.5,10301,5233,5068,103.3
'34060, 논산시,'065001, 60세,2019,2227,1130,1097,103,2193,1109,1084,102.3
'34060, 논산시,'065002, 61세,2019,2085,1043,1042,100.1,2050,1024,1026,99.8
'34060, 논산시,'065003, 62세,2019,2063,1076,987,109,2035,1061,974,108.9
'34060, 논산시,'065004, 63세,2019,1993,992,1001,99.1,1960,976,984,99.2
'34060, 논산시,'065005, 64세,2019,2081,1073,1008,106.4,2063,1063,1000,106.3
'34060, 논산시,'070,65~69세,2019,7832,3822,4010,95.3,7776,3787,3989,94.9
'34060, 논산시,'070001, 65세,2019,1878,923,955,96.6,1858,911,947,96.2
'34060, 논산시,'070002, 66세,2019,1515,753,762,98.8,1503,742,761,97.5
'34060, 논산시,'070003, 67세,2019,1568,744,824,90.3,1558,740,818,90.5
'34060, 논산시,'070004, 68세,2019,1351,653,698,93.6,1347,651,696,93.5
'34060, 논산시,'070005, 69세,2019,1520,749,771,97.1,1510,743,767,96.9
'34060, 논산시,'075,70~74세,2019,6279,2900,3379,85.8,6261,2896,3365,86.1
'34060, 논산시,'075001, 70세,2019,1476,682,794,85.9,1469,680,789,86.2
'34060, 논산시,'075002, 71세,2019,1394,649,745,87.1,1392,649,743,87.3
'34060, 논산시,'075003, 72세,2019,1397,662,735,90.1,1391,661,730,90.5
'34060, 논산시,'075004, 73세,2019,939,439,500,87.8,937,439,498,88.2
'34060, 논산시,'075005, 74세,2019,1073,468,605,77.4,1072,467,605,77.2
'34060, 논산시,'080,75~79세,2019,6229,2538,3691,68.8,6217,2534,3683,68.8
'34060, 논산시,'080001, 75세,2019,1189,495,694,71.3,1188,495,693,71.4
'34060, 논산시,'080002, 76세,2019,1169,496,673,73.7,1168,496,672,73.8
'34060, 논산시,'080003, 77세,2019,1573,670,903,74.2,1568,666,902,73.8
'34060, 논산시,'080004, 78세,2019,1217,456,761,59.9,1214,456,758,60.2
'34060, 논산시,'080005, 79세,2019,1081,421,660,63.8,1079,421,658,64
'34060, 논산시,'085,80~84세,2019,5202,1842,3360,54.8,5195,1838,3357,54.8
'34060, 논산시,'085001, 80세,2019,1217,474,743,63.8,1215,472,743,63.5
'34060, 논산시,'085002, 81세,2019,1062,355,707,50.2,1061,355,706,50.3
'34060, 논산시,'085003, 82세,2019,1072,389,683,57,1071,388,683,56.8
'34060, 논산시,'085004, 83세,2019,939,331,608,54.4,937,330,607,54.4
'34060, 논산시,'085005, 84세,2019,912,293,619,47.3,911,293,618,47.4
'34060, 논산시,'086,85세이상,2019,3756,1090,2666,40.9,3750,1087,2663,40.8
'34060, 논산시,'090,85~89세,2019,2637,821,1816,45.2,2636,821,1815,45.2
'34060, 논산시,'090001, 85세,2019,761,251,510,49.2,761,251,510,49.2
'34060, 논산시,'090002, 86세,2019,611,205,406,50.5,610,205,405,50.6
'34060, 논산시,'090003, 87세,2019,554,172,382,45,554,172,382,45
'34060, 논산시,'090004, 88세,2019,375,108,267,40.4,375,108,267,40.4
'34060, 논산시,'090005, 89세,2019,336,85,251,33.9,336,85,251,33.9
'34060, 논산시,'095,90~94세,2019,896,217,679,32,891,214,677,31.6
'34060, 논산시,'095001, 90세,2019,264,70,194,36.1,260,67,193,34.7
'34060, 논산시,'095002, 91세,2019,243,57,186,30.6,243,57,186,30.6
'34060, 논산시,'095003, 92세,2019,205,58,147,39.5,204,58,146,39.7
'34060, 논산시,'095004, 93세,2019,98,15,83,18.1,98,15,83,18.1
'34060, 논산시,'095005, 94세,2019,86,17,69,24.6,86,17,69,24.6
'34060, 논산시,'100,95~99세,2019,191,42,149,28.2,191,42,149,28.2
'34060, 논산시,'100001, 95세,2019,52,10,42,23.8,52,10,42,23.8
'34060, 논산시,'100002, 96세,2019,52,11,41,26.8,52,11,41,26.8
'34060, 논산시,'100003, 97세,2019,40,11,29,37.9,40,11,29,37.9
'34060, 논산시,'100004, 98세,2019,24,5,19,26.3,24,5,19,26.3
'34060, 논산시,'100005, 99세,2019,23,5,18,27.8,23,5,18,27.8
'34060, 논산시,'101,100세이상,2019,32,10,22,45.5,32,10,22,45.5
'34060, 논산시,'102,15세미만,2019,12414,6370,6044,105.4,12310,6313,5997,105.3
'34060, 논산시,'103,15~64세,2019,80399,42605,37794,112.7,74657,39621,35036,113.1
'34060, 논산시,'104,65세이상,2019,29298,12192,17106,71.3,29199,12142,17057,71.2
'34060, 논산시,'126,평균연령,2019,46.9,44.9,48.9,,47.5,45.4,49.6,
'34060, 논산시,'127,중위연령,2019,49.2,47,51.6,,50.4,48.2,52.9,
'34070, 계룡시,'000,합계,2019,41153,20531,20622,99.6,40839,20369,20470,99.5
'34070, 계룡시,'005,0~4세,2019,1623,831,792,104.9,1621,830,791,104.9
'34070, 계룡시,'005001, 0세,2019,234,133,101,131.7,233,133,100,133
'34070, 계룡시,'005002, 1세,2019,267,126,141,89.4,267,126,141,89.4
'34070, 계룡시,'005003, 2세,2019,317,165,152,108.6,316,164,152,107.9
'34070, 계룡시,'005004, 3세,2019,387,205,182,112.6,387,205,182,112.6
'34070, 계룡시,'005005, 4세,2019,418,202,216,93.5,418,202,216,93.5
'34070, 계룡시,'010,5~9세,2019,2515,1285,1230,104.5,2513,1284,1229,104.5
'34070, 계룡시,'010001, 5세,2019,455,215,240,89.6,455,215,240,89.6
'34070, 계룡시,'010002, 6세,2019,449,230,219,105,449,230,219,105
'34070, 계룡시,'010003, 7세,2019,508,255,253,100.8,508,255,253,100.8
'34070, 계룡시,'010004, 8세,2019,552,294,258,114,551,293,258,113.6
'34070, 계룡시,'010005, 9세,2019,551,291,260,111.9,550,291,259,112.4
'34070, 계룡시,'015,10~14세,2019,2996,1555,1441,107.9,2996,1555,1441,107.9
'34070, 계룡시,'015001, 10세,2019,538,278,260,106.9,538,278,260,106.9
'34070, 계룡시,'015002, 11세,2019,587,316,271,116.6,587,316,271,116.6
'34070, 계룡시,'015003, 12세,2019,644,341,303,112.5,644,341,303,112.5
'34070, 계룡시,'015004, 13세,2019,653,330,323,102.2,653,330,323,102.2
'34070, 계룡시,'015005, 14세,2019,574,290,284,102.1,574,290,284,102.1
'34070, 계룡시,'020,15~19세,2019,2768,1453,1315,110.5,2766,1452,1314,110.5
'34070, 계룡시,'020001, 15세,2019,618,325,293,110.9,618,325,293,110.9
'34070, 계룡시,'020002, 16세,2019,568,286,282,101.4,568,286,282,101.4
'34070, 계룡시,'020003, 17세,2019,518,259,259,100,518,259,259,100
'34070, 계룡시,'020004, 18세,2019,561,282,279,101.1,561,282,279,101.1
'34070, 계룡시,'020005, 19세,2019,503,301,202,149,501,300,201,149.3
'34070, 계룡시,'025,20~24세,2019,2268,1360,908,149.8,2228,1332,896,148.7
'34070, 계룡시,'025001, 20세,2019,485,302,183,165,480,298,182,163.7
'34070, 계룡시,'025002, 21세,2019,452,279,173,161.3,449,276,173,159.5
'34070, 계룡시,'025003, 22세,2019,458,271,187,144.9,446,261,185,141.1
'34070, 계룡시,'025004, 23세,2019,441,257,184,139.7,434,253,181,139.8
'34070, 계룡시,'025005, 24세,2019,432,251,181,138.7,419,244,175,139.4
'34070, 계룡시,'030,25~29세,2019,1909,1064,845,125.9,1845,1027,818,125.6
'34070, 계룡시,'030001, 25세,2019,426,240,186,129,413,233,180,129.4
'34070, 계룡시,'030002, 26세,2019,378,212,166,127.7,373,208,165,126.1
'34070, 계룡시,'030003, 27세,2019,413,232,181,128.2,396,223,173,128.9
'34070, 계룡시,'030004, 28세,2019,328,164,164,100,313,156,157,99.4
'34070, 계룡시,'030005, 29세,2019,364,216,148,145.9,350,207,143,144.8
'34070, 계룡시,'035,30~34세,2019,1682,844,838,100.7,1649,830,819,101.3
'34070, 계룡시,'035001, 30세,2019,313,155,158,98.1,303,151,152,99.3
'34070, 계룡시,'035002, 31세,2019,320,157,163,96.3,310,153,157,97.5
'34070, 계룡시,'035003, 32세,2019,311,151,160,94.4,306,148,158,93.7
'34070, 계룡시,'035004, 33세,2019,350,185,165,112.1,344,182,162,112.3
'34070, 계룡시,'035005, 34세,2019,388,196,192,102.1,386,196,190,103.2
'34070, 계룡시,'040,35~39세,2019,3040,1436,1604,89.5,3015,1427,1588,89.9
'34070, 계룡시,'040001, 35세,2019,406,181,225,80.4,403,179,224,79.9
'34070, 계룡시,'040002, 36세,2019,536,256,280,91.4,531,255,276,92.4
'34070, 계룡시,'040003, 37세,2019,684,320,364,87.9,675,318,357,89.1
'34070, 계룡시,'040004, 38세,2019,693,333,360,92.5,690,332,358,92.7
'34070, 계룡시,'040005, 39세,2019,721,346,375,92.3,716,343,373,92
'34070, 계룡시,'045,40~44세,2019,3694,1736,1958,88.7,3669,1724,1945,88.6
'34070, 계룡시,'045001, 40세,2019,700,302,398,75.9,696,300,396,75.8
'34070, 계룡시,'045002, 41세,2019,632,292,340,85.9,628,291,337,86.4
'34070, 계룡시,'045003, 42세,2019,746,338,408,82.8,739,335,404,82.9
'34070, 계룡시,'045004, 43세,2019,789,382,407,93.9,783,378,405,93.3
'34070, 계룡시,'045005, 44세,2019,827,422,405,104.2,823,420,403,104.2
'34070, 계룡시,'050,45~49세,2019,4723,2360,2363,99.9,4694,2348,2346,100.1
'34070, 계룡시,'050001, 45세,2019,1005,510,495,103,999,506,493,102.6
'34070, 계룡시,'050002, 46세,2019,895,405,490,82.7,890,403,487,82.8
'34070, 계룡시,'050003, 47세,2019,945,510,435,117.2,941,509,432,117.8
'34070, 계룡시,'050004, 48세,2019,990,491,499,98.4,986,490,496,98.8
'34070, 계룡시,'050005, 49세,2019,888,444,444,100,878,440,438,100.5
'34070, 계룡시,'055,50~54세,2019,3782,1916,1866,102.7,3753,1901,1852,102.6
'34070, 계룡시,'055001, 50세,2019,919,453,466,97.2,914,449,465,96.6
'34070, 계룡시,'055002, 51세,2019,840,415,425,97.6,833,411,422,97.4
'34070, 계룡시,'055003, 52세,2019,697,351,346,101.4,689,347,342,101.5
'34070, 계룡시,'055004, 53세,2019,672,368,304,121.1,668,367,301,121.9
'34070, 계룡시,'055005, 54세,2019,654,329,325,101.2,649,327,322,101.6
'34070, 계룡시,'060,55~59세,2019,3009,1519,1490,101.9,2983,1509,1474,102.4
'34070, 계룡시,'060001, 55세,2019,575,309,266,116.2,565,306,259,118.1
'34070, 계룡시,'060002, 56세,2019,585,297,288,103.1,579,295,284,103.9
'34070, 계룡시,'060003, 57세,2019,598,293,305,96.1,592,291,301,96.7
'34070, 계룡시,'060004, 58세,2019,649,331,318,104.1,645,328,317,103.5
'34070, 계룡시,'060005, 59세,2019,602,289,313,92.3,602,289,313,92.3
'34070, 계룡시,'065,60~64세,2019,2463,1195,1268,94.2,2449,1184,1265,93.6
'34070, 계룡시,'065001, 60세,2019,527,249,278,89.6,526,248,278,89.2
'34070, 계룡시,'065002, 61세,2019,537,256,281,91.1,530,251,279,90
'34070, 계룡시,'065003, 62세,2019,492,246,246,100,491,245,246,99.6
'34070, 계룡시,'065004, 63세,2019,439,211,228,92.5,437,209,228,91.7
'34070, 계룡시,'065005, 64세,2019,468,233,235,99.1,465,231,234,98.7
'34070, 계룡시,'070,65~69세,2019,1560,784,776,101,1545,777,768,101.2
'34070, 계룡시,'070001, 65세,2019,394,202,192,105.2,390,202,188,107.4
'34070, 계룡시,'070002, 66세,2019,364,194,170,114.1,363,194,169,114.8
'34070, 계룡시,'070003, 67세,2019,325,152,173,87.9,323,151,172,87.8
'34070, 계룡시,'070004, 68세,2019,235,120,115,104.3,233,119,114,104.4
'34070, 계룡시,'070005, 69세,2019,242,116,126,92.1,236,111,125,88.8
'34070, 계룡시,'075,70~74세,2019,1075,520,555,93.7,1070,518,552,93.8
'34070, 계룡시,'075001, 70세,2019,278,123,155,79.4,275,121,154,78.6
'34070, 계룡시,'075002, 71세,2019,241,116,125,92.8,241,116,125,92.8
'34070, 계룡시,'075003, 72세,2019,240,132,108,122.2,239,132,107,123.4
'34070, 계룡시,'075004, 73세,2019,141,69,72,95.8,140,69,71,97.2
'34070, 계룡시,'075005, 74세,2019,175,80,95,84.2,175,80,95,84.2
'34070, 계룡시,'080,75~79세,2019,829,335,494,67.8,827,334,493,67.7
'34070, 계룡시,'080001, 75세,2019,178,84,94,89.4,178,84,94,89.4
'34070, 계룡시,'080002, 76세,2019,182,76,106,71.7,182,76,106,71.7
'34070, 계룡시,'080003, 77세,2019,187,60,127,47.2,186,60,126,47.6
'34070, 계룡시,'080004, 78세,2019,150,49,101,48.5,149,48,101,47.5
'34070, 계룡시,'080005, 79세,2019,132,66,66,100,132,66,66,100
'34070, 계룡시,'085,80~84세,2019,683,200,483,41.4,683,200,483,41.4
'34070, 계룡시,'085001, 80세,2019,159,50,109,45.9,159,50,109,45.9
'34070, 계룡시,'085002, 81세,2019,140,47,93,50.5,140,47,93,50.5
'34070, 계룡시,'085003, 82세,2019,139,46,93,49.5,139,46,93,49.5
'34070, 계룡시,'085004, 83세,2019,123,30,93,32.3,123,30,93,32.3
'34070, 계룡시,'085005, 84세,2019,122,27,95,28.4,122,27,95,28.4
'34070, 계룡시,'086,85세이상,2019,534,138,396,34.8,533,137,396,34.6
'34070, 계룡시,'090,85~89세,2019,367,103,264,39,366,102,264,38.6
'34070, 계룡시,'090001, 85세,2019,110,33,77,42.9,110,33,77,42.9
'34070, 계룡시,'090002, 86세,2019,92,24,68,35.3,92,24,68,35.3
'34070, 계룡시,'090003, 87세,2019,71,22,49,44.9,70,21,49,42.9
'34070, 계룡시,'090004, 88세,2019,47,10,37,27,47,10,37,27
'34070, 계룡시,'090005, 89세,2019,47,14,33,42.4,47,14,33,42.4
'34070, 계룡시,'095,90~94세,2019,137,29,108,26.9,137,29,108,26.9
'34070, 계룡시,'095001, 90세,2019,38,8,30,26.7,38,8,30,26.7
'34070, 계룡시,'095002, 91세,2019,38,8,30,26.7,38,8,30,26.7
'34070, 계룡시,'095003, 92세,2019,33,8,25,32,33,8,25,32
'34070, 계룡시,'095004, 93세,2019,13,X,10,30,13,X,10,30
'34070, 계룡시,'095005, 94세,2019,15,X,13,15.4,15,X,13,15.4
'34070, 계룡시,'100,95~99세,2019,26,5,21,23.8,26,5,21,23.8
'34070, 계룡시,'100001, 95세,2019,6,X,6,0,6,X,6,0
'34070, 계룡시,'100002, 96세,2019,13,X,10,30,13,X,10,30
'34070, 계룡시,'100003, 97세,2019,5,X,X,25,5,X,X,25
'34070, 계룡시,'100004, 98세,2019,X,X,X,100,X,X,X,100
'34070, 계룡시,'100005, 99세,2019,X,X,X,,X,X,X,
'34070, 계룡시,'101,100세이상,2019,X,X,X,33.3,X,X,X,33.3
'34070, 계룡시,'102,15세미만,2019,7134,3671,3463,106,7130,3669,3461,106
'34070, 계룡시,'103,15~64세,2019,29338,14883,14455,103,29051,14734,14317,102.9
'34070, 계룡시,'104,65세이상,2019,4681,1977,2704,73.1,4658,1966,2692,73
'34070, 계룡시,'126,평균연령,2019,39.8,38.6,41.1,,39.8,38.5,41.1,
'34070, 계룡시,'127,중위연령,2019,42.6,41.5,43.5,,42.6,41.5,43.5,
'34080, 당진시,'000,합계,2019,169171,90358,78813,114.6,160567,84675,75892,111.6
'34080, 당진시,'005,0~4세,2019,7715,3938,3777,104.3,7599,3876,3723,104.1
'34080, 당진시,'005001, 0세,2019,1294,675,619,109,1277,667,610,109.3
'34080, 당진시,'005002, 1세,2019,1404,722,682,105.9,1376,707,669,105.7
'34080, 당진시,'005003, 2세,2019,1575,818,757,108.1,1545,802,743,107.9
'34080, 당진시,'005004, 3세,2019,1651,827,824,100.4,1633,818,815,100.4
'34080, 당진시,'005005, 4세,2019,1791,896,895,100.1,1768,882,886,99.5
'34080, 당진시,'010,5~9세,2019,9001,4644,4357,106.6,8929,4603,4326,106.4
'34080, 당진시,'010001, 5세,2019,1777,891,886,100.6,1753,875,878,99.7
'34080, 당진시,'010002, 6세,2019,1749,891,858,103.8,1735,887,848,104.6
'34080, 당진시,'010003, 7세,2019,1837,942,895,105.3,1821,933,888,105.1
'34080, 당진시,'010004, 8세,2019,1851,966,885,109.2,1842,960,882,108.8
'34080, 당진시,'010005, 9세,2019,1787,954,833,114.5,1778,948,830,114.2
'34080, 당진시,'015,10~14세,2019,7856,4115,3741,110,7808,4085,3723,109.7
'34080, 당진시,'015001, 10세,2019,1672,842,830,101.4,1659,835,824,101.3
'34080, 당진시,'015002, 11세,2019,1673,881,792,111.2,1662,875,787,111.2
'34080, 당진시,'015003, 12세,2019,1666,895,771,116.1,1655,886,769,115.2
'34080, 당진시,'015004, 13세,2019,1435,765,670,114.2,1431,765,666,114.9
'34080, 당진시,'015005, 14세,2019,1410,732,678,108,1401,724,677,106.9
'34080, 당진시,'020,15~19세,2019,7364,3953,3411,115.9,7285,3905,3380,115.5
'34080, 당진시,'020001, 15세,2019,1476,755,721,104.7,1469,753,716,105.2
'34080, 당진시,'020002, 16세,2019,1315,714,601,118.8,1310,711,599,118.7
'34080, 당진시,'020003, 17세,2019,1398,786,612,128.4,1391,782,609,128.4
'34080, 당진시,'020004, 18세,2019,1607,858,749,114.6,1590,845,745,113.4
'34080, 당진시,'020005, 19세,2019,1568,840,728,115.4,1525,814,711,114.5
'34080, 당진시,'025,20~24세,2019,8271,4608,3663,125.8,7557,4108,3449,119.1
'34080, 당진시,'025001, 20세,2019,1740,894,846,105.7,1688,862,826,104.4
'34080, 당진시,'025002, 21세,2019,1638,911,727,125.3,1534,850,684,124.3
'34080, 당진시,'025003, 22세,2019,1585,852,733,116.2,1437,752,685,109.8
'34080, 당진시,'025004, 23세,2019,1630,971,659,147.3,1442,834,608,137.2
'34080, 당진시,'025005, 24세,2019,1678,980,698,140.4,1456,810,646,125.4
'34080, 당진시,'030,25~29세,2019,9709,5950,3759,158.3,8329,4942,3387,145.9
'34080, 당진시,'030001, 25세,2019,1727,1030,697,147.8,1458,842,616,136.7
'34080, 당진시,'030002, 26세,2019,1879,1117,762,146.6,1627,923,704,131.1
'34080, 당진시,'030003, 27세,2019,1954,1203,751,160.2,1676,994,682,145.7
'34080, 당진시,'030004, 28세,2019,2014,1271,743,171.1,1747,1072,675,158.8
'34080, 당진시,'030005, 29세,2019,2135,1329,806,164.9,1821,1111,710,156.5
'34080, 당진시,'035,30~34세,2019,11613,6858,4755,144.2,10037,5770,4267,135.2
'34080, 당진시,'035001, 30세,2019,2211,1337,874,153,1892,1108,784,141.3
'34080, 당진시,'035002, 31세,2019,2272,1385,887,156.1,1954,1166,788,148
'34080, 당진시,'035003, 32세,2019,2325,1331,994,133.9,2016,1121,895,125.3
'34080, 당진시,'035004, 33세,2019,2322,1339,983,136.2,2020,1140,880,129.5
'34080, 당진시,'035005, 34세,2019,2483,1466,1017,144.1,2155,1235,920,134.2
'34080, 당진시,'040,35~39세,2019,14688,8355,6333,131.9,13522,7522,6000,125.4
'34080, 당진시,'040001, 35세,2019,2617,1509,1108,136.2,2358,1322,1036,127.6
'34080, 당진시,'040002, 36세,2019,2853,1660,1193,139.1,2595,1478,1117,132.3
'34080, 당진시,'040003, 37세,2019,3105,1769,1336,132.4,2867,1606,1261,127.4
'34080, 당진시,'040004, 38세,2019,3029,1704,1325,128.6,2829,1559,1270,122.8
'34080, 당진시,'040005, 39세,2019,3084,1713,1371,124.9,2873,1557,1316,118.3
'34080, 당진시,'045,40~44세,2019,13125,7380,5745,128.5,12289,6843,5446,125.7
'34080, 당진시,'045001, 40세,2019,2829,1595,1234,129.3,2643,1482,1161,127.6
'34080, 당진시,'045002, 41세,2019,2539,1434,1105,129.8,2355,1305,1050,124.3
'34080, 당진시,'045003, 42세,2019,2744,1533,1211,126.6,2575,1430,1145,124.9
'34080, 당진시,'045004, 43세,2019,2465,1351,1114,121.3,2305,1249,1056,118.3
'34080, 당진시,'045005, 44세,2019,2548,1467,1081,135.7,2411,1377,1034,133.2
'34080, 당진시,'050,45~49세,2019,13592,7760,5832,133.1,12769,7235,5534,130.7
'34080, 당진시,'050001, 45세,2019,2782,1608,1174,137,2642,1520,1122,135.5
'34080, 당진시,'050002, 46세,2019,2823,1551,1272,121.9,2661,1448,1213,119.4
'34080, 당진시,'050003, 47세,2019,2539,1471,1068,137.7,2376,1361,1015,134.1
'34080, 당진시,'050004, 48세,2019,2909,1701,1208,140.8,2719,1577,1142,138.1
'34080, 당진시,'050005, 49세,2019,2539,1429,1110,128.7,2371,1329,1042,127.5
'34080, 당진시,'055,50~54세,2019,12968,7279,5689,127.9,12335,6920,5415,127.8
'34080, 당진시,'055001, 50세,2019,2821,1589,1232,129,2684,1508,1176,128.2
'34080, 당진시,'055002, 51세,2019,2695,1551,1144,135.6,2546,1462,1084,134.9
'34080, 당진시,'055003, 52세,2019,2520,1381,1139,121.2,2417,1323,1094,120.9
'34080, 당진시,'055004, 53세,2019,2242,1256,986,127.4,2132,1200,932,128.8
'34080, 당진시,'055005, 54세,2019,2690,1502,1188,126.4,2556,1427,1129,126.4
'34080, 당진시,'060,55~59세,2019,12976,7037,5939,118.5,12429,6727,5702,118
'34080, 당진시,'060001, 55세,2019,2358,1330,1028,129.4,2220,1242,978,127
'34080, 당진시,'060002, 56세,2019,2406,1339,1067,125.5,2285,1270,1015,125.1
'34080, 당진시,'060003, 57세,2019,2543,1390,1153,120.6,2435,1331,1104,120.6
'34080, 당진시,'060004, 58세,2019,2867,1514,1353,111.9,2781,1464,1317,111.2
'34080, 당진시,'060005, 59세,2019,2802,1464,1338,109.4,2708,1420,1288,110.2
'34080, 당진시,'065,60~64세,2019,11207,5771,5436,106.2,10877,5579,5298,105.3
'34080, 당진시,'065001, 60세,2019,2417,1277,1140,112,2337,1230,1107,111.1
'34080, 당진시,'065002, 61세,2019,2173,1130,1043,108.3,2102,1088,1014,107.3
'34080, 당진시,'065003, 62세,2019,2317,1214,1103,110.1,2242,1167,1075,108.6
'34080, 당진시,'065004, 63세,2019,2110,1045,1065,98.1,2053,1008,1045,96.5
'34080, 당진시,'065005, 64세,2019,2190,1105,1085,101.8,2143,1086,1057,102.7
'34080, 당진시,'070,65~69세,2019,8010,3956,4054,97.6,7846,3863,3983,97
'34080, 당진시,'070001, 65세,2019,1733,848,885,95.8,1684,821,863,95.1
'34080, 당진시,'070002, 66세,2019,1477,735,742,99.1,1438,714,724,98.6
'34080, 당진시,'070003, 67세,2019,1800,900,900,100,1771,884,887,99.7
'34080, 당진시,'070004, 68세,2019,1381,707,674,104.9,1354,691,663,104.2
'34080, 당진시,'070005, 69세,2019,1619,766,853,89.8,1599,753,846,89
'34080, 당진시,'075,70~74세,2019,6527,3256,3271,99.5,6472,3227,3245,99.4
'34080, 당진시,'075001, 70세,2019,1571,785,786,99.9,1552,772,780,99
'34080, 당진시,'075002, 71세,2019,1429,712,717,99.3,1420,706,714,98.9
'34080, 당진시,'075003, 72세,2019,1470,740,730,101.4,1458,738,720,102.5
'34080, 당진시,'075004, 73세,2019,1049,520,529,98.3,1039,515,524,98.3
'34080, 당진시,'075005, 74세,2019,1008,499,509,98,1003,496,507,97.8
'34080, 당진시,'080,75~79세,2019,6019,2589,3430,75.5,5984,2574,3410,75.5
'34080, 당진시,'080001, 75세,2019,1123,498,625,79.7,1113,495,618,80.1
'34080, 당진시,'080002, 76세,2019,1136,524,612,85.6,1126,517,609,84.9
'34080, 당진시,'080003, 77세,2019,1581,669,912,73.4,1578,668,910,73.4
'34080, 당진시,'080004, 78세,2019,1113,471,642,73.4,1105,467,638,73.2
'34080, 당진시,'080005, 79세,2019,1066,427,639,66.8,1062,427,635,67.2
'34080, 당진시,'085,80~84세,2019,5099,1910,3189,59.9,5081,1905,3176,60
'34080, 당진시,'085001, 80세,2019,1162,464,698,66.5,1159,464,695,66.8
'34080, 당진시,'085002, 81세,2019,1113,444,669,66.4,1109,444,665,66.8
'34080, 당진시,'085003, 82세,2019,996,350,646,54.2,991,348,643,54.1
'34080, 당진시,'085004, 83세,2019,950,356,594,59.9,946,355,591,60.1
'34080, 당진시,'085005, 84세,2019,878,296,582,50.9,876,294,582,50.5
'34080, 당진시,'086,85세이상,2019,3431,999,2432,41.1,3419,991,2428,40.8
'34080, 당진시,'090,85~89세,2019,2440,759,1681,45.2,2431,754,1677,45
'34080, 당진시,'090001, 85세,2019,699,258,441,58.5,697,257,440,58.4
'34080, 당진시,'090002, 86세,2019,589,183,406,45.1,587,182,405,44.9
'34080, 당진시,'090003, 87세,2019,489,141,348,40.5,489,141,348,40.5
'34080, 당진시,'090004, 88세,2019,321,86,235,36.6,319,84,235,35.7
'34080, 당진시,'090005, 89세,2019,342,91,251,36.3,339,90,249,36.1
'34080, 당진시,'095,90~94세,2019,764,211,553,38.2,761,208,553,37.6
'34080, 당진시,'095001, 90세,2019,266,63,203,31,265,62,203,30.5
'34080, 당진시,'095002, 91세,2019,212,63,149,42.3,212,63,149,42.3
'34080, 당진시,'095003, 92세,2019,124,37,87,42.5,123,36,87,41.4
'34080, 당진시,'095004, 93세,2019,90,26,64,40.6,90,26,64,40.6
'34080, 당진시,'095005, 94세,2019,72,22,50,44,71,21,50,42
'34080, 당진시,'100,95~99세,2019,209,27,182,14.8,209,27,182,14.8
'34080, 당진시,'100001, 95세,2019,63,12,51,23.5,63,12,51,23.5
'34080, 당진시,'100002, 96세,2019,53,6,47,12.8,53,6,47,12.8
'34080, 당진시,'100003, 97세,2019,49,5,44,11.4,49,5,44,11.4
'34080, 당진시,'100004, 98세,2019,26,X,23,13,26,X,23,13
'34080, 당진시,'100005, 99세,2019,18,X,17,5.9,18,X,17,5.9
'34080, 당진시,'101,100세이상,2019,18,X,16,12.5,18,X,16,12.5
'34080, 당진시,'102,15세미만,2019,24572,12697,11875,106.9,24336,12564,11772,106.7
'34080, 당진시,'103,15~64세,2019,115513,64951,50562,128.5,107429,59551,47878,124.4
'34080, 당진시,'104,65세이상,2019,29086,12710,16376,77.6,28802,12560,16242,77.3
'34080, 당진시,'126,평균연령,2019,42.7,41.5,44.2,,43,41.7,44.4,
'34080, 당진시,'127,중위연령,2019,43.1,41.8,44.9,,43.7,42.5,45.2,
'34310, 금산군,'000,합계,2019,54442,27198,27244,99.8,51201,25584,25617,99.9
'34310, 금산군,'005,0~4세,2019,1096,527,569,92.6,1084,520,564,92.2
'34310, 금산군,'005001, 0세,2019,195,104,91,114.3,190,102,88,115.9
'34310, 금산군,'005002, 1세,2019,185,78,107,72.9,185,78,107,72.9
'34310, 금산군,'005003, 2세,2019,235,112,123,91.1,233,111,122,91
'34310, 금산군,'005004, 3세,2019,229,109,120,90.8,226,107,119,89.9
'34310, 금산군,'005005, 4세,2019,252,124,128,96.9,250,122,128,95.3
'34310, 금산군,'010,5~9세,2019,1677,891,786,113.4,1670,886,784,113
'34310, 금산군,'010001, 5세,2019,266,138,128,107.8,264,137,127,107.9
'34310, 금산군,'010002, 6세,2019,298,170,128,132.8,297,169,128,132
'34310, 금산군,'010003, 7세,2019,324,180,144,125,323,179,144,124.3
'34310, 금산군,'010004, 8세,2019,386,188,198,94.9,386,188,198,94.9
'34310, 금산군,'010005, 9세,2019,403,215,188,114.4,400,213,187,113.9
'34310, 금산군,'015,10~14세,2019,2072,1075,997,107.8,2067,1073,994,107.9
'34310, 금산군,'015001, 10세,2019,354,182,172,105.8,351,181,170,106.5
'34310, 금산군,'015002, 11세,2019,392,220,172,127.9,391,220,171,128.7
'34310, 금산군,'015003, 12세,2019,444,223,221,100.9,443,222,221,100.5
'34310, 금산군,'015004, 13세,2019,425,218,207,105.3,425,218,207,105.3
'34310, 금산군,'015005, 14세,2019,457,232,225,103.1,457,232,225,103.1
'34310, 금산군,'020,15~19세,2019,3033,1536,1497,102.6,2928,1477,1451,101.8
'34310, 금산군,'020001, 15세,2019,436,230,206,111.7,435,230,205,112.2
'34310, 금산군,'020002, 16세,2019,440,218,222,98.2,437,217,220,98.6
'34310, 금산군,'020003, 17세,2019,428,215,213,100.9,425,213,212,100.5
'34310, 금산군,'020004, 18세,2019,682,350,332,105.4,656,336,320,105
'34310, 금산군,'020005, 19세,2019,1047,523,524,99.8,975,481,494,97.4
'34310, 금산군,'025,20~24세,2019,4285,2339,1946,120.2,3330,1860,1470,126.5
'34310, 금산군,'025001, 20세,2019,859,385,474,81.2,699,301,398,75.6
'34310, 금산군,'025002, 21세,2019,946,468,478,97.9,695,318,377,84.4
'34310, 금산군,'025003, 22세,2019,937,513,424,121,740,417,323,129.1
'34310, 금산군,'025004, 23세,2019,792,488,304,160.5,611,410,201,204
'34310, 금산군,'025005, 24세,2019,751,485,266,182.3,585,414,171,242.1
'34310, 금산군,'030,25~29세,2019,2544,1422,1122,126.7,1833,1086,747,145.4
'34310, 금산군,'030001, 25세,2019,640,372,268,138.8,457,287,170,168.8
'34310, 금산군,'030002, 26세,2019,527,303,224,135.3,371,217,154,140.9
'34310, 금산군,'030003, 27세,2019,487,279,208,134.1,345,206,139,148.2
'34310, 금산군,'030004, 28세,2019,444,232,212,109.4,324,185,139,133.1
'34310, 금산군,'030005, 29세,2019,446,236,210,112.4,336,191,145,131.7
'34310, 금산군,'035,30~34세,2019,2072,1100,972,113.2,1632,872,760,114.7
'34310, 금산군,'035001, 30세,2019,401,223,178,125.3,299,169,130,130
'34310, 금산군,'035002, 31세,2019,441,225,216,104.2,336,172,164,104.9
'34310, 금산군,'035003, 32세,2019,377,205,172,119.2,311,166,145,114.5
'34310, 금산군,'035004, 33세,2019,433,227,206,110.2,353,190,163,116.6
'34310, 금산군,'035005, 34세,2019,420,220,200,110,333,175,158,110.8
'34310, 금산군,'040,35~39세,2019,2578,1340,1238,108.2,2252,1186,1066,111.3
'34310, 금산군,'040001, 35세,2019,438,228,210,108.6,359,186,173,107.5
'34310, 금산군,'040002, 36세,2019,469,246,223,110.3,404,211,193,109.3
'34310, 금산군,'040003, 37세,2019,533,276,257,107.4,463,249,214,116.4
'34310, 금산군,'040004, 38세,2019,585,307,278,110.4,517,272,245,111
'34310, 금산군,'040005, 39세,2019,553,283,270,104.8,509,268,241,111.2
'34310, 금산군,'045,40~44세,2019,2853,1538,1315,117,2618,1415,1203,117.6
'34310, 금산군,'045001, 40세,2019,569,298,271,110,500,262,238,110.1
'34310, 금산군,'045002, 41세,2019,530,280,250,112,482,257,225,114.2
'34310, 금산군,'045003, 42세,2019,548,295,253,116.6,509,275,234,117.5
'34310, 금산군,'045004, 43세,2019,590,313,277,113,552,287,265,108.3
'34310, 금산군,'045005, 44세,2019,616,352,264,133.3,575,334,241,138.6
'34310, 금산군,'050,45~49세,2019,3621,2008,1613,124.5,3456,1931,1525,126.6
'34310, 금산군,'050001, 45세,2019,651,372,279,133.3,620,357,263,135.7
'34310, 금산군,'050002, 46세,2019,698,381,317,120.2,664,362,302,119.9
'34310, 금산군,'050003, 47세,2019,709,404,305,132.5,673,389,284,137
'34310, 금산군,'050004, 48세,2019,781,420,361,116.3,752,407,345,118
'34310, 금산군,'050005, 49세,2019,782,431,351,122.8,747,416,331,125.7
'34310, 금산군,'055,50~54세,2019,4036,2186,1850,118.2,3921,2125,1796,118.3
'34310, 금산군,'055001, 50세,2019,787,452,335,134.9,760,437,323,135.3
'34310, 금산군,'055002, 51세,2019,797,415,382,108.6,774,404,370,109.2
'34310, 금산군,'055003, 52세,2019,855,442,413,107,837,434,403,107.7
'34310, 금산군,'055004, 53세,2019,729,400,329,121.6,705,385,320,120.3
'34310, 금산군,'055005, 54세,2019,868,477,391,122,845,465,380,122.4
'34310, 금산군,'060,55~59세,2019,4869,2572,2297,112,4786,2527,2259,111.9
'34310, 금산군,'060001, 55세,2019,806,421,385,109.4,785,408,377,108.2
'34310, 금산군,'060002, 56세,2019,885,494,391,126.3,868,483,385,125.5
'34310, 금산군,'060003, 57세,2019,911,491,420,116.9,899,484,415,116.6
'34310, 금산군,'060004, 58세,2019,1128,604,524,115.3,1107,596,511,116.6
'34310, 금산군,'060005, 59세,2019,1139,562,577,97.4,1127,556,571,97.4
'34310, 금산군,'065,60~64세,2019,4816,2420,2396,101,4768,2393,2375,100.8
'34310, 금산군,'065001, 60세,2019,934,448,486,92.2,924,445,479,92.9
'34310, 금산군,'065002, 61세,2019,957,460,497,92.6,946,454,492,92.3
'34310, 금산군,'065003, 62세,2019,1038,563,475,118.5,1031,560,471,118.9
'34310, 금산군,'065004, 63세,2019,901,462,439,105.2,894,456,438,104.1
'34310, 금산군,'065005, 64세,2019,986,487,499,97.6,973,478,495,96.6
'34310, 금산군,'070,65~69세,2019,3951,1946,2005,97.1,3931,1939,1992,97.3
'34310, 금산군,'070001, 65세,2019,945,476,469,101.5,940,475,465,102.2
'34310, 금산군,'070002, 66세,2019,708,328,380,86.3,704,327,377,86.7
'34310, 금산군,'070003, 67세,2019,864,435,429,101.4,862,435,427,101.9
'34310, 금산군,'070004, 68세,2019,679,323,356,90.7,672,319,353,90.4
'34310, 금산군,'070005, 69세,2019,755,384,371,103.5,753,383,370,103.5
'34310, 금산군,'075,70~74세,2019,3258,1537,1721,89.3,3250,1536,1714,89.6
'34310, 금산군,'075001, 70세,2019,714,359,355,101.1,712,359,353,101.7
'34310, 금산군,'075002, 71세,2019,714,339,375,90.4,713,339,374,90.6
'34310, 금산군,'075003, 72세,2019,731,340,391,87,726,339,387,87.6
'34310, 금산군,'075004, 73세,2019,562,274,288,95.1,562,274,288,95.1
'34310, 금산군,'075005, 74세,2019,537,225,312,72.1,537,225,312,72.1
'34310, 금산군,'080,75~79세,2019,3271,1312,1959,67,3268,1311,1957,67
'34310, 금산군,'080001, 75세,2019,549,229,320,71.6,548,229,319,71.8
'34310, 금산군,'080002, 76세,2019,670,280,390,71.8,670,280,390,71.8
'34310, 금산군,'080003, 77세,2019,885,368,517,71.2,884,367,517,71
'34310, 금산군,'080004, 78세,2019,569,209,360,58.1,568,209,359,58.2
'34310, 금산군,'080005, 79세,2019,598,226,372,60.8,598,226,372,60.8
'34310, 금산군,'085,80~84세,2019,2672,946,1726,54.8,2671,946,1725,54.8
'34310, 금산군,'085001, 80세,2019,643,231,412,56.1,643,231,412,56.1
'34310, 금산군,'085002, 81세,2019,607,221,386,57.3,606,221,385,57.4
'34310, 금산군,'085003, 82세,2019,475,174,301,57.8,475,174,301,57.8
'34310, 금산군,'085004, 83세,2019,492,171,321,53.3,492,171,321,53.3
'34310, 금산군,'085005, 84세,2019,455,149,306,48.7,455,149,306,48.7
'34310, 금산군,'086,85세이상,2019,1738,503,1235,40.7,1736,501,1235,40.6
'34310, 금산군,'090,85~89세,2019,1271,388,883,43.9,1269,386,883,43.7
'34310, 금산군,'090001, 85세,2019,363,118,245,48.2,363,118,245,48.2
'34310, 금산군,'090002, 86세,2019,278,92,186,49.5,277,91,186,48.9
'34310, 금산군,'090003, 87세,2019,288,92,196,46.9,288,92,196,46.9
'34310, 금산군,'090004, 88세,2019,178,51,127,40.2,177,50,127,39.4
'34310, 금산군,'090005, 89세,2019,164,35,129,27.1,164,35,129,27.1
'34310, 금산군,'095,90~94세,2019,379,98,281,34.9,379,98,281,34.9
'34310, 금산군,'095001, 90세,2019,118,37,81,45.7,118,37,81,45.7
'34310, 금산군,'095002, 91세,2019,97,22,75,29.3,97,22,75,29.3
'34310, 금산군,'095003, 92세,2019,80,18,62,29,80,18,62,29
'34310, 금산군,'095004, 93세,2019,42,13,29,44.8,42,13,29,44.8
'34310, 금산군,'095005, 94세,2019,42,8,34,23.5,42,8,34,23.5
'34310, 금산군,'100,95~99세,2019,80,16,64,25,80,16,64,25
'34310, 금산군,'100001, 95세,2019,19,X,15,26.7,19,X,15,26.7
'34310, 금산군,'100002, 96세,2019,31,6,25,24,31,6,25,24
'34310, 금산군,'100003, 97세,2019,14,X,11,27.3,14,X,11,27.3
'34310, 금산군,'100004, 98세,2019,10,X,8,25,10,X,8,25
'34310, 금산군,'100005, 99세,2019,6,X,5,20,6,X,5,20
'34310, 금산군,'101,100세이상,2019,8,X,7,14.3,8,X,7,14.3
'34310, 금산군,'102,15세미만,2019,4845,2493,2352,106,4821,2479,2342,105.8
'34310, 금산군,'103,15~64세,2019,34707,18461,16246,113.6,31524,16872,14652,115.2
'34310, 금산군,'104,65세이상,2019,14890,6244,8646,72.2,14856,6233,8623,72.3
'34310, 금산군,'126,평균연령,2019,48.6,46.6,50.5,,49.6,47.6,51.6,
'34310, 금산군,'127,중위연령,2019,51.8,49.6,54.3,,53.5,51.1,56.2,
'34330, 부여군,'000,합계,2019,65337,32446,32891,98.6,63440,31450,31990,98.3
'34330, 부여군,'005,0~4세,2019,1260,653,607,107.6,1256,652,604,107.9
'34330, 부여군,'005001, 0세,2019,177,89,88,101.1,177,89,88,101.1
'34330, 부여군,'005002, 1세,2019,219,119,100,119,217,118,99,119.2
'34330, 부여군,'005003, 2세,2019,249,132,117,112.8,248,132,116,113.8
'34330, 부여군,'005004, 3세,2019,283,140,143,97.9,283,140,143,97.9
'34330, 부여군,'005005, 4세,2019,332,173,159,108.8,331,173,158,109.5
'34330, 부여군,'010,5~9세,2019,1820,985,835,118,1816,981,835,117.5
'34330, 부여군,'010001, 5세,2019,329,176,153,115,328,175,153,114.4
'34330, 부여군,'010002, 6세,2019,330,177,153,115.7,330,177,153,115.7
'34330, 부여군,'010003, 7세,2019,394,209,185,113,392,207,185,111.9
'34330, 부여군,'010004, 8세,2019,366,204,162,125.9,366,204,162,125.9
'34330, 부여군,'010005, 9세,2019,401,219,182,120.3,400,218,182,119.8
'34330, 부여군,'015,10~14세,2019,2140,1111,1029,108,2138,1110,1028,108
'34330, 부여군,'015001, 10세,2019,372,200,172,116.3,372,200,172,116.3
'34330, 부여군,'015002, 11세,2019,416,202,214,94.4,416,202,214,94.4
'34330, 부여군,'015003, 12세,2019,427,228,199,114.6,426,228,198,115.2
'34330, 부여군,'015004, 13세,2019,456,243,213,114.1,456,243,213,114.1
'34330, 부여군,'015005, 14세,2019,469,238,231,103,468,237,231,102.6
'34330, 부여군,'020,15~19세,2019,2559,1342,1217,110.3,2542,1337,1205,111
'34330, 부여군,'020001, 15세,2019,452,249,203,122.7,452,249,203,122.7
'34330, 부여군,'020002, 16세,2019,502,271,231,117.3,501,270,231,116.9
'34330, 부여군,'020003, 17세,2019,513,264,249,106,512,264,248,106.5
'34330, 부여군,'020004, 18세,2019,568,315,253,124.5,562,313,249,125.7
'34330, 부여군,'020005, 19세,2019,524,243,281,86.5,515,241,274,88
'34330, 부여군,'025,20~24세,2019,3166,1810,1356,133.5,2952,1707,1245,137.1
'34330, 부여군,'025001, 20세,2019,601,354,247,143.3,584,351,233,150.6
'34330, 부여군,'025002, 21세,2019,657,385,272,141.5,629,371,258,143.8
'34330, 부여군,'025003, 22세,2019,639,376,263,143,581,343,238,144.1
'34330, 부여군,'025004, 23세,2019,665,351,314,111.8,609,324,285,113.7
'34330, 부여군,'025005, 24세,2019,604,344,260,132.3,549,318,231,137.7
'34330, 부여군,'030,25~29세,2019,2730,1602,1128,142,2294,1344,950,141.5
'34330, 부여군,'030001, 25세,2019,633,389,244,159.4,554,341,213,160.1
'34330, 부여군,'030002, 26세,2019,535,306,229,133.6,449,260,189,137.6
'34330, 부여군,'030003, 27세,2019,546,315,231,136.4,458,259,199,130.2
'34330, 부여군,'030004, 28세,2019,500,284,216,131.5,416,235,181,129.8
'34330, 부여군,'030005, 29세,2019,516,308,208,148.1,417,249,168,148.2
'34330, 부여군,'035,30~34세,2019,2347,1289,1058,121.8,1955,1075,880,122.2
'34330, 부여군,'035001, 30세,2019,438,251,187,134.2,352,197,155,127.1
'34330, 부여군,'035002, 31세,2019,477,273,204,133.8,391,221,170,130
'34330, 부여군,'035003, 32세,2019,500,271,229,118.3,429,235,194,121.1
'34330, 부여군,'035004, 33세,2019,462,235,227,103.5,390,201,189,106.3
'34330, 부여군,'035005, 34세,2019,470,259,211,122.7,393,221,172,128.5
'34330, 부여군,'040,35~39세,2019,2788,1517,1271,119.4,2546,1398,1148,121.8
'34330, 부여군,'040001, 35세,2019,492,254,238,106.7,438,230,208,110.6
'34330, 부여군,'040002, 36세,2019,547,304,243,125.1,490,275,215,127.9
'34330, 부여군,'040003, 37세,2019,580,320,260,123.1,531,291,240,121.3
'34330, 부여군,'040004, 38세,2019,540,295,245,120.4,502,280,222,126.1
'34330, 부여군,'040005, 39세,2019,629,344,285,120.7,585,322,263,122.4
'34330, 부여군,'045,40~44세,2019,3168,1710,1458,117.3,3017,1645,1372,119.9
'34330, 부여군,'045001, 40세,2019,571,301,270,111.5,527,282,245,115.1
'34330, 부여군,'045002, 41세,2019,623,347,276,125.7,596,337,259,130.1
'34330, 부여군,'045003, 42세,2019,638,338,300,112.7,608,321,287,111.8
'34330, 부여군,'045004, 43세,2019,638,343,295,116.3,613,332,281,118.1
'34330, 부여군,'045005, 44세,2019,698,381,317,120.2,673,373,300,124.3
'34330, 부여군,'050,45~49세,2019,4253,2339,1914,122.2,4112,2265,1847,122.6
'34330, 부여군,'050001, 45세,2019,828,452,376,120.2,788,433,355,122
'34330, 부여군,'050002, 46세,2019,821,458,363,126.2,795,441,354,124.6
'34330, 부여군,'050003, 47세,2019,820,457,363,125.9,786,435,351,123.9
'34330, 부여군,'050004, 48세,2019,902,495,407,121.6,879,486,393,123.7
'34330, 부여군,'050005, 49세,2019,882,477,405,117.8,864,470,394,119.3
'34330, 부여군,'055,50~54세,2019,4855,2594,2261,114.7,4737,2529,2208,114.5
'34330, 부여군,'055001, 50세,2019,970,490,480,102.1,945,477,468,101.9
'34330, 부여군,'055002, 51세,2019,1003,542,461,117.6,973,527,446,118.2
'34330, 부여군,'055003, 52세,2019,950,525,425,123.5,935,516,419,123.2
'34330, 부여군,'055004, 53세,2019,868,462,406,113.8,844,447,397,112.6
'34330, 부여군,'055005, 54세,2019,1064,575,489,117.6,1040,562,478,117.6
'34330, 부여군,'060,55~59세,2019,6230,3101,3129,99.1,6128,3049,3079,99
'34330, 부여군,'060001, 55세,2019,1037,513,524,97.9,1008,495,513,96.5
'34330, 부여군,'060002, 56세,2019,1052,514,538,95.5,1033,507,526,96.4
'34330, 부여군,'060003, 57세,2019,1189,620,569,109,1174,614,560,109.6
'34330, 부여군,'060004, 58세,2019,1467,737,730,101,1448,728,720,101.1
'34330, 부여군,'060005, 59세,2019,1485,717,768,93.4,1465,705,760,92.8
'34330, 부여군,'065,60~64세,2019,6728,3412,3316,102.9,6690,3389,3301,102.7
'34330, 부여군,'065001, 60세,2019,1321,652,669,97.5,1313,647,666,97.1
'34330, 부여군,'065002, 61세,2019,1280,641,639,100.3,1273,639,634,100.8
'34330, 부여군,'065003, 62세,2019,1389,740,649,114,1379,732,647,113.1
'34330, 부여군,'065004, 63세,2019,1382,710,672,105.7,1374,705,669,105.4
'34330, 부여군,'065005, 64세,2019,1356,669,687,97.4,1351,666,685,97.2
'34330, 부여군,'070,65~69세,2019,5329,2619,2710,96.6,5311,2612,2699,96.8
'34330, 부여군,'070001, 65세,2019,1219,603,616,97.9,1216,603,613,98.4
'34330, 부여군,'070002, 66세,2019,971,464,507,91.5,964,462,502,92
'34330, 부여군,'070003, 67세,2019,1112,555,557,99.6,1109,553,556,99.5
'34330, 부여군,'070004, 68세,2019,935,459,476,96.4,933,458,475,96.4
'34330, 부여군,'070005, 69세,2019,1092,538,554,97.1,1089,536,553,96.9
'34330, 부여군,'075,70~74세,2019,4533,2151,2382,90.3,4525,2149,2376,90.4
'34330, 부여군,'075001, 70세,2019,1138,524,614,85.3,1135,523,612,85.5
'34330, 부여군,'075002, 71세,2019,969,451,518,87.1,968,451,517,87.2
'34330, 부여군,'075003, 72세,2019,969,463,506,91.5,969,463,506,91.5
'34330, 부여군,'075004, 73세,2019,670,341,329,103.6,668,341,327,104.3
'34330, 부여군,'075005, 74세,2019,787,372,415,89.6,785,371,414,89.6
'34330, 부여군,'080,75~79세,2019,4534,1889,2645,71.4,4530,1888,2642,71.5
'34330, 부여군,'080001, 75세,2019,849,354,495,71.5,848,353,495,71.3
'34330, 부여군,'080002, 76세,2019,844,380,464,81.9,843,380,463,82.1
'34330, 부여군,'080003, 77세,2019,1111,455,656,69.4,1110,455,655,69.5
'34330, 부여군,'080004, 78세,2019,918,375,543,69.1,917,375,542,69.2
'34330, 부여군,'080005, 79세,2019,812,325,487,66.7,812,325,487,66.7
'34330, 부여군,'085,80~84세,2019,3918,1411,2507,56.3,3916,1411,2505,56.3
'34330, 부여군,'085001, 80세,2019,899,330,569,58,898,330,568,58.1
'34330, 부여군,'085002, 81세,2019,800,286,514,55.6,799,286,513,55.8
'34330, 부여군,'085003, 82세,2019,776,283,493,57.4,776,283,493,57.4
'34330, 부여군,'085004, 83세,2019,718,273,445,61.3,718,273,445,61.3
'34330, 부여군,'085005, 84세,2019,725,239,486,49.2,725,239,486,49.2
'34330, 부여군,'086,85세이상,2019,2979,911,2068,44.1,2975,909,2066,44
'34330, 부여군,'090,85~89세,2019,2106,707,1399,50.5,2104,707,1397,50.6
'34330, 부여군,'090001, 85세,2019,590,206,384,53.6,590,206,384,53.6
'34330, 부여군,'090002, 86세,2019,492,172,320,53.8,491,172,319,53.9
'34330, 부여군,'090003, 87세,2019,436,149,287,51.9,436,149,287,51.9
'34330, 부여군,'090004, 88세,2019,307,87,220,39.5,307,87,220,39.5
'34330, 부여군,'090005, 89세,2019,281,93,188,49.5,280,93,187,49.7
'34330, 부여군,'095,90~94세,2019,732,181,551,32.8,731,180,551,32.7
'34330, 부여군,'095001, 90세,2019,204,58,146,39.7,204,58,146,39.7
'34330, 부여군,'095002, 91세,2019,212,62,150,41.3,212,62,150,41.3
'34330, 부여군,'095003, 92세,2019,138,31,107,29,137,30,107,28
'34330, 부여군,'095004, 93세,2019,110,20,90,22.2,110,20,90,22.2
'34330, 부여군,'095005, 94세,2019,68,10,58,17.2,68,10,58,17.2
'34330, 부여군,'100,95~99세,2019,124,21,103,20.4,123,20,103,19.4
'34330, 부여군,'100001, 95세,2019,32,6,26,23.1,32,6,26,23.1
'34330, 부여군,'100002, 96세,2019,38,6,32,18.8,38,6,32,18.8
'34330, 부여군,'100003, 97세,2019,24,X,21,14.3,24,X,21,14.3
'34330, 부여군,'100004, 98세,2019,20,5,15,33.3,20,5,15,33.3
'34330, 부여군,'100005, 99세,2019,10,X,9,11.1,9,X,9,0
'34330, 부여군,'101,100세이상,2019,17,X,15,13.3,17,X,15,13.3
'34330, 부여군,'102,15세미만,2019,5220,2749,2471,111.3,5210,2743,2467,111.2
'34330, 부여군,'103,15~64세,2019,38824,20716,18108,114.4,36973,19738,17235,114.5
'34330, 부여군,'104,65세이상,2019,21293,8981,12312,72.9,21257,8969,12288,73
'34330, 부여군,'126,평균연령,2019,52.3,49.9,54.6,,52.7,50.3,55.1,
'34330, 부여군,'127,중위연령,2019,56.5,53.7,58.9,,57.3,54.4,59.5,
'34340, 서천군,'000,합계,2019,51826,26010,25816,100.8,49836,24562,25274,97.2
'34340, 서천군,'005,0~4세,2019,990,500,490,102,990,500,490,102
'34340, 서천군,'005001, 0세,2019,167,85,82,103.7,167,85,82,103.7
'34340, 서천군,'005002, 1세,2019,185,101,84,120.2,185,101,84,120.2
'34340, 서천군,'005003, 2세,2019,184,87,97,89.7,184,87,97,89.7
'34340, 서천군,'005004, 3세,2019,217,107,110,97.3,217,107,110,97.3
'34340, 서천군,'005005, 4세,2019,237,120,117,102.6,237,120,117,102.6
'34340, 서천군,'010,5~9세,2019,1441,722,719,100.4,1437,720,717,100.4
'34340, 서천군,'010001, 5세,2019,267,141,126,111.9,266,140,126,111.1
'34340, 서천군,'010002, 6세,2019,266,128,138,92.8,266,128,138,92.8
'34340, 서천군,'010003, 7세,2019,284,138,146,94.5,283,137,146,93.8
'34340, 서천군,'010004, 8세,2019,310,163,147,110.9,309,163,146,111.6
'34340, 서천군,'010005, 9세,2019,314,152,162,93.8,313,152,161,94.4
'34340, 서천군,'015,10~14세,2019,1539,788,751,104.9,1536,787,749,105.1
'34340, 서천군,'015001, 10세,2019,270,148,122,121.3,269,148,121,122.3
'34340, 서천군,'015002, 11세,2019,315,161,154,104.5,314,160,154,103.9
'34340, 서천군,'015003, 12세,2019,310,151,159,95,309,151,158,95.6
'34340, 서천군,'015004, 13세,2019,304,159,145,109.7,304,159,145,109.7
'34340, 서천군,'015005, 14세,2019,340,169,171,98.8,340,169,171,98.8
'34340, 서천군,'020,15~19세,2019,1976,1071,905,118.3,1950,1053,897,117.4
'34340, 서천군,'020001, 15세,2019,338,163,175,93.1,334,162,172,94.2
'34340, 서천군,'020002, 16세,2019,426,216,210,102.9,424,216,208,103.8
'34340, 서천군,'020003, 17세,2019,478,268,210,127.6,475,266,209,127.3
'34340, 서천군,'020004, 18세,2019,452,249,203,122.7,446,243,203,119.7
'34340, 서천군,'020005, 19세,2019,282,175,107,163.6,271,166,105,158.1
'34340, 서천군,'025,20~24세,2019,1989,1263,726,174,1756,1080,676,159.8
'34340, 서천군,'025001, 20세,2019,343,220,123,178.9,329,210,119,176.5
'34340, 서천군,'025002, 21세,2019,418,288,130,221.5,393,270,123,219.5
'34340, 서천군,'025003, 22세,2019,383,232,151,153.6,339,198,141,140.4
'34340, 서천군,'025004, 23세,2019,398,248,150,165.3,333,198,135,146.7
'34340, 서천군,'025005, 24세,2019,447,275,172,159.9,362,204,158,129.1
'34340, 서천군,'030,25~29세,2019,2142,1321,821,160.9,1669,965,704,137.1
'34340, 서천군,'030001, 25세,2019,426,266,160,166.3,341,201,140,143.6
'34340, 서천군,'030002, 26세,2019,464,282,182,154.9,372,210,162,129.6
'34340, 서천군,'030003, 27세,2019,409,254,155,163.9,320,181,139,130.2
'34340, 서천군,'030004, 28세,2019,466,291,175,166.3,344,203,141,144
'34340, 서천군,'030005, 29세,2019,377,228,149,153,292,170,122,139.3
'34340, 서천군,'035,30~34세,2019,1906,1171,735,159.3,1486,860,626,137.4
'34340, 서천군,'035001, 30세,2019,392,246,146,168.5,293,168,125,134.4
'34340, 서천군,'035002, 31세,2019,375,222,153,145.1,285,156,129,120.9
'34340, 서천군,'035003, 32세,2019,400,252,148,170.3,312,191,121,157.9
'34340, 서천군,'035004, 33세,2019,384,228,156,146.2,314,176,138,127.5
'34340, 서천군,'035005, 34세,2019,355,223,132,168.9,282,169,113,149.6
'34340, 서천군,'040,35~39세,2019,2320,1332,988,134.8,2041,1122,919,122.1
'34340, 서천군,'040001, 35세,2019,410,233,177,131.6,344,187,157,119.1
'34340, 서천군,'040002, 36세,2019,434,250,184,135.9,371,205,166,123.5
'34340, 서천군,'040003, 37세,2019,489,294,195,150.8,428,243,185,131.4
'34340, 서천군,'040004, 38세,2019,477,275,202,136.1,432,239,193,123.8
'34340, 서천군,'040005, 39세,2019,510,280,230,121.7,466,248,218,113.8
'34340, 서천군,'045,40~44세,2019,2583,1477,1106,133.5,2386,1328,1058,125.5
'34340, 서천군,'045001, 40세,2019,479,267,212,125.9,440,236,204,115.7
'34340, 서천군,'045002, 41세,2019,468,272,196,138.8,421,233,188,123.9
'34340, 서천군,'045003, 42세,2019,514,289,225,128.4,476,260,216,120.4
'34340, 서천군,'045004, 43세,2019,568,349,219,159.4,534,322,212,151.9
'34340, 서천군,'045005, 44세,2019,554,300,254,118.1,515,277,238,116.4
'34340, 서천군,'050,45~49세,2019,3458,1913,1545,123.8,3289,1800,1489,120.9
'34340, 서천군,'050001, 45세,2019,647,345,302,114.2,606,315,291,108.2
'34340, 서천군,'050002, 46세,2019,640,357,283,126.1,603,336,267,125.8
'34340, 서천군,'050003, 47세,2019,643,345,298,115.8,612,324,288,112.5
'34340, 서천군,'050004, 48세,2019,776,441,335,131.6,745,416,329,126.4
'34340, 서천군,'050005, 49세,2019,752,425,327,130,723,409,314,130.3
'34340, 서천군,'055,50~54세,2019,3768,2054,1714,119.8,3680,1999,1681,118.9
'34340, 서천군,'055001, 50세,2019,777,450,327,137.6,750,434,316,137.3
'34340, 서천군,'055002, 51세,2019,741,386,355,108.7,723,374,349,107.2
'34340, 서천군,'055003, 52세,2019,769,416,353,117.8,749,403,346,116.5
'34340, 서천군,'055004, 53세,2019,648,362,286,126.6,636,353,283,124.7
'34340, 서천군,'055005, 54세,2019,833,440,393,112,822,435,387,112.4
'34340, 서천군,'060,55~59세,2019,4673,2415,2258,107,4629,2392,2237,106.9
'34340, 서천군,'060001, 55세,2019,760,420,340,123.5,745,412,333,123.7
'34340, 서천군,'060002, 56세,2019,822,448,374,119.8,812,443,369,120.1
'34340, 서천군,'060003, 57세,2019,933,504,429,117.5,925,500,425,117.6
'34340, 서천군,'060004, 58세,2019,1049,514,535,96.1,1044,511,533,95.9
'34340, 서천군,'060005, 59세,2019,1109,529,580,91.2,1103,526,577,91.2
'34340, 서천군,'065,60~64세,2019,5147,2581,2566,100.6,5118,2563,2555,100.3
'34340, 서천군,'065001, 60세,2019,1058,531,527,100.8,1052,527,525,100.4
'34340, 서천군,'065002, 61세,2019,1000,477,523,91.2,997,475,522,91
'34340, 서천군,'065003, 62세,2019,949,490,459,106.8,940,485,455,106.6
'34340, 서천군,'065004, 63세,2019,1013,508,505,100.6,1008,505,503,100.4
'34340, 서천군,'065005, 64세,2019,1127,575,552,104.2,1121,571,550,103.8
'34340, 서천군,'070,65~69세,2019,4416,2064,2352,87.8,4404,2059,2345,87.8
'34340, 서천군,'070001, 65세,2019,1001,453,548,82.7,998,451,547,82.4
'34340, 서천군,'070002, 66세,2019,746,338,408,82.8,741,336,405,83
'34340, 서천군,'070003, 67세,2019,945,447,498,89.8,945,447,498,89.8
'34340, 서천군,'070004, 68세,2019,806,387,419,92.4,805,387,418,92.6
'34340, 서천군,'070005, 69세,2019,918,439,479,91.6,915,438,477,91.8
'34340, 서천군,'075,70~74세,2019,3896,1866,2030,91.9,3893,1865,2028,92
'34340, 서천군,'075001, 70세,2019,846,398,448,88.8,844,398,446,89.2
'34340, 서천군,'075002, 71세,2019,881,424,457,92.8,881,424,457,92.8
'34340, 서천군,'075003, 72세,2019,959,476,483,98.6,959,476,483,98.6
'34340, 서천군,'075004, 73세,2019,569,262,307,85.3,569,262,307,85.3
'34340, 서천군,'075005, 74세,2019,641,306,335,91.3,640,305,335,91
'34340, 서천군,'080,75~79세,2019,3794,1506,2288,65.8,3790,1504,2286,65.8
'34340, 서천군,'080001, 75세,2019,661,269,392,68.6,660,269,391,68.8
'34340, 서천군,'080002, 76세,2019,797,311,486,64,796,311,485,64.1
'34340, 서천군,'080003, 77세,2019,948,393,555,70.8,948,393,555,70.8
'34340, 서천군,'080004, 78세,2019,716,281,435,64.6,716,281,435,64.6
'34340, 서천군,'080005, 79세,2019,672,252,420,60,670,250,420,59.5
'34340, 서천군,'085,80~84세,2019,3276,1236,2040,60.6,3271,1235,2036,60.7
'34340, 서천군,'085001, 80세,2019,766,293,473,61.9,766,293,473,61.9
'34340, 서천군,'085002, 81세,2019,708,257,451,57,705,256,449,57
'34340, 서천군,'085003, 82세,2019,641,258,383,67.4,640,258,382,67.5
'34340, 서천군,'085004, 83세,2019,600,232,368,63,600,232,368,63
'34340, 서천군,'085005, 84세,2019,561,196,365,53.7,560,196,364,53.8
'34340, 서천군,'086,85세이상,2019,2512,730,1782,41,2511,730,1781,41
'34340, 서천군,'090,85~89세,2019,1794,575,1219,47.2,1793,575,1218,47.2
'34340, 서천군,'090001, 85세,2019,438,155,283,54.8,437,155,282,55
'34340, 서천군,'090002, 86세,2019,422,147,275,53.5,422,147,275,53.5
'34340, 서천군,'090003, 87세,2019,397,124,273,45.4,397,124,273,45.4
'34340, 서천군,'090004, 88세,2019,273,82,191,42.9,273,82,191,42.9
'34340, 서천군,'090005, 89세,2019,264,67,197,34,264,67,197,34
'34340, 서천군,'095,90~94세,2019,591,133,458,29,591,133,458,29
'34340, 서천군,'095001, 90세,2019,205,48,157,30.6,205,48,157,30.6
'34340, 서천군,'095002, 91세,2019,142,31,111,27.9,142,31,111,27.9
'34340, 서천군,'095003, 92세,2019,122,26,96,27.1,122,26,96,27.1
'34340, 서천군,'095004, 93세,2019,74,17,57,29.8,74,17,57,29.8
'34340, 서천군,'095005, 94세,2019,48,11,37,29.7,48,11,37,29.7
'34340, 서천군,'100,95~99세,2019,111,20,91,22,111,20,91,22
'34340, 서천군,'100001, 95세,2019,33,8,25,32,33,8,25,32
'34340, 서천군,'100002, 96세,2019,43,8,35,22.9,43,8,35,22.9
'34340, 서천군,'100003, 97세,2019,17,X,14,21.4,17,X,14,21.4
'34340, 서천군,'100004, 98세,2019,9,X,8,12.5,9,X,8,12.5
'34340, 서천군,'100005, 99세,2019,9,X,9,0,9,X,9,0
'34340, 서천군,'101,100세이상,2019,16,X,14,14.3,16,X,14,14.3
'34340, 서천군,'102,15세미만,2019,3970,2010,1960,102.6,3963,2007,1956,102.6
'34340, 서천군,'103,15~64세,2019,29962,16598,13364,124.2,28004,15162,12842,118.1
'34340, 서천군,'104,65세이상,2019,17894,7402,10492,70.5,17869,7393,10476,70.6
'34340, 서천군,'126,평균연령,2019,53.1,50.3,55.9,,53.8,51.2,56.3,
'34340, 서천군,'127,중위연령,2019,57.2,53.5,60.3,,58.2,55.2,60.7,
'34350, 청양군,'000,합계,2019,30783,15600,15183,102.7,29885,15162,14723,103
'34350, 청양군,'005,0~4세,2019,535,279,256,109,535,279,256,109
'34350, 청양군,'005001, 0세,2019,97,47,50,94,97,47,50,94
'34350, 청양군,'005002, 1세,2019,99,53,46,115.2,99,53,46,115.2
'34350, 청양군,'005003, 2세,2019,100,54,46,117.4,100,54,46,117.4
'34350, 청양군,'005004, 3세,2019,115,61,54,113,115,61,54,113
'34350, 청양군,'005005, 4세,2019,124,64,60,106.7,124,64,60,106.7
'34350, 청양군,'010,5~9세,2019,784,393,391,100.5,784,393,391,100.5
'34350, 청양군,'010001, 5세,2019,142,63,79,79.7,142,63,79,79.7
'34350, 청양군,'010002, 6세,2019,144,83,61,136.1,144,83,61,136.1
'34350, 청양군,'010003, 7세,2019,162,82,80,102.5,162,82,80,102.5
'34350, 청양군,'010004, 8세,2019,167,87,80,108.8,167,87,80,108.8
'34350, 청양군,'010005, 9세,2019,169,78,91,85.7,169,78,91,85.7
'34350, 청양군,'015,10~14세,2019,814,424,390,108.7,812,424,388,109.3
'34350, 청양군,'015001, 10세,2019,153,78,75,104,152,78,74,105.4
'34350, 청양군,'015002, 11세,2019,163,93,70,132.9,163,93,70,132.9
'34350, 청양군,'015003, 12세,2019,162,81,81,100,161,81,80,101.3
'34350, 청양군,'015004, 13세,2019,170,91,79,115.2,170,91,79,115.2
'34350, 청양군,'015005, 14세,2019,166,81,85,95.3,166,81,85,95.3
'34350, 청양군,'020,15~19세,2019,1309,710,599,118.5,1305,709,596,119
'34350, 청양군,'020001, 15세,2019,193,101,92,109.8,191,101,90,112.2
'34350, 청양군,'020002, 16세,2019,199,109,90,121.1,199,109,90,121.1
'34350, 청양군,'020003, 17세,2019,227,110,117,94,227,110,117,94
'34350, 청양군,'020004, 18세,2019,281,168,113,148.7,280,168,112,150
'34350, 청양군,'020005, 19세,2019,409,222,187,118.7,408,221,187,118.2
'34350, 청양군,'025,20~24세,2019,1705,981,724,135.5,1606,934,672,139
'34350, 청양군,'025001, 20세,2019,384,189,195,96.9,378,186,192,96.9
'34350, 청양군,'025002, 21세,2019,343,183,160,114.4,330,178,152,117.1
'34350, 청양군,'025003, 22세,2019,341,220,121,181.8,327,213,114,186.8
'34350, 청양군,'025004, 23세,2019,334,214,120,178.3,301,198,103,192.2
'34350, 청양군,'025005, 24세,2019,303,175,128,136.7,270,159,111,143.2
'34350, 청양군,'030,25~29세,2019,1272,745,527,141.4,1086,651,435,149.7
'34350, 청양군,'030001, 25세,2019,283,176,107,164.5,245,153,92,166.3
'34350, 청양군,'030002, 26세,2019,253,149,104,143.3,218,132,86,153.5
'34350, 청양군,'030003, 27세,2019,263,153,110,139.1,225,131,94,139.4
'34350, 청양군,'030004, 28세,2019,245,139,106,131.1,204,116,88,131.8
'34350, 청양군,'030005, 29세,2019,228,128,100,128,194,119,75,158.7
'34350, 청양군,'035,30~34세,2019,1131,645,486,132.7,955,553,402,137.6
'34350, 청양군,'035001, 30세,2019,227,134,93,144.1,192,115,77,149.4
'34350, 청양군,'035002, 31세,2019,236,139,97,143.3,194,118,76,155.3
'34350, 청양군,'035003, 32세,2019,249,138,111,124.3,207,119,88,135.2
'34350, 청양군,'035004, 33세,2019,212,122,90,135.6,190,108,82,131.7
'34350, 청양군,'035005, 34세,2019,207,112,95,117.9,172,93,79,117.7
'34350, 청양군,'040,35~39세,2019,1197,685,512,133.8,1103,640,463,138.2
'34350, 청양군,'040001, 35세,2019,232,143,89,160.7,213,133,80,166.3
'34350, 청양군,'040002, 36세,2019,237,122,115,106.1,210,108,102,105.9
'34350, 청양군,'040003, 37세,2019,238,135,103,131.1,221,125,96,130.2
'34350, 청양군,'040004, 38세,2019,257,153,104,147.1,241,149,92,162
'34350, 청양군,'040005, 39세,2019,233,132,101,130.7,218,125,93,134.4
'34350, 청양군,'045,40~44세,2019,1369,792,577,137.3,1291,751,540,139.1
'34350, 청양군,'045001, 40세,2019,263,149,114,130.7,239,137,102,134.3
'34350, 청양군,'045002, 41세,2019,227,135,92,146.7,217,128,89,143.8
'34350, 청양군,'045003, 42세,2019,271,149,122,122.1,258,144,114,126.3
'34350, 청양군,'045004, 43세,2019,305,190,115,165.2,284,177,107,165.4
'34350, 청양군,'045005, 44세,2019,303,169,134,126.1,293,165,128,128.9
'34350, 청양군,'050,45~49세,2019,1863,1078,785,137.3,1804,1053,751,140.2
'34350, 청양군,'050001, 45세,2019,313,186,127,146.5,306,182,124,146.8
'34350, 청양군,'050002, 46세,2019,364,213,151,141.1,351,207,144,143.8
'34350, 청양군,'050003, 47세,2019,378,209,169,123.7,365,205,160,128.1
'34350, 청양군,'050004, 48세,2019,399,236,163,144.8,386,232,154,150.6
'34350, 청양군,'050005, 49세,2019,409,234,175,133.7,396,227,169,134.3
'34350, 청양군,'055,50~54세,2019,2336,1311,1025,127.9,2257,1273,984,129.4
'34350, 청양군,'055001, 50세,2019,459,261,198,131.8,437,250,187,133.7
'34350, 청양군,'055002, 51세,2019,481,271,210,129,461,260,201,129.4
'34350, 청양군,'055003, 52세,2019,424,234,190,123.2,405,223,182,122.5
'34350, 청양군,'055004, 53세,2019,430,246,184,133.7,420,241,179,134.6
'34350, 청양군,'055005, 54세,2019,542,299,243,123,534,299,235,127.2
'34350, 청양군,'060,55~59세,2019,3049,1583,1466,108,2987,1558,1429,109
'34350, 청양군,'060001, 55세,2019,500,264,236,111.9,484,257,227,113.2
'34350, 청양군,'060002, 56세,2019,475,239,236,101.3,463,235,228,103.1
'34350, 청양군,'060003, 57세,2019,609,308,301,102.3,595,301,294,102.4
'34350, 청양군,'060004, 58세,2019,729,371,358,103.6,721,369,352,104.8
'34350, 청양군,'060005, 59세,2019,736,401,335,119.7,724,396,328,120.7
'34350, 청양군,'065,60~64세,2019,3121,1532,1589,96.4,3092,1519,1573,96.6
'34350, 청양군,'065001, 60세,2019,641,312,329,94.8,633,307,326,94.2
'34350, 청양군,'065002, 61세,2019,589,284,305,93.1,584,280,304,92.1
'34350, 청양군,'065003, 62세,2019,631,315,316,99.7,625,313,312,100.3
'34350, 청양군,'065004, 63세,2019,589,285,304,93.8,583,284,299,95
'34350, 청양군,'065005, 64세,2019,671,336,335,100.3,667,335,332,100.9
'34350, 청양군,'070,65~69세,2019,2505,1302,1203,108.2,2492,1293,1199,107.8
'34350, 청양군,'070001, 65세,2019,561,292,269,108.6,558,290,268,108.2
'34350, 청양군,'070002, 66세,2019,472,254,218,116.5,467,250,217,115.2
'34350, 청양군,'070003, 67세,2019,503,249,254,98,502,249,253,98.4
'34350, 청양군,'070004, 68세,2019,437,239,198,120.7,436,238,198,120.2
'34350, 청양군,'070005, 69세,2019,532,268,264,101.5,529,266,263,101.1
'34350, 청양군,'075,70~74세,2019,2151,1039,1112,93.4,2141,1035,1106,93.6
'34350, 청양군,'075001, 70세,2019,517,256,261,98.1,515,255,260,98.1
'34350, 청양군,'075002, 71세,2019,502,247,255,96.9,501,247,254,97.2
'34350, 청양군,'075003, 72세,2019,419,189,230,82.2,416,188,228,82.5
'34350, 청양군,'075004, 73세,2019,346,169,177,95.5,344,168,176,95.5
'34350, 청양군,'075005, 74세,2019,367,178,189,94.2,365,177,188,94.1
'34350, 청양군,'080,75~79세,2019,2201,871,1330,65.5,2195,867,1328,65.3
'34350, 청양군,'080001, 75세,2019,407,158,249,63.5,406,157,249,63.1
'34350, 청양군,'080002, 76세,2019,396,164,232,70.7,395,163,232,70.3
'34350, 청양군,'080003, 77세,2019,556,225,331,68,556,225,331,68
'34350, 청양군,'080004, 78세,2019,437,184,253,72.7,434,182,252,72.2
'34350, 청양군,'080005, 79세,2019,405,140,265,52.8,404,140,264,53
'34350, 청양군,'085,80~84세,2019,2030,753,1277,59,2029,753,1276,59
'34350, 청양군,'085001, 80세,2019,457,188,269,69.9,457,188,269,69.9
'34350, 청양군,'085002, 81세,2019,396,150,246,61,396,150,246,61
'34350, 청양군,'085003, 82세,2019,409,137,272,50.4,409,137,272,50.4
'34350, 청양군,'085004, 83세,2019,401,156,245,63.7,401,156,245,63.7
'34350, 청양군,'085005, 84세,2019,367,122,245,49.8,366,122,244,50
'34350, 청양군,'086,85세이상,2019,1411,477,934,51.1,1411,477,934,51.1
'34350, 청양군,'090,85~89세,2019,1048,381,667,57.1,1048,381,667,57.1
'34350, 청양군,'090001, 85세,2019,311,121,190,63.7,311,121,190,63.7
'34350, 청양군,'090002, 86세,2019,241,100,141,70.9,241,100,141,70.9
'34350, 청양군,'090003, 87세,2019,234,77,157,49,234,77,157,49
'34350, 청양군,'090004, 88세,2019,144,41,103,39.8,144,41,103,39.8
'34350, 청양군,'090005, 89세,2019,118,42,76,55.3,118,42,76,55.3
'34350, 청양군,'095,90~94세,2019,304,79,225,35.1,304,79,225,35.1
'34350, 청양군,'095001, 90세,2019,104,28,76,36.8,104,28,76,36.8
'34350, 청양군,'095002, 91세,2019,74,17,57,29.8,74,17,57,29.8
'34350, 청양군,'095003, 92세,2019,48,9,39,23.1,48,9,39,23.1
'34350, 청양군,'095004, 93세,2019,44,11,33,33.3,44,11,33,33.3
'34350, 청양군,'095005, 94세,2019,34,14,20,70,34,14,20,70
'34350, 청양군,'100,95~99세,2019,51,16,35,45.7,51,16,35,45.7
'34350, 청양군,'100001, 95세,2019,18,5,13,38.5,18,5,13,38.5
'34350, 청양군,'100002, 96세,2019,10,X,7,42.9,10,X,7,42.9
'34350, 청양군,'100003, 97세,2019,16,5,11,45.5,16,5,11,45.5
'34350, 청양군,'100004, 98세,2019,X,X,X,,X,X,X,
'34350, 청양군,'100005, 99세,2019,5,X,X,25,5,X,X,25
'34350, 청양군,'101,100세이상,2019,8,X,7,14.3,8,X,7,14.3
'34350, 청양군,'102,15세미만,2019,2133,1096,1037,105.7,2131,1096,1035,105.9
'34350, 청양군,'103,15~64세,2019,18352,10062,8290,121.4,17486,9641,7845,122.9
'34350, 청양군,'104,65세이상,2019,10298,4442,5856,75.9,10268,4425,5843,75.7
'34350, 청양군,'126,평균연령,2019,52.8,50.4,55.2,,53.2,50.8,55.7,
'34350, 청양군,'127,중위연령,2019,57.2,54.2,59.6,,57.8,54.7,60.2,
'34360, 홍성군,'000,합계,2019,102791,51530,51261,100.5,99198,49116,50082,98.1
'34360, 홍성군,'005,0~4세,2019,3597,1852,1745,106.1,3556,1825,1731,105.4
'34360, 홍성군,'005001, 0세,2019,617,330,287,115,610,325,285,114
'34360, 홍성군,'005002, 1세,2019,646,323,323,100,641,321,320,100.3
'34360, 홍성군,'005003, 2세,2019,739,373,366,101.9,728,368,360,102.2
'34360, 홍성군,'005004, 3세,2019,746,385,361,106.6,736,377,359,105
'34360, 홍성군,'005005, 4세,2019,849,441,408,108.1,841,434,407,106.6
'34360, 홍성군,'010,5~9세,2019,4486,2344,2142,109.4,4454,2325,2129,109.2
'34360, 홍성군,'010001, 5세,2019,819,442,377,117.2,806,433,373,116.1
'34360, 홍성군,'010002, 6세,2019,850,442,408,108.3,845,439,406,108.1
'34360, 홍성군,'010003, 7세,2019,944,503,441,114.1,938,500,438,114.2
'34360, 홍성군,'010004, 8세,2019,923,479,444,107.9,919,477,442,107.9
'34360, 홍성군,'010005, 9세,2019,950,478,472,101.3,946,476,470,101.3
'34360, 홍성군,'015,10~14세,2019,4606,2339,2267,103.2,4584,2324,2260,102.8
'34360, 홍성군,'015001, 10세,2019,947,478,469,101.9,939,472,467,101.1
'34360, 홍성군,'015002, 11세,2019,953,482,471,102.3,949,480,469,102.3
'34360, 홍성군,'015003, 12세,2019,985,488,497,98.2,980,485,495,98
'34360, 홍성군,'015004, 13세,2019,882,470,412,114.1,879,468,411,113.9
'34360, 홍성군,'015005, 14세,2019,839,421,418,100.7,837,419,418,100.2
'34360, 홍성군,'020,15~19세,2019,6005,3008,2997,100.4,5963,2988,2975,100.4
'34360, 홍성군,'020001, 15세,2019,1022,515,507,101.6,1015,511,504,101.4
'34360, 홍성군,'020002, 16세,2019,1097,553,544,101.7,1094,551,543,101.5
'34360, 홍성군,'020003, 17세,2019,988,493,495,99.6,984,491,493,99.6
'34360, 홍성군,'020004, 18세,2019,1269,663,606,109.4,1261,660,601,109.8
'34360, 홍성군,'020005, 19세,2019,1629,784,845,92.8,1609,775,834,92.9
'34360, 홍성군,'025,20~24세,2019,6515,3465,3050,113.6,6109,3186,2923,109
'34360, 홍성군,'025001, 20세,2019,1419,644,775,83.1,1391,632,759,83.3
'34360, 홍성군,'025002, 21세,2019,1337,625,712,87.8,1285,598,687,87
'34360, 홍성군,'025003, 22세,2019,1360,722,638,113.2,1289,670,619,108.2
'34360, 홍성군,'025004, 23세,2019,1209,722,487,148.3,1102,639,463,138
'34360, 홍성군,'025005, 24세,2019,1190,752,438,171.7,1042,647,395,163.8
'34360, 홍성군,'030,25~29세,2019,5252,3027,2225,136,4492,2464,2028,121.5
'34360, 홍성군,'030001, 25세,2019,1083,679,404,168.1,934,563,371,151.8
'34360, 홍성군,'030002, 26세,2019,1030,592,438,135.2,868,468,400,117
'34360, 홍성군,'030003, 27세,2019,1056,588,468,125.6,909,487,422,115.4
'34360, 홍성군,'030004, 28세,2019,1045,590,455,129.7,887,478,409,116.9
'34360, 홍성군,'030005, 29세,2019,1038,578,460,125.7,894,468,426,109.9
'34360, 홍성군,'035,30~34세,2019,5186,2896,2290,126.5,4524,2398,2126,112.8
'34360, 홍성군,'035001, 30세,2019,950,536,414,129.5,822,442,380,116.3
'34360, 홍성군,'035002, 31세,2019,1003,555,448,123.9,874,457,417,109.6
'34360, 홍성군,'035003, 32세,2019,1029,562,467,120.3,885,449,436,103
'34360, 홍성군,'035004, 33세,2019,1061,604,457,132.2,931,514,417,123.3
'34360, 홍성군,'035005, 34세,2019,1143,639,504,126.8,1012,536,476,112.6
'34360, 홍성군,'040,35~39세,2019,6663,3466,3197,108.4,6185,3141,3044,103.2
'34360, 홍성군,'040001, 35세,2019,1159,600,559,107.3,1059,530,529,100.2
'34360, 홍성군,'040002, 36세,2019,1228,685,543,126.2,1140,615,525,117.1
'34360, 홍성군,'040003, 37세,2019,1414,681,733,92.9,1310,613,697,87.9
'34360, 홍성군,'040004, 38세,2019,1405,738,667,110.6,1309,680,629,108.1
'34360, 홍성군,'040005, 39세,2019,1457,762,695,109.6,1367,703,664,105.9
'34360, 홍성군,'045,40~44세,2019,6777,3484,3293,105.8,6482,3280,3202,102.4
'34360, 홍성군,'045001, 40세,2019,1355,692,663,104.4,1288,645,643,100.3
'34360, 홍성군,'045002, 41세,2019,1307,674,633,106.5,1244,630,614,102.6
'34360, 홍성군,'045003, 42세,2019,1326,706,620,113.9,1264,660,604,109.3
'34360, 홍성군,'045004, 43세,2019,1299,658,641,102.7,1246,625,621,100.6
'34360, 홍성군,'045005, 44세,2019,1490,754,736,102.4,1440,720,720,100
'34360, 홍성군,'050,45~49세,2019,7833,4240,3593,118,7566,4061,3505,115.9
'34360, 홍성군,'050001, 45세,2019,1584,852,732,116.4,1522,812,710,114.4
'34360, 홍성군,'050002, 46세,2019,1545,821,724,113.4,1500,791,709,111.6
'34360, 홍성군,'050003, 47세,2019,1565,870,695,125.2,1508,828,680,121.8
'34360, 홍성군,'050004, 48세,2019,1598,868,730,118.9,1542,831,711,116.9
'34360, 홍성군,'050005, 49세,2019,1541,829,712,116.4,1494,799,695,115
'34360, 홍성군,'055,50~54세,2019,7574,3973,3601,110.3,7360,3864,3496,110.5
'34360, 홍성군,'055001, 50세,2019,1587,859,728,118,1545,840,705,119.1
'34360, 홍성군,'055002, 51세,2019,1627,874,753,116.1,1579,848,731,116
'34360, 홍성군,'055003, 52세,2019,1472,750,722,103.9,1434,731,703,104
'34360, 홍성군,'055004, 53세,2019,1291,663,628,105.6,1251,641,610,105.1
'34360, 홍성군,'055005, 54세,2019,1597,827,770,107.4,1551,804,747,107.6
'34360, 홍성군,'060,55~59세,2019,8395,4240,4155,102,8229,4158,4071,102.1
'34360, 홍성군,'060001, 55세,2019,1418,721,697,103.4,1390,708,682,103.8
'34360, 홍성군,'060002, 56세,2019,1587,823,764,107.7,1542,802,740,108.4
'34360, 홍성군,'060003, 57세,2019,1675,864,811,106.5,1630,843,787,107.1
'34360, 홍성군,'060004, 58세,2019,1842,927,915,101.3,1823,917,906,101.2
'34360, 홍성군,'060005, 59세,2019,1873,905,968,93.5,1844,888,956,92.9
'34360, 홍성군,'065,60~64세,2019,7586,3809,3777,100.8,7473,3755,3718,101
'34360, 홍성군,'065001, 60세,2019,1561,822,739,111.2,1540,814,726,112.1
'34360, 홍성군,'065002, 61세,2019,1493,734,759,96.7,1465,723,742,97.4
'34360, 홍성군,'065003, 62세,2019,1505,776,729,106.4,1475,760,715,106.3
'34360, 홍성군,'065004, 63세,2019,1447,706,741,95.3,1428,697,731,95.3
'34360, 홍성군,'065005, 64세,2019,1580,771,809,95.3,1565,761,804,94.7
'34360, 홍성군,'070,65~69세,2019,5920,2803,3117,89.9,5866,2779,3087,90
'34360, 홍성군,'070001, 65세,2019,1362,667,695,96,1345,662,683,96.9
'34360, 홍성군,'070002, 66세,2019,1064,518,546,94.9,1056,514,542,94.8
'34360, 홍성군,'070003, 67세,2019,1245,578,667,86.7,1234,573,661,86.7
'34360, 홍성군,'070004, 68세,2019,1109,530,579,91.5,1097,523,574,91.1
'34360, 홍성군,'070005, 69세,2019,1140,510,630,81,1134,507,627,80.9
'34360, 홍성군,'075,70~74세,2019,4932,2401,2531,94.9,4914,2393,2521,94.9
'34360, 홍성군,'075001, 70세,2019,1265,628,637,98.6,1259,625,634,98.6
'34360, 홍성군,'075002, 71세,2019,1097,529,568,93.1,1095,528,567,93.1
'34360, 홍성군,'075003, 72세,2019,1047,502,545,92.1,1044,500,544,91.9
'34360, 홍성군,'075004, 73세,2019,791,404,387,104.4,786,402,384,104.7
'34360, 홍성군,'075005, 74세,2019,732,338,394,85.8,730,338,392,86.2
'34360, 홍성군,'080,75~79세,2019,4689,1887,2802,67.3,4678,1883,2795,67.4
'34360, 홍성군,'080001, 75세,2019,913,383,530,72.3,911,383,528,72.5
'34360, 홍성군,'080002, 76세,2019,931,386,545,70.8,930,386,544,71
'34360, 홍성군,'080003, 77세,2019,1195,477,718,66.4,1192,475,717,66.2
'34360, 홍성군,'080004, 78세,2019,871,341,530,64.3,868,340,528,64.4
'34360, 홍성군,'080005, 79세,2019,779,300,479,62.6,777,299,478,62.6
'34360, 홍성군,'085,80~84세,2019,4022,1488,2534,58.7,4015,1486,2529,58.8
'34360, 홍성군,'085001, 80세,2019,906,347,559,62.1,906,347,559,62.1
'34360, 홍성군,'085002, 81세,2019,882,321,561,57.2,881,320,561,57
'34360, 홍성군,'085003, 82세,2019,733,275,458,60,729,275,454,60.6
'34360, 홍성군,'085004, 83세,2019,823,308,515,59.8,822,308,514,59.9
'34360, 홍성군,'085005, 84세,2019,678,237,441,53.7,677,236,441,53.5
'34360, 홍성군,'086,85세이상,2019,2753,808,1945,41.5,2748,806,1942,41.5
'34360, 홍성군,'090,85~89세,2019,1988,630,1358,46.4,1987,629,1358,46.3
'34360, 홍성군,'090001, 85세,2019,561,206,355,58,561,206,355,58
'34360, 홍성군,'090002, 86세,2019,463,132,331,39.9,462,131,331,39.6
'34360, 홍성군,'090003, 87세,2019,441,141,300,47,441,141,300,47
'34360, 홍성군,'090004, 88세,2019,280,80,200,40,280,80,200,40
'34360, 홍성군,'090005, 89세,2019,243,71,172,41.3,243,71,172,41.3
'34360, 홍성군,'095,90~94세,2019,599,151,448,33.7,597,150,447,33.6
'34360, 홍성군,'095001, 90세,2019,215,55,160,34.4,215,55,160,34.4
'34360, 홍성군,'095002, 91세,2019,149,36,113,31.9,147,35,112,31.3
'34360, 홍성군,'095003, 92세,2019,99,23,76,30.3,99,23,76,30.3
'34360, 홍성군,'095004, 93세,2019,80,20,60,33.3,80,20,60,33.3
'34360, 홍성군,'095005, 94세,2019,56,17,39,43.6,56,17,39,43.6
'34360, 홍성군,'100,95~99세,2019,145,26,119,21.8,143,26,117,22.2
'34360, 홍성군,'100001, 95세,2019,42,6,36,16.7,42,6,36,16.7
'34360, 홍성군,'100002, 96세,2019,52,10,42,23.8,51,10,41,24.4
'34360, 홍성군,'100003, 97세,2019,34,7,27,25.9,34,7,27,25.9
'34360, 홍성군,'100004, 98세,2019,11,X,9,22.2,11,X,9,22.2
'34360, 홍성군,'100005, 99세,2019,6,X,5,20,5,X,X,25
'34360, 홍성군,'101,100세이상,2019,21,X,20,5,21,X,20,5
'34360, 홍성군,'102,15세미만,2019,12689,6535,6154,106.2,12594,6474,6120,105.8
'34360, 홍성군,'103,15~64세,2019,67786,35608,32178,110.7,64383,33295,31088,107.1
'34360, 홍성군,'104,65세이상,2019,22316,9387,12929,72.6,22221,9347,12874,72.6
'34360, 홍성군,'126,평균연령,2019,45,43.3,46.7,,45.3,43.7,46.9,
'34360, 홍성군,'127,중위연령,2019,46.5,44.8,48.4,,47.2,45.8,48.7,
'34370, 예산군,'000,합계,2019,78963,40300,38663,104.2,75571,37989,37582,101.1
'34370, 예산군,'005,0~4세,2019,1580,812,768,105.7,1555,796,759,104.9
'34370, 예산군,'005001, 0세,2019,287,140,147,95.2,286,139,147,94.6
'34370, 예산군,'005002, 1세,2019,283,137,146,93.8,275,131,144,91
'34370, 예산군,'005003, 2세,2019,300,152,148,102.7,291,147,144,102.1
'34370, 예산군,'005004, 3세,2019,330,172,158,108.9,327,171,156,109.6
'34370, 예산군,'005005, 4세,2019,380,211,169,124.9,376,208,168,123.8
'34370, 예산군,'010,5~9세,2019,2290,1177,1113,105.8,2268,1165,1103,105.6
'34370, 예산군,'010001, 5세,2019,393,195,198,98.5,389,192,197,97.5
'34370, 예산군,'010002, 6세,2019,430,210,220,95.5,426,208,218,95.4
'34370, 예산군,'010003, 7세,2019,483,261,222,117.6,479,258,221,116.7
'34370, 예산군,'010004, 8세,2019,496,265,231,114.7,490,263,227,115.9
'34370, 예산군,'010005, 9세,2019,488,246,242,101.7,484,244,240,101.7
'34370, 예산군,'015,10~14세,2019,2560,1315,1245,105.6,2541,1308,1233,106.1
'34370, 예산군,'015001, 10세,2019,464,247,217,113.8,458,244,214,114
'34370, 예산군,'015002, 11세,2019,484,246,238,103.4,483,246,237,103.8
'34370, 예산군,'015003, 12세,2019,596,318,278,114.4,592,316,276,114.5
'34370, 예산군,'015004, 13세,2019,507,241,266,90.6,504,240,264,90.9
'34370, 예산군,'015005, 14세,2019,509,263,246,106.9,504,262,242,108.3
'34370, 예산군,'020,15~19세,2019,3428,1828,1600,114.3,3404,1817,1587,114.5
'34370, 예산군,'020001, 15세,2019,540,286,254,112.6,537,285,252,113.1
'34370, 예산군,'020002, 16세,2019,671,342,329,104,667,341,326,104.6
'34370, 예산군,'020003, 17세,2019,740,402,338,118.9,738,401,337,119
'34370, 예산군,'020004, 18세,2019,722,397,325,122.2,719,395,324,121.9
'34370, 예산군,'020005, 19세,2019,755,401,354,113.3,743,395,348,113.5
'34370, 예산군,'025,20~24세,2019,4044,2313,1731,133.6,3729,2089,1640,127.4
'34370, 예산군,'025001, 20세,2019,791,437,354,123.4,771,421,350,120.3
'34370, 예산군,'025002, 21세,2019,795,434,361,120.2,760,409,351,116.5
'34370, 예산군,'025003, 22세,2019,781,431,350,123.1,726,393,333,118
'34370, 예산군,'025004, 23세,2019,839,496,343,144.6,742,429,313,137.1
'34370, 예산군,'025005, 24세,2019,838,515,323,159.4,730,437,293,149.1
'34370, 예산군,'030,25~29세,2019,3793,2342,1451,161.4,3131,1834,1297,141.4
'34370, 예산군,'030001, 25세,2019,748,469,279,168.1,639,379,260,145.8
'34370, 예산군,'030002, 26세,2019,793,468,325,144,662,367,295,124.4
'34370, 예산군,'030003, 27세,2019,752,464,288,161.1,634,380,254,149.6
'34370, 예산군,'030004, 28세,2019,763,473,290,163.1,611,354,257,137.7
'34370, 예산군,'030005, 29세,2019,737,468,269,174,585,354,231,153.2
'34370, 예산군,'035,30~34세,2019,3350,2003,1347,148.7,2680,1518,1162,130.6
'34370, 예산군,'035001, 30세,2019,654,405,249,162.7,514,310,204,152
'34370, 예산군,'035002, 31세,2019,639,390,249,156.6,514,293,221,132.6
'34370, 예산군,'035003, 32세,2019,708,414,294,140.8,552,298,254,117.3
'34370, 예산군,'035004, 33세,2019,652,390,262,148.9,529,304,225,135.1
'34370, 예산군,'035005, 34세,2019,697,404,293,137.9,571,313,258,121.3
'34370, 예산군,'040,35~39세,2019,3987,2284,1703,134.1,3476,1917,1559,123
'34370, 예산군,'040001, 35세,2019,735,432,303,142.6,605,335,270,124.1
'34370, 예산군,'040002, 36세,2019,742,442,300,147.3,637,364,273,133.3
'34370, 예산군,'040003, 37세,2019,827,466,361,129.1,715,389,326,119.3
'34370, 예산군,'040004, 38세,2019,803,458,345,132.8,722,403,319,126.3
'34370, 예산군,'040005, 39세,2019,880,486,394,123.4,797,426,371,114.8
'34370, 예산군,'045,40~44세,2019,4278,2375,1903,124.8,3952,2162,1790,120.8
'34370, 예산군,'045001, 40세,2019,806,429,377,113.8,743,386,357,108.1
'34370, 예산군,'045002, 41세,2019,779,435,344,126.5,703,385,318,121.1
'34370, 예산군,'045003, 42세,2019,842,482,360,133.9,770,433,337,128.5
'34370, 예산군,'045004, 43세,2019,916,509,407,125.1,856,473,383,123.5
'34370, 예산군,'045005, 44세,2019,935,520,415,125.3,880,485,395,122.8
'34370, 예산군,'050,45~49세,2019,5676,3183,2493,127.7,5395,3007,2388,125.9
'34370, 예산군,'050001, 45세,2019,1089,572,517,110.6,1039,541,498,108.6
'34370, 예산군,'050002, 46세,2019,1173,680,493,137.9,1119,647,472,137.1
'34370, 예산군,'050003, 47세,2019,1085,623,462,134.8,1024,583,441,132.2
'34370, 예산군,'050004, 48세,2019,1162,657,505,130.1,1101,619,482,128.4
'34370, 예산군,'050005, 49세,2019,1167,651,516,126.2,1112,617,495,124.6
'34370, 예산군,'055,50~54세,2019,6239,3372,2867,117.6,6009,3236,2773,116.7
'34370, 예산군,'055001, 50세,2019,1303,729,574,127,1244,692,552,125.4
'34370, 예산군,'055002, 51세,2019,1315,712,603,118.1,1267,682,585,116.6
'34370, 예산군,'055003, 52세,2019,1147,636,511,124.5,1111,614,497,123.5
'34370, 예산군,'055004, 53세,2019,1113,587,526,111.6,1071,557,514,108.4
'34370, 예산군,'055005, 54세,2019,1361,708,653,108.4,1316,691,625,110.6
'34370, 예산군,'060,55~59세,2019,7638,3861,3777,102.2,7474,3766,3708,101.6
'34370, 예산군,'060001, 55세,2019,1235,660,575,114.8,1198,640,558,114.7
'34370, 예산군,'060002, 56세,2019,1278,661,617,107.1,1233,637,596,106.9
'34370, 예산군,'060003, 57세,2019,1508,778,730,106.6,1467,751,716,104.9
'34370, 예산군,'060004, 58세,2019,1838,933,905,103.1,1819,920,899,102.3
'34370, 예산군,'060005, 59세,2019,1779,829,950,87.3,1757,818,939,87.1
'34370, 예산군,'065,60~64세,2019,7430,3727,3703,100.6,7346,3688,3658,100.8
'34370, 예산군,'065001, 60세,2019,1487,726,761,95.4,1470,721,749,96.3
'34370, 예산군,'065002, 61세,2019,1445,710,735,96.6,1419,695,724,96
'34370, 예산군,'065003, 62세,2019,1504,767,737,104.1,1489,758,731,103.7
'34370, 예산군,'065004, 63세,2019,1437,752,685,109.8,1420,746,674,110.7
'34370, 예산군,'065005, 64세,2019,1557,772,785,98.3,1548,768,780,98.5
'34370, 예산군,'070,65~69세,2019,6001,2873,3128,91.8,5978,2860,3118,91.7
'34370, 예산군,'070001, 65세,2019,1360,667,693,96.2,1350,663,687,96.5
'34370, 예산군,'070002, 66세,2019,1108,551,557,98.9,1105,548,557,98.4
'34370, 예산군,'070003, 67세,2019,1299,626,673,93,1295,625,670,93.3
'34370, 예산군,'070004, 68세,2019,1024,453,571,79.3,1021,450,571,78.8
'34370, 예산군,'070005, 69세,2019,1210,576,634,90.9,1207,574,633,90.7
'34370, 예산군,'075,70~74세,2019,4921,2360,2561,92.2,4901,2354,2547,92.4
'34370, 예산군,'075001, 70세,2019,1167,581,586,99.1,1163,579,584,99.1
'34370, 예산군,'075002, 71세,2019,1120,537,583,92.1,1119,537,582,92.3
'34370, 예산군,'075003, 72세,2019,1100,542,558,97.1,1097,542,555,97.7
'34370, 예산군,'075004, 73세,2019,763,383,380,100.8,759,383,376,101.9
'34370, 예산군,'075005, 74세,2019,771,317,454,69.8,763,313,450,69.6
'34370, 예산군,'080,75~79세,2019,4924,2103,2821,74.5,4915,2101,2814,74.7
'34370, 예산군,'080001, 75세,2019,933,408,525,77.7,930,407,523,77.8
'34370, 예산군,'080002, 76세,2019,932,423,509,83.1,931,422,509,82.9
'34370, 예산군,'080003, 77세,2019,1278,527,751,70.2,1278,527,751,70.2
'34370, 예산군,'080004, 78세,2019,933,384,549,69.9,930,384,546,70.3
'34370, 예산군,'080005, 79세,2019,848,361,487,74.1,846,361,485,74.4
'34370, 예산군,'085,80~84세,2019,4088,1556,2532,61.5,4083,1555,2528,61.5
'34370, 예산군,'085001, 80세,2019,930,359,571,62.9,929,359,570,63
'34370, 예산군,'085002, 81세,2019,885,331,554,59.7,883,331,552,60
'34370, 예산군,'085003, 82세,2019,825,331,494,67,823,330,493,66.9
'34370, 예산군,'085004, 83세,2019,773,293,480,61,773,293,480,61
'34370, 예산군,'085005, 84세,2019,675,242,433,55.9,675,242,433,55.9
'34370, 예산군,'086,85세이상,2019,2736,816,1920,42.5,2734,816,1918,42.5
'34370, 예산군,'090,85~89세,2019,2029,648,1381,46.9,2027,648,1379,47
'34370, 예산군,'090001, 85세,2019,606,222,384,57.8,606,222,384,57.8
'34370, 예산군,'090002, 86세,2019,499,161,338,47.6,498,161,337,47.8
'34370, 예산군,'090003, 87세,2019,409,129,280,46.1,409,129,280,46.1
'34370, 예산군,'090004, 88세,2019,285,83,202,41.1,285,83,202,41.1
'34370, 예산군,'090005, 89세,2019,230,53,177,29.9,229,53,176,30.1
'34370, 예산군,'095,90~94세,2019,566,150,416,36.1,566,150,416,36.1
'34370, 예산군,'095001, 90세,2019,190,54,136,39.7,190,54,136,39.7
'34370, 예산군,'095002, 91세,2019,145,27,118,22.9,145,27,118,22.9
'34370, 예산군,'095003, 92세,2019,109,40,69,58,109,40,69,58
'34370, 예산군,'095004, 93세,2019,65,16,49,32.7,65,16,49,32.7
'34370, 예산군,'095005, 94세,2019,57,13,44,29.5,57,13,44,29.5
'34370, 예산군,'100,95~99세,2019,126,17,109,15.6,126,17,109,15.6
'34370, 예산군,'100001, 95세,2019,32,X,29,10.3,32,X,29,10.3
'34370, 예산군,'100002, 96세,2019,41,8,33,24.2,41,8,33,24.2
'34370, 예산군,'100003, 97세,2019,20,X,20,0,20,X,20,0
'34370, 예산군,'100004, 98세,2019,24,6,18,33.3,24,6,18,33.3
'34370, 예산군,'100005, 99세,2019,9,X,9,0,9,X,9,0
'34370, 예산군,'101,100세이상,2019,15,X,14,7.1,15,X,14,7.1
'34370, 예산군,'102,15세미만,2019,6430,3304,3126,105.7,6364,3269,3095,105.6
'34370, 예산군,'103,15~64세,2019,49863,27288,22575,120.9,46596,25034,21562,116.1
'34370, 예산군,'104,65세이상,2019,22670,9708,12962,74.9,22611,9686,12925,74.9
'34370, 예산군,'126,평균연령,2019,50.3,48.1,52.6,,50.9,48.9,53,
'34370, 예산군,'127,중위연령,2019,53.7,50.7,56.9,,54.7,52,57.5,
'34380, 태안군,'000,합계,2019,60896,31367,29529,106.2,58929,29988,28941,103.6
'34380, 태안군,'005,0~4세,2019,1385,703,682,103.1,1379,698,681,102.5
'34380, 태안군,'005001, 0세,2019,232,116,116,100,232,116,116,100
'34380, 태안군,'005002, 1세,2019,249,124,125,99.2,248,124,124,100
'34380, 태안군,'005003, 2세,2019,253,131,122,107.4,252,130,122,106.6
'34380, 태안군,'005004, 3세,2019,327,165,162,101.9,324,162,162,100
'34380, 태안군,'005005, 4세,2019,324,167,157,106.4,323,166,157,105.7
'34380, 태안군,'010,5~9세,2019,1856,938,918,102.2,1852,935,917,102
'34380, 태안군,'010001, 5세,2019,328,154,174,88.5,327,153,174,87.9
'34380, 태안군,'010002, 6세,2019,388,195,193,101,388,195,193,101
'34380, 태안군,'010003, 7세,2019,399,192,207,92.8,398,191,207,92.3
'34380, 태안군,'010004, 8세,2019,395,210,185,113.5,395,210,185,113.5
'34380, 태안군,'010005, 9세,2019,346,187,159,117.6,344,186,158,117.7
'34380, 태안군,'015,10~14세,2019,2112,1079,1033,104.5,2110,1077,1033,104.3
'34380, 태안군,'015001, 10세,2019,398,216,182,118.7,397,215,182,118.1
'34380, 태안군,'015002, 11세,2019,451,229,222,103.2,451,229,222,103.2
'34380, 태안군,'015003, 12세,2019,428,221,207,106.8,428,221,207,106.8
'34380, 태안군,'015004, 13세,2019,420,217,203,106.9,419,216,203,106.4
'34380, 태안군,'015005, 14세,2019,415,196,219,89.5,415,196,219,89.5
'34380, 태안군,'020,15~19세,2019,2274,1224,1050,116.6,2264,1215,1049,115.8
'34380, 태안군,'020001, 15세,2019,406,198,208,95.2,405,198,207,95.7
'34380, 태안군,'020002, 16세,2019,424,196,228,86,421,193,228,84.6
'34380, 태안군,'020003, 17세,2019,431,198,233,85,429,196,233,84.1
'34380, 태안군,'020004, 18세,2019,479,259,220,117.7,477,257,220,116.8
'34380, 태안군,'020005, 19세,2019,534,373,161,231.7,532,371,161,230.4
'34380, 태안군,'025,20~24세,2019,2848,1911,937,203.9,2679,1799,880,204.4
'34380, 태안군,'025001, 20세,2019,505,345,160,215.6,489,335,154,217.5
'34380, 태안군,'025002, 21세,2019,516,349,167,209,492,334,158,211.4
'34380, 태안군,'025003, 22세,2019,614,414,200,207,577,390,187,208.6
'34380, 태안군,'025004, 23세,2019,576,381,195,195.4,534,353,181,195
'34380, 태안군,'025005, 24세,2019,637,422,215,196.3,587,387,200,193.5
'34380, 태안군,'030,25~29세,2019,2701,1697,1004,169,2319,1425,894,159.4
'34380, 태안군,'030001, 25세,2019,590,407,183,222.4,514,349,165,211.5
'34380, 태안군,'030002, 26세,2019,552,337,215,156.7,483,292,191,152.9
'34380, 태안군,'030003, 27세,2019,566,356,210,169.5,485,296,189,156.6
'34380, 태안군,'030004, 28세,2019,489,289,200,144.5,419,241,178,135.4
'34380, 태안군,'030005, 29세,2019,504,308,196,157.1,418,247,171,144.4
'34380, 태안군,'035,30~34세,2019,2563,1494,1069,139.8,2203,1239,964,128.5
'34380, 태안군,'035001, 30세,2019,509,296,213,139,441,250,191,130.9
'34380, 태안군,'035002, 31세,2019,500,292,208,140.4,424,237,187,126.7
'34380, 태안군,'035003, 32세,2019,519,296,223,132.7,447,244,203,120.2
'34380, 태안군,'035004, 33세,2019,510,317,193,164.2,433,258,175,147.4
'34380, 태안군,'035005, 34세,2019,525,293,232,126.3,458,250,208,120.2
'34380, 태안군,'040,35~39세,2019,3360,1918,1442,133,3040,1674,1366,122.5
'34380, 태안군,'040001, 35세,2019,559,318,241,132,488,265,223,118.8
'34380, 태안군,'040002, 36세,2019,632,371,261,142.1,561,319,242,131.8
'34380, 태안군,'040003, 37세,2019,706,382,324,117.9,643,331,312,106.1
'34380, 태안군,'040004, 38세,2019,672,394,278,141.7,613,350,263,133.1
'34380, 태안군,'040005, 39세,2019,791,453,338,134,735,409,326,125.5
'34380, 태안군,'045,40~44세,2019,3502,2046,1456,140.5,3268,1862,1406,132.4
'34380, 태안군,'045001, 40세,2019,663,395,268,147.4,605,348,257,135.4
'34380, 태안군,'045002, 41세,2019,713,420,293,143.3,652,371,281,132
'34380, 태안군,'045003, 42세,2019,694,403,291,138.5,653,373,280,133.2
'34380, 태안군,'045004, 43세,2019,703,408,295,138.3,675,386,289,133.6
'34380, 태안군,'045005, 44세,2019,729,420,309,135.9,683,384,299,128.4
'34380, 태안군,'050,45~49세,2019,4208,2408,1800,133.8,4020,2272,1748,130
'34380, 태안군,'050001, 45세,2019,813,439,374,117.4,778,411,367,112
'34380, 태안군,'050002, 46세,2019,864,503,361,139.3,823,473,350,135.1
'34380, 태안군,'050003, 47세,2019,815,484,331,146.2,771,454,317,143.2
'34380, 태안군,'050004, 48세,2019,848,495,353,140.2,809,466,343,135.9
'34380, 태안군,'050005, 49세,2019,868,487,381,127.8,839,468,371,126.1
'34380, 태안군,'055,50~54세,2019,4706,2475,2231,110.9,4616,2422,2194,110.4
'34380, 태안군,'055001, 50세,2019,928,496,432,114.8,910,485,425,114.1
'34380, 태안군,'055002, 51세,2019,943,493,450,109.6,923,478,445,107.4
'34380, 태안군,'055003, 52세,2019,899,479,420,114,875,467,408,114.5
'34380, 태안군,'055004, 53세,2019,898,451,447,100.9,882,443,439,100.9
'34380, 태안군,'055005, 54세,2019,1038,556,482,115.4,1026,549,477,115.1
'34380, 태안군,'060,55~59세,2019,5740,2903,2837,102.3,5662,2861,2801,102.1
'34380, 태안군,'060001, 55세,2019,955,487,468,104.1,938,474,464,102.2
'34380, 태안군,'060002, 56세,2019,1028,546,482,113.3,1007,537,470,114.3
'34380, 태안군,'060003, 57세,2019,1063,529,534,99.1,1050,522,528,98.9
'34380, 태안군,'060004, 58세,2019,1340,658,682,96.5,1331,652,679,96
'34380, 태안군,'060005, 59세,2019,1354,683,671,101.8,1336,676,660,102.4
'34380, 태안군,'065,60~64세,2019,5969,2814,3155,89.2,5907,2779,3128,88.8
'34380, 태안군,'065001, 60세,2019,1218,582,636,91.5,1203,572,631,90.6
'34380, 태안군,'065002, 61세,2019,1207,587,620,94.7,1194,580,614,94.5
'34380, 태안군,'065003, 62세,2019,1190,547,643,85.1,1177,541,636,85.1
'34380, 태안군,'065004, 63세,2019,1166,535,631,84.8,1153,528,625,84.5
'34380, 태안군,'065005, 64세,2019,1188,563,625,90.1,1180,558,622,89.7
'34380, 태안군,'070,65~69세,2019,4927,2424,2503,96.8,4889,2403,2486,96.7
'34380, 태안군,'070001, 65세,2019,1040,495,545,90.8,1034,493,541,91.1
'34380, 태안군,'070002, 66세,2019,949,444,505,87.9,940,441,499,88.4
'34380, 태안군,'070003, 67세,2019,1076,533,543,98.2,1066,526,540,97.4
'34380, 태안군,'070004, 68세,2019,855,421,434,97,848,416,432,96.3
'34380, 태안군,'070005, 69세,2019,1007,531,476,111.6,1001,527,474,111.2
'34380, 태안군,'075,70~74세,2019,4311,2144,2167,98.9,4300,2142,2158,99.3
'34380, 태안군,'075001, 70세,2019,1036,528,508,103.9,1030,528,502,105.2
'34380, 태안군,'075002, 71세,2019,942,439,503,87.3,940,437,503,86.9
'34380, 태안군,'075003, 72세,2019,956,483,473,102.1,956,483,473,102.1
'34380, 태안군,'075004, 73세,2019,683,365,318,114.8,681,365,316,115.5
'34380, 태안군,'075005, 74세,2019,694,329,365,90.1,693,329,364,90.4
'34380, 태안군,'080,75~79세,2019,3821,1638,2183,75,3815,1635,2180,75
'34380, 태안군,'080001, 75세,2019,798,370,428,86.4,796,369,427,86.4
'34380, 태안군,'080002, 76세,2019,788,327,461,70.9,787,326,461,70.7
'34380, 태안군,'080003, 77세,2019,980,426,554,76.9,978,426,552,77.2
'34380, 태안군,'080004, 78세,2019,658,270,388,69.6,657,269,388,69.3
'34380, 태안군,'080005, 79세,2019,597,245,352,69.6,597,245,352,69.6
'34380, 태안군,'085,80~84세,2019,2731,1027,1704,60.3,2726,1026,1700,60.4
'34380, 태안군,'085001, 80세,2019,665,259,406,63.8,663,259,404,64.1
'34380, 태안군,'085002, 81세,2019,571,229,342,67,571,229,342,67
'34380, 태안군,'085003, 82세,2019,509,211,298,70.8,507,210,297,70.7
'34380, 태안군,'085004, 83세,2019,523,186,337,55.2,523,186,337,55.2
'34380, 태안군,'085005, 84세,2019,463,142,321,44.2,462,142,320,44.4
'34380, 태안군,'086,85세이상,2019,1882,524,1358,38.6,1880,524,1356,38.6
'34380, 태안군,'090,85~89세,2019,1361,412,949,43.4,1359,412,947,43.5
'34380, 태안군,'090001, 85세,2019,359,112,247,45.3,359,112,247,45.3
'34380, 태안군,'090002, 86세,2019,363,110,253,43.5,363,110,253,43.5
'34380, 태안군,'090003, 87세,2019,306,103,203,50.7,305,103,202,51
'34380, 태안군,'090004, 88세,2019,189,55,134,41,189,55,134,41
'34380, 태안군,'090005, 89세,2019,144,32,112,28.6,143,32,111,28.8
'34380, 태안군,'095,90~94세,2019,429,96,333,28.8,429,96,333,28.8
'34380, 태안군,'095001, 90세,2019,134,29,105,27.6,134,29,105,27.6
'34380, 태안군,'095002, 91세,2019,118,32,86,37.2,118,32,86,37.2
'34380, 태안군,'095003, 92세,2019,71,17,54,31.5,71,17,54,31.5
'34380, 태안군,'095004, 93세,2019,45,7,38,18.4,45,7,38,18.4
'34380, 태안군,'095005, 94세,2019,61,11,50,22,61,11,50,22
'34380, 태안군,'100,95~99세,2019,85,15,70,21.4,85,15,70,21.4
'34380, 태안군,'100001, 95세,2019,34,X,31,9.7,34,X,31,9.7
'34380, 태안군,'100002, 96세,2019,22,6,16,37.5,22,6,16,37.5
'34380, 태안군,'100003, 97세,2019,17,X,15,13.3,17,X,15,13.3
'34380, 태안군,'100004, 98세,2019,9,X,6,50,9,X,6,50
'34380, 태안군,'100005, 99세,2019,X,X,X,50,X,X,X,50
'34380, 태안군,'101,100세이상,2019,7,X,6,16.7,7,X,6,16.7
'34380, 태안군,'102,15세미만,2019,5353,2720,2633,103.3,5341,2710,2631,103
'34380, 태안군,'103,15~64세,2019,37871,20890,16981,123,35978,19548,16430,119
'34380, 태안군,'104,65세이상,2019,17672,7757,9915,78.2,17610,7730,9880,78.2
'34380, 태안군,'126,평균연령,2019,50.3,48,52.8,,50.7,48.5,53.1,
'34380, 태안군,'127,중위연령,2019,54,50.5,57.4,,54.7,51.7,57.8,
'35,전라북도,'000,합계,2019,1807423,902704,904719,99.8,1763463,878627,884836,99.3
'35,전라북도,'005,0~4세,2019,58372,29799,28573,104.3,57948,29558,28390,104.1
'35,전라북도,'005001, 0세,2019,9146,4650,4496,103.4,9055,4597,4458,103.1
'35,전라북도,'005002, 1세,2019,10290,5236,5054,103.6,10219,5198,5021,103.5
'35,전라북도,'005003, 2세,2019,11508,5852,5656,103.5,11414,5796,5618,103.2
'35,전라북도,'005004, 3세,2019,13161,6747,6414,105.2,13076,6700,6376,105.1
'35,전라북도,'005005, 4세,2019,14267,7314,6953,105.2,14184,7267,6917,105.1
'35,전라북도,'010,5~9세,2019,77840,40091,37749,106.2,77587,39949,37638,106.1
'35,전라북도,'010001, 5세,2019,14306,7384,6922,106.7,14238,7351,6887,106.7
'35,전라북도,'010002, 6세,2019,14955,7772,7183,108.2,14907,7745,7162,108.1
'35,전라북도,'010003, 7세,2019,16330,8371,7959,105.2,16272,8334,7938,105
'35,전라북도,'010004, 8세,2019,16581,8466,8115,104.3,16542,8446,8096,104.3
'35,전라북도,'010005, 9세,2019,15668,8098,7570,107,15628,8073,7555,106.9
'35,전라북도,'015,10~14세,2019,79205,41082,38123,107.8,79071,41016,38055,107.8
'35,전라북도,'015001, 10세,2019,15200,7827,7373,106.2,15162,7806,7356,106.1
'35,전라북도,'015002, 11세,2019,16050,8341,7709,108.2,16015,8324,7691,108.2
'35,전라북도,'015003, 12세,2019,16679,8582,8097,106,16658,8573,8085,106
'35,전라북도,'015004, 13세,2019,15515,8072,7443,108.5,15495,8062,7433,108.5
'35,전라북도,'015005, 14세,2019,15761,8260,7501,110.1,15741,8251,7490,110.2
'35,전라북도,'020,15~19세,2019,101942,53956,47986,112.4,100447,53146,47301,112.4
'35,전라북도,'020001, 15세,2019,17081,8854,8227,107.6,17029,8826,8203,107.6
'35,전라북도,'020002, 16세,2019,18287,9537,8750,109,18244,9513,8731,109
'35,전라북도,'020003, 17세,2019,19561,10396,9165,113.4,19494,10365,9129,113.5
'35,전라북도,'020004, 18세,2019,22429,11803,10626,111.1,22102,11634,10468,111.1
'35,전라북도,'020005, 19세,2019,24584,13366,11218,119.1,23578,12808,10770,118.9
'35,전라북도,'025,20~24세,2019,124548,69242,55306,125.2,115976,64325,51651,124.5
'35,전라북도,'025001, 20세,2019,23973,13112,10861,120.7,22536,12347,10189,121.2
'35,전라북도,'025002, 21세,2019,25370,13876,11494,120.7,23567,12850,10717,119.9
'35,전라북도,'025003, 22세,2019,25533,14042,11491,122.2,23791,13000,10791,120.5
'35,전라북도,'025004, 23세,2019,25351,14356,10995,130.6,23593,13340,10253,130.1
'35,전라북도,'025005, 24세,2019,24321,13856,10465,132.4,22489,12788,9701,131.8
'35,전라북도,'030,25~29세,2019,103749,56701,47048,120.5,95285,51837,43448,119.3
'35,전라북도,'030001, 25세,2019,23266,13092,10174,128.7,21476,12089,9387,128.8
'35,전라북도,'030002, 26세,2019,21608,11874,9734,122,19859,10890,8969,121.4
'35,전라북도,'030003, 27세,2019,20947,11255,9692,116.1,19282,10290,8992,114.4
'35,전라북도,'030004, 28세,2019,19491,10479,9012,116.3,17825,9524,8301,114.7
'35,전라북도,'030005, 29세,2019,18437,10001,8436,118.6,16843,9044,7799,116
'35,전라북도,'035,30~34세,2019,89313,46712,42601,109.7,82318,42643,39675,107.5
'35,전라북도,'035001, 30세,2019,17663,9493,8170,116.2,16142,8606,7536,114.2
'35,전라북도,'035002, 31세,2019,17625,9231,8394,110,16079,8339,7740,107.7
'35,전라북도,'035003, 32세,2019,17615,9200,8415,109.3,16180,8344,7836,106.5
'35,전라북도,'035004, 33세,2019,18102,9382,8720,107.6,16808,8619,8189,105.3
'35,전라북도,'035005, 34세,2019,18308,9406,8902,105.7,17109,8735,8374,104.3
'35,전라북도,'040,35~39세,2019,114218,58694,55524,105.7,109269,55986,53283,105.1
'35,전라북도,'040001, 35세,2019,19899,10229,9670,105.8,18733,9577,9156,104.6
'35,전라북도,'040002, 36세,2019,21727,11214,10513,106.7,20677,10637,10040,105.9
'35,전라북도,'040003, 37세,2019,23916,12240,11676,104.8,22934,11701,11233,104.2
'35,전라북도,'040004, 38세,2019,23500,12154,11346,107.1,22632,11689,10943,106.8
'35,전라북도,'040005, 39세,2019,25176,12857,12319,104.4,24293,12382,11911,104
'35,전라북도,'045,40~44세,2019,120833,61886,58947,105,117525,60152,57373,104.8
'35,전라북도,'045001, 40세,2019,24221,12469,11752,106.1,23371,11995,11376,105.4
'35,전라북도,'045002, 41세,2019,23162,11842,11320,104.6,22477,11495,10982,104.7
'35,전라북도,'045003, 42세,2019,24156,12323,11833,104.1,23557,12023,11534,104.2
'35,전라북도,'045004, 43세,2019,24032,12350,11682,105.7,23425,12027,11398,105.5
'35,전라북도,'045005, 44세,2019,25262,12902,12360,104.4,24695,12612,12083,104.4
'35,전라북도,'050,45~49세,2019,147802,76470,71332,107.2,144933,75035,69898,107.3
'35,전라북도,'050001, 45세,2019,29241,15019,14222,105.6,28685,14754,13931,105.9
'35,전라북도,'050002, 46세,2019,28973,14751,14222,103.7,28378,14448,13930,103.7
'35,전라북도,'050003, 47세,2019,28631,14952,13679,109.3,28032,14648,13384,109.4
'35,전라북도,'050004, 48세,2019,31360,16357,15003,109,30808,16089,14719,109.3
'35,전라북도,'050005, 49세,2019,29597,15391,14206,108.3,29030,15096,13934,108.3
'35,전라북도,'055,50~54세,2019,146460,75420,71040,106.2,143988,74225,69763,106.4
'35,전라북도,'055001, 50세,2019,30189,15529,14660,105.9,29671,15268,14403,106
'35,전라북도,'055002, 51세,2019,30666,15808,14858,106.4,30105,15539,14566,106.7
'35,전라북도,'055003, 52세,2019,28176,14386,13790,104.3,27753,14182,13571,104.5
'35,전라북도,'055004, 53세,2019,28638,14962,13676,109.4,28146,14721,13425,109.7
'35,전라북도,'055005, 54세,2019,28791,14735,14056,104.8,28313,14515,13798,105.2
'35,전라북도,'060,55~59세,2019,149653,75865,73788,102.8,147775,74960,72815,102.9
'35,전라북도,'060001, 55세,2019,26303,13571,12732,106.6,25861,13351,12510,106.7
'35,전라북도,'060002, 56세,2019,28175,14513,13662,106.2,27748,14295,13453,106.3
'35,전라북도,'060003, 57세,2019,29301,15031,14270,105.3,28912,14845,14067,105.5
'35,전라북도,'060004, 58세,2019,32156,16053,16103,99.7,31883,15935,15948,99.9
'35,전라북도,'060005, 59세,2019,33718,16697,17021,98.1,33371,16534,16837,98.2
'35,전라북도,'065,60~64세,2019,133798,66591,67207,99.1,132659,66054,66605,99.2
'35,전라북도,'065001, 60세,2019,28934,14274,14660,97.4,28688,14163,14525,97.5
'35,전라북도,'065002, 61세,2019,26188,13038,13150,99.1,25919,12916,13003,99.3
'35,전라북도,'065003, 62세,2019,27328,13824,13504,102.4,27099,13715,13384,102.5
'35,전라북도,'065004, 63세,2019,24771,12354,12417,99.5,24559,12250,12309,99.5
'35,전라북도,'065005, 64세,2019,26577,13101,13476,97.2,26394,13010,13384,97.2
'35,전라북도,'070,65~69세,2019,100965,48900,52065,93.9,100445,48648,51797,93.9
'35,전라북도,'070001, 65세,2019,22805,11144,11661,95.6,22664,11074,11590,95.5
'35,전라북도,'070002, 66세,2019,18534,8984,9550,94.1,18413,8928,9485,94.1
'35,전라북도,'070003, 67세,2019,20859,10160,10699,95,20777,10115,10662,94.9
'35,전라북도,'070004, 68세,2019,18183,8802,9381,93.8,18092,8762,9330,93.9
'35,전라북도,'070005, 69세,2019,20584,9810,10774,91.1,20499,9769,10730,91
'35,전라북도,'075,70~74세,2019,84975,39365,45610,86.3,84706,39247,45459,86.3
'35,전라북도,'075001, 70세,2019,18609,8617,9992,86.2,18540,8594,9946,86.4
'35,전라북도,'075002, 71세,2019,18187,8542,9645,88.6,18124,8512,9612,88.6
'35,전라북도,'075003, 72세,2019,19893,9377,10516,89.2,19836,9353,10483,89.2
'35,전라북도,'075004, 73세,2019,14930,6992,7938,88.1,14886,6972,7914,88.1
'35,전라북도,'075005, 74세,2019,13356,5837,7519,77.6,13320,5816,7504,77.5
'35,전라북도,'080,75~79세,2019,75849,30719,45130,68.1,75742,30681,45061,68.1
'35,전라북도,'080001, 75세,2019,13628,5853,7775,75.3,13600,5844,7756,75.3
'35,전라북도,'080002, 76세,2019,14563,6021,8542,70.5,14543,6012,8531,70.5
'35,전라북도,'080003, 77세,2019,20645,8273,12372,66.9,20623,8267,12356,66.9
'35,전라북도,'080004, 78세,2019,14109,5610,8499,66,14098,5604,8494,66
'35,전라북도,'080005, 79세,2019,12904,4962,7942,62.5,12878,4954,7924,62.5
'35,전라북도,'085,80~84세,2019,56799,20255,36544,55.4,56730,20229,36501,55.4
'35,전라북도,'085001, 80세,2019,13532,5166,8366,61.7,13515,5162,8353,61.8
'35,전라북도,'085002, 81세,2019,12283,4430,7853,56.4,12267,4425,7842,56.4
'35,전라북도,'085003, 82세,2019,11113,3982,7131,55.8,11095,3974,7121,55.8
'35,전라북도,'085004, 83세,2019,10090,3445,6645,51.8,10082,3441,6641,51.8
'35,전라북도,'085005, 84세,2019,9781,3232,6549,49.4,9771,3227,6544,49.3
'35,전라북도,'086,85세이상,2019,41102,10956,30146,36.3,41059,10936,30123,36.3
'35,전라북도,'090,85~89세,2019,29195,8315,20880,39.8,29168,8298,20870,39.8
'35,전라북도,'090001, 85세,2019,8273,2610,5663,46.1,8266,2607,5659,46.1
'35,전라북도,'090002, 86세,2019,6903,2051,4852,42.3,6897,2045,4852,42.1
'35,전라북도,'090003, 87세,2019,5699,1560,4139,37.7,5695,1558,4137,37.7
'35,전라북도,'090004, 88세,2019,4419,1168,3251,35.9,4411,1163,3248,35.8
'35,전라북도,'090005, 89세,2019,3901,926,2975,31.1,3899,925,2974,31.1
'35,전라북도,'095,90~94세,2019,9625,2232,7393,30.2,9612,2229,7383,30.2
'35,전라북도,'095001, 90세,2019,3090,787,2303,34.2,3084,787,2297,34.3
'35,전라북도,'095002, 91세,2019,2602,590,2012,29.3,2599,589,2010,29.3
'35,전라북도,'095003, 92세,2019,1956,427,1529,27.9,1955,426,1529,27.9
'35,전라북도,'095004, 93세,2019,1150,254,896,28.3,1148,253,895,28.3
'35,전라북도,'095005, 94세,2019,827,174,653,26.6,826,174,652,26.7
'35,전라북도,'100,95~99세,2019,2007,366,1641,22.3,2005,366,1639,22.3
'35,전라북도,'100001, 95세,2019,556,122,434,28.1,556,122,434,28.1
'35,전라북도,'100002, 96세,2019,619,100,519,19.3,619,100,519,19.3
'35,전라북도,'100003, 97세,2019,433,82,351,23.4,432,82,350,23.4
'35,전라북도,'100004, 98세,2019,216,36,180,20,216,36,180,20
'35,전라북도,'100005, 99세,2019,183,26,157,16.6,182,26,156,16.7
'35,전라북도,'101,100세이상,2019,275,43,232,18.5,274,43,231,18.6
'35,전라북도,'102,15세미만,2019,215417,110972,104445,106.2,214606,110523,104083,106.2
'35,전라북도,'103,15~64세,2019,1232316,641537,590779,108.6,1190175,618363,571812,108.1
'35,전라북도,'104,65세이상,2019,359690,150195,209495,71.7,358682,149741,208941,71.7
'35,전라북도,'126,평균연령,2019,44.5,42.8,46.2,,44.7,43,46.4,
'35,전라북도,'127,중위연령,2019,46.2,44.5,47.9,,46.6,45,48.3,
'35004, 읍부,'000,합계,2019,156875,78890,77985,101.2,151177,75787,75390,100.5
'35004, 읍부,'005,0~4세,2019,5428,2780,2648,105,5393,2764,2629,105.1
'35004, 읍부,'005001, 0세,2019,926,484,442,109.5,919,481,438,109.8
'35004, 읍부,'005002, 1세,2019,975,487,488,99.8,968,484,484,100
'35004, 읍부,'005003, 2세,2019,1048,534,514,103.9,1038,530,508,104.3
'35004, 읍부,'005004, 3세,2019,1205,625,580,107.8,1202,624,578,108
'35004, 읍부,'005005, 4세,2019,1274,650,624,104.2,1266,645,621,103.9
'35004, 읍부,'010,5~9세,2019,7302,3826,3476,110.1,7286,3814,3472,109.9
'35004, 읍부,'010001, 5세,2019,1282,673,609,110.5,1277,671,606,110.7
'35004, 읍부,'010002, 6세,2019,1406,725,681,106.5,1405,725,680,106.6
'35004, 읍부,'010003, 7세,2019,1515,784,731,107.3,1511,780,731,106.7
'35004, 읍부,'010004, 8세,2019,1601,825,776,106.3,1598,822,776,105.9
'35004, 읍부,'010005, 9세,2019,1498,819,679,120.6,1495,816,679,120.2
'35004, 읍부,'015,10~14세,2019,7210,3698,3512,105.3,7201,3691,3510,105.2
'35004, 읍부,'015001, 10세,2019,1438,709,729,97.3,1436,708,728,97.3
'35004, 읍부,'015002, 11세,2019,1505,788,717,109.9,1503,786,717,109.6
'35004, 읍부,'015003, 12세,2019,1524,789,735,107.3,1523,789,734,107.5
'35004, 읍부,'015004, 13세,2019,1366,715,651,109.8,1364,713,651,109.5
'35004, 읍부,'015005, 14세,2019,1377,697,680,102.5,1375,695,680,102.2
'35004, 읍부,'020,15~19세,2019,9288,4984,4304,115.8,9007,4819,4188,115.1
'35004, 읍부,'020001, 15세,2019,1432,780,652,119.6,1425,777,648,119.9
'35004, 읍부,'020002, 16세,2019,1621,803,818,98.2,1615,801,814,98.4
'35004, 읍부,'020003, 17세,2019,1853,974,879,110.8,1845,970,875,110.9
'35004, 읍부,'020004, 18세,2019,2122,1127,995,113.3,2076,1105,971,113.8
'35004, 읍부,'020005, 19세,2019,2260,1300,960,135.4,2046,1166,880,132.5
'35004, 읍부,'025,20~24세,2019,9737,5727,4010,142.8,8578,5025,3553,141.4
'35004, 읍부,'025001, 20세,2019,2107,1245,862,144.4,1888,1094,794,137.8
'35004, 읍부,'025002, 21세,2019,2003,1161,842,137.9,1779,1029,750,137.2
'35004, 읍부,'025003, 22세,2019,1950,1144,806,141.9,1717,1000,717,139.5
'35004, 읍부,'025004, 23세,2019,1865,1094,771,141.9,1616,949,667,142.3
'35004, 읍부,'025005, 24세,2019,1812,1083,729,148.6,1578,953,625,152.5
'35004, 읍부,'030,25~29세,2019,7790,4292,3498,122.7,6741,3716,3025,122.8
'35004, 읍부,'030001, 25세,2019,1701,970,731,132.7,1484,848,636,133.3
'35004, 읍부,'030002, 26세,2019,1618,892,726,122.9,1380,766,614,124.8
'35004, 읍부,'030003, 27세,2019,1579,837,742,112.8,1385,740,645,114.7
'35004, 읍부,'030004, 28세,2019,1460,804,656,122.6,1256,687,569,120.7
'35004, 읍부,'030005, 29세,2019,1432,789,643,122.7,1236,675,561,120.3
'35004, 읍부,'035,30~34세,2019,7285,3715,3570,104.1,6418,3235,3183,101.6
'35004, 읍부,'035001, 30세,2019,1390,733,657,111.6,1204,629,575,109.4
'35004, 읍부,'035002, 31세,2019,1432,741,691,107.2,1248,634,614,103.3
'35004, 읍부,'035003, 32세,2019,1480,759,721,105.3,1280,653,627,104.1
'35004, 읍부,'035004, 33세,2019,1442,720,722,99.7,1288,630,658,95.7
'35004, 읍부,'035005, 34세,2019,1541,762,779,97.8,1398,689,709,97.2
'35004, 읍부,'040,35~39세,2019,9773,4903,4870,100.7,9125,4577,4548,100.6
'35004, 읍부,'040001, 35세,2019,1667,842,825,102.1,1502,759,743,102.2
'35004, 읍부,'040002, 36세,2019,1803,901,902,99.9,1681,848,833,101.8
'35004, 읍부,'040003, 37세,2019,2024,997,1027,97.1,1901,930,971,95.8
'35004, 읍부,'040004, 38세,2019,2031,1026,1005,102.1,1916,965,951,101.5
'35004, 읍부,'040005, 39세,2019,2248,1137,1111,102.3,2125,1075,1050,102.4
'35004, 읍부,'045,40~44세,2019,10363,5522,4841,114.1,9943,5300,4643,114.2
'35004, 읍부,'045001, 40세,2019,2199,1143,1056,108.2,2082,1080,1002,107.8
'35004, 읍부,'045002, 41세,2019,1965,1017,948,107.3,1887,976,911,107.1
'35004, 읍부,'045003, 42세,2019,2091,1108,983,112.7,2012,1072,940,114
'35004, 읍부,'045004, 43세,2019,2038,1135,903,125.7,1959,1091,868,125.7
'35004, 읍부,'045005, 44세,2019,2070,1119,951,117.7,2003,1081,922,117.2
'35004, 읍부,'050,45~49세,2019,12118,6551,5567,117.7,11762,6370,5392,118.1
'35004, 읍부,'050001, 45세,2019,2457,1327,1130,117.4,2382,1289,1093,117.9
'35004, 읍부,'050002, 46세,2019,2377,1267,1110,114.1,2306,1225,1081,113.3
'35004, 읍부,'050003, 47세,2019,2330,1264,1066,118.6,2243,1227,1016,120.8
'35004, 읍부,'050004, 48세,2019,2605,1416,1189,119.1,2538,1385,1153,120.1
'35004, 읍부,'050005, 49세,2019,2349,1277,1072,119.1,2293,1244,1049,118.6
'35004, 읍부,'055,50~54세,2019,11895,6538,5357,122,11569,6386,5183,123.2
'35004, 읍부,'055001, 50세,2019,2418,1334,1084,123.1,2354,1307,1047,124.8
'35004, 읍부,'055002, 51세,2019,2581,1418,1163,121.9,2512,1383,1129,122.5
'35004, 읍부,'055003, 52세,2019,2265,1228,1037,118.4,2203,1197,1006,119
'35004, 읍부,'055004, 53세,2019,2321,1282,1039,123.4,2251,1249,1002,124.7
'35004, 읍부,'055005, 54세,2019,2310,1276,1034,123.4,2249,1250,999,125.1
'35004, 읍부,'060,55~59세,2019,12261,6301,5960,105.7,12014,6177,5837,105.8
'35004, 읍부,'060001, 55세,2019,2137,1134,1003,113.1,2084,1103,981,112.4
'35004, 읍부,'060002, 56세,2019,2210,1170,1040,112.5,2158,1145,1013,113
'35004, 읍부,'060003, 57세,2019,2395,1255,1140,110.1,2345,1230,1115,110.3
'35004, 읍부,'060004, 58세,2019,2655,1318,1337,98.6,2613,1298,1315,98.7
'35004, 읍부,'060005, 59세,2019,2864,1424,1440,98.9,2814,1401,1413,99.2
'35004, 읍부,'065,60~64세,2019,11603,5847,5756,101.6,11455,5773,5682,101.6
'35004, 읍부,'065001, 60세,2019,2475,1260,1215,103.7,2434,1239,1195,103.7
'35004, 읍부,'065002, 61세,2019,2207,1136,1071,106.1,2169,1115,1054,105.8
'35004, 읍부,'065003, 62세,2019,2367,1204,1163,103.5,2341,1193,1148,103.9
'35004, 읍부,'065004, 63세,2019,2227,1113,1114,99.9,2204,1102,1102,100
'35004, 읍부,'065005, 64세,2019,2327,1134,1193,95.1,2307,1124,1183,95
'35004, 읍부,'070,65~69세,2019,9020,4388,4632,94.7,8951,4356,4595,94.8
'35004, 읍부,'070001, 65세,2019,2024,994,1030,96.5,2008,984,1024,96.1
'35004, 읍부,'070002, 66세,2019,1666,861,805,107,1651,855,796,107.4
'35004, 읍부,'070003, 67세,2019,1863,899,964,93.3,1850,892,958,93.1
'35004, 읍부,'070004, 68세,2019,1614,753,861,87.5,1597,746,851,87.7
'35004, 읍부,'070005, 69세,2019,1853,881,972,90.6,1845,879,966,91
'35004, 읍부,'075,70~74세,2019,7898,3610,4288,84.2,7856,3588,4268,84.1
'35004, 읍부,'075001, 70세,2019,1710,773,937,82.5,1699,768,931,82.5
'35004, 읍부,'075002, 71세,2019,1698,798,900,88.7,1691,794,897,88.5
'35004, 읍부,'075003, 72세,2019,1844,861,983,87.6,1835,859,976,88
'35004, 읍부,'075004, 73세,2019,1379,641,738,86.9,1370,636,734,86.6
'35004, 읍부,'075005, 74세,2019,1267,537,730,73.6,1261,531,730,72.7
'35004, 읍부,'080,75~79세,2019,7360,2940,4420,66.5,7347,2934,4413,66.5
'35004, 읍부,'080001, 75세,2019,1303,571,732,78,1297,567,730,77.7
'35004, 읍부,'080002, 76세,2019,1342,546,796,68.6,1339,545,794,68.6
'35004, 읍부,'080003, 77세,2019,1972,768,1204,63.8,1971,768,1203,63.8
'35004, 읍부,'080004, 78세,2019,1415,560,855,65.5,1414,559,855,65.4
'35004, 읍부,'080005, 79세,2019,1328,495,833,59.4,1326,495,831,59.6
'35004, 읍부,'085,80~84세,2019,5996,2106,3890,54.1,5988,2101,3887,54.1
'35004, 읍부,'085001, 80세,2019,1409,521,888,58.7,1406,520,886,58.7
'35004, 읍부,'085002, 81세,2019,1309,494,815,60.6,1307,493,814,60.6
'35004, 읍부,'085003, 82세,2019,1086,378,708,53.4,1084,376,708,53.1
'35004, 읍부,'085004, 83세,2019,1124,366,758,48.3,1123,365,758,48.2
'35004, 읍부,'085005, 84세,2019,1068,347,721,48.1,1068,347,721,48.1
'35004, 읍부,'086,85세이상,2019,4548,1162,3386,34.3,4543,1161,3382,34.3
'35004, 읍부,'090,85~89세,2019,3140,876,2264,38.7,3138,875,2263,38.7
'35004, 읍부,'090001, 85세,2019,926,268,658,40.7,925,268,657,40.8
'35004, 읍부,'090002, 86세,2019,727,227,500,45.4,727,227,500,45.4
'35004, 읍부,'090003, 87세,2019,608,167,441,37.9,608,167,441,37.9
'35004, 읍부,'090004, 88세,2019,445,114,331,34.4,444,113,331,34.1
'35004, 읍부,'090005, 89세,2019,434,100,334,29.9,434,100,334,29.9
'35004, 읍부,'095,90~94세,2019,1137,241,896,26.9,1134,241,893,27
'35004, 읍부,'095001, 90세,2019,353,85,268,31.7,352,85,267,31.8
'35004, 읍부,'095002, 91세,2019,288,66,222,29.7,287,66,221,29.9
'35004, 읍부,'095003, 92세,2019,244,46,198,23.2,244,46,198,23.2
'35004, 읍부,'095004, 93세,2019,151,22,129,17.1,150,22,128,17.2
'35004, 읍부,'095005, 94세,2019,101,22,79,27.8,101,22,79,27.8
'35004, 읍부,'100,95~99세,2019,239,40,199,20.1,239,40,199,20.1
'35004, 읍부,'100001, 95세,2019,60,12,48,25,60,12,48,25
'35004, 읍부,'100002, 96세,2019,82,9,73,12.3,82,9,73,12.3
'35004, 읍부,'100003, 97세,2019,56,10,46,21.7,56,10,46,21.7
'35004, 읍부,'100004, 98세,2019,19,5,14,35.7,19,5,14,35.7
'35004, 읍부,'100005, 99세,2019,22,X,18,22.2,22,X,18,22.2
'35004, 읍부,'101,100세이상,2019,32,5,27,18.5,32,5,27,18.5
'35004, 읍부,'102,15세미만,2019,19940,10304,9636,106.9,19880,10269,9611,106.8
'35004, 읍부,'103,15~64세,2019,102113,54380,47733,113.9,96612,51378,45234,113.6
'35004, 읍부,'104,65세이상,2019,34822,14206,20616,68.9,34685,14140,20545,68.8
'35004, 읍부,'126,평균연령,2019,45.1,43.1,47.2,,45.5,43.5,47.6,
'35004, 읍부,'127,중위연령,2019,46.8,45,48.8,,47.5,45.7,49.6,
'35005, 면부,'000,합계,2019,363012,181958,181054,100.5,351206,174846,176360,99.1
'35005, 면부,'005,0~4세,2019,6859,3498,3361,104.1,6833,3483,3350,104
'35005, 면부,'005001, 0세,2019,1194,596,598,99.7,1190,593,597,99.3
'35005, 면부,'005002, 1세,2019,1236,652,584,111.6,1233,651,582,111.9
'35005, 면부,'005003, 2세,2019,1349,690,659,104.7,1344,687,657,104.6
'35005, 면부,'005004, 3세,2019,1465,723,742,97.4,1456,717,739,97
'35005, 면부,'005005, 4세,2019,1615,837,778,107.6,1610,835,775,107.7
'35005, 면부,'010,5~9세,2019,8550,4480,4070,110.1,8522,4468,4054,110.2
'35005, 면부,'010001, 5세,2019,1646,835,811,103,1639,832,807,103.1
'35005, 면부,'010002, 6세,2019,1583,820,763,107.5,1576,817,759,107.6
'35005, 면부,'010003, 7세,2019,1765,932,833,111.9,1757,928,829,111.9
'35005, 면부,'010004, 8세,2019,1852,1018,834,122.1,1850,1017,833,122.1
'35005, 면부,'010005, 9세,2019,1704,875,829,105.5,1700,874,826,105.8
'35005, 면부,'015,10~14세,2019,8972,4720,4252,111,8950,4710,4240,111.1
'35005, 면부,'015001, 10세,2019,1688,882,806,109.4,1684,881,803,109.7
'35005, 면부,'015002, 11세,2019,1729,906,823,110.1,1722,901,821,109.7
'35005, 면부,'015003, 12세,2019,1788,945,843,112.1,1783,942,841,112
'35005, 면부,'015004, 13세,2019,1845,994,851,116.8,1842,993,849,117
'35005, 면부,'015005, 14세,2019,1922,993,929,106.9,1919,993,926,107.2
'35005, 면부,'020,15~19세,2019,11911,6753,5158,130.9,11811,6701,5110,131.1
'35005, 면부,'020001, 15세,2019,2096,1175,921,127.6,2087,1170,917,127.6
'35005, 면부,'020002, 16세,2019,2239,1269,970,130.8,2231,1261,970,130
'35005, 면부,'020003, 17세,2019,2347,1283,1064,120.6,2337,1281,1056,121.3
'35005, 면부,'020004, 18세,2019,2721,1563,1158,135,2706,1559,1147,135.9
'35005, 면부,'020005, 19세,2019,2508,1463,1045,140,2450,1430,1020,140.2
'35005, 면부,'025,20~24세,2019,15622,9264,6358,145.7,13810,8118,5692,142.6
'35005, 면부,'025001, 20세,2019,2740,1638,1102,148.6,2595,1572,1023,153.7
'35005, 면부,'025002, 21세,2019,3176,1883,1293,145.6,2835,1657,1178,140.7
'35005, 면부,'025003, 22세,2019,3178,1878,1300,144.5,2820,1655,1165,142.1
'35005, 면부,'025004, 23세,2019,3194,1843,1351,136.4,2756,1565,1191,131.4
'35005, 면부,'025005, 24세,2019,3334,2022,1312,154.1,2804,1669,1135,147
'35005, 면부,'030,25~29세,2019,15019,8876,6143,144.5,12258,7038,5220,134.8
'35005, 면부,'030001, 25세,2019,3235,1937,1298,149.2,2673,1587,1086,146.1
'35005, 면부,'030002, 26세,2019,3032,1784,1248,142.9,2475,1419,1056,134.4
'35005, 면부,'030003, 27세,2019,2967,1769,1198,147.7,2407,1371,1036,132.3
'35005, 면부,'030004, 28세,2019,2941,1719,1222,140.7,2387,1351,1036,130.4
'35005, 면부,'030005, 29세,2019,2844,1667,1177,141.6,2316,1310,1006,130.2
'35005, 면부,'035,30~34세,2019,13118,7535,5583,135,10797,5986,4811,124.4
'35005, 면부,'035001, 30세,2019,2675,1578,1097,143.8,2165,1225,940,130.3
'35005, 면부,'035002, 31세,2019,2714,1575,1139,138.3,2176,1220,956,127.6
'35005, 면부,'035003, 32세,2019,2582,1487,1095,135.8,2117,1170,947,123.5
'35005, 면부,'035004, 33세,2019,2623,1476,1147,128.7,2199,1196,1003,119.2
'35005, 면부,'035005, 34세,2019,2524,1419,1105,128.4,2140,1175,965,121.8
'35005, 면부,'040,35~39세,2019,14769,8411,6358,132.3,13271,7527,5744,131
'35005, 면부,'040001, 35세,2019,2707,1517,1190,127.5,2357,1313,1044,125.8
'35005, 면부,'040002, 36세,2019,2824,1605,1219,131.7,2494,1390,1104,125.9
'35005, 면부,'040003, 37세,2019,3054,1741,1313,132.6,2749,1567,1182,132.6
'35005, 면부,'040004, 38세,2019,3008,1730,1278,135.4,2756,1585,1171,135.4
'35005, 면부,'040005, 39세,2019,3176,1818,1358,133.9,2915,1672,1243,134.5
'35005, 면부,'045,40~44세,2019,15802,9486,6316,150.2,14859,8978,5881,152.7
'35005, 면부,'045001, 40세,2019,3051,1822,1229,148.3,2801,1687,1114,151.4
'35005, 면부,'045002, 41세,2019,3021,1815,1206,150.5,2830,1707,1123,152
'35005, 면부,'045003, 42세,2019,3122,1881,1241,151.6,2942,1778,1164,152.7
'35005, 면부,'045004, 43세,2019,3182,1891,1291,146.5,3009,1804,1205,149.7
'35005, 면부,'045005, 44세,2019,3426,2077,1349,154,3277,2002,1275,157
'35005, 면부,'050,45~49세,2019,21671,12808,8863,144.5,20969,12474,8495,146.8
'35005, 면부,'050001, 45세,2019,4035,2411,1624,148.5,3902,2352,1550,151.7
'35005, 면부,'050002, 46세,2019,4195,2495,1700,146.8,4053,2425,1628,149
'35005, 면부,'050003, 47세,2019,4168,2465,1703,144.7,4020,2402,1618,148.5
'35005, 면부,'050004, 48세,2019,4711,2796,1915,146,4568,2726,1842,148
'35005, 면부,'050005, 49세,2019,4562,2641,1921,137.5,4426,2569,1857,138.3
'35005, 면부,'055,50~54세,2019,27718,15396,12322,124.9,27057,15070,11987,125.7
'35005, 면부,'055001, 50세,2019,5101,2882,2219,129.9,4961,2811,2150,130.7
'35005, 면부,'055002, 51세,2019,5564,3139,2425,129.4,5407,3062,2345,130.6
'35005, 면부,'055003, 52세,2019,5305,2909,2396,121.4,5195,2857,2338,122.2
'35005, 면부,'055004, 53세,2019,5747,3202,2545,125.8,5630,3140,2490,126.1
'35005, 면부,'055005, 54세,2019,6001,3264,2737,119.3,5864,3200,2664,120.1
'35005, 면부,'060,55~59세,2019,35242,18451,16791,109.9,34762,18218,16544,110.1
'35005, 면부,'060001, 55세,2019,5653,3037,2616,116.1,5523,2975,2548,116.8
'35005, 면부,'060002, 56세,2019,6127,3280,2847,115.2,6015,3217,2798,115
'35005, 면부,'060003, 57세,2019,6988,3683,3305,111.4,6893,3640,3253,111.9
'35005, 면부,'060004, 58세,2019,7956,4123,3833,107.6,7891,4097,3794,108
'35005, 면부,'060005, 59세,2019,8518,4328,4190,103.3,8440,4289,4151,103.3
'35005, 면부,'065,60~64세,2019,36734,18769,17965,104.5,36479,18651,17828,104.6
'35005, 면부,'065001, 60세,2019,7433,3768,3665,102.8,7378,3746,3632,103.1
'35005, 면부,'065002, 61세,2019,7066,3581,3485,102.8,7023,3562,3461,102.9
'35005, 면부,'065003, 62세,2019,7540,3942,3598,109.6,7487,3921,3566,110
'35005, 면부,'065004, 63세,2019,7045,3614,3431,105.3,6990,3587,3403,105.4
'35005, 면부,'065005, 64세,2019,7650,3864,3786,102.1,7601,3835,3766,101.8
'35005, 면부,'070,65~69세,2019,31076,15212,15864,95.9,30973,15166,15807,95.9
'35005, 면부,'070001, 65세,2019,6839,3414,3425,99.7,6815,3404,3411,99.8
'35005, 면부,'070002, 66세,2019,5469,2711,2758,98.3,5445,2701,2744,98.4
'35005, 면부,'070003, 67세,2019,6399,3084,3315,93,6378,3073,3305,93
'35005, 면부,'070004, 68세,2019,5799,2815,2984,94.3,5786,2810,2976,94.4
'35005, 면부,'070005, 69세,2019,6570,3188,3382,94.3,6549,3178,3371,94.3
'35005, 면부,'075,70~74세,2019,28673,13422,15251,88,28618,13399,15219,88
'35005, 면부,'075001, 70세,2019,6041,2839,3202,88.7,6028,2833,3195,88.7
'35005, 면부,'075002, 71세,2019,6108,2962,3146,94.2,6095,2957,3138,94.2
'35005, 면부,'075003, 72세,2019,6680,3164,3516,90,6669,3160,3509,90.1
'35005, 면부,'075004, 73세,2019,5093,2383,2710,87.9,5085,2380,2705,88
'35005, 면부,'075005, 74세,2019,4751,2074,2677,77.5,4741,2069,2672,77.4
'35005, 면부,'080,75~79세,2019,29997,11717,18280,64.1,29974,11709,18265,64.1
'35005, 면부,'080001, 75세,2019,4975,2055,2920,70.4,4970,2054,2916,70.4
'35005, 면부,'080002, 76세,2019,5647,2283,3364,67.9,5643,2281,3362,67.8
'35005, 면부,'080003, 77세,2019,8346,3216,5130,62.7,8342,3216,5126,62.7
'35005, 면부,'080004, 78세,2019,5762,2197,3565,61.6,5761,2197,3564,61.6
'35005, 면부,'080005, 79세,2019,5267,1966,3301,59.6,5258,1961,3297,59.5
'35005, 면부,'085,80~84세,2019,24178,8413,15765,53.4,24168,8408,15760,53.4
'35005, 면부,'085001, 80세,2019,5771,2111,3660,57.7,5768,2109,3659,57.6
'35005, 면부,'085002, 81세,2019,5148,1800,3348,53.8,5144,1799,3345,53.8
'35005, 면부,'085003, 82세,2019,4773,1699,3074,55.3,4771,1698,3073,55.3
'35005, 면부,'085004, 83세,2019,4329,1451,2878,50.4,4329,1451,2878,50.4
'35005, 면부,'085005, 84세,2019,4157,1352,2805,48.2,4156,1351,2805,48.2
'35005, 면부,'086,85세이상,2019,17101,4747,12354,38.4,17095,4742,12353,38.4
'35005, 면부,'090,85~89세,2019,12357,3604,8753,41.2,12352,3599,8753,41.1
'35005, 면부,'090001, 85세,2019,3529,1152,2377,48.5,3527,1150,2377,48.4
'35005, 면부,'090002, 86세,2019,2926,869,2057,42.2,2925,868,2057,42.2
'35005, 면부,'090003, 87세,2019,2427,682,1745,39.1,2426,681,1745,39
'35005, 면부,'090004, 88세,2019,1898,526,1372,38.3,1898,526,1372,38.3
'35005, 면부,'090005, 89세,2019,1577,375,1202,31.2,1576,374,1202,31.1
'35005, 면부,'095,90~94세,2019,3868,965,2903,33.2,3867,965,2902,33.3
'35005, 면부,'095001, 90세,2019,1214,327,887,36.9,1214,327,887,36.9
'35005, 면부,'095002, 91세,2019,1074,250,824,30.3,1073,250,823,30.4
'35005, 면부,'095003, 92세,2019,801,189,612,30.9,801,189,612,30.9
'35005, 면부,'095004, 93세,2019,449,121,328,36.9,449,121,328,36.9
'35005, 면부,'095005, 94세,2019,330,78,252,31,330,78,252,31
'35005, 면부,'100,95~99세,2019,779,161,618,26.1,779,161,618,26.1
'35005, 면부,'100001, 95세,2019,208,51,157,32.5,208,51,157,32.5
'35005, 면부,'100002, 96세,2019,233,47,186,25.3,233,47,186,25.3
'35005, 면부,'100003, 97세,2019,171,36,135,26.7,171,36,135,26.7
'35005, 면부,'100004, 98세,2019,87,17,70,24.3,87,17,70,24.3
'35005, 면부,'100005, 99세,2019,80,10,70,14.3,80,10,70,14.3
'35005, 면부,'101,100세이상,2019,97,17,80,21.3,97,17,80,21.3
'35005, 면부,'102,15세미만,2019,24381,12698,11683,108.7,24305,12661,11644,108.7
'35005, 면부,'103,15~64세,2019,207606,115749,91857,126,196073,108761,87312,124.6
'35005, 면부,'104,65세이상,2019,131025,53511,77514,69,130828,53424,77404,69
'35005, 면부,'126,평균연령,2019,54.1,51.2,57.1,,54.8,51.9,57.6,
'35005, 면부,'127,중위연령,2019,58.3,54.9,61.4,,59,56,62,
'35003, 동부,'000,합계,2019,1287536,641856,645680,99.4,1261080,627994,633086,99.2
'35003, 동부,'005,0~4세,2019,46085,23521,22564,104.2,45722,23311,22411,104
'35003, 동부,'005001, 0세,2019,7026,3570,3456,103.3,6946,3523,3423,102.9
'35003, 동부,'005002, 1세,2019,8079,4097,3982,102.9,8018,4063,3955,102.7
'35003, 동부,'005003, 2세,2019,9111,4628,4483,103.2,9032,4579,4453,102.8
'35003, 동부,'005004, 3세,2019,10491,5399,5092,106,10418,5359,5059,105.9
'35003, 동부,'005005, 4세,2019,11378,5827,5551,105,11308,5787,5521,104.8
'35003, 동부,'010,5~9세,2019,61988,31785,30203,105.2,61779,31667,30112,105.2
'35003, 동부,'010001, 5세,2019,11378,5876,5502,106.8,11322,5848,5474,106.8
'35003, 동부,'010002, 6세,2019,11966,6227,5739,108.5,11926,6203,5723,108.4
'35003, 동부,'010003, 7세,2019,13050,6655,6395,104.1,13004,6626,6378,103.9
'35003, 동부,'010004, 8세,2019,13128,6623,6505,101.8,13094,6607,6487,101.8
'35003, 동부,'010005, 9세,2019,12466,6404,6062,105.6,12433,6383,6050,105.5
'35003, 동부,'015,10~14세,2019,63023,32664,30359,107.6,62920,32615,30305,107.6
'35003, 동부,'015001, 10세,2019,12074,6236,5838,106.8,12042,6217,5825,106.7
'35003, 동부,'015002, 11세,2019,12816,6647,6169,107.7,12790,6637,6153,107.9
'35003, 동부,'015003, 12세,2019,13367,6848,6519,105,13352,6842,6510,105.1
'35003, 동부,'015004, 13세,2019,12304,6363,5941,107.1,12289,6356,5933,107.1
'35003, 동부,'015005, 14세,2019,12462,6570,5892,111.5,12447,6563,5884,111.5
'35003, 동부,'020,15~19세,2019,80743,42219,38524,109.6,79629,41626,38003,109.5
'35003, 동부,'020001, 15세,2019,13553,6899,6654,103.7,13517,6879,6638,103.6
'35003, 동부,'020002, 16세,2019,14427,7465,6962,107.2,14398,7451,6947,107.3
'35003, 동부,'020003, 17세,2019,15361,8139,7222,112.7,15312,8114,7198,112.7
'35003, 동부,'020004, 18세,2019,17586,9113,8473,107.6,17320,8970,8350,107.4
'35003, 동부,'020005, 19세,2019,19816,10603,9213,115.1,19082,10212,8870,115.1
'35003, 동부,'025,20~24세,2019,99189,54251,44938,120.7,93588,51182,42406,120.7
'35003, 동부,'025001, 20세,2019,19126,10229,8897,115,18053,9681,8372,115.6
'35003, 동부,'025002, 21세,2019,20191,10832,9359,115.7,18953,10164,8789,115.6
'35003, 동부,'025003, 22세,2019,20405,11020,9385,117.4,19254,10345,8909,116.1
'35003, 동부,'025004, 23세,2019,20292,11419,8873,128.7,19221,10826,8395,129
'35003, 동부,'025005, 24세,2019,19175,10751,8424,127.6,18107,10166,7941,128
'35003, 동부,'030,25~29세,2019,80940,43533,37407,116.4,76286,41083,35203,116.7
'35003, 동부,'030001, 25세,2019,18330,10185,8145,125,17319,9654,7665,125.9
'35003, 동부,'030002, 26세,2019,16958,9198,7760,118.5,16004,8705,7299,119.3
'35003, 동부,'030003, 27세,2019,16401,8649,7752,111.6,15490,8179,7311,111.9
'35003, 동부,'030004, 28세,2019,15090,7956,7134,111.5,14182,7486,6696,111.8
'35003, 동부,'030005, 29세,2019,14161,7545,6616,114,13291,7059,6232,113.3
'35003, 동부,'035,30~34세,2019,68910,35462,33448,106,65103,33422,31681,105.5
'35003, 동부,'035001, 30세,2019,13598,7182,6416,111.9,12773,6752,6021,112.1
'35003, 동부,'035002, 31세,2019,13479,6915,6564,105.3,12655,6485,6170,105.1
'35003, 동부,'035003, 32세,2019,13553,6954,6599,105.4,12783,6521,6262,104.1
'35003, 동부,'035004, 33세,2019,14037,7186,6851,104.9,13321,6793,6528,104.1
'35003, 동부,'035005, 34세,2019,14243,7225,7018,102.9,13571,6871,6700,102.6
'35003, 동부,'040,35~39세,2019,89676,45380,44296,102.4,86873,43882,42991,102.1
'35003, 동부,'040001, 35세,2019,15525,7870,7655,102.8,14874,7505,7369,101.8
'35003, 동부,'040002, 36세,2019,17100,8708,8392,103.8,16502,8399,8103,103.7
'35003, 동부,'040003, 37세,2019,18838,9502,9336,101.8,18284,9204,9080,101.4
'35003, 동부,'040004, 38세,2019,18461,9398,9063,103.7,17960,9139,8821,103.6
'35003, 동부,'040005, 39세,2019,19752,9902,9850,100.5,19253,9635,9618,100.2
'35003, 동부,'045,40~44세,2019,94668,46878,47790,98.1,92723,45874,46849,97.9
'35003, 동부,'045001, 40세,2019,18971,9504,9467,100.4,18488,9228,9260,99.7
'35003, 동부,'045002, 41세,2019,18176,9010,9166,98.3,17760,8812,8948,98.5
'35003, 동부,'045003, 42세,2019,18943,9334,9609,97.1,18603,9173,9430,97.3
'35003, 동부,'045004, 43세,2019,18812,9324,9488,98.3,18457,9132,9325,97.9
'35003, 동부,'045005, 44세,2019,19766,9706,10060,96.5,19415,9529,9886,96.4
'35003, 동부,'050,45~49세,2019,114013,57111,56902,100.4,112202,56191,56011,100.3
'35003, 동부,'050001, 45세,2019,22749,11281,11468,98.4,22401,11113,11288,98.4
'35003, 동부,'050002, 46세,2019,22401,10989,11412,96.3,22019,10798,11221,96.2
'35003, 동부,'050003, 47세,2019,22133,11223,10910,102.9,21769,11019,10750,102.5
'35003, 동부,'050004, 48세,2019,24044,12145,11899,102.1,23702,11978,11724,102.2
'35003, 동부,'050005, 49세,2019,22686,11473,11213,102.3,22311,11283,11028,102.3
'35003, 동부,'055,50~54세,2019,106847,53486,53361,100.2,105362,52769,52593,100.3
'35003, 동부,'055001, 50세,2019,22670,11313,11357,99.6,22356,11150,11206,99.5
'35003, 동부,'055002, 51세,2019,22521,11251,11270,99.8,22186,11094,11092,100
'35003, 동부,'055003, 52세,2019,20606,10249,10357,99,20355,10128,10227,99
'35003, 동부,'055004, 53세,2019,20570,10478,10092,103.8,20265,10332,9933,104
'35003, 동부,'055005, 54세,2019,20480,10195,10285,99.1,20200,10065,10135,99.3
'35003, 동부,'060,55~59세,2019,102150,51113,51037,100.1,100999,50565,50434,100.3
'35003, 동부,'060001, 55세,2019,18513,9400,9113,103.1,18254,9273,8981,103.3
'35003, 동부,'060002, 56세,2019,19838,10063,9775,102.9,19575,9933,9642,103
'35003, 동부,'060003, 57세,2019,19918,10093,9825,102.7,19674,9975,9699,102.8
'35003, 동부,'060004, 58세,2019,21545,10612,10933,97.1,21379,10540,10839,97.2
'35003, 동부,'060005, 59세,2019,22336,10945,11391,96.1,22117,10844,11273,96.2
'35003, 동부,'065,60~64세,2019,85461,41975,43486,96.5,84725,41630,43095,96.6
'35003, 동부,'065001, 60세,2019,19026,9246,9780,94.5,18876,9178,9698,94.6
'35003, 동부,'065002, 61세,2019,16915,8321,8594,96.8,16727,8239,8488,97.1
'35003, 동부,'065003, 62세,2019,17421,8678,8743,99.3,17271,8601,8670,99.2
'35003, 동부,'065004, 63세,2019,15499,7627,7872,96.9,15365,7561,7804,96.9
'35003, 동부,'065005, 64세,2019,16600,8103,8497,95.4,16486,8051,8435,95.4
'35003, 동부,'070,65~69세,2019,60869,29300,31569,92.8,60521,29126,31395,92.8
'35003, 동부,'070001, 65세,2019,13942,6736,7206,93.5,13841,6686,7155,93.4
'35003, 동부,'070002, 66세,2019,11399,5412,5987,90.4,11317,5372,5945,90.4
'35003, 동부,'070003, 67세,2019,12597,6177,6420,96.2,12549,6150,6399,96.1
'35003, 동부,'070004, 68세,2019,10770,5234,5536,94.5,10709,5206,5503,94.6
'35003, 동부,'070005, 69세,2019,12161,5741,6420,89.4,12105,5712,6393,89.3
'35003, 동부,'075,70~74세,2019,48404,22333,26071,85.7,48232,22260,25972,85.7
'35003, 동부,'075001, 70세,2019,10858,5005,5853,85.5,10813,4993,5820,85.8
'35003, 동부,'075002, 71세,2019,10381,4782,5599,85.4,10338,4761,5577,85.4
'35003, 동부,'075003, 72세,2019,11369,5352,6017,88.9,11332,5334,5998,88.9
'35003, 동부,'075004, 73세,2019,8458,3968,4490,88.4,8431,3956,4475,88.4
'35003, 동부,'075005, 74세,2019,7338,3226,4112,78.5,7318,3216,4102,78.4
'35003, 동부,'080,75~79세,2019,38492,16062,22430,71.6,38421,16038,22383,71.7
'35003, 동부,'080001, 75세,2019,7350,3227,4123,78.3,7333,3223,4110,78.4
'35003, 동부,'080002, 76세,2019,7574,3192,4382,72.8,7561,3186,4375,72.8
'35003, 동부,'080003, 77세,2019,10327,4289,6038,71,10310,4283,6027,71.1
'35003, 동부,'080004, 78세,2019,6932,2853,4079,69.9,6923,2848,4075,69.9
'35003, 동부,'080005, 79세,2019,6309,2501,3808,65.7,6294,2498,3796,65.8
'35003, 동부,'085,80~84세,2019,26625,9736,16889,57.6,26574,9720,16854,57.7
'35003, 동부,'085001, 80세,2019,6352,2534,3818,66.4,6341,2533,3808,66.5
'35003, 동부,'085002, 81세,2019,5826,2136,3690,57.9,5816,2133,3683,57.9
'35003, 동부,'085003, 82세,2019,5254,1905,3349,56.9,5240,1900,3340,56.9
'35003, 동부,'085004, 83세,2019,4637,1628,3009,54.1,4630,1625,3005,54.1
'35003, 동부,'085005, 84세,2019,4556,1533,3023,50.7,4547,1529,3018,50.7
'35003, 동부,'086,85세이상,2019,19453,5047,14406,35,19421,5033,14388,35
'35003, 동부,'090,85~89세,2019,13698,3835,9863,38.9,13678,3824,9854,38.8
'35003, 동부,'090001, 85세,2019,3818,1190,2628,45.3,3814,1189,2625,45.3
'35003, 동부,'090002, 86세,2019,3250,955,2295,41.6,3245,950,2295,41.4
'35003, 동부,'090003, 87세,2019,2664,711,1953,36.4,2661,710,1951,36.4
'35003, 동부,'090004, 88세,2019,2076,528,1548,34.1,2069,524,1545,33.9
'35003, 동부,'090005, 89세,2019,1890,451,1439,31.3,1889,451,1438,31.4
'35003, 동부,'095,90~94세,2019,4620,1026,3594,28.5,4611,1023,3588,28.5
'35003, 동부,'095001, 90세,2019,1523,375,1148,32.7,1518,375,1143,32.8
'35003, 동부,'095002, 91세,2019,1240,274,966,28.4,1239,273,966,28.3
'35003, 동부,'095003, 92세,2019,911,192,719,26.7,910,191,719,26.6
'35003, 동부,'095004, 93세,2019,550,111,439,25.3,549,110,439,25.1
'35003, 동부,'095005, 94세,2019,396,74,322,23,395,74,321,23.1
'35003, 동부,'100,95~99세,2019,989,165,824,20,987,165,822,20.1
'35003, 동부,'100001, 95세,2019,288,59,229,25.8,288,59,229,25.8
'35003, 동부,'100002, 96세,2019,304,44,260,16.9,304,44,260,16.9
'35003, 동부,'100003, 97세,2019,206,36,170,21.2,205,36,169,21.3
'35003, 동부,'100004, 98세,2019,110,14,96,14.6,110,14,96,14.6
'35003, 동부,'100005, 99세,2019,81,12,69,17.4,80,12,68,17.6
'35003, 동부,'101,100세이상,2019,146,21,125,16.8,145,21,124,16.9
'35003, 동부,'102,15세미만,2019,171096,87970,83126,105.8,170421,87593,82828,105.8
'35003, 동부,'103,15~64세,2019,922597,471408,451189,104.5,897490,458224,439266,104.3
'35003, 동부,'104,65세이상,2019,193843,82478,111365,74.1,193169,82177,110992,74
'35003, 동부,'126,평균연령,2019,41.7,40.3,43,,41.8,40.5,43.1,
'35003, 동부,'127,중위연령,2019,42.8,41.3,44.3,,43.2,41.7,44.7,
'35010, 전주시,'000,합계,2019,662086,327260,334826,97.7,651092,322025,329067,97.9
'35010, 전주시,'005,0~4세,2019,24032,12301,11731,104.9,23826,12184,11642,104.7
'35010, 전주시,'005001, 0세,2019,3680,1870,1810,103.3,3627,1837,1790,102.6
'35010, 전주시,'005002, 1세,2019,4138,2120,2018,105.1,4100,2098,2002,104.8
'35010, 전주시,'005003, 2세,2019,4791,2462,2329,105.7,4747,2437,2310,105.5
'35010, 전주시,'005004, 3세,2019,5485,2862,2623,109.1,5446,2842,2604,109.1
'35010, 전주시,'005005, 4세,2019,5938,2987,2951,101.2,5906,2970,2936,101.2
'35010, 전주시,'010,5~9세,2019,32078,16439,15639,105.1,31961,16373,15588,105
'35010, 전주시,'010001, 5세,2019,5941,3054,2887,105.8,5912,3044,2868,106.1
'35010, 전주시,'010002, 6세,2019,6168,3204,2964,108.1,6149,3191,2958,107.9
'35010, 전주시,'010003, 7세,2019,6751,3403,3348,101.6,6723,3383,3340,101.3
'35010, 전주시,'010004, 8세,2019,6675,3377,3298,102.4,6658,3369,3289,102.4
'35010, 전주시,'010005, 9세,2019,6543,3401,3142,108.2,6519,3386,3133,108.1
'35010, 전주시,'015,10~14세,2019,32715,17055,15660,108.9,32678,17039,15639,109
'35010, 전주시,'015001, 10세,2019,6252,3217,3035,106,6239,3209,3030,105.9
'35010, 전주시,'015002, 11세,2019,6653,3438,3215,106.9,6644,3437,3207,107.2
'35010, 전주시,'015003, 12세,2019,6927,3628,3299,110,6922,3626,3296,110
'35010, 전주시,'015004, 13세,2019,6376,3328,3048,109.2,6372,3325,3047,109.1
'35010, 전주시,'015005, 14세,2019,6507,3444,3063,112.4,6501,3442,3059,112.5
'35010, 전주시,'020,15~19세,2019,42466,21911,20555,106.6,41790,21563,20227,106.6
'35010, 전주시,'020001, 15세,2019,7059,3577,3482,102.7,7042,3568,3474,102.7
'35010, 전주시,'020002, 16세,2019,7429,3842,3587,107.1,7415,3835,3580,107.1
'35010, 전주시,'020003, 17세,2019,7888,4107,3781,108.6,7866,4093,3773,108.5
'35010, 전주시,'020004, 18세,2019,9240,4755,4485,106,9067,4663,4404,105.9
'35010, 전주시,'020005, 19세,2019,10850,5630,5220,107.9,10400,5404,4996,108.2
'35010, 전주시,'025,20~24세,2019,53428,28495,24933,114.3,50555,27041,23514,115
'35010, 전주시,'025001, 20세,2019,10367,5442,4925,110.5,9726,5124,4602,111.3
'35010, 전주시,'025002, 21세,2019,10868,5701,5167,110.3,10224,5379,4845,111
'35010, 전주시,'025003, 22세,2019,10982,5771,5211,110.7,10371,5444,4927,110.5
'35010, 전주시,'025004, 23세,2019,10883,5938,4945,120.1,10384,5694,4690,121.4
'35010, 전주시,'025005, 24세,2019,10328,5643,4685,120.4,9850,5400,4450,121.3
'35010, 전주시,'030,25~29세,2019,44473,23564,20909,112.7,42548,22670,19878,114
'35010, 전주시,'030001, 25세,2019,9987,5417,4570,118.5,9538,5211,4327,120.4
'35010, 전주시,'030002, 26세,2019,9298,4993,4305,116,8884,4790,4094,117
'35010, 전주시,'030003, 27세,2019,9090,4725,4365,108.2,8707,4561,4146,110
'35010, 전주시,'030004, 28세,2019,8359,4348,4011,108.4,8010,4188,3822,109.6
'35010, 전주시,'030005, 29세,2019,7739,4081,3658,111.6,7409,3920,3489,112.4
'35010, 전주시,'035,30~34세,2019,37084,18808,18276,102.9,35642,18158,17484,103.9
'35010, 전주시,'035001, 30세,2019,7380,3822,3558,107.4,7057,3670,3387,108.4
'35010, 전주시,'035002, 31세,2019,7286,3705,3581,103.5,6975,3566,3409,104.6
'35010, 전주시,'035003, 32세,2019,7360,3678,3682,99.9,7069,3546,3523,100.7
'35010, 전주시,'035004, 33세,2019,7495,3765,3730,100.9,7228,3644,3584,101.7
'35010, 전주시,'035005, 34세,2019,7563,3838,3725,103,7313,3732,3581,104.2
'35010, 전주시,'040,35~39세,2019,46676,23228,23448,99.1,45692,22774,22918,99.4
'35010, 전주시,'040001, 35세,2019,8218,4082,4136,98.7,7987,3961,4026,98.4
'35010, 전주시,'040002, 36세,2019,8984,4523,4461,101.4,8774,4434,4340,102.2
'35010, 전주시,'040003, 37세,2019,9770,4828,4942,97.7,9576,4740,4836,98
'35010, 전주시,'040004, 38세,2019,9498,4772,4726,101,9330,4700,4630,101.5
'35010, 전주시,'040005, 39세,2019,10206,5023,5183,96.9,10025,4939,5086,97.1
'35010, 전주시,'045,40~44세,2019,48721,23794,24927,95.5,48059,23485,24574,95.6
'35010, 전주시,'045001, 40세,2019,9818,4861,4957,98.1,9660,4778,4882,97.9
'35010, 전주시,'045002, 41세,2019,9349,4537,4812,94.3,9218,4486,4732,94.8
'35010, 전주시,'045003, 42세,2019,9735,4771,4964,96.1,9612,4720,4892,96.5
'35010, 전주시,'045004, 43세,2019,9643,4675,4968,94.1,9523,4609,4914,93.8
'35010, 전주시,'045005, 44세,2019,10176,4950,5226,94.7,10046,4892,5154,94.9
'35010, 전주시,'050,45~49세,2019,58255,28705,29550,97.1,57598,28396,29202,97.2
'35010, 전주시,'050001, 45세,2019,11516,5604,5912,94.8,11381,5543,5838,94.9
'35010, 전주시,'050002, 46세,2019,11494,5488,6006,91.4,11354,5429,5925,91.6
'35010, 전주시,'050003, 47세,2019,11296,5652,5644,100.1,11172,5583,5589,99.9
'35010, 전주시,'050004, 48세,2019,12300,6164,6136,100.5,12181,6105,6076,100.5
'35010, 전주시,'050005, 49세,2019,11649,5797,5852,99.1,11510,5736,5774,99.3
'35010, 전주시,'055,50~54세,2019,54650,26843,27807,96.5,54088,26589,27499,96.7
'35010, 전주시,'055001, 50세,2019,11557,5648,5909,95.6,11444,5593,5851,95.6
'35010, 전주시,'055002, 51세,2019,11486,5645,5841,96.6,11362,5589,5773,96.8
'35010, 전주시,'055003, 52세,2019,10498,5178,5320,97.3,10399,5134,5265,97.5
'35010, 전주시,'055004, 53세,2019,10563,5236,5327,98.3,10450,5187,5263,98.6
'35010, 전주시,'055005, 54세,2019,10546,5136,5410,94.9,10433,5086,5347,95.1
'35010, 전주시,'060,55~59세,2019,51645,25506,26139,97.6,51253,25326,25927,97.7
'35010, 전주시,'060001, 55세,2019,9469,4728,4741,99.7,9373,4683,4690,99.9
'35010, 전주시,'060002, 56세,2019,9971,4967,5004,99.3,9882,4923,4959,99.3
'35010, 전주시,'060003, 57세,2019,10111,5042,5069,99.5,10036,5006,5030,99.5
'35010, 전주시,'060004, 58세,2019,10778,5244,5534,94.8,10725,5222,5503,94.9
'35010, 전주시,'060005, 59세,2019,11316,5525,5791,95.4,11237,5492,5745,95.6
'35010, 전주시,'065,60~64세,2019,41987,20376,21611,94.3,41744,20275,21469,94.4
'35010, 전주시,'065001, 60세,2019,9521,4542,4979,91.2,9483,4526,4957,91.3
'35010, 전주시,'065002, 61세,2019,8199,4028,4171,96.6,8132,4003,4129,96.9
'35010, 전주시,'065003, 62세,2019,8488,4113,4375,94,8440,4090,4350,94
'35010, 전주시,'065004, 63세,2019,7605,3725,3880,96,7562,3709,3853,96.3
'35010, 전주시,'065005, 64세,2019,8174,3968,4206,94.3,8127,3947,4180,94.4
'35010, 전주시,'070,65~69세,2019,30014,14325,15689,91.3,29914,14284,15630,91.4
'35010, 전주시,'070001, 65세,2019,6881,3318,3563,93.1,6846,3307,3539,93.4
'35010, 전주시,'070002, 66세,2019,5759,2696,3063,88,5736,2682,3054,87.8
'35010, 전주시,'070003, 67세,2019,6179,2988,3191,93.6,6168,2984,3184,93.7
'35010, 전주시,'070004, 68세,2019,5165,2505,2660,94.2,5147,2500,2647,94.4
'35010, 전주시,'070005, 69세,2019,6030,2818,3212,87.7,6017,2811,3206,87.7
'35010, 전주시,'075,70~74세,2019,23453,10792,12661,85.2,23391,10766,12625,85.3
'35010, 전주시,'075001, 70세,2019,5309,2400,2909,82.5,5292,2398,2894,82.9
'35010, 전주시,'075002, 71세,2019,5102,2354,2748,85.7,5090,2347,2743,85.6
'35010, 전주시,'075003, 72세,2019,5447,2560,2887,88.7,5428,2549,2879,88.5
'35010, 전주시,'075004, 73세,2019,4099,1923,2176,88.4,4090,1919,2171,88.4
'35010, 전주시,'075005, 74세,2019,3496,1555,1941,80.1,3491,1553,1938,80.1
'35010, 전주시,'080,75~79세,2019,18403,7832,10571,74.1,18378,7823,10555,74.1
'35010, 전주시,'080001, 75세,2019,3507,1576,1931,81.6,3500,1574,1926,81.7
'35010, 전주시,'080002, 76세,2019,3592,1537,2055,74.8,3589,1537,2052,74.9
'35010, 전주시,'080003, 77세,2019,4994,2114,2880,73.4,4987,2111,2876,73.4
'35010, 전주시,'080004, 78세,2019,3323,1387,1936,71.6,3319,1385,1934,71.6
'35010, 전주시,'080005, 79세,2019,2987,1218,1769,68.9,2983,1216,1767,68.8
'35010, 전주시,'085,80~84세,2019,12845,4799,8046,59.6,12828,4798,8030,59.8
'35010, 전주시,'085001, 80세,2019,3108,1270,1838,69.1,3103,1270,1833,69.3
'35010, 전주시,'085002, 81세,2019,2761,1045,1716,60.9,2758,1045,1713,61
'35010, 전주시,'085003, 82세,2019,2591,972,1619,60,2585,971,1614,60.2
'35010, 전주시,'085004, 83세,2019,2234,779,1455,53.5,2233,779,1454,53.6
'35010, 전주시,'085005, 84세,2019,2151,733,1418,51.7,2149,733,1416,51.8
'35010, 전주시,'086,85세이상,2019,9161,2487,6674,37.3,9147,2481,6666,37.2
'35010, 전주시,'090,85~89세,2019,6441,1884,4557,41.3,6432,1879,4553,41.3
'35010, 전주시,'090001, 85세,2019,1810,576,1234,46.7,1810,576,1234,46.7
'35010, 전주시,'090002, 86세,2019,1483,450,1033,43.6,1480,447,1033,43.3
'35010, 전주시,'090003, 87세,2019,1288,365,923,39.5,1287,365,922,39.6
'35010, 전주시,'090004, 88세,2019,987,280,707,39.6,983,278,705,39.4
'35010, 전주시,'090005, 89세,2019,873,213,660,32.3,872,213,659,32.3
'35010, 전주시,'095,90~94세,2019,2186,521,1665,31.3,2183,520,1663,31.3
'35010, 전주시,'095001, 90세,2019,717,184,533,34.5,715,184,531,34.7
'35010, 전주시,'095002, 91세,2019,580,143,437,32.7,580,143,437,32.7
'35010, 전주시,'095003, 92세,2019,443,111,332,33.4,442,110,332,33.1
'35010, 전주시,'095004, 93세,2019,261,46,215,21.4,261,46,215,21.4
'35010, 전주시,'095005, 94세,2019,185,37,148,25,185,37,148,25
'35010, 전주시,'100,95~99세,2019,454,73,381,19.2,453,73,380,19.2
'35010, 전주시,'100001, 95세,2019,115,23,92,25,115,23,92,25
'35010, 전주시,'100002, 96세,2019,138,22,116,19,138,22,116,19
'35010, 전주시,'100003, 97세,2019,107,19,88,21.6,107,19,88,21.6
'35010, 전주시,'100004, 98세,2019,53,X,49,8.2,53,X,49,8.2
'35010, 전주시,'100005, 99세,2019,41,5,36,13.9,40,5,35,14.3
'35010, 전주시,'101,100세이상,2019,80,9,71,12.7,79,9,70,12.9
'35010, 전주시,'102,15세미만,2019,88825,45795,43030,106.4,88465,45596,42869,106.4
'35010, 전주시,'103,15~64세,2019,479385,241230,238155,101.3,468969,236277,232692,101.5
'35010, 전주시,'104,65세이상,2019,93876,40235,53641,75,93658,40152,53506,75
'35010, 전주시,'126,평균연령,2019,41,39.8,42.2,,41.2,39.9,42.4,
'35010, 전주시,'127,중위연령,2019,41.9,40.4,43.3,,42.2,40.7,43.6,
'35011, 완산구,'000,합계,2019,341123,166781,174342,95.7,336237,164451,171786,95.7
'35011, 완산구,'005,0~4세,2019,10694,5486,5208,105.3,10642,5457,5185,105.2
'35011, 완산구,'005001, 0세,2019,1589,816,773,105.6,1572,805,767,105
'35011, 완산구,'005002, 1세,2019,1830,969,861,112.5,1821,965,856,112.7
'35011, 완산구,'005003, 2세,2019,2171,1107,1064,104,2159,1099,1060,103.7
'35011, 완산구,'005004, 3세,2019,2473,1300,1173,110.8,2467,1298,1169,111
'35011, 완산구,'005005, 4세,2019,2631,1294,1337,96.8,2623,1290,1333,96.8
'35011, 완산구,'010,5~9세,2019,14801,7647,7154,106.9,14776,7629,7147,106.7
'35011, 완산구,'010001, 5세,2019,2697,1415,1282,110.4,2694,1414,1280,110.5
'35011, 완산구,'010002, 6세,2019,2772,1429,1343,106.4,2767,1425,1342,106.2
'35011, 완산구,'010003, 7세,2019,3104,1574,1530,102.9,3097,1568,1529,102.6
'35011, 완산구,'010004, 8세,2019,3127,1588,1539,103.2,3124,1586,1538,103.1
'35011, 완산구,'010005, 9세,2019,3101,1641,1460,112.4,3094,1636,1458,112.2
'35011, 완산구,'015,10~14세,2019,15998,8328,7670,108.6,15984,8322,7662,108.6
'35011, 완산구,'015001, 10세,2019,2993,1565,1428,109.6,2988,1562,1426,109.5
'35011, 완산구,'015002, 11세,2019,3169,1641,1528,107.4,3164,1641,1523,107.7
'35011, 완산구,'015003, 12세,2019,3338,1718,1620,106,3337,1717,1620,106
'35011, 완산구,'015004, 13세,2019,3160,1643,1517,108.3,3158,1641,1517,108.2
'35011, 완산구,'015005, 14세,2019,3338,1761,1577,111.7,3337,1761,1576,111.7
'35011, 완산구,'020,15~19세,2019,22937,12066,10871,111,22478,11820,10658,110.9
'35011, 완산구,'020001, 15세,2019,3689,1917,1772,108.2,3682,1913,1769,108.1
'35011, 완산구,'020002, 16세,2019,4195,2283,1912,119.4,4188,2280,1908,119.5
'35011, 완산구,'020003, 17세,2019,4560,2463,2097,117.5,4549,2457,2092,117.4
'35011, 완산구,'020004, 18세,2019,5112,2673,2439,109.6,4994,2610,2384,109.5
'35011, 완산구,'020005, 19세,2019,5381,2730,2651,103,5065,2560,2505,102.2
'35011, 완산구,'025,20~24세,2019,27144,14110,13034,108.3,25766,13357,12409,107.6
'35011, 완산구,'025001, 20세,2019,5366,2757,2609,105.7,4990,2546,2444,104.2
'35011, 완산구,'025002, 21세,2019,5672,2923,2749,106.3,5349,2747,2602,105.6
'35011, 완산구,'025003, 22세,2019,5590,2860,2730,104.8,5307,2695,2612,103.2
'35011, 완산구,'025004, 23세,2019,5383,2859,2524,113.3,5165,2754,2411,114.2
'35011, 완산구,'025005, 24세,2019,5133,2711,2422,111.9,4955,2615,2340,111.8
'35011, 완산구,'030,25~29세,2019,22668,11801,10867,108.6,21960,11499,10461,109.9
'35011, 완산구,'030001, 25세,2019,5057,2648,2409,109.9,4891,2577,2314,111.4
'35011, 완산구,'030002, 26세,2019,4690,2416,2274,106.2,4554,2352,2202,106.8
'35011, 완산구,'030003, 27세,2019,4705,2405,2300,104.6,4562,2347,2215,106
'35011, 완산구,'030004, 28세,2019,4315,2269,2046,110.9,4182,2217,1965,112.8
'35011, 완산구,'030005, 29세,2019,3901,2063,1838,112.2,3771,2006,1765,113.7
'35011, 완산구,'035,30~34세,2019,18230,9281,8949,103.7,17635,9034,8601,105
'35011, 완산구,'035001, 30세,2019,3706,1927,1779,108.3,3586,1874,1712,109.5
'35011, 완산구,'035002, 31세,2019,3658,1825,1833,99.6,3529,1779,1750,101.7
'35011, 완산구,'035003, 32세,2019,3635,1841,1794,102.6,3514,1790,1724,103.8
'35011, 완산구,'035004, 33세,2019,3615,1854,1761,105.3,3502,1803,1699,106.1
'35011, 완산구,'035005, 34세,2019,3616,1834,1782,102.9,3504,1788,1716,104.2
'35011, 완산구,'040,35~39세,2019,22103,10966,11137,98.5,21693,10804,10889,99.2
'35011, 완산구,'040001, 35세,2019,4004,1984,2020,98.2,3915,1942,1973,98.4
'35011, 완산구,'040002, 36세,2019,4246,2127,2119,100.4,4168,2099,2069,101.4
'35011, 완산구,'040003, 37세,2019,4555,2253,2302,97.9,4470,2218,2252,98.5
'35011, 완산구,'040004, 38세,2019,4453,2262,2191,103.2,4375,2238,2137,104.7
'35011, 완산구,'040005, 39세,2019,4845,2340,2505,93.4,4765,2307,2458,93.9
'35011, 완산구,'045,40~44세,2019,23718,11404,12314,92.6,23415,11256,12159,92.6
'35011, 완산구,'045001, 40세,2019,4642,2288,2354,97.2,4565,2247,2318,96.9
'35011, 완산구,'045002, 41세,2019,4483,2194,2289,95.8,4426,2173,2253,96.4
'35011, 완산구,'045003, 42세,2019,4764,2266,2498,90.7,4707,2241,2466,90.9
'35011, 완산구,'045004, 43세,2019,4713,2241,2472,90.7,4657,2204,2453,89.8
'35011, 완산구,'045005, 44세,2019,5116,2415,2701,89.4,5060,2391,2669,89.6
'35011, 완산구,'050,45~49세,2019,30528,14670,15858,92.5,30251,14534,15717,92.5
'35011, 완산구,'050001, 45세,2019,5918,2773,3145,88.2,5852,2744,3108,88.3
'35011, 완산구,'050002, 46세,2019,5937,2760,3177,86.9,5879,2733,3146,86.9
'35011, 완산구,'050003, 47세,2019,5859,2839,3020,94,5815,2815,3000,93.8
'35011, 완산구,'050004, 48세,2019,6563,3187,3376,94.4,6518,3160,3358,94.1
'35011, 완산구,'050005, 49세,2019,6251,3111,3140,99.1,6187,3082,3105,99.3
'35011, 완산구,'055,50~54세,2019,29461,14293,15168,94.2,29184,14173,15011,94.4
'35011, 완산구,'055001, 50세,2019,6168,2968,3200,92.8,6111,2942,3169,92.8
'35011, 완산구,'055002, 51세,2019,6212,3038,3174,95.7,6159,3017,3142,96
'35011, 완산구,'055003, 52세,2019,5650,2740,2910,94.2,5602,2721,2881,94.4
'35011, 완산구,'055004, 53세,2019,5664,2757,2907,94.8,5605,2733,2872,95.2
'35011, 완산구,'055005, 54세,2019,5767,2790,2977,93.7,5707,2760,2947,93.7
'35011, 완산구,'060,55~59세,2019,28171,13646,14525,93.9,27983,13560,14423,94
'35011, 완산구,'060001, 55세,2019,5163,2538,2625,96.7,5112,2518,2594,97.1
'35011, 완산구,'060002, 56세,2019,5460,2630,2830,92.9,5425,2612,2813,92.9
'35011, 완산구,'060003, 57세,2019,5455,2715,2740,99.1,5423,2698,2725,99
'35011, 완산구,'060004, 58세,2019,5983,2850,3133,91,5956,2839,3117,91.1
'35011, 완산구,'060005, 59세,2019,6110,2913,3197,91.1,6067,2893,3174,91.1
'35011, 완산구,'065,60~64세,2019,23259,11203,12056,92.9,23155,11161,11994,93.1
'35011, 완산구,'065001, 60세,2019,5258,2472,2786,88.7,5245,2466,2779,88.7
'35011, 완산구,'065002, 61세,2019,4579,2229,2350,94.9,4551,2220,2331,95.2
'35011, 완산구,'065003, 62세,2019,4764,2292,2472,92.7,4748,2283,2465,92.6
'35011, 완산구,'065004, 63세,2019,4163,2021,2142,94.4,4140,2012,2128,94.5
'35011, 완산구,'065005, 64세,2019,4495,2189,2306,94.9,4471,2180,2291,95.2
'35011, 완산구,'070,65~69세,2019,16563,7873,8690,90.6,16525,7859,8666,90.7
'35011, 완산구,'070001, 65세,2019,3855,1864,1991,93.6,3839,1860,1979,94
'35011, 완산구,'070002, 66세,2019,3157,1450,1707,84.9,3151,1447,1704,84.9
'35011, 완산구,'070003, 67세,2019,3442,1678,1764,95.1,3436,1677,1759,95.3
'35011, 완산구,'070004, 68세,2019,2791,1331,1460,91.2,2787,1329,1458,91.2
'35011, 완산구,'070005, 69세,2019,3318,1550,1768,87.7,3312,1546,1766,87.5
'35011, 완산구,'075,70~74세,2019,12737,5906,6831,86.5,12706,5891,6815,86.4
'35011, 완산구,'075001, 70세,2019,2925,1325,1600,82.8,2917,1324,1593,83.1
'35011, 완산구,'075002, 71세,2019,2756,1311,1445,90.7,2751,1307,1444,90.5
'35011, 완산구,'075003, 72세,2019,2963,1392,1571,88.6,2953,1387,1566,88.6
'35011, 완산구,'075004, 73세,2019,2201,1051,1150,91.4,2195,1047,1148,91.2
'35011, 완산구,'075005, 74세,2019,1892,827,1065,77.7,1890,826,1064,77.6
'35011, 완산구,'080,75~79세,2019,9887,4166,5721,72.8,9875,4163,5712,72.9
'35011, 완산구,'080001, 75세,2019,1866,834,1032,80.8,1863,833,1030,80.9
'35011, 완산구,'080002, 76세,2019,1974,840,1134,74.1,1973,840,1133,74.1
'35011, 완산구,'080003, 77세,2019,2659,1112,1547,71.9,2654,1111,1543,72
'35011, 완산구,'080004, 78세,2019,1801,738,1063,69.4,1800,737,1063,69.3
'35011, 완산구,'080005, 79세,2019,1587,642,945,67.9,1585,642,943,68.1
'35011, 완산구,'085,80~84세,2019,6982,2546,4436,57.4,6974,2546,4428,57.5
'35011, 완산구,'085001, 80세,2019,1659,675,984,68.6,1654,675,979,68.9
'35011, 완산구,'085002, 81세,2019,1493,542,951,57,1493,542,951,57
'35011, 완산구,'085003, 82세,2019,1420,536,884,60.6,1419,536,883,60.7
'35011, 완산구,'085004, 83세,2019,1208,403,805,50.1,1207,403,804,50.1
'35011, 완산구,'085005, 84세,2019,1202,390,812,48,1201,390,811,48.1
'35011, 완산구,'086,85세이상,2019,5242,1389,3853,36,5235,1386,3849,36
'35011, 완산구,'090,85~89세,2019,3650,1053,2597,40.5,3647,1051,2596,40.5
'35011, 완산구,'090001, 85세,2019,1030,326,704,46.3,1030,326,704,46.3
'35011, 완산구,'090002, 86세,2019,827,244,583,41.9,825,242,583,41.5
'35011, 완산구,'090003, 87세,2019,738,213,525,40.6,738,213,525,40.6
'35011, 완산구,'090004, 88세,2019,549,147,402,36.6,549,147,402,36.6
'35011, 완산구,'090005, 89세,2019,506,123,383,32.1,505,123,382,32.2
'35011, 완산구,'095,90~94세,2019,1269,295,974,30.3,1267,294,973,30.2
'35011, 완산구,'095001, 90세,2019,393,107,286,37.4,392,107,285,37.5
'35011, 완산구,'095002, 91세,2019,337,74,263,28.1,337,74,263,28.1
'35011, 완산구,'095003, 92세,2019,270,63,207,30.4,269,62,207,30
'35011, 완산구,'095004, 93세,2019,162,29,133,21.8,162,29,133,21.8
'35011, 완산구,'095005, 94세,2019,107,22,85,25.9,107,22,85,25.9
'35011, 완산구,'100,95~99세,2019,269,35,234,15,268,35,233,15
'35011, 완산구,'100001, 95세,2019,68,11,57,19.3,68,11,57,19.3
'35011, 완산구,'100002, 96세,2019,86,11,75,14.7,86,11,75,14.7
'35011, 완산구,'100003, 97세,2019,59,10,49,20.4,59,10,49,20.4
'35011, 완산구,'100004, 98세,2019,33,X,31,6.5,33,X,31,6.5
'35011, 완산구,'100005, 99세,2019,23,X,22,4.5,22,X,21,4.8
'35011, 완산구,'101,100세이상,2019,54,6,48,12.5,53,6,47,12.8
'35011, 완산구,'102,15세미만,2019,41493,21461,20032,107.1,41402,21408,19994,107.1
'35011, 완산구,'103,15~64세,2019,248219,123440,124779,98.9,243520,121198,122322,99.1
'35011, 완산구,'104,65세이상,2019,51411,21880,29531,74.1,51315,21845,29470,74.1
'35011, 완산구,'126,평균연령,2019,42,40.6,43.3,,42.1,40.7,43.5,
'35011, 완산구,'127,중위연령,2019,43.4,41.6,45,,43.7,41.9,45.2,
'35012, 덕진구,'000,합계,2019,320963,160479,160484,100,314855,157574,157281,100.2
'35012, 덕진구,'005,0~4세,2019,13338,6815,6523,104.5,13184,6727,6457,104.2
'35012, 덕진구,'005001, 0세,2019,2091,1054,1037,101.6,2055,1032,1023,100.9
'35012, 덕진구,'005002, 1세,2019,2308,1151,1157,99.5,2279,1133,1146,98.9
'35012, 덕진구,'005003, 2세,2019,2620,1355,1265,107.1,2588,1338,1250,107
'35012, 덕진구,'005004, 3세,2019,3012,1562,1450,107.7,2979,1544,1435,107.6
'35012, 덕진구,'005005, 4세,2019,3307,1693,1614,104.9,3283,1680,1603,104.8
'35012, 덕진구,'010,5~9세,2019,17277,8792,8485,103.6,17185,8744,8441,103.6
'35012, 덕진구,'010001, 5세,2019,3244,1639,1605,102.1,3218,1630,1588,102.6
'35012, 덕진구,'010002, 6세,2019,3396,1775,1621,109.5,3382,1766,1616,109.3
'35012, 덕진구,'010003, 7세,2019,3647,1829,1818,100.6,3626,1815,1811,100.2
'35012, 덕진구,'010004, 8세,2019,3548,1789,1759,101.7,3534,1783,1751,101.8
'35012, 덕진구,'010005, 9세,2019,3442,1760,1682,104.6,3425,1750,1675,104.5
'35012, 덕진구,'015,10~14세,2019,16717,8727,7990,109.2,16694,8717,7977,109.3
'35012, 덕진구,'015001, 10세,2019,3259,1652,1607,102.8,3251,1647,1604,102.7
'35012, 덕진구,'015002, 11세,2019,3484,1797,1687,106.5,3480,1796,1684,106.7
'35012, 덕진구,'015003, 12세,2019,3589,1910,1679,113.8,3585,1909,1676,113.9
'35012, 덕진구,'015004, 13세,2019,3216,1685,1531,110.1,3214,1684,1530,110.1
'35012, 덕진구,'015005, 14세,2019,3169,1683,1486,113.3,3164,1681,1483,113.4
'35012, 덕진구,'020,15~19세,2019,19529,9845,9684,101.7,19312,9743,9569,101.8
'35012, 덕진구,'020001, 15세,2019,3370,1660,1710,97.1,3360,1655,1705,97.1
'35012, 덕진구,'020002, 16세,2019,3234,1559,1675,93.1,3227,1555,1672,93
'35012, 덕진구,'020003, 17세,2019,3328,1644,1684,97.6,3317,1636,1681,97.3
'35012, 덕진구,'020004, 18세,2019,4128,2082,2046,101.8,4073,2053,2020,101.6
'35012, 덕진구,'020005, 19세,2019,5469,2900,2569,112.9,5335,2844,2491,114.2
'35012, 덕진구,'025,20~24세,2019,26284,14385,11899,120.9,24789,13684,11105,123.2
'35012, 덕진구,'025001, 20세,2019,5001,2685,2316,115.9,4736,2578,2158,119.5
'35012, 덕진구,'025002, 21세,2019,5196,2778,2418,114.9,4875,2632,2243,117.3
'35012, 덕진구,'025003, 22세,2019,5392,2911,2481,117.3,5064,2749,2315,118.7
'35012, 덕진구,'025004, 23세,2019,5500,3079,2421,127.2,5219,2940,2279,129
'35012, 덕진구,'025005, 24세,2019,5195,2932,2263,129.6,4895,2785,2110,132
'35012, 덕진구,'030,25~29세,2019,21805,11763,10042,117.1,20588,11171,9417,118.6
'35012, 덕진구,'030001, 25세,2019,4930,2769,2161,128.1,4647,2634,2013,130.8
'35012, 덕진구,'030002, 26세,2019,4608,2577,2031,126.9,4330,2438,1892,128.9
'35012, 덕진구,'030003, 27세,2019,4385,2320,2065,112.3,4145,2214,1931,114.7
'35012, 덕진구,'030004, 28세,2019,4044,2079,1965,105.8,3828,1971,1857,106.1
'35012, 덕진구,'030005, 29세,2019,3838,2018,1820,110.9,3638,1914,1724,111
'35012, 덕진구,'035,30~34세,2019,18854,9527,9327,102.1,18007,9124,8883,102.7
'35012, 덕진구,'035001, 30세,2019,3674,1895,1779,106.5,3471,1796,1675,107.2
'35012, 덕진구,'035002, 31세,2019,3628,1880,1748,107.6,3446,1787,1659,107.7
'35012, 덕진구,'035003, 32세,2019,3725,1837,1888,97.3,3555,1756,1799,97.6
'35012, 덕진구,'035004, 33세,2019,3880,1911,1969,97.1,3726,1841,1885,97.7
'35012, 덕진구,'035005, 34세,2019,3947,2004,1943,103.1,3809,1944,1865,104.2
'35012, 덕진구,'040,35~39세,2019,24573,12262,12311,99.6,23999,11970,12029,99.5
'35012, 덕진구,'040001, 35세,2019,4214,2098,2116,99.1,4072,2019,2053,98.3
'35012, 덕진구,'040002, 36세,2019,4738,2396,2342,102.3,4606,2335,2271,102.8
'35012, 덕진구,'040003, 37세,2019,5215,2575,2640,97.5,5106,2522,2584,97.6
'35012, 덕진구,'040004, 38세,2019,5045,2510,2535,99,4955,2462,2493,98.8
'35012, 덕진구,'040005, 39세,2019,5361,2683,2678,100.2,5260,2632,2628,100.2
'35012, 덕진구,'045,40~44세,2019,25003,12390,12613,98.2,24644,12229,12415,98.5
'35012, 덕진구,'045001, 40세,2019,5176,2573,2603,98.8,5095,2531,2564,98.7
'35012, 덕진구,'045002, 41세,2019,4866,2343,2523,92.9,4792,2313,2479,93.3
'35012, 덕진구,'045003, 42세,2019,4971,2505,2466,101.6,4905,2479,2426,102.2
'35012, 덕진구,'045004, 43세,2019,4930,2434,2496,97.5,4866,2405,2461,97.7
'35012, 덕진구,'045005, 44세,2019,5060,2535,2525,100.4,4986,2501,2485,100.6
'35012, 덕진구,'050,45~49세,2019,27727,14035,13692,102.5,27347,13862,13485,102.8
'35012, 덕진구,'050001, 45세,2019,5598,2831,2767,102.3,5529,2799,2730,102.5
'35012, 덕진구,'050002, 46세,2019,5557,2728,2829,96.4,5475,2696,2779,97
'35012, 덕진구,'050003, 47세,2019,5437,2813,2624,107.2,5357,2768,2589,106.9
'35012, 덕진구,'050004, 48세,2019,5737,2977,2760,107.9,5663,2945,2718,108.4
'35012, 덕진구,'050005, 49세,2019,5398,2686,2712,99,5323,2654,2669,99.4
'35012, 덕진구,'055,50~54세,2019,25189,12550,12639,99.3,24904,12416,12488,99.4
'35012, 덕진구,'055001, 50세,2019,5389,2680,2709,98.9,5333,2651,2682,98.8
'35012, 덕진구,'055002, 51세,2019,5274,2607,2667,97.8,5203,2572,2631,97.8
'35012, 덕진구,'055003, 52세,2019,4848,2438,2410,101.2,4797,2413,2384,101.2
'35012, 덕진구,'055004, 53세,2019,4899,2479,2420,102.4,4845,2454,2391,102.6
'35012, 덕진구,'055005, 54세,2019,4779,2346,2433,96.4,4726,2326,2400,96.9
'35012, 덕진구,'060,55~59세,2019,23474,11860,11614,102.1,23270,11766,11504,102.3
'35012, 덕진구,'060001, 55세,2019,4306,2190,2116,103.5,4261,2165,2096,103.3
'35012, 덕진구,'060002, 56세,2019,4511,2337,2174,107.5,4457,2311,2146,107.7
'35012, 덕진구,'060003, 57세,2019,4656,2327,2329,99.9,4613,2308,2305,100.1
'35012, 덕진구,'060004, 58세,2019,4795,2394,2401,99.7,4769,2383,2386,99.9
'35012, 덕진구,'060005, 59세,2019,5206,2612,2594,100.7,5170,2599,2571,101.1
'35012, 덕진구,'065,60~64세,2019,18728,9173,9555,96,18589,9114,9475,96.2
'35012, 덕진구,'065001, 60세,2019,4263,2070,2193,94.4,4238,2060,2178,94.6
'35012, 덕진구,'065002, 61세,2019,3620,1799,1821,98.8,3581,1783,1798,99.2
'35012, 덕진구,'065003, 62세,2019,3724,1821,1903,95.7,3692,1807,1885,95.9
'35012, 덕진구,'065004, 63세,2019,3442,1704,1738,98,3422,1697,1725,98.4
'35012, 덕진구,'065005, 64세,2019,3679,1779,1900,93.6,3656,1767,1889,93.5
'35012, 덕진구,'070,65~69세,2019,13451,6452,6999,92.2,13389,6425,6964,92.3
'35012, 덕진구,'070001, 65세,2019,3026,1454,1572,92.5,3007,1447,1560,92.8
'35012, 덕진구,'070002, 66세,2019,2602,1246,1356,91.9,2585,1235,1350,91.5
'35012, 덕진구,'070003, 67세,2019,2737,1310,1427,91.8,2732,1307,1425,91.7
'35012, 덕진구,'070004, 68세,2019,2374,1174,1200,97.8,2360,1171,1189,98.5
'35012, 덕진구,'070005, 69세,2019,2712,1268,1444,87.8,2705,1265,1440,87.8
'35012, 덕진구,'075,70~74세,2019,10716,4886,5830,83.8,10685,4875,5810,83.9
'35012, 덕진구,'075001, 70세,2019,2384,1075,1309,82.1,2375,1074,1301,82.6
'35012, 덕진구,'075002, 71세,2019,2346,1043,1303,80,2339,1040,1299,80.1
'35012, 덕진구,'075003, 72세,2019,2484,1168,1316,88.8,2475,1162,1313,88.5
'35012, 덕진구,'075004, 73세,2019,1898,872,1026,85,1895,872,1023,85.2
'35012, 덕진구,'075005, 74세,2019,1604,728,876,83.1,1601,727,874,83.2
'35012, 덕진구,'080,75~79세,2019,8516,3666,4850,75.6,8503,3660,4843,75.6
'35012, 덕진구,'080001, 75세,2019,1641,742,899,82.5,1637,741,896,82.7
'35012, 덕진구,'080002, 76세,2019,1618,697,921,75.7,1616,697,919,75.8
'35012, 덕진구,'080003, 77세,2019,2335,1002,1333,75.2,2333,1000,1333,75
'35012, 덕진구,'080004, 78세,2019,1522,649,873,74.3,1519,648,871,74.4
'35012, 덕진구,'080005, 79세,2019,1400,576,824,69.9,1398,574,824,69.7
'35012, 덕진구,'085,80~84세,2019,5863,2253,3610,62.4,5854,2252,3602,62.5
'35012, 덕진구,'085001, 80세,2019,1449,595,854,69.7,1449,595,854,69.7
'35012, 덕진구,'085002, 81세,2019,1268,503,765,65.8,1265,503,762,66
'35012, 덕진구,'085003, 82세,2019,1171,436,735,59.3,1166,435,731,59.5
'35012, 덕진구,'085004, 83세,2019,1026,376,650,57.8,1026,376,650,57.8
'35012, 덕진구,'085005, 84세,2019,949,343,606,56.6,948,343,605,56.7
'35012, 덕진구,'086,85세이상,2019,3919,1098,2821,38.9,3912,1095,2817,38.9
'35012, 덕진구,'090,85~89세,2019,2791,831,1960,42.4,2785,828,1957,42.3
'35012, 덕진구,'090001, 85세,2019,780,250,530,47.2,780,250,530,47.2
'35012, 덕진구,'090002, 86세,2019,656,206,450,45.8,655,205,450,45.6
'35012, 덕진구,'090003, 87세,2019,550,152,398,38.2,549,152,397,38.3
'35012, 덕진구,'090004, 88세,2019,438,133,305,43.6,434,131,303,43.2
'35012, 덕진구,'090005, 89세,2019,367,90,277,32.5,367,90,277,32.5
'35012, 덕진구,'095,90~94세,2019,917,226,691,32.7,916,226,690,32.8
'35012, 덕진구,'095001, 90세,2019,324,77,247,31.2,323,77,246,31.3
'35012, 덕진구,'095002, 91세,2019,243,69,174,39.7,243,69,174,39.7
'35012, 덕진구,'095003, 92세,2019,173,48,125,38.4,173,48,125,38.4
'35012, 덕진구,'095004, 93세,2019,99,17,82,20.7,99,17,82,20.7
'35012, 덕진구,'095005, 94세,2019,78,15,63,23.8,78,15,63,23.8
'35012, 덕진구,'100,95~99세,2019,185,38,147,25.9,185,38,147,25.9
'35012, 덕진구,'100001, 95세,2019,47,12,35,34.3,47,12,35,34.3
'35012, 덕진구,'100002, 96세,2019,52,11,41,26.8,52,11,41,26.8
'35012, 덕진구,'100003, 97세,2019,48,9,39,23.1,48,9,39,23.1
'35012, 덕진구,'100004, 98세,2019,20,X,18,11.1,20,X,18,11.1
'35012, 덕진구,'100005, 99세,2019,18,X,14,28.6,18,X,14,28.6
'35012, 덕진구,'101,100세이상,2019,26,X,23,13,26,X,23,13
'35012, 덕진구,'102,15세미만,2019,47332,24334,22998,105.8,47063,24188,22875,105.7
'35012, 덕진구,'103,15~64세,2019,231166,117790,113376,103.9,225449,115079,110370,104.3
'35012, 덕진구,'104,65세이상,2019,42465,18355,24110,76.1,42343,18307,24036,76.2
'35012, 덕진구,'126,평균연령,2019,40,38.9,41.1,,40.2,39.1,41.3,
'35012, 덕진구,'127,중위연령,2019,40.4,39.3,41.5,,40.7,39.6,41.9,
'35020, 군산시,'000,합계,2019,270635,138144,132491,104.3,262499,132902,129597,102.6
'35020, 군산시,'005,0~4세,2019,9527,4797,4730,101.4,9463,4762,4701,101.3
'35020, 군산시,'005001, 0세,2019,1363,686,677,101.3,1354,682,672,101.5
'35020, 군산시,'005002, 1세,2019,1652,836,816,102.5,1641,830,811,102.3
'35020, 군산시,'005003, 2세,2019,1870,940,930,101.1,1852,929,923,100.7
'35020, 군산시,'005004, 3세,2019,2181,1084,1097,98.8,2171,1080,1091,99
'35020, 군산시,'005005, 4세,2019,2461,1251,1210,103.4,2445,1241,1204,103.1
'35020, 군산시,'010,5~9세,2019,13004,6678,6326,105.6,12966,6657,6309,105.5
'35020, 군산시,'010001, 5세,2019,2427,1272,1155,110.1,2419,1267,1152,110
'35020, 군산시,'010002, 6세,2019,2607,1330,1277,104.2,2597,1324,1273,104
'35020, 군산시,'010003, 7세,2019,2684,1379,1305,105.7,2674,1373,1301,105.5
'35020, 군산시,'010004, 8세,2019,2733,1423,1310,108.6,2727,1420,1307,108.6
'35020, 군산시,'010005, 9세,2019,2553,1274,1279,99.6,2549,1273,1276,99.8
'35020, 군산시,'015,10~14세,2019,12331,6380,5951,107.2,12295,6366,5929,107.4
'35020, 군산시,'015001, 10세,2019,2480,1266,1214,104.3,2471,1260,1211,104
'35020, 군산시,'015002, 11세,2019,2496,1338,1158,115.5,2486,1335,1151,116
'35020, 군산시,'015003, 12세,2019,2622,1317,1305,100.9,2617,1316,1301,101.2
'35020, 군산시,'015004, 13세,2019,2397,1238,1159,106.8,2390,1237,1153,107.3
'35020, 군산시,'015005, 14세,2019,2336,1221,1115,109.5,2331,1218,1113,109.4
'35020, 군산시,'020,15~19세,2019,14963,7862,7101,110.7,14756,7754,7002,110.7
'35020, 군산시,'020001, 15세,2019,2568,1305,1263,103.3,2559,1300,1259,103.3
'35020, 군산시,'020002, 16세,2019,2596,1323,1273,103.9,2586,1317,1269,103.8
'35020, 군산시,'020003, 17세,2019,2674,1388,1286,107.9,2663,1384,1279,108.2
'35020, 군산시,'020004, 18세,2019,3300,1736,1564,111,3254,1713,1541,111.2
'35020, 군산시,'020005, 19세,2019,3825,2110,1715,123,3694,2040,1654,123.3
'35020, 군산시,'025,20~24세,2019,18242,10442,7800,133.9,17055,9642,7413,130.1
'35020, 군산시,'025001, 20세,2019,3647,2022,1625,124.4,3464,1921,1543,124.5
'35020, 군산시,'025002, 21세,2019,3722,2037,1685,120.9,3513,1894,1619,117
'35020, 군산시,'025003, 22세,2019,3741,2153,1588,135.6,3532,2005,1527,131.3
'35020, 군산시,'025004, 23세,2019,3664,2186,1478,147.9,3354,1973,1381,142.9
'35020, 군산시,'025005, 24세,2019,3468,2044,1424,143.5,3192,1849,1343,137.7
'35020, 군산시,'030,25~29세,2019,14823,8381,6442,130.1,13300,7309,5991,122
'35020, 군산시,'030001, 25세,2019,3175,1887,1288,146.5,2901,1690,1211,139.6
'35020, 군산시,'030002, 26세,2019,3046,1696,1350,125.6,2776,1512,1264,119.6
'35020, 군산시,'030003, 27세,2019,3075,1691,1384,122.2,2766,1470,1296,113.4
'35020, 군산시,'030004, 28세,2019,2783,1578,1205,131,2431,1330,1101,120.8
'35020, 군산시,'030005, 29세,2019,2744,1529,1215,125.8,2426,1307,1119,116.8
'35020, 군산시,'035,30~34세,2019,14339,7808,6531,119.6,12886,6743,6143,109.8
'35020, 군산시,'035001, 30세,2019,2754,1502,1252,120,2451,1287,1164,110.6
'35020, 군산시,'035002, 31세,2019,2744,1485,1259,118,2424,1256,1168,107.5
'35020, 군산시,'035003, 32세,2019,2852,1586,1266,125.3,2536,1347,1189,113.3
'35020, 군산시,'035004, 33세,2019,2949,1622,1327,122.2,2675,1420,1255,113.1
'35020, 군산시,'035005, 34세,2019,3040,1613,1427,113,2800,1433,1367,104.8
'35020, 군산시,'040,35~39세,2019,19945,10586,9359,113.1,18907,9887,9020,109.6
'35020, 군산시,'040001, 35세,2019,3334,1785,1549,115.2,3099,1620,1479,109.5
'35020, 군산시,'040002, 36세,2019,3763,1994,1769,112.7,3531,1835,1696,108.2
'35020, 군산시,'040003, 37세,2019,4362,2306,2056,112.2,4141,2148,1993,107.8
'35020, 군산시,'040004, 38세,2019,4182,2205,1977,111.5,4008,2100,1908,110.1
'35020, 군산시,'040005, 39세,2019,4304,2296,2008,114.3,4128,2184,1944,112.3
'35020, 군산시,'045,40~44세,2019,20205,10542,9663,109.1,19493,10118,9375,107.9
'35020, 군산시,'045001, 40세,2019,4162,2206,1956,112.8,3967,2083,1884,110.6
'35020, 군산시,'045002, 41세,2019,3885,2038,1847,110.3,3747,1963,1784,110
'35020, 군산시,'045003, 42세,2019,4063,2125,1938,109.6,3934,2045,1889,108.3
'35020, 군산시,'045004, 43세,2019,3849,1997,1852,107.8,3720,1925,1795,107.2
'35020, 군산시,'045005, 44세,2019,4246,2176,2070,105.1,4125,2102,2023,103.9
'35020, 군산시,'050,45~49세,2019,23831,12600,11231,112.2,23229,12241,10988,111.4
'35020, 군산시,'050001, 45세,2019,4761,2458,2303,106.7,4650,2399,2251,106.6
'35020, 군산시,'050002, 46세,2019,4599,2424,2175,111.4,4477,2344,2133,109.9
'35020, 군산시,'050003, 47세,2019,4685,2522,2163,116.6,4554,2443,2111,115.7
'35020, 군산시,'050004, 48세,2019,5030,2657,2373,112,4918,2596,2322,111.8
'35020, 군산시,'050005, 49세,2019,4756,2539,2217,114.5,4630,2459,2171,113.3
'35020, 군산시,'055,50~54세,2019,21460,11158,10302,108.3,20987,10907,10080,108.2
'35020, 군산시,'055001, 50세,2019,4532,2391,2141,111.7,4434,2335,2099,111.2
'35020, 군산시,'055002, 51세,2019,4597,2390,2207,108.3,4491,2342,2149,109
'35020, 군산시,'055003, 52세,2019,4112,2085,2027,102.9,4031,2039,1992,102.4
'35020, 군산시,'055004, 53세,2019,4133,2180,1953,111.6,4031,2120,1911,110.9
'35020, 군산시,'055005, 54세,2019,4086,2112,1974,107,4000,2071,1929,107.4
'35020, 군산시,'060,55~59세,2019,21597,11009,10588,104,21246,10837,10409,104.1
'35020, 군산시,'060001, 55세,2019,3867,2025,1842,109.9,3792,1990,1802,110.4
'35020, 군산시,'060002, 56세,2019,4173,2175,1998,108.9,4086,2128,1958,108.7
'35020, 군산시,'060003, 57세,2019,4200,2180,2020,107.9,4124,2140,1984,107.9
'35020, 군산시,'060004, 58세,2019,4632,2353,2279,103.2,4578,2329,2249,103.6
'35020, 군산시,'060005, 59세,2019,4725,2276,2449,92.9,4666,2250,2416,93.1
'35020, 군산시,'065,60~64세,2019,19805,9835,9970,98.6,19590,9725,9865,98.6
'35020, 군산시,'065001, 60세,2019,4299,2074,2225,93.2,4246,2053,2193,93.6
'35020, 군산시,'065002, 61세,2019,3948,1908,2040,93.5,3897,1882,2015,93.4
'35020, 군산시,'065003, 62세,2019,4074,2105,1969,106.9,4033,2083,1950,106.8
'35020, 군산시,'065004, 63세,2019,3642,1834,1808,101.4,3600,1808,1792,100.9
'35020, 군산시,'065005, 64세,2019,3842,1914,1928,99.3,3814,1899,1915,99.2
'35020, 군산시,'070,65~69세,2019,14572,7206,7366,97.8,14456,7149,7307,97.8
'35020, 군산시,'070001, 65세,2019,3372,1698,1674,101.4,3344,1683,1661,101.3
'35020, 군산시,'070002, 66세,2019,2638,1278,1360,94,2613,1269,1344,94.4
'35020, 군산시,'070003, 67세,2019,2975,1506,1469,102.5,2956,1493,1463,102.1
'35020, 군산시,'070004, 68세,2019,2722,1330,1392,95.5,2697,1319,1378,95.7
'35020, 군산시,'070005, 69세,2019,2865,1394,1471,94.8,2846,1385,1461,94.8
'35020, 군산시,'075,70~74세,2019,11731,5516,6215,88.8,11659,5483,6176,88.8
'35020, 군산시,'075001, 70세,2019,2552,1215,1337,90.9,2536,1211,1325,91.4
'35020, 군산시,'075002, 71세,2019,2437,1129,1308,86.3,2420,1121,1299,86.3
'35020, 군산시,'075003, 72세,2019,2790,1318,1472,89.5,2775,1312,1463,89.7
'35020, 군산시,'075004, 73세,2019,2095,1018,1077,94.5,2082,1010,1072,94.2
'35020, 군산시,'075005, 74세,2019,1857,836,1021,81.9,1846,829,1017,81.5
'35020, 군산시,'080,75~79세,2019,9363,3890,5473,71.1,9341,3880,5461,71
'35020, 군산시,'080001, 75세,2019,1866,801,1065,75.2,1860,800,1060,75.5
'35020, 군산시,'080002, 76세,2019,1867,817,1050,77.8,1862,812,1050,77.3
'35020, 군산시,'080003, 77세,2019,2507,1036,1471,70.4,2504,1035,1469,70.5
'35020, 군산시,'080004, 78세,2019,1586,640,946,67.7,1584,638,946,67.4
'35020, 군산시,'080005, 79세,2019,1537,596,941,63.3,1531,595,936,63.6
'35020, 군산시,'085,80~84세,2019,6235,2289,3946,58,6215,2280,3935,57.9
'35020, 군산시,'085001, 80세,2019,1472,613,859,71.4,1469,612,857,71.4
'35020, 군산시,'085002, 81세,2019,1416,479,937,51.1,1412,477,935,51
'35020, 군산시,'085003, 82세,2019,1195,453,742,61.1,1191,451,740,60.9
'35020, 군산시,'085004, 83세,2019,1106,402,704,57.1,1102,400,702,57
'35020, 군산시,'085005, 84세,2019,1046,342,704,48.6,1041,340,701,48.5
'35020, 군산시,'086,85세이상,2019,4662,1165,3497,33.3,4655,1162,3493,33.3
'35020, 군산시,'090,85~89세,2019,3335,899,2436,36.9,3330,896,2434,36.8
'35020, 군산시,'090001, 85세,2019,828,267,561,47.6,825,266,559,47.6
'35020, 군산시,'090002, 86세,2019,828,244,584,41.8,828,244,584,41.8
'35020, 군산시,'090003, 87세,2019,689,162,527,30.7,688,161,527,30.6
'35020, 군산시,'090004, 88세,2019,515,117,398,29.4,514,116,398,29.1
'35020, 군산시,'090005, 89세,2019,475,109,366,29.8,475,109,366,29.8
'35020, 군산시,'095,90~94세,2019,1071,216,855,25.3,1070,216,854,25.3
'35020, 군산시,'095001, 90세,2019,342,89,253,35.2,341,89,252,35.3
'35020, 군산시,'095002, 91세,2019,294,48,246,19.5,294,48,246,19.5
'35020, 군산시,'095003, 92세,2019,208,38,170,22.4,208,38,170,22.4
'35020, 군산시,'095004, 93세,2019,131,27,104,26,131,27,104,26
'35020, 군산시,'095005, 94세,2019,96,14,82,17.1,96,14,82,17.1
'35020, 군산시,'100,95~99세,2019,225,42,183,23,224,42,182,23.1
'35020, 군산시,'100001, 95세,2019,65,8,57,14,65,8,57,14
'35020, 군산시,'100002, 96세,2019,84,18,66,27.3,84,18,66,27.3
'35020, 군산시,'100003, 97세,2019,36,5,31,16.1,35,5,30,16.7
'35020, 군산시,'100004, 98세,2019,23,5,18,27.8,23,5,18,27.8
'35020, 군산시,'100005, 99세,2019,17,6,11,54.5,17,6,11,54.5
'35020, 군산시,'101,100세이상,2019,31,8,23,34.8,31,8,23,34.8
'35020, 군산시,'102,15세미만,2019,34862,17855,17007,105,34724,17785,16939,105
'35020, 군산시,'103,15~64세,2019,189210,100223,88987,112.6,181449,95163,86286,110.3
'35020, 군산시,'104,65세이상,2019,46563,20066,26497,75.7,46326,19954,26372,75.7
'35020, 군산시,'126,평균연령,2019,43.1,41.7,44.5,,43.3,41.9,44.7,
'35020, 군산시,'127,중위연령,2019,44.5,42.9,46,,45,43.6,46.3,
'35030, 익산시,'000,합계,2019,290119,145682,144437,100.9,283074,142016,141058,100.7
'35030, 익산시,'005,0~4세,2019,8934,4514,4420,102.1,8875,4473,4402,101.6
'35030, 익산시,'005001, 0세,2019,1389,709,680,104.3,1375,700,675,103.7
'35030, 익산시,'005002, 1세,2019,1592,788,804,98,1583,784,799,98.1
'35030, 익산시,'005003, 2세,2019,1760,854,906,94.3,1748,843,905,93.1
'35030, 익산시,'005004, 3세,2019,2014,1008,1006,100.2,1999,999,1000,99.9
'35030, 익산시,'005005, 4세,2019,2179,1155,1024,112.8,2170,1147,1023,112.1
'35030, 익산시,'010,5~9세,2019,11918,6117,5801,105.4,11884,6095,5789,105.3
'35030, 익산시,'010001, 5세,2019,2108,1106,1002,110.4,2096,1097,999,109.8
'35030, 익산시,'010002, 6세,2019,2257,1185,1072,110.5,2249,1180,1069,110.4
'35030, 익산시,'010003, 7세,2019,2605,1337,1268,105.4,2601,1336,1265,105.6
'35030, 익산시,'010004, 8세,2019,2592,1306,1286,101.6,2586,1303,1283,101.6
'35030, 익산시,'010005, 9세,2019,2356,1183,1173,100.9,2352,1179,1173,100.5
'35030, 익산시,'015,10~14세,2019,12482,6412,6070,105.6,12462,6399,6063,105.5
'35030, 익산시,'015001, 10세,2019,2355,1210,1145,105.7,2346,1206,1140,105.8
'35030, 익산시,'015002, 11세,2019,2540,1282,1258,101.9,2538,1280,1258,101.7
'35030, 익산시,'015003, 12세,2019,2636,1344,1292,104,2633,1341,1292,103.8
'35030, 익산시,'015004, 13세,2019,2440,1245,1195,104.2,2436,1242,1194,104
'35030, 익산시,'015005, 14세,2019,2511,1331,1180,112.8,2509,1330,1179,112.8
'35030, 익산시,'020,15~19세,2019,17807,9647,8160,118.2,17717,9605,8112,118.4
'35030, 익산시,'020001, 15세,2019,2754,1422,1332,106.8,2749,1419,1330,106.7
'35030, 익산시,'020002, 16세,2019,3119,1699,1420,119.6,3116,1697,1419,119.6
'35030, 익산시,'020003, 17세,2019,3372,1908,1464,130.3,3360,1902,1458,130.5
'35030, 익산시,'020004, 18세,2019,3868,2049,1819,112.6,3846,2039,1807,112.8
'35030, 익산시,'020005, 19세,2019,4694,2569,2125,120.9,4646,2548,2098,121.4
'35030, 익산시,'025,20~24세,2019,23582,13039,10543,123.7,22232,12309,9923,124
'35030, 익산시,'025001, 20세,2019,4358,2250,2108,106.7,4231,2192,2039,107.5
'35030, 익산시,'025002, 21세,2019,4732,2469,2263,109.1,4387,2280,2107,108.2
'35030, 익산시,'025003, 22세,2019,4943,2669,2274,117.4,4662,2505,2157,116.1
'35030, 익산시,'025004, 23세,2019,4880,2873,2007,143.1,4607,2729,1878,145.3
'35030, 익산시,'025005, 24세,2019,4669,2778,1891,146.9,4345,2603,1742,149.4
'35030, 익산시,'030,25~29세,2019,18320,10192,8128,125.4,16830,9403,7427,126.6
'35030, 익산시,'030001, 25세,2019,4407,2555,1852,138,4045,2368,1677,141.2
'35030, 익산시,'030002, 26세,2019,3893,2201,1692,130.1,3594,2048,1546,132.5
'35030, 익산시,'030003, 27세,2019,3610,1963,1647,119.2,3320,1807,1513,119.4
'35030, 익산시,'030004, 28세,2019,3345,1776,1569,113.2,3078,1644,1434,114.6
'35030, 익산시,'030005, 29세,2019,3065,1697,1368,124,2793,1536,1257,122.2
'35030, 익산시,'035,30~34세,2019,14138,7545,6593,114.4,12977,6924,6053,114.4
'35030, 익산시,'035001, 30세,2019,2898,1658,1240,133.7,2624,1504,1120,134.3
'35030, 익산시,'035002, 31세,2019,2848,1523,1325,114.9,2577,1378,1199,114.9
'35030, 익산시,'035003, 32세,2019,2687,1435,1252,114.6,2479,1315,1164,113
'35030, 익산시,'035004, 33세,2019,2893,1483,1410,105.2,2685,1374,1311,104.8
'35030, 익산시,'035005, 34세,2019,2812,1446,1366,105.9,2612,1353,1259,107.5
'35030, 익산시,'040,35~39세,2019,17644,9137,8507,107.4,16840,8725,8115,107.5
'35030, 익산시,'040001, 35세,2019,3108,1608,1500,107.2,2921,1508,1413,106.7
'35030, 익산시,'040002, 36세,2019,3407,1752,1655,105.9,3230,1661,1569,105.9
'35030, 익산시,'040003, 37세,2019,3626,1896,1730,109.6,3472,1827,1645,111.1
'35030, 익산시,'040004, 38세,2019,3612,1887,1725,109.4,3460,1810,1650,109.7
'35030, 익산시,'040005, 39세,2019,3891,1994,1897,105.1,3757,1919,1838,104.4
'35030, 익산시,'045,40~44세,2019,18943,9687,9256,104.7,18383,9405,8978,104.8
'35030, 익산시,'045001, 40세,2019,3711,1911,1800,106.2,3557,1826,1731,105.5
'35030, 익산시,'045002, 41세,2019,3679,1893,1786,106,3561,1830,1731,105.7
'35030, 익산시,'045003, 42세,2019,3755,1888,1867,101.1,3660,1846,1814,101.8
'35030, 익산시,'045004, 43세,2019,3887,2009,1878,107,3787,1963,1824,107.6
'35030, 익산시,'045005, 44세,2019,3911,1986,1925,103.2,3818,1940,1878,103.3
'35030, 익산시,'050,45~49세,2019,23700,11933,11767,101.4,23282,11742,11540,101.8
'35030, 익산시,'050001, 45세,2019,4733,2407,2326,103.5,4647,2368,2279,103.9
'35030, 익산시,'050002, 46세,2019,4646,2318,2328,99.6,4552,2277,2275,100.1
'35030, 익산시,'050003, 47세,2019,4480,2244,2236,100.4,4405,2214,2191,101
'35030, 익산시,'050004, 48세,2019,5068,2577,2491,103.5,4982,2538,2444,103.8
'35030, 익산시,'050005, 49세,2019,4773,2387,2386,100,4696,2345,2351,99.7
'35030, 익산시,'055,50~54세,2019,24254,12230,12024,101.7,23872,12035,11837,101.7
'35030, 익산시,'055001, 50세,2019,4990,2498,2492,100.2,4908,2455,2453,100.1
'35030, 익산시,'055002, 51세,2019,4991,2494,2497,99.9,4896,2445,2451,99.8
'35030, 익산시,'055003, 52세,2019,4743,2327,2416,96.3,4687,2301,2386,96.4
'35030, 익산시,'055004, 53세,2019,4775,2519,2256,111.7,4695,2476,2219,111.6
'35030, 익산시,'055005, 54세,2019,4755,2392,2363,101.2,4686,2358,2328,101.3
'35030, 익산시,'060,55~59세,2019,24787,12503,12284,101.8,24450,12337,12113,101.8
'35030, 익산시,'060001, 55세,2019,4427,2277,2150,105.9,4346,2235,2111,105.9
'35030, 익산시,'060002, 56세,2019,4733,2409,2324,103.7,4661,2373,2288,103.7
'35030, 익산시,'060003, 57세,2019,4850,2477,2373,104.4,4776,2443,2333,104.7
'35030, 익산시,'060004, 58세,2019,5246,2596,2650,98,5197,2574,2623,98.1
'35030, 익산시,'060005, 59세,2019,5531,2744,2787,98.5,5470,2712,2758,98.3
'35030, 익산시,'065,60~64세,2019,21634,10861,10773,100.8,21460,10777,10683,100.9
'35030, 익산시,'065001, 60세,2019,4729,2394,2335,102.5,4677,2367,2310,102.5
'35030, 익산시,'065002, 61세,2019,4164,2091,2073,100.9,4128,2071,2057,100.7
'35030, 익산시,'065003, 62세,2019,4434,2250,2184,103,4396,2234,2162,103.3
'35030, 익산시,'065004, 63세,2019,4084,2061,2023,101.9,4062,2050,2012,101.9
'35030, 익산시,'065005, 64세,2019,4223,2065,2158,95.7,4197,2055,2142,95.9
'35030, 익산시,'070,65~69세,2019,15603,7588,8015,94.7,15514,7542,7972,94.6
'35030, 익산시,'070001, 65세,2019,3499,1674,1825,91.7,3480,1665,1815,91.7
'35030, 익산시,'070002, 66세,2019,2920,1455,1465,99.3,2893,1442,1451,99.4
'35030, 익산시,'070003, 67세,2019,3244,1578,1666,94.7,3232,1569,1663,94.3
'35030, 익산시,'070004, 68세,2019,2799,1377,1422,96.8,2785,1371,1414,97
'35030, 익산시,'070005, 69세,2019,3141,1504,1637,91.9,3124,1495,1629,91.8
'35030, 익산시,'075,70~74세,2019,12267,5728,6539,87.6,12227,5707,6520,87.5
'35030, 익산시,'075001, 70세,2019,2724,1267,1457,87,2716,1263,1453,86.9
'35030, 익산시,'075002, 71세,2019,2676,1250,1426,87.7,2663,1244,1419,87.7
'35030, 익산시,'075003, 72세,2019,2867,1392,1475,94.4,2860,1387,1473,94.2
'35030, 익산시,'075004, 73세,2019,2108,969,1139,85.1,2102,967,1135,85.2
'35030, 익산시,'075005, 74세,2019,1892,850,1042,81.6,1886,846,1040,81.3
'35030, 익산시,'080,75~79세,2019,10574,4324,6250,69.2,10550,4318,6232,69.3
'35030, 익산시,'080001, 75세,2019,1893,820,1073,76.4,1889,819,1070,76.5
'35030, 익산시,'080002, 76세,2019,2131,884,1247,70.9,2125,882,1243,71
'35030, 익산시,'080003, 77세,2019,2957,1236,1721,71.8,2952,1235,1717,71.9
'35030, 익산시,'080004, 78세,2019,1879,747,1132,66,1877,746,1131,66
'35030, 익산시,'080005, 79세,2019,1714,637,1077,59.1,1707,636,1071,59.4
'35030, 익산시,'085,80~84세,2019,7705,2662,5043,52.8,7697,2659,5038,52.8
'35030, 익산시,'085001, 80세,2019,1856,688,1168,58.9,1852,688,1164,59.1
'35030, 익산시,'085002, 81세,2019,1682,580,1102,52.6,1680,579,1101,52.6
'35030, 익산시,'085003, 82세,2019,1523,520,1003,51.8,1522,519,1003,51.7
'35030, 익산시,'085004, 83세,2019,1344,443,901,49.2,1344,443,901,49.2
'35030, 익산시,'085005, 84세,2019,1300,431,869,49.6,1299,430,869,49.5
'35030, 익산시,'086,85세이상,2019,5827,1563,4264,36.7,5822,1561,4261,36.6
'35030, 익산시,'090,85~89세,2019,4144,1168,2976,39.2,4140,1166,2974,39.2
'35030, 익산시,'090001, 85세,2019,1124,369,755,48.9,1123,369,754,48.9
'35030, 익산시,'090002, 86세,2019,1026,287,739,38.8,1025,286,739,38.7
'35030, 익산시,'090003, 87세,2019,794,232,562,41.3,794,232,562,41.3
'35030, 익산시,'090004, 88세,2019,650,144,506,28.5,648,143,505,28.3
'35030, 익산시,'090005, 89세,2019,550,136,414,32.9,550,136,414,32.9
'35030, 익산시,'095,90~94세,2019,1383,336,1047,32.1,1382,336,1046,32.1
'35030, 익산시,'095001, 90세,2019,470,123,347,35.4,469,123,346,35.5
'35030, 익산시,'095002, 91세,2019,360,85,275,30.9,360,85,275,30.9
'35030, 익산시,'095003, 92세,2019,275,60,215,27.9,275,60,215,27.9
'35030, 익산시,'095004, 93세,2019,162,45,117,38.5,162,45,117,38.5
'35030, 익산시,'095005, 94세,2019,116,23,93,24.7,116,23,93,24.7
'35030, 익산시,'100,95~99세,2019,272,53,219,24.2,272,53,219,24.2
'35030, 익산시,'100001, 95세,2019,92,26,66,39.4,92,26,66,39.4
'35030, 익산시,'100002, 96세,2019,75,6,69,8.7,75,6,69,8.7
'35030, 익산시,'100003, 97세,2019,57,13,44,29.5,57,13,44,29.5
'35030, 익산시,'100004, 98세,2019,25,X,21,19,25,X,21,19
'35030, 익산시,'100005, 99세,2019,23,X,19,21.1,23,X,19,21.1
'35030, 익산시,'101,100세이상,2019,28,6,22,27.3,28,6,22,27.3
'35030, 익산시,'102,15세미만,2019,33334,17043,16291,104.6,33221,16967,16254,104.4
'35030, 익산시,'103,15~64세,2019,204809,106774,98035,108.9,198043,103262,94781,108.9
'35030, 익산시,'104,65세이상,2019,51976,21865,30111,72.6,51810,21787,30023,72.6
'35030, 익산시,'126,평균연령,2019,43.6,41.9,45.2,,43.8,42.1,45.4,
'35030, 익산시,'127,중위연령,2019,45.3,43.3,47,,45.7,43.8,47.5,
'35040, 정읍시,'000,합계,2019,107348,53527,53821,99.5,103510,51189,52321,97.8
'35040, 정읍시,'005,0~4세,2019,2848,1459,1389,105,2823,1449,1374,105.5
'35040, 정읍시,'005001, 0세,2019,465,224,241,92.9,461,223,238,93.7
'35040, 정읍시,'005002, 1세,2019,521,245,276,88.8,517,244,273,89.4
'35040, 정읍시,'005003, 2세,2019,523,284,239,118.8,520,283,237,119.4
'35040, 정읍시,'005004, 3세,2019,644,331,313,105.8,639,328,311,105.5
'35040, 정읍시,'005005, 4세,2019,695,375,320,117.2,686,371,315,117.8
'35040, 정읍시,'010,5~9세,2019,3982,2060,1922,107.2,3966,2053,1913,107.3
'35040, 정읍시,'010001, 5세,2019,734,363,371,97.8,729,360,369,97.6
'35040, 정읍시,'010002, 6세,2019,710,369,341,108.2,706,368,338,108.9
'35040, 정읍시,'010003, 7세,2019,863,447,416,107.5,860,446,414,107.7
'35040, 정읍시,'010004, 8세,2019,882,455,427,106.6,880,454,426,106.6
'35040, 정읍시,'010005, 9세,2019,793,426,367,116.1,791,425,366,116.1
'35040, 정읍시,'015,10~14세,2019,4224,2229,1995,111.7,4213,2224,1989,111.8
'35040, 정읍시,'015001, 10세,2019,764,419,345,121.4,763,418,345,121.2
'35040, 정읍시,'015002, 11세,2019,853,448,405,110.6,848,445,403,110.4
'35040, 정읍시,'015003, 12세,2019,919,462,457,101.1,917,462,455,101.5
'35040, 정읍시,'015004, 13세,2019,827,457,370,123.5,825,457,368,124.2
'35040, 정읍시,'015005, 14세,2019,861,443,418,106,860,442,418,105.7
'35040, 정읍시,'020,15~19세,2019,5360,2818,2542,110.9,5203,2715,2488,109.1
'35040, 정읍시,'020001, 15세,2019,965,520,445,116.9,960,516,444,116.2
'35040, 정읍시,'020002, 16세,2019,1037,515,522,98.7,1033,512,521,98.3
'35040, 정읍시,'020003, 17세,2019,1194,619,575,107.7,1188,617,571,108.1
'35040, 정읍시,'020004, 18세,2019,1171,594,577,102.9,1143,577,566,101.9
'35040, 정읍시,'020005, 19세,2019,993,570,423,134.8,879,493,386,127.7
'35040, 정읍시,'025,20~24세,2019,5833,3365,2468,136.3,5038,2836,2202,128.8
'35040, 정읍시,'025001, 20세,2019,1108,642,466,137.8,972,566,406,139.4
'35040, 정읍시,'025002, 21세,2019,1190,692,498,139,1073,621,452,137.4
'35040, 정읍시,'025003, 22세,2019,1178,679,499,136.1,995,545,450,121.1
'35040, 정읍시,'025004, 23세,2019,1204,687,517,132.9,1042,570,472,120.8
'35040, 정읍시,'025005, 24세,2019,1153,665,488,136.3,956,534,422,126.5
'35040, 정읍시,'030,25~29세,2019,5030,2844,2186,130.1,4321,2375,1946,122
'35040, 정읍시,'030001, 25세,2019,1096,622,474,131.2,953,524,429,122.1
'35040, 정읍시,'030002, 26세,2019,1008,550,458,120.1,847,449,398,112.8
'35040, 정읍시,'030003, 27세,2019,1016,562,454,123.8,885,483,402,120.1
'35040, 정읍시,'030004, 28세,2019,983,585,398,147,851,492,359,137
'35040, 정읍시,'030005, 29세,2019,927,525,402,130.6,785,427,358,119.3
'35040, 정읍시,'035,30~34세,2019,4490,2467,2023,121.9,3888,2088,1800,116
'35040, 정읍시,'035001, 30세,2019,884,492,392,125.5,760,416,344,120.9
'35040, 정읍시,'035002, 31세,2019,927,515,412,125,779,424,355,119.4
'35040, 정읍시,'035003, 32세,2019,892,486,406,119.7,762,405,357,113.4
'35040, 정읍시,'035004, 33세,2019,899,505,394,128.2,798,440,358,122.9
'35040, 정읍시,'035005, 34세,2019,888,469,419,111.9,789,403,386,104.4
'35040, 정읍시,'040,35~39세,2019,5571,2966,2605,113.9,5125,2702,2423,111.5
'35040, 정읍시,'040001, 35세,2019,996,532,464,114.7,886,475,411,115.6
'35040, 정읍시,'040002, 36세,2019,1043,572,471,121.4,959,522,437,119.5
'35040, 정읍시,'040003, 37세,2019,1145,601,544,110.5,1054,542,512,105.9
'35040, 정읍시,'040004, 38세,2019,1148,613,535,114.6,1062,558,504,110.7
'35040, 정읍시,'040005, 39세,2019,1239,648,591,109.6,1164,605,559,108.2
'35040, 정읍시,'045,40~44세,2019,6628,3451,3177,108.6,6362,3290,3072,107.1
'35040, 정읍시,'045001, 40세,2019,1302,669,633,105.7,1234,632,602,105
'35040, 정읍시,'045002, 41세,2019,1261,660,601,109.8,1194,614,580,105.9
'35040, 정읍시,'045003, 42세,2019,1311,681,630,108.1,1268,655,613,106.9
'35040, 정읍시,'045004, 43세,2019,1323,708,615,115.1,1274,676,598,113
'35040, 정읍시,'045005, 44세,2019,1431,733,698,105,1392,713,679,105
'35040, 정읍시,'050,45~49세,2019,8363,4447,3916,113.6,8123,4323,3800,113.8
'35040, 정읍시,'050001, 45세,2019,1642,879,763,115.2,1604,859,745,115.3
'35040, 정읍시,'050002, 46세,2019,1661,867,794,109.2,1603,836,767,109
'35040, 정읍시,'050003, 47세,2019,1600,864,736,117.4,1557,838,719,116.6
'35040, 정읍시,'050004, 48세,2019,1786,923,863,107,1733,899,834,107.8
'35040, 정읍시,'050005, 49세,2019,1674,914,760,120.3,1626,891,735,121.2
'35040, 정읍시,'055,50~54세,2019,8741,4723,4018,117.5,8548,4619,3929,117.6
'35040, 정읍시,'055001, 50세,2019,1782,966,816,118.4,1740,942,798,118
'35040, 정읍시,'055002, 51세,2019,1792,970,822,118,1747,944,803,117.6
'35040, 정읍시,'055003, 52세,2019,1674,903,771,117.1,1648,891,757,117.7
'35040, 정읍시,'055004, 53세,2019,1690,924,766,120.6,1651,903,748,120.7
'35040, 정읍시,'055005, 54세,2019,1803,960,843,113.9,1762,939,823,114.1
'35040, 정읍시,'060,55~59세,2019,9345,4832,4513,107.1,9184,4748,4436,107
'35040, 정읍시,'060001, 55세,2019,1625,848,777,109.1,1591,826,765,108
'35040, 정읍시,'060002, 56세,2019,1758,936,822,113.9,1725,918,807,113.8
'35040, 정읍시,'060003, 57세,2019,1744,937,807,116.1,1710,918,792,115.9
'35040, 정읍시,'060004, 58세,2019,2140,1081,1059,102.1,2121,1077,1044,103.2
'35040, 정읍시,'060005, 59세,2019,2078,1030,1048,98.3,2037,1009,1028,98.2
'35040, 정읍시,'065,60~64세,2019,8753,4470,4283,104.4,8626,4415,4211,104.8
'35040, 정읍시,'065001, 60세,2019,1799,955,844,113.2,1777,949,828,114.6
'35040, 정읍시,'065002, 61세,2019,1720,864,856,100.9,1684,851,833,102.2
'35040, 정읍시,'065003, 62세,2019,1883,1013,870,116.4,1860,1004,856,117.3
'35040, 정읍시,'065004, 63세,2019,1538,766,772,99.2,1513,752,761,98.8
'35040, 정읍시,'065005, 64세,2019,1813,872,941,92.7,1792,859,933,92.1
'35040, 정읍시,'070,65~69세,2019,6758,3181,3577,88.9,6704,3151,3553,88.7
'35040, 정읍시,'070001, 65세,2019,1498,703,795,88.4,1483,694,789,88
'35040, 정읍시,'070002, 66세,2019,1200,542,658,82.4,1186,535,651,82.2
'35040, 정읍시,'070003, 67세,2019,1414,676,738,91.6,1406,671,735,91.3
'35040, 정읍시,'070004, 68세,2019,1229,573,656,87.3,1221,568,653,87
'35040, 정읍시,'070005, 69세,2019,1417,687,730,94.1,1408,683,725,94.2
'35040, 정읍시,'075,70~74세,2019,6511,3019,3492,86.5,6494,3014,3480,86.6
'35040, 정읍시,'075001, 70세,2019,1457,684,773,88.5,1449,680,769,88.4
'35040, 정읍시,'075002, 71세,2019,1362,676,686,98.5,1359,676,683,99
'35040, 정읍시,'075003, 72세,2019,1512,700,812,86.2,1510,699,811,86.2
'35040, 정읍시,'075004, 73세,2019,1121,528,593,89,1120,528,592,89.2
'35040, 정읍시,'075005, 74세,2019,1059,431,628,68.6,1056,431,625,69
'35040, 정읍시,'080,75~79세,2019,6326,2500,3826,65.3,6316,2497,3819,65.4
'35040, 정읍시,'080001, 75세,2019,1098,459,639,71.8,1095,458,637,71.9
'35040, 정읍시,'080002, 76세,2019,1202,484,718,67.4,1201,484,717,67.5
'35040, 정읍시,'080003, 77세,2019,1683,645,1038,62.1,1681,644,1037,62.1
'35040, 정읍시,'080004, 78세,2019,1205,463,742,62.4,1204,463,741,62.5
'35040, 정읍시,'080005, 79세,2019,1138,449,689,65.2,1135,448,687,65.2
'35040, 정읍시,'085,80~84세,2019,5006,1775,3231,54.9,5000,1770,3230,54.8
'35040, 정읍시,'085001, 80세,2019,1158,424,734,57.8,1157,423,734,57.6
'35040, 정읍시,'085002, 81세,2019,1063,399,664,60.1,1063,399,664,60.1
'35040, 정읍시,'085003, 82세,2019,968,349,619,56.4,965,346,619,55.9
'35040, 정읍시,'085004, 83세,2019,900,318,582,54.6,899,318,581,54.7
'35040, 정읍시,'085005, 84세,2019,917,285,632,45.1,916,284,632,44.9
'35040, 정읍시,'086,85세이상,2019,3579,921,2658,34.7,3576,920,2656,34.6
'35040, 정읍시,'090,85~89세,2019,2567,706,1861,37.9,2565,705,1860,37.9
'35040, 정읍시,'090001, 85세,2019,750,243,507,47.9,750,243,507,47.9
'35040, 정읍시,'090002, 86세,2019,621,189,432,43.8,620,188,432,43.5
'35040, 정읍시,'090003, 87세,2019,477,111,366,30.3,476,111,365,30.4
'35040, 정읍시,'090004, 88세,2019,379,91,288,31.6,379,91,288,31.6
'35040, 정읍시,'090005, 89세,2019,340,72,268,26.9,340,72,268,26.9
'35040, 정읍시,'095,90~94세,2019,814,179,635,28.2,813,179,634,28.2
'35040, 정읍시,'095001, 90세,2019,268,68,200,34,267,68,199,34.2
'35040, 정읍시,'095002, 91세,2019,241,52,189,27.5,241,52,189,27.5
'35040, 정읍시,'095003, 92세,2019,175,30,145,20.7,175,30,145,20.7
'35040, 정읍시,'095004, 93세,2019,72,16,56,28.6,72,16,56,28.6
'35040, 정읍시,'095005, 94세,2019,58,13,45,28.9,58,13,45,28.9
'35040, 정읍시,'100,95~99세,2019,176,33,143,23.1,176,33,143,23.1
'35040, 정읍시,'100001, 95세,2019,49,14,35,40,49,14,35,40
'35040, 정읍시,'100002, 96세,2019,50,6,44,13.6,50,6,44,13.6
'35040, 정읍시,'100003, 97세,2019,38,6,32,18.8,38,6,32,18.8
'35040, 정읍시,'100004, 98세,2019,28,7,21,33.3,28,7,21,33.3
'35040, 정읍시,'100005, 99세,2019,11,X,11,0,11,X,11,0
'35040, 정읍시,'101,100세이상,2019,22,X,19,15.8,22,X,19,15.8
'35040, 정읍시,'102,15세미만,2019,11054,5748,5306,108.3,11002,5726,5276,108.5
'35040, 정읍시,'103,15~64세,2019,68114,36383,31731,114.7,64418,34111,30307,112.6
'35040, 정읍시,'104,65세이상,2019,28180,11396,16784,67.9,28090,11352,16738,67.8
'35040, 정읍시,'126,평균연령,2019,48.3,46,50.5,,48.8,46.5,51,
'35040, 정읍시,'127,중위연령,2019,50.8,48.5,53.4,,51.5,49.5,54.1,
'35050, 남원시,'000,합계,2019,77690,38019,39671,95.8,76215,37371,38844,96.2
'35050, 남원시,'005,0~4세,2019,2271,1223,1048,116.7,2261,1218,1043,116.8
'35050, 남원시,'005001, 0세,2019,406,210,196,107.1,404,209,195,107.2
'35050, 남원시,'005002, 1세,2019,448,265,183,144.8,448,265,183,144.8
'35050, 남원시,'005003, 2세,2019,445,232,213,108.9,444,231,213,108.5
'35050, 남원시,'005004, 3세,2019,482,247,235,105.1,478,245,233,105.2
'35050, 남원시,'005005, 4세,2019,490,269,221,121.7,487,268,219,122.4
'35050, 남원시,'010,5~9세,2019,2918,1517,1401,108.3,2910,1514,1396,108.5
'35050, 남원시,'010001, 5세,2019,528,269,259,103.9,523,267,256,104.3
'35050, 남원시,'010002, 6세,2019,568,295,273,108.1,567,295,272,108.5
'35050, 남원시,'010003, 7세,2019,574,313,261,119.9,574,313,261,119.9
'35050, 남원시,'010004, 8세,2019,660,335,325,103.1,659,334,325,102.8
'35050, 남원시,'010005, 9세,2019,588,305,283,107.8,587,305,282,108.2
'35050, 남원시,'015,10~14세,2019,3222,1672,1550,107.9,3216,1669,1547,107.9
'35050, 남원시,'015001, 10세,2019,593,332,261,127.2,591,332,259,128.2
'35050, 남원시,'015002, 11세,2019,669,354,315,112.4,665,351,314,111.8
'35050, 남원시,'015003, 12세,2019,650,325,325,100,650,325,325,100
'35050, 남원시,'015004, 13세,2019,639,330,309,106.8,639,330,309,106.8
'35050, 남원시,'015005, 14세,2019,671,331,340,97.4,671,331,340,97.4
'35050, 남원시,'020,15~19세,2019,3518,1898,1620,117.2,3499,1887,1612,117.1
'35050, 남원시,'020001, 15세,2019,702,365,337,108.3,698,362,336,107.7
'35050, 남원시,'020002, 16세,2019,733,378,355,106.5,731,378,353,107.1
'35050, 남원시,'020003, 17세,2019,782,390,392,99.5,780,390,390,100
'35050, 남원시,'020004, 18세,2019,812,437,375,116.5,809,435,374,116.3
'35050, 남원시,'020005, 19세,2019,489,328,161,203.7,481,322,159,202.5
'35050, 남원시,'025,20~24세,2019,3503,2111,1392,151.7,3326,2024,1302,155.5
'35050, 남원시,'025001, 20세,2019,621,435,186,233.9,594,423,171,247.4
'35050, 남원시,'025002, 21세,2019,701,480,221,217.2,678,469,209,224.4
'35050, 남원시,'025003, 22세,2019,693,395,298,132.6,659,380,279,136.2
'35050, 남원시,'025004, 23세,2019,769,408,361,113,736,389,347,112.1
'35050, 남원시,'025005, 24세,2019,719,393,326,120.6,659,363,296,122.6
'35050, 남원시,'030,25~29세,2019,3287,1745,1542,113.2,3042,1639,1403,116.8
'35050, 남원시,'030001, 25세,2019,723,385,338,113.9,661,354,307,115.3
'35050, 남원시,'030002, 26세,2019,702,381,321,118.7,649,358,291,123
'35050, 남원시,'030003, 27세,2019,636,355,281,126.3,597,337,260,129.6
'35050, 남원시,'030004, 28세,2019,615,309,306,101,571,298,273,109.2
'35050, 남원시,'030005, 29세,2019,611,315,296,106.4,564,292,272,107.4
'35050, 남원시,'035,30~34세,2019,2998,1489,1509,98.7,2788,1393,1395,99.9
'35050, 남원시,'035001, 30세,2019,574,286,288,99.3,531,263,268,98.1
'35050, 남원시,'035002, 31세,2019,603,298,305,97.7,555,279,276,101.1
'35050, 남원시,'035003, 32세,2019,585,309,276,112,544,289,255,113.3
'35050, 남원시,'035004, 33세,2019,617,289,328,88.1,577,271,306,88.6
'35050, 남원시,'035005, 34세,2019,619,307,312,98.4,581,291,290,100.3
'35050, 남원시,'040,35~39세,2019,3857,1935,1922,100.7,3690,1873,1817,103.1
'35050, 남원시,'040001, 35세,2019,664,338,326,103.7,625,323,302,107
'35050, 남원시,'040002, 36세,2019,730,380,350,108.6,694,362,332,109
'35050, 남원시,'040003, 37세,2019,776,386,390,99,743,379,364,104.1
'35050, 남원시,'040004, 38세,2019,799,411,388,105.9,773,400,373,107.2
'35050, 남원시,'040005, 39세,2019,888,420,468,89.7,855,409,446,91.7
'35050, 남원시,'045,40~44세,2019,4535,2230,2305,96.7,4405,2171,2234,97.2
'35050, 남원시,'045001, 40세,2019,846,418,428,97.7,823,407,416,97.8
'35050, 남원시,'045002, 41세,2019,834,414,420,98.6,802,401,401,100
'35050, 남원시,'045003, 42세,2019,915,441,474,93,890,426,464,91.8
'35050, 남원시,'045004, 43세,2019,954,479,475,100.8,929,468,461,101.5
'35050, 남원시,'045005, 44세,2019,986,478,508,94.1,961,469,492,95.3
'35050, 남원시,'050,45~49세,2019,6151,3303,2848,116,6008,3245,2763,117.4
'35050, 남원시,'050001, 45세,2019,1214,650,564,115.2,1183,637,546,116.7
'35050, 남원시,'050002, 46세,2019,1211,654,557,117.4,1188,641,547,117.2
'35050, 남원시,'050003, 47세,2019,1202,632,570,110.9,1164,620,544,114
'35050, 남원시,'050004, 48세,2019,1321,697,624,111.7,1300,689,611,112.8
'35050, 남원시,'050005, 49세,2019,1203,670,533,125.7,1173,658,515,127.8
'35050, 남원시,'055,50~54세,2019,6686,3491,3195,109.3,6546,3434,3112,110.3
'35050, 남원시,'055001, 50세,2019,1427,765,662,115.6,1392,749,643,116.5
'35050, 남원시,'055002, 51세,2019,1380,707,673,105.1,1350,694,656,105.8
'35050, 남원시,'055003, 52세,2019,1281,666,615,108.3,1259,656,603,108.8
'35050, 남원시,'055004, 53세,2019,1305,667,638,104.5,1283,659,624,105.6
'35050, 남원시,'055005, 54세,2019,1293,686,607,113,1262,676,586,115.4
'35050, 남원시,'060,55~59세,2019,6896,3599,3297,109.2,6811,3559,3252,109.4
'35050, 남원시,'060001, 55세,2019,1046,572,474,120.7,1024,563,461,122.1
'35050, 남원시,'060002, 56세,2019,1252,680,572,118.9,1233,670,563,119
'35050, 남원시,'060003, 57세,2019,1416,745,671,111,1404,742,662,112.1
'35050, 남원시,'060004, 58세,2019,1530,754,776,97.2,1514,745,769,96.9
'35050, 남원시,'060005, 59세,2019,1652,848,804,105.5,1636,839,797,105.3
'35050, 남원시,'065,60~64세,2019,6530,3236,3294,98.2,6448,3201,3247,98.6
'35050, 남원시,'065001, 60세,2019,1386,683,703,97.2,1375,678,697,97.3
'35050, 남원시,'065002, 61세,2019,1280,658,622,105.8,1264,654,610,107.2
'35050, 남원시,'065003, 62세,2019,1275,650,625,104,1256,637,619,102.9
'35050, 남원시,'065004, 63세,2019,1235,578,657,88,1215,572,643,89
'35050, 남원시,'065005, 64세,2019,1354,667,687,97.1,1338,660,678,97.3
'35050, 남원시,'070,65~69세,2019,5284,2625,2659,98.7,5254,2606,2648,98.4
'35050, 남원시,'070001, 65세,2019,1167,593,574,103.3,1157,585,572,102.3
'35050, 남원시,'070002, 66세,2019,976,503,473,106.3,973,501,472,106.1
'35050, 남원시,'070003, 67세,2019,1119,546,573,95.3,1113,543,570,95.3
'35050, 남원시,'070004, 68세,2019,969,481,488,98.6,962,477,485,98.4
'35050, 남원시,'070005, 69세,2019,1053,502,551,91.1,1049,500,549,91.1
'35050, 남원시,'075,70~74세,2019,4807,2134,2673,79.8,4794,2131,2663,80
'35050, 남원시,'075001, 70세,2019,996,430,566,76,993,429,564,76.1
'35050, 남원시,'075002, 71세,2019,1083,465,618,75.2,1079,464,615,75.4
'35050, 남원시,'075003, 72세,2019,1162,554,608,91.1,1160,554,606,91.4
'35050, 남원시,'075004, 73세,2019,837,380,457,83.2,835,380,455,83.5
'35050, 남원시,'075005, 74세,2019,729,305,424,71.9,727,304,423,71.9
'35050, 남원시,'080,75~79세,2019,4620,1757,2863,61.4,4617,1756,2861,61.4
'35050, 남원시,'080001, 75세,2019,728,283,445,63.6,726,282,444,63.5
'35050, 남원시,'080002, 76세,2019,824,328,496,66.1,824,328,496,66.1
'35050, 남원시,'080003, 77세,2019,1323,463,860,53.8,1322,463,859,53.9
'35050, 남원시,'080004, 78세,2019,946,378,568,66.5,946,378,568,66.5
'35050, 남원시,'080005, 79세,2019,799,305,494,61.7,799,305,494,61.7
'35050, 남원시,'085,80~84세,2019,3779,1303,2476,52.6,3777,1303,2474,52.7
'35050, 남원시,'085001, 80세,2019,862,311,551,56.4,861,311,550,56.5
'35050, 남원시,'085002, 81세,2019,792,286,506,56.5,791,286,505,56.6
'35050, 남원시,'085003, 82세,2019,769,259,510,50.8,769,259,510,50.8
'35050, 남원시,'085004, 83세,2019,676,245,431,56.8,676,245,431,56.8
'35050, 남원시,'085005, 84세,2019,680,202,478,42.3,680,202,478,42.3
'35050, 남원시,'086,85세이상,2019,2828,751,2077,36.2,2823,748,2075,36
'35050, 남원시,'090,85~89세,2019,1957,549,1408,39,1956,548,1408,38.9
'35050, 남원시,'090001, 85세,2019,628,173,455,38,628,173,455,38
'35050, 남원시,'090002, 86세,2019,410,125,285,43.9,410,125,285,43.9
'35050, 남원시,'090003, 87세,2019,395,111,284,39.1,394,110,284,38.7
'35050, 남원시,'090004, 88세,2019,286,78,208,37.5,286,78,208,37.5
'35050, 남원시,'090005, 89세,2019,238,62,176,35.2,238,62,176,35.2
'35050, 남원시,'095,90~94세,2019,679,158,521,30.3,675,156,519,30.1
'35050, 남원시,'095001, 90세,2019,190,48,142,33.8,189,48,141,34
'35050, 남원시,'095002, 91세,2019,206,50,156,32.1,205,49,156,31.4
'35050, 남원시,'095003, 92세,2019,137,34,103,33,137,34,103,33
'35050, 남원시,'095004, 93세,2019,94,15,79,19,93,14,79,17.7
'35050, 남원시,'095005, 94세,2019,52,11,41,26.8,51,11,40,27.5
'35050, 남원시,'100,95~99세,2019,169,42,127,33.1,169,42,127,33.1
'35050, 남원시,'100001, 95세,2019,47,7,40,17.5,47,7,40,17.5
'35050, 남원시,'100002, 96세,2019,56,19,37,51.4,56,19,37,51.4
'35050, 남원시,'100003, 97세,2019,35,11,24,45.8,35,11,24,45.8
'35050, 남원시,'100004, 98세,2019,16,X,14,14.3,16,X,14,14.3
'35050, 남원시,'100005, 99세,2019,15,X,12,25,15,X,12,25
'35050, 남원시,'101,100세이상,2019,23,X,21,9.5,23,X,21,9.5
'35050, 남원시,'102,15세미만,2019,8411,4412,3999,110.3,8387,4401,3986,110.4
'35050, 남원시,'103,15~64세,2019,47961,25037,22924,109.2,46563,24426,22137,110.3
'35050, 남원시,'104,65세이상,2019,21318,8570,12748,67.2,21265,8544,12721,67.2
'35050, 남원시,'126,평균연령,2019,49,46.6,51.4,,49.2,46.7,51.6,
'35050, 남원시,'127,중위연령,2019,51.8,49.8,54.2,,52.2,50.1,54.7,
'35060, 김제시,'000,합계,2019,80422,40068,40354,99.3,77674,38236,39438,97
'35060, 김제시,'005,0~4세,2019,1888,972,916,106.1,1878,967,911,106.1
'35060, 김제시,'005001, 0세,2019,281,151,130,116.2,281,151,130,116.2
'35060, 김제시,'005002, 1세,2019,341,177,164,107.9,340,176,164,107.3
'35060, 김제시,'005003, 2세,2019,385,191,194,98.5,380,189,191,99
'35060, 김제시,'005004, 3세,2019,421,223,198,112.6,418,221,197,112.2
'35060, 김제시,'005005, 4세,2019,460,230,230,100,459,230,229,100.4
'35060, 김제시,'010,5~9세,2019,2731,1399,1332,105,2719,1394,1325,105.2
'35060, 김제시,'010001, 5세,2019,481,253,228,111,480,253,227,111.5
'35060, 김제시,'010002, 6세,2019,512,277,235,117.9,509,276,233,118.5
'35060, 김제시,'010003, 7세,2019,587,304,283,107.4,582,301,281,107.1
'35060, 김제시,'010004, 8세,2019,610,285,325,87.7,608,285,323,88.2
'35060, 김제시,'010005, 9세,2019,541,280,261,107.3,540,279,261,106.9
'35060, 김제시,'015,10~14세,2019,2750,1436,1314,109.3,2744,1433,1311,109.3
'35060, 김제시,'015001, 10세,2019,551,283,268,105.6,550,282,268,105.2
'35060, 김제시,'015002, 11세,2019,525,274,251,109.2,524,273,251,108.8
'35060, 김제시,'015003, 12세,2019,575,295,280,105.4,573,294,279,105.4
'35060, 김제시,'015004, 13세,2019,548,289,259,111.6,548,289,259,111.6
'35060, 김제시,'015005, 14세,2019,551,295,256,115.2,549,295,254,116.1
'35060, 김제시,'020,15~19세,2019,3018,1576,1442,109.3,2995,1561,1434,108.9
'35060, 김제시,'020001, 15세,2019,566,275,291,94.5,563,274,289,94.8
'35060, 김제시,'020002, 16세,2019,566,277,289,95.8,565,276,289,95.5
'35060, 김제시,'020003, 17세,2019,620,320,300,106.7,618,320,298,107.4
'35060, 김제시,'020004, 18세,2019,698,374,324,115.4,695,372,323,115.2
'35060, 김제시,'020005, 19세,2019,568,330,238,138.7,554,319,235,135.7
'35060, 김제시,'025,20~24세,2019,3804,2311,1493,154.8,3495,2101,1394,150.7
'35060, 김제시,'025001, 20세,2019,652,416,236,176.3,624,395,229,172.5
'35060, 김제시,'025002, 21세,2019,751,479,272,176.1,708,451,257,175.5
'35060, 김제시,'025003, 22세,2019,746,462,284,162.7,696,426,270,157.8
'35060, 김제시,'025004, 23세,2019,832,484,348,139.1,741,427,314,136
'35060, 김제시,'025005, 24세,2019,823,470,353,133.1,726,402,324,124.1
'35060, 김제시,'030,25~29세,2019,3813,2241,1572,142.6,3182,1784,1398,127.6
'35060, 김제시,'030001, 25세,2019,836,493,343,143.7,735,421,314,134.1
'35060, 김제시,'030002, 26세,2019,805,478,327,146.2,667,380,287,132.4
'35060, 김제시,'030003, 27세,2019,738,428,310,138.1,591,314,277,113.4
'35060, 김제시,'030004, 28세,2019,707,403,304,132.6,580,322,258,124.8
'35060, 김제시,'030005, 29세,2019,727,439,288,152.4,609,347,262,132.4
'35060, 김제시,'035,30~34세,2019,3347,1883,1464,128.6,2751,1452,1299,111.8
'35060, 김제시,'035001, 30세,2019,660,386,274,140.9,537,306,231,132.5
'35060, 김제시,'035002, 31세,2019,683,371,312,118.9,552,283,269,105.2
'35060, 김제시,'035003, 32세,2019,669,380,289,131.5,548,286,262,109.2
'35060, 김제시,'035004, 33세,2019,667,390,277,140.8,548,294,254,115.7
'35060, 김제시,'035005, 34세,2019,668,356,312,114.1,566,283,283,100
'35060, 김제시,'040,35~39세,2019,4178,2289,1889,121.2,3769,2013,1756,114.6
'35060, 김제시,'040001, 35세,2019,740,400,340,117.6,654,342,312,109.6
'35060, 김제시,'040002, 36세,2019,764,408,356,114.6,671,343,328,104.6
'35060, 김제시,'040003, 37세,2019,873,492,381,129.1,791,437,354,123.4
'35060, 김제시,'040004, 38세,2019,887,490,397,123.4,822,444,378,117.5
'35060, 김제시,'040005, 39세,2019,914,499,415,120.2,831,447,384,116.4
'35060, 김제시,'045,40~44세,2019,4403,2465,1938,127.2,4149,2290,1859,123.2
'35060, 김제시,'045001, 40세,2019,858,467,391,119.4,783,414,369,112.2
'35060, 김제시,'045002, 41세,2019,837,480,357,134.5,774,437,337,129.7
'35060, 김제시,'045003, 42세,2019,914,498,416,119.7,865,469,396,118.4
'35060, 김제시,'045004, 43세,2019,877,506,371,136.4,838,475,363,130.9
'35060, 김제시,'045005, 44세,2019,917,514,403,127.5,889,495,394,125.6
'35060, 김제시,'050,45~49세,2019,5520,3104,2416,128.5,5346,3002,2344,128.1
'35060, 김제시,'050001, 45세,2019,1098,629,469,134.1,1065,607,458,132.5
'35060, 김제시,'050002, 46세,2019,1061,577,484,119.2,1027,558,469,119
'35060, 김제시,'050003, 47세,2019,1116,635,481,132,1075,612,463,132.2
'35060, 김제시,'050004, 48세,2019,1102,632,470,134.5,1063,610,453,134.7
'35060, 김제시,'050005, 49세,2019,1143,631,512,123.2,1116,615,501,122.8
'35060, 김제시,'055,50~54세,2019,6053,3274,2779,117.8,5928,3215,2713,118.5
'35060, 김제시,'055001, 50세,2019,1154,623,531,117.3,1129,610,519,117.5
'35060, 김제시,'055002, 51세,2019,1272,676,596,113.4,1245,663,582,113.9
'35060, 김제시,'055003, 52세,2019,1192,651,541,120.3,1167,641,526,121.9
'35060, 김제시,'055004, 53세,2019,1178,658,520,126.5,1153,646,507,127.4
'35060, 김제시,'055005, 54세,2019,1257,666,591,112.7,1234,655,579,113.1
'35060, 김제시,'060,55~59세,2019,7265,3710,3555,104.4,7163,3663,3500,104.7
'35060, 김제시,'060001, 55세,2019,1222,629,593,106.1,1194,615,579,106.2
'35060, 김제시,'060002, 56세,2019,1327,685,642,106.7,1306,675,631,107
'35060, 김제시,'060003, 57세,2019,1384,716,668,107.2,1362,704,658,107
'35060, 김제시,'060004, 58세,2019,1595,827,768,107.7,1585,823,762,108
'35060, 김제시,'060005, 59세,2019,1737,853,884,96.5,1716,846,870,97.2
'35060, 김제시,'065,60~64세,2019,7248,3629,3619,100.3,7206,3605,3601,100.1
'35060, 김제시,'065001, 60세,2019,1409,696,713,97.6,1400,690,710,97.2
'35060, 김제시,'065002, 61세,2019,1425,691,734,94.1,1417,687,730,94.1
'35060, 김제시,'065003, 62세,2019,1486,762,724,105.2,1475,757,718,105.4
'35060, 김제시,'065004, 63세,2019,1424,734,690,106.4,1418,730,688,106.1
'35060, 김제시,'065005, 64세,2019,1504,746,758,98.4,1496,741,755,98.1
'35060, 김제시,'070,65~69세,2019,6014,2832,3182,89,5973,2816,3157,89.2
'35060, 김제시,'070001, 65세,2019,1302,624,678,92,1288,620,668,92.8
'35060, 김제시,'070002, 66세,2019,1020,499,521,95.8,1016,499,517,96.5
'35060, 김제시,'070003, 67세,2019,1228,575,653,88.1,1218,570,648,88
'35060, 김제시,'070004, 68세,2019,1150,549,601,91.3,1146,548,598,91.6
'35060, 김제시,'070005, 69세,2019,1314,585,729,80.2,1305,579,726,79.8
'35060, 김제시,'075,70~74세,2019,5379,2483,2896,85.7,5372,2479,2893,85.7
'35060, 김제시,'075001, 70세,2019,1125,517,608,85,1123,515,608,84.7
'35060, 김제시,'075002, 71세,2019,1081,539,542,99.4,1080,539,541,99.6
'35060, 김제시,'075003, 72세,2019,1335,601,734,81.9,1334,601,733,82
'35060, 김제시,'075004, 73세,2019,952,444,508,87.4,950,443,507,87.4
'35060, 김제시,'075005, 74세,2019,886,382,504,75.8,885,381,504,75.6
'35060, 김제시,'080,75~79세,2019,5312,2110,3202,65.9,5312,2110,3202,65.9
'35060, 김제시,'080001, 75세,2019,916,376,540,69.6,916,376,540,69.6
'35060, 김제시,'080002, 76세,2019,982,397,585,67.9,982,397,585,67.9
'35060, 김제시,'080003, 77세,2019,1500,596,904,65.9,1500,596,904,65.9
'35060, 김제시,'080004, 78세,2019,989,395,594,66.5,989,395,594,66.5
'35060, 김제시,'080005, 79세,2019,925,346,579,59.8,925,346,579,59.8
'35060, 김제시,'085,80~84세,2019,4302,1466,2836,51.7,4297,1464,2833,51.7
'35060, 김제시,'085001, 80세,2019,995,345,650,53.1,994,345,649,53.2
'35060, 김제시,'085002, 81세,2019,920,312,608,51.3,920,312,608,51.3
'35060, 김제시,'085003, 82세,2019,842,301,541,55.6,840,301,539,55.8
'35060, 김제시,'085004, 83세,2019,767,238,529,45,766,237,529,44.8
'35060, 김제시,'085005, 84세,2019,778,270,508,53.1,777,269,508,53
'35060, 김제시,'086,85세이상,2019,3397,888,2509,35.4,3395,887,2508,35.4
'35060, 김제시,'090,85~89세,2019,2461,669,1792,37.3,2460,668,1792,37.3
'35060, 김제시,'090001, 85세,2019,677,205,472,43.4,677,205,472,43.4
'35060, 김제시,'090002, 86세,2019,640,168,472,35.6,639,167,472,35.4
'35060, 김제시,'090003, 87세,2019,459,119,340,35,459,119,340,35
'35060, 김제시,'090004, 88세,2019,342,98,244,40.2,342,98,244,40.2
'35060, 김제시,'090005, 89세,2019,343,79,264,29.9,343,79,264,29.9
'35060, 김제시,'095,90~94세,2019,770,187,583,32.1,769,187,582,32.1
'35060, 김제시,'095001, 90세,2019,266,67,199,33.7,266,67,199,33.7
'35060, 김제시,'095002, 91세,2019,208,46,162,28.4,207,46,161,28.6
'35060, 김제시,'095003, 92세,2019,130,28,102,27.5,130,28,102,27.5
'35060, 김제시,'095004, 93세,2019,98,29,69,42,98,29,69,42
'35060, 김제시,'095005, 94세,2019,68,17,51,33.3,68,17,51,33.3
'35060, 김제시,'100,95~99세,2019,157,32,125,25.6,157,32,125,25.6
'35060, 김제시,'100001, 95세,2019,51,13,38,34.2,51,13,38,34.2
'35060, 김제시,'100002, 96세,2019,45,7,38,18.4,45,7,38,18.4
'35060, 김제시,'100003, 97세,2019,30,7,23,30.4,30,7,23,30.4
'35060, 김제시,'100004, 98세,2019,14,X,12,16.7,14,X,12,16.7
'35060, 김제시,'100005, 99세,2019,17,X,14,21.4,17,X,14,21.4
'35060, 김제시,'101,100세이상,2019,9,X,9,0,9,X,9,0
'35060, 김제시,'102,15세미만,2019,7369,3807,3562,106.9,7341,3794,3547,107
'35060, 김제시,'103,15~64세,2019,48649,26482,22167,119.5,45984,24686,21298,115.9
'35060, 김제시,'104,65세이상,2019,24404,9779,14625,66.9,24349,9756,14593,66.9
'35060, 김제시,'126,평균연령,2019,50.6,47.9,53.4,,51.2,48.5,53.7,
'35060, 김제시,'127,중위연령,2019,54,50.6,57.6,,54.9,51.8,58.1,
'35310, 완주군,'000,합계,2019,96212,49610,46602,106.5,91499,46859,44640,105
'35310, 완주군,'005,0~4세,2019,3257,1585,1672,94.8,3222,1568,1654,94.8
'35310, 완주군,'005001, 0세,2019,468,234,234,100,461,231,230,100.4
'35310, 완주군,'005002, 1세,2019,537,257,280,91.8,533,256,277,92.4
'35310, 완주군,'005003, 2세,2019,651,312,339,92,643,308,335,91.9
'35310, 완주군,'005004, 3세,2019,752,365,387,94.3,746,360,386,93.3
'35310, 완주군,'005005, 4세,2019,849,417,432,96.5,839,413,426,96.9
'35310, 완주군,'010,5~9세,2019,4359,2276,2083,109.3,4336,2261,2075,109
'35310, 완주군,'010001, 5세,2019,796,390,406,96.1,789,386,403,95.8
'35310, 완주군,'010002, 6세,2019,846,436,410,106.3,843,435,408,106.6
'35310, 완주군,'010003, 7세,2019,933,486,447,108.7,928,482,446,108.1
'35310, 완주군,'010004, 8세,2019,881,471,410,114.9,876,467,409,114.2
'35310, 완주군,'010005, 9세,2019,903,493,410,120.2,900,491,409,120
'35310, 완주군,'015,10~14세,2019,4132,2123,2009,105.7,4125,2118,2007,105.5
'35310, 완주군,'015001, 10세,2019,777,382,395,96.7,776,382,394,97
'35310, 완주군,'015002, 11세,2019,838,442,396,111.6,837,441,396,111.4
'35310, 완주군,'015003, 12세,2019,847,440,407,108.1,847,440,407,108.1
'35310, 완주군,'015004, 13세,2019,817,423,394,107.4,815,421,394,106.9
'35310, 완주군,'015005, 14세,2019,853,436,417,104.6,850,434,416,104.3
'35310, 완주군,'020,15~19세,2019,5774,3179,2595,122.5,5495,3011,2484,121.2
'35310, 완주군,'020001, 15세,2019,872,497,375,132.5,867,495,372,133.1
'35310, 완주군,'020002, 16세,2019,919,506,413,122.5,917,505,412,122.6
'35310, 완주군,'020003, 17세,2019,950,523,427,122.5,945,520,425,122.4
'35310, 완주군,'020004, 18세,2019,1181,625,556,112.4,1135,603,532,113.3
'35310, 완주군,'020005, 19세,2019,1852,1028,824,124.8,1631,888,743,119.5
'35310, 완주군,'025,20~24세,2019,7482,4388,3094,141.8,6162,3539,2623,134.9
'35310, 완주군,'025001, 20세,2019,1720,928,792,117.2,1465,761,704,108.1
'35310, 완주군,'025002, 21세,2019,1629,901,728,123.8,1313,693,620,111.8
'35310, 완주군,'025003, 22세,2019,1525,917,608,150.8,1251,740,511,144.8
'35310, 완주군,'025004, 23세,2019,1375,844,531,158.9,1132,693,439,157.9
'35310, 완주군,'025005, 24세,2019,1233,798,435,183.4,1001,652,349,186.8
'35310, 완주군,'030,25~29세,2019,5103,2918,2185,133.5,4193,2372,1821,130.3
'35310, 완주군,'030001, 25세,2019,1152,711,441,161.2,955,595,360,165.3
'35310, 완주군,'030002, 26세,2019,1064,587,477,123.1,864,471,393,119.8
'35310, 완주군,'030003, 27세,2019,1036,599,437,137.1,851,483,368,131.3
'35310, 완주군,'030004, 28세,2019,933,512,421,121.6,767,412,355,116.1
'35310, 완주군,'030005, 29세,2019,918,509,409,124.4,756,411,345,119.1
'35310, 완주군,'035,30~34세,2019,4673,2419,2254,107.3,4016,2045,1971,103.8
'35310, 완주군,'035001, 30세,2019,877,472,405,116.5,730,388,342,113.5
'35310, 완주군,'035002, 31세,2019,912,465,447,104,775,384,391,98.2
'35310, 완주군,'035003, 32세,2019,935,480,455,105.5,787,400,387,103.4
'35310, 완주군,'035004, 33세,2019,916,468,448,104.5,795,399,396,100.8
'35310, 완주군,'035005, 34세,2019,1033,534,499,107,929,474,455,104.2
'35310, 완주군,'040,35~39세,2019,6379,3319,3060,108.5,5902,3065,2837,108
'35310, 완주군,'040001, 35세,2019,1069,570,499,114.2,951,505,446,113.2
'35310, 완주군,'040002, 36세,2019,1179,581,598,97.2,1085,541,544,99.4
'35310, 완주군,'040003, 37세,2019,1357,710,647,109.7,1262,657,605,108.6
'35310, 완주군,'040004, 38세,2019,1319,681,638,106.7,1239,635,604,105.1
'35310, 완주군,'040005, 39세,2019,1455,777,678,114.6,1365,727,638,113.9
'35310, 완주군,'045,40~44세,2019,6321,3452,2869,120.3,6020,3299,2721,121.2
'35310, 완주군,'045001, 40세,2019,1338,724,614,117.9,1264,685,579,118.3
'35310, 완주군,'045002, 41세,2019,1198,648,550,117.8,1147,624,523,119.3
'35310, 완주군,'045003, 42세,2019,1232,660,572,115.4,1177,632,545,116
'35310, 완주군,'045004, 43세,2019,1269,703,566,124.2,1196,665,531,125.2
'35310, 완주군,'045005, 44세,2019,1284,717,567,126.5,1236,693,543,127.6
'35310, 완주군,'050,45~49세,2019,7115,4004,3111,128.7,6886,3879,3007,129
'35310, 완주군,'050001, 45세,2019,1401,792,609,130,1351,763,588,129.8
'35310, 완주군,'050002, 46세,2019,1399,778,621,125.3,1352,755,597,126.5
'35310, 완주군,'050003, 47세,2019,1400,794,606,131,1353,768,585,131.3
'35310, 완주군,'050004, 48세,2019,1553,871,682,127.7,1506,847,659,128.5
'35310, 완주군,'050005, 49세,2019,1362,769,593,129.7,1324,746,578,129.1
'35310, 완주군,'055,50~54세,2019,7143,3958,3185,124.3,6933,3847,3086,124.7
'35310, 완주군,'055001, 50세,2019,1380,755,625,120.8,1342,737,605,121.8
'35310, 완주군,'055002, 51세,2019,1574,906,668,135.6,1524,879,645,136.3
'35310, 완주군,'055003, 52세,2019,1347,742,605,122.6,1304,716,588,121.8
'35310, 완주군,'055004, 53세,2019,1437,800,637,125.6,1395,779,616,126.5
'35310, 완주군,'055005, 54세,2019,1405,755,650,116.2,1368,736,632,116.5
'35310, 완주군,'060,55~59세,2019,7670,4040,3630,111.3,7545,3972,3573,111.2
'35310, 완주군,'060001, 55세,2019,1297,720,577,124.8,1268,702,566,124
'35310, 완주군,'060002, 56세,2019,1426,755,671,112.5,1394,737,657,112.2
'35310, 완주군,'060003, 57세,2019,1525,799,726,110.1,1499,786,713,110.2
'35310, 완주군,'060004, 58세,2019,1676,871,805,108.2,1655,860,795,108.2
'35310, 완주군,'060005, 59세,2019,1746,895,851,105.2,1729,887,842,105.3
'35310, 완주군,'065,60~64세,2019,7031,3602,3429,105,6952,3557,3395,104.8
'35310, 완주군,'065001, 60세,2019,1490,763,727,105,1471,753,718,104.9
'35310, 완주군,'065002, 61세,2019,1347,695,652,106.6,1328,680,648,104.9
'35310, 완주군,'065003, 62세,2019,1393,694,699,99.3,1379,686,693,99
'35310, 완주군,'065004, 63세,2019,1370,707,663,106.6,1355,701,654,107.2
'35310, 완주군,'065005, 64세,2019,1431,743,688,108,1419,737,682,108.1
'35310, 완주군,'070,65~69세,2019,5367,2683,2684,100,5339,2674,2665,100.3
'35310, 완주군,'070001, 65세,2019,1262,618,644,96,1255,612,643,95.2
'35310, 완주군,'070002, 66세,2019,949,495,454,109,942,494,448,110.3
'35310, 완주군,'070003, 67세,2019,1075,533,542,98.3,1071,533,538,99.1
'35310, 완주군,'070004, 68세,2019,966,484,482,100.4,963,483,480,100.6
'35310, 완주군,'070005, 69세,2019,1115,553,562,98.4,1108,552,556,99.3
'35310, 완주군,'075,70~74세,2019,4528,2176,2352,92.5,4505,2166,2339,92.6
'35310, 완주군,'075001, 70세,2019,973,460,513,89.7,965,455,510,89.2
'35310, 완주군,'075002, 71세,2019,964,471,493,95.5,959,469,490,95.7
'35310, 완주군,'075003, 72세,2019,1054,519,535,97,1049,519,530,97.9
'35310, 완주군,'075004, 73세,2019,824,418,406,103,821,417,404,103.2
'35310, 완주군,'075005, 74세,2019,713,308,405,76,711,306,405,75.6
'35310, 완주군,'080,75~79세,2019,4163,1672,2491,67.1,4158,1671,2487,67.2
'35310, 완주군,'080001, 75세,2019,765,338,427,79.2,764,338,426,79.3
'35310, 완주군,'080002, 76세,2019,758,312,446,70,756,311,445,69.9
'35310, 완주군,'080003, 77세,2019,1150,453,697,65,1148,453,695,65.2
'35310, 완주군,'080004, 78세,2019,777,309,468,66,777,309,468,66
'35310, 완주군,'080005, 79세,2019,713,260,453,57.4,713,260,453,57.4
'35310, 완주군,'085,80~84세,2019,3341,1180,2161,54.6,3338,1180,2158,54.7
'35310, 완주군,'085001, 80세,2019,759,282,477,59.1,759,282,477,59.1
'35310, 완주군,'085002, 81세,2019,742,270,472,57.2,740,270,470,57.4
'35310, 완주군,'085003, 82세,2019,641,224,417,53.7,640,224,416,53.8
'35310, 완주군,'085004, 83세,2019,614,209,405,51.6,614,209,405,51.6
'35310, 완주군,'085005, 84세,2019,585,195,390,50,585,195,390,50
'35310, 완주군,'086,85세이상,2019,2374,636,1738,36.6,2372,635,1737,36.6
'35310, 완주군,'090,85~89세,2019,1633,483,1150,42,1632,482,1150,41.9
'35310, 완주군,'090001, 85세,2019,462,155,307,50.5,461,154,307,50.2
'35310, 완주군,'090002, 86세,2019,388,126,262,48.1,388,126,262,48.1
'35310, 완주군,'090003, 87세,2019,294,79,215,36.7,294,79,215,36.7
'35310, 완주군,'090004, 88세,2019,262,69,193,35.8,262,69,193,35.8
'35310, 완주군,'090005, 89세,2019,227,54,173,31.2,227,54,173,31.2
'35310, 완주군,'095,90~94세,2019,606,129,477,27,605,129,476,27.1
'35310, 완주군,'095001, 90세,2019,179,33,146,22.6,179,33,146,22.6
'35310, 완주군,'095002, 91세,2019,152,40,112,35.7,151,40,111,36
'35310, 완주군,'095003, 92세,2019,133,33,100,33,133,33,100,33
'35310, 완주군,'095004, 93세,2019,78,13,65,20,78,13,65,20
'35310, 완주군,'095005, 94세,2019,64,10,54,18.5,64,10,54,18.5
'35310, 완주군,'100,95~99세,2019,120,20,100,20,120,20,100,20
'35310, 완주군,'100001, 95세,2019,29,5,24,20.8,29,5,24,20.8
'35310, 완주군,'100002, 96세,2019,44,X,40,10,44,X,40,10
'35310, 완주군,'100003, 97세,2019,25,X,21,19,25,X,21,19
'35310, 완주군,'100004, 98세,2019,11,X,8,37.5,11,X,8,37.5
'35310, 완주군,'100005, 99세,2019,11,X,7,57.1,11,X,7,57.1
'35310, 완주군,'101,100세이상,2019,15,X,11,36.4,15,X,11,36.4
'35310, 완주군,'102,15세미만,2019,11748,5984,5764,103.8,11683,5947,5736,103.7
'35310, 완주군,'103,15~64세,2019,64691,35279,29412,119.9,60104,32586,27518,118.4
'35310, 완주군,'104,65세이상,2019,19773,8347,11426,73.1,19712,8326,11386,73.1
'35310, 완주군,'126,평균연령,2019,44.3,42.5,46.1,,44.9,43.2,46.6,
'35310, 완주군,'127,중위연령,2019,45.4,43.8,47.4,,46.7,45.2,48.5,
'35320, 진안군,'000,합계,2019,23013,11446,11567,99,22501,11245,11256,99.9
'35320, 진안군,'005,0~4세,2019,653,327,326,100.3,651,327,324,100.9
'35320, 진안군,'005001, 0세,2019,138,73,65,112.3,138,73,65,112.3
'35320, 진안군,'005002, 1세,2019,145,67,78,85.9,145,67,78,85.9
'35320, 진안군,'005003, 2세,2019,121,74,47,157.4,119,74,45,164.4
'35320, 진안군,'005004, 3세,2019,132,62,70,88.6,132,62,70,88.6
'35320, 진안군,'005005, 4세,2019,117,51,66,77.3,117,51,66,77.3
'35320, 진안군,'010,5~9세,2019,683,338,345,98,682,338,344,98.3
'35320, 진안군,'010001, 5세,2019,128,56,72,77.8,128,56,72,77.8
'35320, 진안군,'010002, 6세,2019,112,51,61,83.6,112,51,61,83.6
'35320, 진안군,'010003, 7세,2019,134,64,70,91.4,133,64,69,92.8
'35320, 진안군,'010004, 8세,2019,158,88,70,125.7,158,88,70,125.7
'35320, 진안군,'010005, 9세,2019,151,79,72,109.7,151,79,72,109.7
'35320, 진안군,'015,10~14세,2019,635,329,306,107.5,632,327,305,107.2
'35320, 진안군,'015001, 10세,2019,131,67,64,104.7,130,66,64,103.1
'35320, 진안군,'015002, 11세,2019,121,60,61,98.4,121,60,61,98.4
'35320, 진안군,'015003, 12세,2019,124,63,61,103.3,122,62,60,103.3
'35320, 진안군,'015004, 13세,2019,135,68,67,101.5,135,68,67,101.5
'35320, 진안군,'015005, 14세,2019,124,71,53,134,124,71,53,134
'35320, 진안군,'020,15~19세,2019,719,373,346,107.8,710,371,339,109.4
'35320, 진안군,'020001, 15세,2019,133,70,63,111.1,133,70,63,111.1
'35320, 진안군,'020002, 16세,2019,161,72,89,80.9,158,70,88,79.5
'35320, 진안군,'020003, 17세,2019,154,76,78,97.4,152,76,76,100
'35320, 진안군,'020004, 18세,2019,166,87,79,110.1,165,87,78,111.5
'35320, 진안군,'020005, 19세,2019,105,68,37,183.8,102,68,34,200
'35320, 진안군,'025,20~24세,2019,885,537,348,154.3,822,510,312,163.5
'35320, 진안군,'025001, 20세,2019,146,101,45,224.4,139,101,38,265.8
'35320, 진안군,'025002, 21세,2019,184,112,72,155.6,164,103,61,168.9
'35320, 진안군,'025003, 22세,2019,197,120,77,155.8,187,115,72,159.7
'35320, 진안군,'025004, 23세,2019,196,110,86,127.9,178,101,77,131.2
'35320, 진안군,'025005, 24세,2019,162,94,68,138.2,154,90,64,140.6
'35320, 진안군,'030,25~29세,2019,870,458,412,111.2,767,407,360,113.1
'35320, 진안군,'030001, 25세,2019,177,97,80,121.3,156,88,68,129.4
'35320, 진안군,'030002, 26세,2019,173,89,84,106,155,78,77,101.3
'35320, 진안군,'030003, 27세,2019,172,90,82,109.8,154,83,71,116.9
'35320, 진안군,'030004, 28세,2019,190,103,87,118.4,160,84,76,110.5
'35320, 진안군,'030005, 29세,2019,158,79,79,100,142,74,68,108.8
'35320, 진안군,'035,30~34세,2019,778,347,431,80.5,696,318,378,84.1
'35320, 진안군,'035001, 30세,2019,144,67,77,87,126,63,63,100
'35320, 진안군,'035002, 31세,2019,149,70,79,88.6,134,65,69,94.2
'35320, 진안군,'035003, 32세,2019,158,70,88,79.5,145,65,80,81.3
'35320, 진안군,'035004, 33세,2019,163,71,92,77.2,146,63,83,75.9
'35320, 진안군,'035005, 34세,2019,164,69,95,72.6,145,62,83,74.7
'35320, 진안군,'040,35~39세,2019,973,490,483,101.4,917,468,449,104.2
'35320, 진안군,'040001, 35세,2019,171,80,91,87.9,158,77,81,95.1
'35320, 진안군,'040002, 36세,2019,179,90,89,101.1,168,84,84,100
'35320, 진안군,'040003, 37세,2019,195,94,101,93.1,182,89,93,95.7
'35320, 진안군,'040004, 38세,2019,192,101,91,111,182,96,86,111.6
'35320, 진안군,'040005, 39세,2019,236,125,111,112.6,227,122,105,116.2
'35320, 진안군,'045,40~44세,2019,1066,613,453,135.3,1022,602,420,143.3
'35320, 진안군,'045001, 40세,2019,204,115,89,129.2,192,112,80,140
'35320, 진안군,'045002, 41세,2019,177,101,76,132.9,169,98,71,138
'35320, 진안군,'045003, 42세,2019,244,143,101,141.6,235,143,92,155.4
'35320, 진안군,'045004, 43세,2019,226,129,97,133,221,128,93,137.6
'35320, 진안군,'045005, 44세,2019,215,125,90,138.9,205,121,84,144
'35320, 진안군,'050,45~49세,2019,1483,844,639,132.1,1449,831,618,134.5
'35320, 진안군,'050001, 45세,2019,294,176,118,149.2,287,175,112,156.3
'35320, 진안군,'050002, 46세,2019,277,146,131,111.5,271,143,128,111.7
'35320, 진안군,'050003, 47세,2019,289,173,116,149.1,282,171,111,154.1
'35320, 진안군,'050004, 48세,2019,299,177,122,145.1,293,174,119,146.2
'35320, 진안군,'050005, 49세,2019,324,172,152,113.2,316,168,148,113.5
'35320, 진안군,'055,50~54세,2019,1857,1071,786,136.3,1819,1057,762,138.7
'35320, 진안군,'055001, 50세,2019,350,208,142,146.5,344,206,138,149.3
'35320, 진안군,'055002, 51세,2019,349,198,151,131.1,345,196,149,131.5
'35320, 진안군,'055003, 52세,2019,345,207,138,150,341,206,135,152.6
'35320, 진안군,'055004, 53세,2019,391,220,171,128.7,383,219,164,133.5
'35320, 진안군,'055005, 54세,2019,422,238,184,129.3,406,230,176,130.7
'35320, 진안군,'060,55~59세,2019,2285,1225,1060,115.6,2241,1208,1033,116.9
'35320, 진안군,'060001, 55세,2019,354,190,164,115.9,347,187,160,116.9
'35320, 진안군,'060002, 56세,2019,389,212,177,119.8,378,211,167,126.3
'35320, 진안군,'060003, 57세,2019,448,240,208,115.4,434,233,201,115.9
'35320, 진안군,'060004, 58세,2019,529,288,241,119.5,524,286,238,120.2
'35320, 진안군,'060005, 59세,2019,565,295,270,109.3,558,291,267,109
'35320, 진안군,'065,60~64세,2019,2245,1158,1087,106.5,2232,1157,1075,107.6
'35320, 진안군,'065001, 60세,2019,482,252,230,109.6,481,252,229,110
'35320, 진안군,'065002, 61세,2019,428,212,216,98.1,426,212,214,99.1
'35320, 진안군,'065003, 62세,2019,443,244,199,122.6,439,244,195,125.1
'35320, 진안군,'065004, 63세,2019,410,211,199,106,408,211,197,107.1
'35320, 진안군,'065005, 64세,2019,482,239,243,98.4,478,238,240,99.2
'35320, 진안군,'070,65~69세,2019,1908,970,938,103.4,1898,963,935,103
'35320, 진안군,'070001, 65세,2019,424,226,198,114.1,422,224,198,113.1
'35320, 진안군,'070002, 66세,2019,350,171,179,95.5,348,170,178,95.5
'35320, 진안군,'070003, 67세,2019,397,210,187,112.3,395,209,186,112.4
'35320, 진안군,'070004, 68세,2019,316,157,159,98.7,313,155,158,98.1
'35320, 진안군,'070005, 69세,2019,421,206,215,95.8,420,205,215,95.3
'35320, 진안군,'075,70~74세,2019,1793,852,941,90.5,1785,849,936,90.7
'35320, 진안군,'075001, 70세,2019,390,188,202,93.1,388,188,200,94
'35320, 진안군,'075002, 71세,2019,378,180,198,90.9,376,178,198,89.9
'35320, 진안군,'075003, 72세,2019,389,184,205,89.8,389,184,205,89.8
'35320, 진안군,'075004, 73세,2019,302,145,157,92.4,299,144,155,92.9
'35320, 진안군,'075005, 74세,2019,334,155,179,86.6,333,155,178,87.1
'35320, 진안군,'080,75~79세,2019,1772,744,1028,72.4,1770,742,1028,72.2
'35320, 진안군,'080001, 75세,2019,282,128,154,83.1,281,127,154,82.5
'35320, 진안군,'080002, 76세,2019,338,132,206,64.1,338,132,206,64.1
'35320, 진안군,'080003, 77세,2019,484,216,268,80.6,484,216,268,80.6
'35320, 진안군,'080004, 78세,2019,343,142,201,70.6,343,142,201,70.6
'35320, 진안군,'080005, 79세,2019,325,126,199,63.3,324,125,199,62.8
'35320, 진안군,'085,80~84세,2019,1441,497,944,52.6,1441,497,944,52.6
'35320, 진안군,'085001, 80세,2019,346,123,223,55.2,346,123,223,55.2
'35320, 진안군,'085002, 81세,2019,292,98,194,50.5,292,98,194,50.5
'35320, 진안군,'085003, 82세,2019,280,97,183,53,280,97,183,53
'35320, 진안군,'085004, 83세,2019,277,96,181,53,277,96,181,53
'35320, 진안군,'085005, 84세,2019,246,83,163,50.9,246,83,163,50.9
'35320, 진안군,'086,85세이상,2019,967,273,694,39.3,967,273,694,39.3
'35320, 진안군,'090,85~89세,2019,696,198,498,39.8,696,198,498,39.8
'35320, 진안군,'090001, 85세,2019,205,62,143,43.4,205,62,143,43.4
'35320, 진안군,'090002, 86세,2019,182,55,127,43.3,182,55,127,43.3
'35320, 진안군,'090003, 87세,2019,132,42,90,46.7,132,42,90,46.7
'35320, 진안군,'090004, 88세,2019,90,22,68,32.4,90,22,68,32.4
'35320, 진안군,'090005, 89세,2019,87,17,70,24.3,87,17,70,24.3
'35320, 진안군,'095,90~94세,2019,221,67,154,43.5,221,67,154,43.5
'35320, 진안군,'095001, 90세,2019,75,24,51,47.1,75,24,51,47.1
'35320, 진안군,'095002, 91세,2019,44,12,32,37.5,44,12,32,37.5
'35320, 진안군,'095003, 92세,2019,55,18,37,48.6,55,18,37,48.6
'35320, 진안군,'095004, 93세,2019,27,7,20,35,27,7,20,35
'35320, 진안군,'095005, 94세,2019,20,6,14,42.9,20,6,14,42.9
'35320, 진안군,'100,95~99세,2019,46,8,38,21.1,46,8,38,21.1
'35320, 진안군,'100001, 95세,2019,17,X,13,30.8,17,X,13,30.8
'35320, 진안군,'100002, 96세,2019,12,X,11,9.1,12,X,11,9.1
'35320, 진안군,'100003, 97세,2019,9,X,7,28.6,9,X,7,28.6
'35320, 진안군,'100004, 98세,2019,5,X,X,25,5,X,X,25
'35320, 진안군,'100005, 99세,2019,X,X,X,0,X,X,X,0
'35320, 진안군,'101,100세이상,2019,X,X,X,0,X,X,X,0
'35320, 진안군,'102,15세미만,2019,1971,994,977,101.7,1965,992,973,102
'35320, 진안군,'103,15~64세,2019,13161,7116,6045,117.7,12675,6929,5746,120.6
'35320, 진안군,'104,65세이상,2019,7881,3336,4545,73.4,7861,3324,4537,73.3
'35320, 진안군,'126,평균연령,2019,53,51,54.9,,53.3,51.2,55.4,
'35320, 진안군,'127,중위연령,2019,57.4,55,59.4,,57.8,55.4,59.9,
'35330, 무주군,'000,합계,2019,22852,11323,11529,98.2,22522,11221,11301,99.3
'35330, 무주군,'005,0~4세,2019,492,253,239,105.9,492,253,239,105.9
'35330, 무주군,'005001, 0세,2019,76,39,37,105.4,76,39,37,105.4
'35330, 무주군,'005002, 1세,2019,79,41,38,107.9,79,41,38,107.9
'35330, 무주군,'005003, 2세,2019,102,45,57,78.9,102,45,57,78.9
'35330, 무주군,'005004, 3세,2019,115,64,51,125.5,115,64,51,125.5
'35330, 무주군,'005005, 4세,2019,120,64,56,114.3,120,64,56,114.3
'35330, 무주군,'010,5~9세,2019,746,409,337,121.4,746,409,337,121.4
'35330, 무주군,'010001, 5세,2019,146,95,51,186.3,146,95,51,186.3
'35330, 무주군,'010002, 6세,2019,136,72,64,112.5,136,72,64,112.5
'35330, 무주군,'010003, 7세,2019,148,80,68,117.6,148,80,68,117.6
'35330, 무주군,'010004, 8세,2019,180,92,88,104.5,180,92,88,104.5
'35330, 무주군,'010005, 9세,2019,136,70,66,106.1,136,70,66,106.1
'35330, 무주군,'015,10~14세,2019,821,404,417,96.9,821,404,417,96.9
'35330, 무주군,'015001, 10세,2019,170,76,94,80.9,170,76,94,80.9
'35330, 무주군,'015002, 11세,2019,159,85,74,114.9,159,85,74,114.9
'35330, 무주군,'015003, 12세,2019,180,88,92,95.7,180,88,92,95.7
'35330, 무주군,'015004, 13세,2019,150,81,69,117.4,150,81,69,117.4
'35330, 무주군,'015005, 14세,2019,162,74,88,84.1,162,74,88,84.1
'35330, 무주군,'020,15~19세,2019,864,463,401,115.5,859,460,399,115.3
'35330, 무주군,'020001, 15세,2019,158,84,74,113.5,157,84,73,115.1
'35330, 무주군,'020002, 16세,2019,169,85,84,101.2,169,85,84,101.2
'35330, 무주군,'020003, 17세,2019,213,98,115,85.2,213,98,115,85.2
'35330, 무주군,'020004, 18세,2019,197,115,82,140.2,196,114,82,139
'35330, 무주군,'020005, 19세,2019,127,81,46,176.1,124,79,45,175.6
'35330, 무주군,'025,20~24세,2019,778,474,304,155.9,738,457,281,162.6
'35330, 무주군,'025001, 20세,2019,115,76,39,194.9,112,75,37,202.7
'35330, 무주군,'025002, 21세,2019,156,99,57,173.7,151,99,52,190.4
'35330, 무주군,'025003, 22세,2019,137,82,55,149.1,129,79,50,158
'35330, 무주군,'025004, 23세,2019,151,93,58,160.3,141,87,54,161.1
'35330, 무주군,'025005, 24세,2019,219,124,95,130.5,205,117,88,133
'35330, 무주군,'030,25~29세,2019,868,459,409,112.2,820,446,374,119.3
'35330, 무주군,'030001, 25세,2019,180,99,81,122.2,170,98,72,136.1
'35330, 무주군,'030002, 26세,2019,181,93,88,105.7,169,88,81,108.6
'35330, 무주군,'030003, 27세,2019,170,80,90,88.9,161,77,84,91.7
'35330, 무주군,'030004, 28세,2019,170,92,78,117.9,158,89,69,129
'35330, 무주군,'030005, 29세,2019,167,95,72,131.9,162,94,68,138.2
'35330, 무주군,'035,30~34세,2019,803,422,381,110.8,749,412,337,122.3
'35330, 무주군,'035001, 30세,2019,146,86,60,143.3,139,84,55,152.7
'35330, 무주군,'035002, 31세,2019,175,98,77,127.3,162,93,69,134.8
'35330, 무주군,'035003, 32세,2019,172,81,91,89,156,80,76,105.3
'35330, 무주군,'035004, 33세,2019,156,81,75,108,146,80,66,121.2
'35330, 무주군,'035005, 34세,2019,154,76,78,97.4,146,75,71,105.6
'35330, 무주군,'040,35~39세,2019,969,499,470,106.2,932,493,439,112.3
'35330, 무주군,'040001, 35세,2019,155,68,87,78.2,150,68,82,82.9
'35330, 무주군,'040002, 36세,2019,193,109,84,129.8,186,109,77,141.6
'35330, 무주군,'040003, 37세,2019,193,107,86,124.4,185,106,79,134.2
'35330, 무주군,'040004, 38세,2019,209,103,106,97.2,199,100,99,101
'35330, 무주군,'040005, 39세,2019,219,112,107,104.7,212,110,102,107.8
'35330, 무주군,'045,40~44세,2019,1205,653,552,118.3,1164,644,520,123.8
'35330, 무주군,'045001, 40세,2019,226,124,102,121.6,219,121,98,123.5
'35330, 무주군,'045002, 41세,2019,214,103,111,92.8,204,103,101,102
'35330, 무주군,'045003, 42세,2019,247,133,114,116.7,239,131,108,121.3
'35330, 무주군,'045004, 43세,2019,261,139,122,113.9,253,137,116,118.1
'35330, 무주군,'045005, 44세,2019,257,154,103,149.5,249,152,97,156.7
'35330, 무주군,'050,45~49세,2019,1598,906,692,130.9,1564,892,672,132.7
'35330, 무주군,'050001, 45세,2019,333,174,159,109.4,325,170,155,109.7
'35330, 무주군,'050002, 46세,2019,327,189,138,137,319,183,136,134.6
'35330, 무주군,'050003, 47세,2019,284,166,118,140.7,276,165,111,148.6
'35330, 무주군,'050004, 48세,2019,338,180,158,113.9,334,179,155,115.5
'35330, 무주군,'050005, 49세,2019,316,197,119,165.5,310,195,115,169.6
'35330, 무주군,'055,50~54세,2019,1882,1056,826,127.8,1858,1049,809,129.7
'35330, 무주군,'055001, 50세,2019,345,192,153,125.5,339,189,150,126
'35330, 무주군,'055002, 51세,2019,387,230,157,146.5,381,228,153,149
'35330, 무주군,'055003, 52세,2019,384,209,175,119.4,379,208,171,121.6
'35330, 무주군,'055004, 53세,2019,388,218,170,128.2,383,217,166,130.7
'35330, 무주군,'055005, 54세,2019,378,207,171,121.1,376,207,169,122.5
'35330, 무주군,'060,55~59세,2019,2166,1148,1018,112.8,2140,1138,1002,113.6
'35330, 무주군,'060001, 55세,2019,334,184,150,122.7,324,180,144,125
'35330, 무주군,'060002, 56세,2019,362,203,159,127.7,354,199,155,128.4
'35330, 무주군,'060003, 57세,2019,481,250,231,108.2,478,250,228,109.6
'35330, 무주군,'060004, 58세,2019,507,265,242,109.5,505,264,241,109.5
'35330, 무주군,'060005, 59세,2019,482,246,236,104.2,479,245,234,104.7
'35330, 무주군,'065,60~64세,2019,2191,1132,1059,106.9,2175,1124,1051,106.9
'35330, 무주군,'065001, 60세,2019,451,238,213,111.7,449,237,212,111.8
'35330, 무주군,'065002, 61세,2019,438,218,220,99.1,433,217,216,100.5
'35330, 무주군,'065003, 62세,2019,466,239,227,105.3,463,237,226,104.9
'35330, 무주군,'065004, 63세,2019,387,206,181,113.8,383,203,180,112.8
'35330, 무주군,'065005, 64세,2019,449,231,218,106,447,230,217,106
'35330, 무주군,'070,65~69세,2019,1820,881,939,93.8,1817,878,939,93.5
'35330, 무주군,'070001, 65세,2019,431,228,203,112.3,429,226,203,111.3
'35330, 무주군,'070002, 66세,2019,303,149,154,96.8,302,148,154,96.1
'35330, 무주군,'070003, 67세,2019,395,190,205,92.7,395,190,205,92.7
'35330, 무주군,'070004, 68세,2019,320,146,174,83.9,320,146,174,83.9
'35330, 무주군,'070005, 69세,2019,371,168,203,82.8,371,168,203,82.8
'35330, 무주군,'075,70~74세,2019,1526,675,851,79.3,1526,675,851,79.3
'35330, 무주군,'075001, 70세,2019,278,144,134,107.5,278,144,134,107.5
'35330, 무주군,'075002, 71세,2019,346,157,189,83.1,346,157,189,83.1
'35330, 무주군,'075003, 72세,2019,339,146,193,75.6,339,146,193,75.6
'35330, 무주군,'075004, 73세,2019,308,128,180,71.1,308,128,180,71.1
'35330, 무주군,'075005, 74세,2019,255,100,155,64.5,255,100,155,64.5
'35330, 무주군,'080,75~79세,2019,1776,714,1062,67.2,1775,713,1062,67.1
'35330, 무주군,'080001, 75세,2019,267,117,150,78,267,117,150,78
'35330, 무주군,'080002, 76세,2019,347,126,221,57,346,125,221,56.6
'35330, 무주군,'080003, 77세,2019,457,175,282,62.1,457,175,282,62.1
'35330, 무주군,'080004, 78세,2019,380,160,220,72.7,380,160,220,72.7
'35330, 무주군,'080005, 79세,2019,325,136,189,72,325,136,189,72
'35330, 무주군,'085,80~84세,2019,1388,507,881,57.5,1388,507,881,57.5
'35330, 무주군,'085001, 80세,2019,317,112,205,54.6,317,112,205,54.6
'35330, 무주군,'085002, 81세,2019,304,120,184,65.2,304,120,184,65.2
'35330, 무주군,'085003, 82세,2019,271,96,175,54.9,271,96,175,54.9
'35330, 무주군,'085004, 83세,2019,260,93,167,55.7,260,93,167,55.7
'35330, 무주군,'085005, 84세,2019,236,86,150,57.3,236,86,150,57.3
'35330, 무주군,'086,85세이상,2019,959,268,691,38.8,958,267,691,38.6
'35330, 무주군,'090,85~89세,2019,677,205,472,43.4,676,204,472,43.2
'35330, 무주군,'090001, 85세,2019,193,56,137,40.9,193,56,137,40.9
'35330, 무주군,'090002, 86세,2019,164,51,113,45.1,164,51,113,45.1
'35330, 무주군,'090003, 87세,2019,139,47,92,51.1,139,47,92,51.1
'35330, 무주군,'090004, 88세,2019,105,37,68,54.4,104,36,68,52.9
'35330, 무주군,'090005, 89세,2019,76,14,62,22.6,76,14,62,22.6
'35330, 무주군,'095,90~94세,2019,223,50,173,28.9,223,50,173,28.9
'35330, 무주군,'095001, 90세,2019,61,13,48,27.1,61,13,48,27.1
'35330, 무주군,'095002, 91세,2019,58,9,49,18.4,58,9,49,18.4
'35330, 무주군,'095003, 92세,2019,47,14,33,42.4,47,14,33,42.4
'35330, 무주군,'095004, 93세,2019,36,8,28,28.6,36,8,28,28.6
'35330, 무주군,'095005, 94세,2019,21,6,15,40,21,6,15,40
'35330, 무주군,'100,95~99세,2019,50,11,39,28.2,50,11,39,28.2
'35330, 무주군,'100001, 95세,2019,12,X,9,33.3,12,X,9,33.3
'35330, 무주군,'100002, 96세,2019,7,X,X,75,7,X,X,75
'35330, 무주군,'100003, 97세,2019,14,X,10,40,14,X,10,40
'35330, 무주군,'100004, 98세,2019,7,X,6,16.7,7,X,6,16.7
'35330, 무주군,'100005, 99세,2019,10,X,10,0,10,X,10,0
'35330, 무주군,'101,100세이상,2019,9,X,7,28.6,9,X,7,28.6
'35330, 무주군,'102,15세미만,2019,2059,1066,993,107.4,2059,1066,993,107.4
'35330, 무주군,'103,15~64세,2019,13324,7212,6112,118,12999,7115,5884,120.9
'35330, 무주군,'104,65세이상,2019,7469,3045,4424,68.8,7464,3040,4424,68.7
'35330, 무주군,'126,평균연령,2019,52.3,49.9,54.6,,52.5,50,55,
'35330, 무주군,'127,중위연령,2019,56.2,53.4,58.8,,56.5,53.5,59.2,
'35340, 장수군,'000,합계,2019,21267,10544,10723,98.3,20740,10303,10437,98.7
'35340, 장수군,'005,0~4세,2019,492,262,230,113.9,490,260,230,113
'35340, 장수군,'005001, 0세,2019,92,46,46,100,91,45,46,97.8
'35340, 장수군,'005002, 1세,2019,80,45,35,128.6,80,45,35,128.6
'35340, 장수군,'005003, 2세,2019,93,46,47,97.9,93,46,47,97.9
'35340, 장수군,'005004, 3세,2019,107,62,45,137.8,106,61,45,135.6
'35340, 장수군,'005005, 4세,2019,120,63,57,110.5,120,63,57,110.5
'35340, 장수군,'010,5~9세,2019,733,379,354,107.1,733,379,354,107.1
'35340, 장수군,'010001, 5세,2019,127,64,63,101.6,127,64,63,101.6
'35340, 장수군,'010002, 6세,2019,144,79,65,121.5,144,79,65,121.5
'35340, 장수군,'010003, 7세,2019,136,69,67,103,136,69,67,103
'35340, 장수군,'010004, 8세,2019,169,87,82,106.1,169,87,82,106.1
'35340, 장수군,'010005, 9세,2019,157,80,77,103.9,157,80,77,103.9
'35340, 장수군,'015,10~14세,2019,767,390,377,103.4,766,389,377,103.2
'35340, 장수군,'015001, 10세,2019,143,82,61,134.4,143,82,61,134.4
'35340, 장수군,'015002, 11세,2019,171,84,87,96.6,171,84,87,96.6
'35340, 장수군,'015003, 12세,2019,165,77,88,87.5,164,76,88,86.4
'35340, 장수군,'015004, 13세,2019,130,69,61,113.1,130,69,61,113.1
'35340, 장수군,'015005, 14세,2019,158,78,80,97.5,158,78,80,97.5
'35340, 장수군,'020,15~19세,2019,950,487,463,105.2,947,486,461,105.4
'35340, 장수군,'020001, 15세,2019,165,77,88,87.5,165,77,88,87.5
'35340, 장수군,'020002, 16세,2019,219,98,121,81,219,98,121,81
'35340, 장수군,'020003, 17세,2019,227,113,114,99.1,227,113,114,99.1
'35340, 장수군,'020004, 18세,2019,233,135,98,137.8,233,135,98,137.8
'35340, 장수군,'020005, 19세,2019,106,64,42,152.4,103,63,40,157.5
'35340, 장수군,'025,20~24세,2019,822,479,343,139.7,759,456,303,150.5
'35340, 장수군,'025001, 20세,2019,143,91,52,175,136,90,46,195.7
'35340, 장수군,'025002, 21세,2019,181,119,62,191.9,171,115,56,205.4
'35340, 장수군,'025003, 22세,2019,150,84,66,127.3,140,80,60,133.3
'35340, 장수군,'025004, 23세,2019,167,81,86,94.2,146,70,76,92.1
'35340, 장수군,'025005, 24세,2019,181,104,77,135.1,166,101,65,155.4
'35340, 장수군,'030,25~29세,2019,811,444,367,121,696,382,314,121.7
'35340, 장수군,'030001, 25세,2019,169,88,81,108.6,148,80,68,117.6
'35340, 장수군,'030002, 26세,2019,166,105,61,172.1,144,90,54,166.7
'35340, 장수군,'030003, 27세,2019,152,76,76,100,129,66,63,104.8
'35340, 장수군,'030004, 28세,2019,161,89,72,123.6,135,74,61,121.3
'35340, 장수군,'030005, 29세,2019,163,86,77,111.7,140,72,68,105.9
'35340, 장수군,'035,30~34세,2019,792,409,383,106.8,709,365,344,106.1
'35340, 장수군,'035001, 30세,2019,160,83,77,107.8,138,71,67,106
'35340, 장수군,'035002, 31세,2019,152,79,73,108.2,134,67,67,100
'35340, 장수군,'035003, 32세,2019,159,77,82,93.9,146,70,76,92.1
'35340, 장수군,'035004, 33세,2019,175,100,75,133.3,162,92,70,131.4
'35340, 장수군,'035005, 34세,2019,146,70,76,92.1,129,65,64,101.6
'35340, 장수군,'040,35~39세,2019,989,519,470,110.4,911,488,423,115.4
'35340, 장수군,'040001, 35세,2019,165,83,82,101.2,141,76,65,116.9
'35340, 장수군,'040002, 36세,2019,180,110,70,157.1,169,104,65,160
'35340, 장수군,'040003, 37세,2019,199,96,103,93.2,182,90,92,97.8
'35340, 장수군,'040004, 38세,2019,198,98,100,98,183,92,91,101.1
'35340, 장수군,'040005, 39세,2019,247,132,115,114.8,236,126,110,114.5
'35340, 장수군,'045,40~44세,2019,1066,613,453,135.3,1030,597,433,137.9
'35340, 장수군,'045001, 40세,2019,208,126,82,153.7,198,122,76,160.5
'35340, 장수군,'045002, 41세,2019,209,115,94,122.3,202,113,89,127
'35340, 장수군,'045003, 42세,2019,230,134,96,139.6,227,132,95,138.9
'35340, 장수군,'045004, 43세,2019,194,104,90,115.6,184,102,82,124.4
'35340, 장수군,'045005, 44세,2019,225,134,91,147.3,219,128,91,140.7
'35340, 장수군,'050,45~49세,2019,1386,779,607,128.3,1340,757,583,129.8
'35340, 장수군,'050001, 45세,2019,249,134,115,116.5,242,131,111,118
'35340, 장수군,'050002, 46세,2019,278,162,116,139.7,273,158,115,137.4
'35340, 장수군,'050003, 47세,2019,264,139,125,111.2,249,133,116,114.7
'35340, 장수군,'050004, 48세,2019,317,183,134,136.6,310,179,131,136.6
'35340, 장수군,'050005, 49세,2019,278,161,117,137.6,266,156,110,141.8
'35340, 장수군,'055,50~54세,2019,1689,931,758,122.8,1652,918,734,125.1
'35340, 장수군,'055001, 50세,2019,321,174,147,118.4,314,173,141,122.7
'35340, 장수군,'055002, 51세,2019,352,187,165,113.3,341,183,158,115.8
'35340, 장수군,'055003, 52세,2019,312,175,137,127.7,307,173,134,129.1
'35340, 장수군,'055004, 53세,2019,327,181,146,124,320,180,140,128.6
'35340, 장수군,'055005, 54세,2019,377,214,163,131.3,370,209,161,129.8
'35340, 장수군,'060,55~59세,2019,1920,1031,889,116,1886,1019,867,117.5
'35340, 장수군,'060001, 55세,2019,286,148,138,107.2,283,148,135,109.6
'35340, 장수군,'060002, 56세,2019,294,158,136,116.2,288,155,133,116.5
'35340, 장수군,'060003, 57세,2019,404,226,178,127,394,222,172,129.1
'35340, 장수군,'060004, 58세,2019,441,235,206,114.1,432,232,200,116
'35340, 장수군,'060005, 59세,2019,495,264,231,114.3,489,262,227,115.4
'35340, 장수군,'065,60~64세,2019,1978,976,1002,97.4,1965,971,994,97.7
'35340, 장수군,'065001, 60세,2019,390,193,197,98,388,193,195,99
'35340, 장수군,'065002, 61세,2019,382,192,190,101.1,380,191,189,101.1
'35340, 장수군,'065003, 62세,2019,390,188,202,93.1,388,187,201,93
'35340, 장수군,'065004, 63세,2019,375,177,198,89.4,373,176,197,89.3
'35340, 장수군,'065005, 64세,2019,441,226,215,105.1,436,224,212,105.7
'35340, 장수군,'070,65~69세,2019,1774,895,879,101.8,1766,890,876,101.6
'35340, 장수군,'070001, 65세,2019,368,187,181,103.3,366,186,180,103.3
'35340, 장수군,'070002, 66세,2019,343,178,165,107.9,340,175,165,106.1
'35340, 장수군,'070003, 67세,2019,385,187,198,94.4,384,186,198,93.9
'35340, 장수군,'070004, 68세,2019,336,161,175,92,335,161,174,92.5
'35340, 장수군,'070005, 69세,2019,342,182,160,113.8,341,182,159,114.5
'35340, 장수군,'075,70~74세,2019,1427,683,744,91.8,1422,680,742,91.6
'35340, 장수군,'075001, 70세,2019,310,161,149,108.1,309,161,148,108.8
'35340, 장수군,'075002, 71세,2019,354,164,190,86.3,353,163,190,85.8
'35340, 장수군,'075003, 72세,2019,309,150,159,94.3,308,150,158,94.9
'35340, 장수군,'075004, 73세,2019,227,110,117,94,226,109,117,93.2
'35340, 장수군,'075005, 74세,2019,227,98,129,76,226,97,129,75.2
'35340, 장수군,'080,75~79세,2019,1581,592,989,59.9,1579,591,988,59.8
'35340, 장수군,'080001, 75세,2019,265,106,159,66.7,265,106,159,66.7
'35340, 장수군,'080002, 76세,2019,284,105,179,58.7,284,105,179,58.7
'35340, 장수군,'080003, 77세,2019,419,157,262,59.9,418,157,261,60.2
'35340, 장수군,'080004, 78세,2019,320,111,209,53.1,320,111,209,53.1
'35340, 장수군,'080005, 79세,2019,293,113,180,62.8,292,112,180,62.2
'35340, 장수군,'085,80~84세,2019,1243,412,831,49.6,1242,412,830,49.6
'35340, 장수군,'085001, 80세,2019,329,114,215,53,329,114,215,53
'35340, 장수군,'085002, 81세,2019,241,85,156,54.5,240,85,155,54.8
'35340, 장수군,'085003, 82세,2019,221,70,151,46.4,221,70,151,46.4
'35340, 장수군,'085004, 83세,2019,241,80,161,49.7,241,80,161,49.7
'35340, 장수군,'085005, 84세,2019,211,63,148,42.6,211,63,148,42.6
'35340, 장수군,'086,85세이상,2019,847,263,584,45,847,263,584,45
'35340, 장수군,'090,85~89세,2019,624,209,415,50.4,624,209,415,50.4
'35340, 장수군,'090001, 85세,2019,199,71,128,55.5,199,71,128,55.5
'35340, 장수군,'090002, 86세,2019,138,45,93,48.4,138,45,93,48.4
'35340, 장수군,'090003, 87세,2019,138,50,88,56.8,138,50,88,56.8
'35340, 장수군,'090004, 88세,2019,75,27,48,56.3,75,27,48,56.3
'35340, 장수군,'090005, 89세,2019,74,16,58,27.6,74,16,58,27.6
'35340, 장수군,'095,90~94세,2019,177,49,128,38.3,177,49,128,38.3
'35340, 장수군,'095001, 90세,2019,42,9,33,27.3,42,9,33,27.3
'35340, 장수군,'095002, 91세,2019,53,19,34,55.9,53,19,34,55.9
'35340, 장수군,'095003, 92세,2019,43,7,36,19.4,43,7,36,19.4
'35340, 장수군,'095004, 93세,2019,15,5,10,50,15,5,10,50
'35340, 장수군,'095005, 94세,2019,24,9,15,60,24,9,15,60
'35340, 장수군,'100,95~99세,2019,42,X,38,10.5,42,X,38,10.5
'35340, 장수군,'100001, 95세,2019,11,X,10,10,11,X,10,10
'35340, 장수군,'100002, 96세,2019,10,X,9,11.1,10,X,9,11.1
'35340, 장수군,'100003, 97세,2019,11,X,10,10,11,X,10,10
'35340, 장수군,'100004, 98세,2019,5,X,X,25,5,X,X,25
'35340, 장수군,'100005, 99세,2019,5,X,5,0,5,X,5,0
'35340, 장수군,'101,100세이상,2019,X,X,X,33.3,X,X,X,33.3
'35340, 장수군,'102,15세미만,2019,1992,1031,961,107.3,1989,1028,961,107
'35340, 장수군,'103,15~64세,2019,12403,6668,5735,116.3,11895,6439,5456,118
'35340, 장수군,'104,65세이상,2019,6872,2845,4027,70.6,6856,2836,4020,70.5
'35340, 장수군,'126,평균연령,2019,51.5,49.1,53.7,,51.8,49.4,54.2,
'35340, 장수군,'127,중위연령,2019,55.5,52.9,58.5,,56.2,53.4,59.1,
'35350, 임실군,'000,합계,2019,26144,13099,13045,100.4,25664,12893,12771,101
'35350, 임실군,'005,0~4세,2019,709,392,317,123.7,708,391,317,123.3
'35350, 임실군,'005001, 0세,2019,139,75,64,117.2,139,75,64,117.2
'35350, 임실군,'005002, 1세,2019,138,88,50,176,137,87,50,174
'35350, 임실군,'005003, 2세,2019,152,80,72,111.1,152,80,72,111.1
'35350, 임실군,'005004, 3세,2019,140,72,68,105.9,140,72,68,105.9
'35350, 임실군,'005005, 4세,2019,140,77,63,122.2,140,77,63,122.2
'35350, 임실군,'010,5~9세,2019,721,373,348,107.2,721,373,348,107.2
'35350, 임실군,'010001, 5세,2019,136,71,65,109.2,136,71,65,109.2
'35350, 임실군,'010002, 6세,2019,144,68,76,89.5,144,68,76,89.5
'35350, 임실군,'010003, 7세,2019,135,66,69,95.7,135,66,69,95.7
'35350, 임실군,'010004, 8세,2019,152,87,65,133.8,152,87,65,133.8
'35350, 임실군,'010005, 9세,2019,154,81,73,111,154,81,73,111
'35350, 임실군,'015,10~14세,2019,763,395,368,107.3,763,395,368,107.3
'35350, 임실군,'015001, 10세,2019,160,87,73,119.2,160,87,73,119.2
'35350, 임실군,'015002, 11세,2019,179,96,83,115.7,179,96,83,115.7
'35350, 임실군,'015003, 12세,2019,151,75,76,98.7,151,75,76,98.7
'35350, 임실군,'015004, 13세,2019,136,63,73,86.3,136,63,73,86.3
'35350, 임실군,'015005, 14세,2019,137,74,63,117.5,137,74,63,117.5
'35350, 임실군,'020,15~19세,2019,946,520,426,122.1,946,520,426,122.1
'35350, 임실군,'020001, 15세,2019,147,82,65,126.2,147,82,65,126.2
'35350, 임실군,'020002, 16세,2019,167,87,80,108.8,167,87,80,108.8
'35350, 임실군,'020003, 17세,2019,161,88,73,120.5,161,88,73,120.5
'35350, 임실군,'020004, 18세,2019,203,109,94,116,203,109,94,116
'35350, 임실군,'020005, 19세,2019,268,154,114,135.1,268,154,114,135.1
'35350, 임실군,'025,20~24세,2019,1294,706,588,120.1,1240,681,559,121.8
'35350, 임실군,'025001, 20세,2019,258,133,125,106.4,254,133,121,109.9
'35350, 임실군,'025002, 21세,2019,246,140,106,132.1,239,137,102,134.3
'35350, 임실군,'025003, 22세,2019,281,145,136,106.6,271,142,129,110.1
'35350, 임실군,'025004, 23세,2019,259,142,117,121.4,244,134,110,121.8
'35350, 임실군,'025005, 24세,2019,250,146,104,140.4,232,135,97,139.2
'35350, 임실군,'030,25~29세,2019,1104,624,480,130,1015,577,438,131.7
'35350, 임실군,'030001, 25세,2019,227,131,96,136.5,207,124,83,149.4
'35350, 임실군,'030002, 26세,2019,205,111,94,118.1,189,100,89,112.4
'35350, 임실군,'030003, 27세,2019,239,137,102,134.3,222,126,96,131.3
'35350, 임실군,'030004, 28세,2019,222,128,94,136.2,201,116,85,136.5
'35350, 임실군,'030005, 29세,2019,211,117,94,124.5,196,111,85,130.6
'35350, 임실군,'035,30~34세,2019,999,514,485,106,914,481,433,111.1
'35350, 임실군,'035001, 30세,2019,226,119,107,111.2,210,112,98,114.3
'35350, 임실군,'035002, 31세,2019,189,96,93,103.2,174,92,82,112.2
'35350, 임실군,'035003, 32세,2019,196,105,91,115.4,172,93,79,117.7
'35350, 임실군,'035004, 33세,2019,192,95,97,97.9,177,90,87,103.4
'35350, 임실군,'035005, 34세,2019,196,99,97,102.1,181,94,87,108
'35350, 임실군,'040,35~39세,2019,1093,589,504,116.9,1036,570,466,122.3
'35350, 임실군,'040001, 35세,2019,216,111,105,105.7,202,104,98,106.1
'35350, 임실군,'040002, 36세,2019,192,99,93,106.5,176,96,80,120
'35350, 임실군,'040003, 37세,2019,229,128,101,126.7,219,126,93,135.5
'35350, 임실군,'040004, 38세,2019,225,122,103,118.4,215,117,98,119.4
'35350, 임실군,'040005, 39세,2019,231,129,102,126.5,224,127,97,130.9
'35350, 임실군,'045,40~44세,2019,1228,728,500,145.6,1185,712,473,150.5
'35350, 임실군,'045001, 40세,2019,259,144,115,125.2,246,140,106,132.1
'35350, 임실군,'045002, 41세,2019,256,153,103,148.5,251,150,101,148.5
'35350, 임실군,'045003, 42세,2019,230,150,80,187.5,221,146,75,194.7
'35350, 임실군,'045004, 43세,2019,242,143,99,144.4,237,141,96,146.9
'35350, 임실군,'045005, 44세,2019,241,138,103,134,230,135,95,142.1
'35350, 임실군,'050,45~49세,2019,1577,928,649,143,1538,916,622,147.3
'35350, 임실군,'050001, 45세,2019,286,163,123,132.5,278,161,117,137.6
'35350, 임실군,'050002, 46세,2019,305,179,126,142.1,298,178,120,148.3
'35350, 임실군,'050003, 47세,2019,315,194,121,160.3,308,190,118,161
'35350, 임실군,'050004, 48세,2019,333,204,129,158.1,325,201,124,162.1
'35350, 임실군,'050005, 49세,2019,338,188,150,125.3,329,186,143,130.1
'35350, 임실군,'055,50~54세,2019,1998,1114,884,126,1952,1092,860,127
'35350, 임실군,'055001, 50세,2019,367,194,173,112.1,353,188,165,113.9
'35350, 임실군,'055002, 51세,2019,419,239,180,132.8,409,234,175,133.7
'35350, 임실군,'055003, 52세,2019,392,220,172,127.9,384,217,167,129.9
'35350, 임실군,'055004, 53세,2019,392,208,184,113,387,204,183,111.5
'35350, 임실군,'055005, 54세,2019,428,253,175,144.6,419,249,170,146.5
'35350, 임실군,'060,55~59세,2019,2380,1268,1112,114,2344,1252,1092,114.7
'35350, 임실군,'060001, 55세,2019,398,218,180,121.1,388,214,174,123
'35350, 임실군,'060002, 56세,2019,418,230,188,122.3,413,226,187,120.9
'35350, 임실군,'060003, 57세,2019,451,235,216,108.8,447,235,212,110.8
'35350, 임실군,'060004, 58세,2019,512,267,245,109,500,262,238,110.1
'35350, 임실군,'060005, 59세,2019,601,318,283,112.4,596,315,281,112.1
'35350, 임실군,'065,60~64세,2019,2319,1226,1093,112.2,2298,1217,1081,112.6
'35350, 임실군,'065001, 60세,2019,514,249,265,94,511,249,262,95
'35350, 임실군,'065002, 61세,2019,422,225,197,114.2,417,223,194,114.9
'35350, 임실군,'065003, 62세,2019,467,260,207,125.6,465,259,206,125.7
'35350, 임실군,'065004, 63세,2019,472,248,224,110.7,465,245,220,111.4
'35350, 임실군,'065005, 64세,2019,444,244,200,122,440,241,199,121.1
'35350, 임실군,'070,65~69세,2019,2032,1017,1015,100.2,2029,1015,1014,100.1
'35350, 임실군,'070001, 65세,2019,423,220,203,108.4,423,220,203,108.4
'35350, 임실군,'070002, 66세,2019,355,189,166,113.9,354,189,165,114.5
'35350, 임실군,'070003, 67세,2019,403,199,204,97.5,403,199,204,97.5
'35350, 임실군,'070004, 68세,2019,389,178,211,84.4,387,176,211,83.4
'35350, 임실군,'070005, 69세,2019,462,231,231,100,462,231,231,100
'35350, 임실군,'075,70~74세,2019,1965,915,1050,87.1,1963,915,1048,87.3
'35350, 임실군,'075001, 70세,2019,399,179,220,81.4,399,179,220,81.4
'35350, 임실군,'075002, 71세,2019,442,214,228,93.9,442,214,228,93.9
'35350, 임실군,'075003, 72세,2019,464,228,236,96.6,463,228,235,97
'35350, 임실군,'075004, 73세,2019,323,152,171,88.9,323,152,171,88.9
'35350, 임실군,'075005, 74세,2019,337,142,195,72.8,336,142,194,73.2
'35350, 임실군,'080,75~79세,2019,2060,804,1256,64,2060,804,1256,64
'35350, 임실군,'080001, 75세,2019,316,142,174,81.6,316,142,174,81.6
'35350, 임실군,'080002, 76세,2019,361,148,213,69.5,361,148,213,69.5
'35350, 임실군,'080003, 77세,2019,565,211,354,59.6,565,211,354,59.6
'35350, 임실군,'080004, 78세,2019,417,163,254,64.2,417,163,254,64.2
'35350, 임실군,'080005, 79세,2019,401,140,261,53.6,401,140,261,53.6
'35350, 임실군,'085,80~84세,2019,1746,637,1109,57.4,1742,633,1109,57.1
'35350, 임실군,'085001, 80세,2019,419,164,255,64.3,418,163,255,63.9
'35350, 임실군,'085002, 81세,2019,345,132,213,62,343,130,213,61
'35350, 임실군,'085003, 82세,2019,373,129,244,52.9,372,128,244,52.5
'35350, 임실군,'085004, 83세,2019,321,118,203,58.1,321,118,203,58.1
'35350, 임실군,'085005, 84세,2019,288,94,194,48.5,288,94,194,48.5
'35350, 임실군,'086,85세이상,2019,1210,349,861,40.5,1210,349,861,40.5
'35350, 임실군,'090,85~89세,2019,847,263,584,45,847,263,584,45
'35350, 임실군,'090001, 85세,2019,270,83,187,44.4,270,83,187,44.4
'35350, 임실군,'090002, 86세,2019,179,56,123,45.5,179,56,123,45.5
'35350, 임실군,'090003, 87세,2019,175,60,115,52.2,175,60,115,52.2
'35350, 임실군,'090004, 88세,2019,132,37,95,38.9,132,37,95,38.9
'35350, 임실군,'090005, 89세,2019,91,27,64,42.2,91,27,64,42.2
'35350, 임실군,'095,90~94세,2019,311,77,234,32.9,311,77,234,32.9
'35350, 임실군,'095001, 90세,2019,106,32,74,43.2,106,32,74,43.2
'35350, 임실군,'095002, 91세,2019,82,20,62,32.3,82,20,62,32.3
'35350, 임실군,'095003, 92세,2019,57,13,44,29.5,57,13,44,29.5
'35350, 임실군,'095004, 93세,2019,41,8,33,24.2,41,8,33,24.2
'35350, 임실군,'095005, 94세,2019,25,X,21,19,25,X,21,19
'35350, 임실군,'100,95~99세,2019,37,6,31,19.4,37,6,31,19.4
'35350, 임실군,'100001, 95세,2019,12,X,9,33.3,12,X,9,33.3
'35350, 임실군,'100002, 96세,2019,13,X,10,30,13,X,10,30
'35350, 임실군,'100003, 97세,2019,7,X,7,0,7,X,7,0
'35350, 임실군,'100004, 98세,2019,X,X,X,0,X,X,X,0
'35350, 임실군,'100005, 99세,2019,X,X,X,0,X,X,X,0
'35350, 임실군,'101,100세이상,2019,15,X,12,25,15,X,12,25
'35350, 임실군,'102,15세미만,2019,2193,1160,1033,112.3,2192,1159,1033,112.2
'35350, 임실군,'103,15~64세,2019,14938,8217,6721,122.3,14468,8018,6450,124.3
'35350, 임실군,'104,65세이상,2019,9013,3722,5291,70.3,9004,3716,5288,70.3
'35350, 임실군,'126,평균연령,2019,52.4,49.9,55,,52.7,50.1,55.4,
'35350, 임실군,'127,중위연령,2019,56.6,53.6,59.5,,57,53.9,59.9,
'35360, 순창군,'000,합계,2019,26642,12782,13860,92.2,26115,12579,13536,92.9
'35360, 순창군,'005,0~4세,2019,875,456,419,108.8,874,456,418,109.1
'35360, 순창군,'005001, 0세,2019,186,96,90,106.7,186,96,90,106.7
'35360, 순창군,'005002, 1세,2019,201,99,102,97.1,200,99,101,98
'35360, 순창군,'005003, 2세,2019,148,76,72,105.6,148,76,72,105.6
'35360, 순창군,'005004, 3세,2019,188,97,91,106.6,188,97,91,106.6
'35360, 순창군,'005005, 4세,2019,152,88,64,137.5,152,88,64,137.5
'35360, 순창군,'010,5~9세,2019,804,418,386,108.3,804,418,386,108.3
'35360, 순창군,'010001, 5세,2019,130,65,65,100,130,65,65,100
'35360, 순창군,'010002, 6세,2019,163,91,72,126.4,163,91,72,126.4
'35360, 순창군,'010003, 7세,2019,158,79,79,100,158,79,79,100
'35360, 순창군,'010004, 8세,2019,169,86,83,103.6,169,86,83,103.6
'35360, 순창군,'010005, 9세,2019,184,97,87,111.5,184,97,87,111.5
'35360, 순창군,'015,10~14세,2019,983,513,470,109.1,983,513,470,109.1
'35360, 순창군,'015001, 10세,2019,180,98,82,119.5,180,98,82,119.5
'35360, 순창군,'015002, 11세,2019,187,90,97,92.8,187,90,97,92.8
'35360, 순창군,'015003, 12세,2019,218,108,110,98.2,218,108,110,98.2
'35360, 순창군,'015004, 13세,2019,209,118,91,129.7,209,118,91,129.7
'35360, 순창군,'015005, 14세,2019,189,99,90,110,189,99,90,110
'35360, 순창군,'020,15~19세,2019,998,520,478,108.8,994,518,476,108.8
'35360, 순창군,'020001, 15세,2019,203,107,96,111.5,202,106,96,110.4
'35360, 순창군,'020002, 16세,2019,205,101,104,97.1,205,101,104,97.1
'35360, 순창군,'020003, 17세,2019,231,115,116,99.1,231,115,116,99.1
'35360, 순창군,'020004, 18세,2019,218,116,102,113.7,218,116,102,113.7
'35360, 순창군,'020005, 19세,2019,141,81,60,135,138,80,58,137.9
'35360, 순창군,'025,20~24세,2019,948,572,376,152.1,872,534,338,158
'35360, 순창군,'025001, 20세,2019,151,113,38,297.4,147,109,38,286.8
'35360, 순창군,'025002, 21세,2019,205,138,67,206,191,129,62,208.1
'35360, 순창군,'025003, 22세,2019,194,108,86,125.6,178,101,77,131.2
'35360, 순창군,'025004, 23세,2019,188,102,86,118.6,168,94,74,127
'35360, 순창군,'025005, 24세,2019,210,111,99,112.1,188,101,87,116.1
'35360, 순창군,'030,25~29세,2019,990,477,513,93,874,437,437,100
'35360, 순창군,'030001, 25세,2019,220,113,107,105.6,192,101,91,111
'35360, 순창군,'030002, 26세,2019,198,100,98,102,169,95,74,128.4
'35360, 순창군,'030003, 27세,2019,192,92,100,92,177,82,95,86.3
'35360, 순창군,'030004, 28세,2019,183,87,96,90.6,166,82,84,97.6
'35360, 순창군,'030005, 29세,2019,197,85,112,75.9,170,77,93,82.8
'35360, 순창군,'035,30~34세,2019,971,438,533,82.2,889,408,481,84.8
'35360, 순창군,'035001, 30세,2019,159,66,93,71,145,61,84,72.6
'35360, 순창군,'035002, 31세,2019,198,98,100,98,174,85,89,95.5
'35360, 순창군,'035003, 32세,2019,201,97,104,93.3,184,93,91,102.2
'35360, 순창군,'035004, 33세,2019,213,89,124,71.8,197,83,114,72.8
'35360, 순창군,'035005, 34세,2019,200,88,112,78.6,189,86,103,83.5
'35360, 순창군,'040,35~39세,2019,1246,601,645,93.2,1190,580,610,95.1
'35360, 순창군,'040001, 35세,2019,215,100,115,87,200,94,106,88.7
'35360, 순창군,'040002, 36세,2019,233,107,126,84.9,224,101,123,82.1
'35360, 순창군,'040003, 37세,2019,245,115,130,88.5,237,113,124,91.1
'35360, 순창군,'040004, 38세,2019,265,136,129,105.4,252,133,119,111.8
'35360, 순창군,'040005, 39세,2019,288,143,145,98.6,277,139,138,100.7
'35360, 순창군,'045,40~44세,2019,1339,738,601,122.8,1304,728,576,126.4
'35360, 순창군,'045001, 40세,2019,285,146,139,105,275,144,131,109.9
'35360, 순창군,'045002, 41세,2019,249,143,106,134.9,241,139,102,136.3
'35360, 순창군,'045003, 42세,2019,269,130,139,93.5,260,129,131,98.5
'35360, 순창군,'045004, 43세,2019,257,160,97,164.9,251,159,92,172.8
'35360, 순창군,'045005, 44세,2019,279,159,120,132.5,277,157,120,130.8
'35360, 순창군,'050,45~49세,2019,1794,1019,775,131.5,1748,1006,742,135.6
'35360, 순창군,'050001, 45세,2019,364,199,165,120.6,358,199,159,125.2
'35360, 순창군,'050002, 46세,2019,338,197,141,139.7,324,192,132,145.5
'35360, 순창군,'050003, 47세,2019,357,204,153,133.3,351,202,149,135.6
'35360, 순창군,'050004, 48세,2019,407,231,176,131.3,396,229,167,137.1
'35360, 순창군,'050005, 49세,2019,328,188,140,134.3,319,184,135,136.3
'35360, 순창군,'055,50~54세,2019,2037,1111,926,120,1997,1095,902,121.4
'35360, 순창군,'055001, 50세,2019,435,251,184,136.4,426,248,178,139.3
'35360, 순창군,'055002, 51세,2019,424,251,173,145.1,414,246,168,146.4
'35360, 순창군,'055003, 52세,2019,390,208,182,114.3,382,204,178,114.6
'35360, 순창군,'055004, 53세,2019,408,209,199,105,399,206,193,106.7
'35360, 순창군,'055005, 54세,2019,380,192,188,102.1,376,191,185,103.2
'35360, 순창군,'060,55~59세,2019,2366,1242,1124,110.5,2324,1225,1099,111.5
'35360, 순창군,'060001, 55세,2019,375,192,183,104.9,363,186,177,105.1
'35360, 순창군,'060002, 56세,2019,394,211,183,115.3,384,209,175,119.4
'35360, 순창군,'060003, 57세,2019,461,243,218,111.5,452,238,214,111.2
'35360, 순창군,'060004, 58세,2019,505,269,236,114,498,266,232,114.7
'35360, 순창군,'060005, 59세,2019,631,327,304,107.6,627,326,301,108.3
'35360, 순창군,'065,60~64세,2019,2336,1195,1141,104.7,2316,1184,1132,104.6
'35360, 순창군,'065001, 60세,2019,502,258,244,105.7,494,252,242,104.1
'35360, 순창군,'065002, 61세,2019,451,238,213,111.7,446,234,212,110.4
'35360, 순창군,'065003, 62세,2019,451,235,216,108.8,447,235,212,110.8
'35360, 순창군,'065004, 63세,2019,452,221,231,95.7,451,221,230,96.1
'35360, 순창군,'065005, 64세,2019,480,243,237,102.5,478,242,236,102.5
'35360, 순창군,'070,65~69세,2019,1914,913,1001,91.2,1912,911,1001,91
'35360, 순창군,'070001, 65세,2019,445,218,227,96,444,217,227,95.6
'35360, 순창군,'070002, 66세,2019,353,160,193,82.9,353,160,193,82.9
'35360, 순창군,'070003, 67세,2019,397,182,215,84.7,396,181,215,84.2
'35360, 순창군,'070004, 68세,2019,336,166,170,97.6,336,166,170,97.6
'35360, 순창군,'070005, 69세,2019,383,187,196,95.4,383,187,196,95.4
'35360, 순창군,'075,70~74세,2019,1958,863,1095,78.8,1956,862,1094,78.8
'35360, 순창군,'075001, 70세,2019,404,177,227,78,404,177,227,78
'35360, 순창군,'075002, 71세,2019,419,192,227,84.6,417,191,226,84.5
'35360, 순창군,'075003, 72세,2019,445,198,247,80.2,445,198,247,80.2
'35360, 순창군,'075004, 73세,2019,360,155,205,75.6,360,155,205,75.6
'35360, 순창군,'075005, 74세,2019,330,141,189,74.6,330,141,189,74.6
'35360, 순창군,'080,75~79세,2019,2177,770,1407,54.7,2174,770,1404,54.8
'35360, 순창군,'080001, 75세,2019,346,130,216,60.2,346,130,216,60.2
'35360, 순창군,'080002, 76세,2019,382,131,251,52.2,382,131,251,52.2
'35360, 순창군,'080003, 77세,2019,584,200,384,52.1,583,200,383,52.2
'35360, 순창군,'080004, 78세,2019,450,164,286,57.3,450,164,286,57.3
'35360, 순창군,'080005, 79세,2019,415,145,270,53.7,413,145,268,54.1
'35360, 순창군,'085,80~84세,2019,1740,624,1116,55.9,1739,623,1116,55.8
'35360, 순창군,'085001, 80세,2019,418,150,268,56,417,149,268,55.6
'35360, 순창군,'085002, 81세,2019,394,137,257,53.3,394,137,257,53.3
'35360, 순창군,'085003, 82세,2019,313,117,196,59.7,313,117,196,59.7
'35360, 순창군,'085004, 83세,2019,327,112,215,52.1,327,112,215,52.1
'35360, 순창군,'085005, 84세,2019,288,108,180,60,288,108,180,60
'35360, 순창군,'086,85세이상,2019,1166,312,854,36.5,1165,311,854,36.4
'35360, 순창군,'090,85~89세,2019,800,225,575,39.1,799,224,575,39
'35360, 순창군,'090001, 85세,2019,240,61,179,34.1,239,60,179,33.5
'35360, 순창군,'090002, 86세,2019,159,52,107,48.6,159,52,107,48.6
'35360, 순창군,'090003, 87세,2019,172,49,123,39.8,172,49,123,39.8
'35360, 순창군,'090004, 88세,2019,118,38,80,47.5,118,38,80,47.5
'35360, 순창군,'090005, 89세,2019,111,25,86,29.1,111,25,86,29.1
'35360, 순창군,'095,90~94세,2019,278,72,206,35,278,72,206,35
'35360, 순창군,'095001, 90세,2019,80,26,54,48.1,80,26,54,48.1
'35360, 순창군,'095002, 91세,2019,74,19,55,34.5,74,19,55,34.5
'35360, 순창군,'095003, 92세,2019,65,12,53,22.6,65,12,53,22.6
'35360, 순창군,'095004, 93세,2019,31,10,21,47.6,31,10,21,47.6
'35360, 순창군,'095005, 94세,2019,28,5,23,21.7,28,5,23,21.7
'35360, 순창군,'100,95~99세,2019,78,13,65,20,78,13,65,20
'35360, 순창군,'100001, 95세,2019,25,X,21,19,25,X,21,19
'35360, 순창군,'100002, 96세,2019,20,X,17,17.6,20,X,17,17.6
'35360, 순창군,'100003, 97세,2019,17,X,14,21.4,17,X,14,21.4
'35360, 순창군,'100004, 98세,2019,7,X,5,40,7,X,5,40
'35360, 순창군,'100005, 99세,2019,9,X,8,12.5,9,X,8,12.5
'35360, 순창군,'101,100세이상,2019,10,X,8,25,10,X,8,25
'35360, 순창군,'102,15세미만,2019,2662,1387,1275,108.8,2661,1387,1274,108.9
'35360, 순창군,'103,15~64세,2019,15025,7913,7112,111.3,14508,7715,6793,113.6
'35360, 순창군,'104,65세이상,2019,8955,3482,5473,63.6,8946,3477,5469,63.6
'35360, 순창군,'126,평균연령,2019,51.9,49.3,54.4,,52.2,49.5,54.8,
'35360, 순창군,'127,중위연령,2019,55.9,52.7,58.9,,56.4,53,59.4,
'35370, 고창군,'000,합계,2019,53260,26405,26855,98.3,51850,25664,26186,98
'35370, 고창군,'005,0~4세,2019,1215,637,578,110.2,1208,630,578,109
'35370, 고창군,'005001, 0세,2019,246,138,108,127.8,245,137,108,126.9
'35370, 고창군,'005002, 1세,2019,216,108,108,100,215,107,108,99.1
'35370, 고창군,'005003, 2세,2019,234,117,117,100,233,116,117,99.1
'35370, 고창군,'005004, 3세,2019,243,133,110,120.9,242,132,110,120
'35370, 고창군,'005005, 4세,2019,276,141,135,104.4,273,138,135,102.2
'35370, 고창군,'010,5~9세,2019,1645,894,751,119,1642,891,751,118.6
'35370, 고창군,'010001, 5세,2019,336,184,152,121.1,336,184,152,121.1
'35370, 고창군,'010002, 6세,2019,293,158,135,117,293,158,135,117
'35370, 고창군,'010003, 7세,2019,317,180,137,131.4,315,178,137,129.9
'35370, 고창군,'010004, 8세,2019,382,198,184,107.6,382,198,184,107.6
'35370, 고창군,'010005, 9세,2019,317,174,143,121.7,316,173,143,121
'35370, 고창군,'015,10~14세,2019,1818,953,865,110.2,1817,952,865,110.1
'35370, 고창군,'015001, 10세,2019,341,169,172,98.3,341,169,172,98.3
'35370, 고창군,'015002, 11세,2019,371,199,172,115.7,370,198,172,115.1
'35370, 고창군,'015003, 12세,2019,338,185,153,120.9,338,185,153,120.9
'35370, 고창군,'015004, 13세,2019,395,199,196,101.5,395,199,196,101.5
'35370, 고창군,'015005, 14세,2019,373,201,172,116.9,373,201,172,116.9
'35370, 고창군,'020,15~19세,2019,2593,1531,1062,144.2,2582,1529,1053,145.2
'35370, 고창군,'020001, 15세,2019,416,244,172,141.9,416,244,172,141.9
'35370, 고창군,'020002, 16세,2019,588,352,236,149.2,587,352,235,149.8
'35370, 고창군,'020003, 17세,2019,664,403,261,154.4,661,402,259,155.2
'35370, 고창군,'020004, 18세,2019,646,359,287,125.1,643,359,284,126.4
'35370, 고창군,'020005, 19세,2019,279,173,106,163.2,275,172,103,167
'35370, 고창군,'025,20~24세,2019,1998,1185,813,145.8,1865,1128,737,153.1
'35370, 고창군,'025001, 20세,2019,327,235,92,255.4,321,231,90,256.7
'35370, 고창군,'025002, 21세,2019,401,271,130,208.5,386,259,127,203.9
'35370, 고창군,'025003, 22세,2019,389,224,165,135.8,367,216,151,143
'35370, 고창군,'025004, 23세,2019,397,199,198,100.5,358,187,171,109.4
'35370, 고창군,'025005, 24세,2019,484,256,228,112.3,433,235,198,118.7
'35370, 고창군,'030,25~29세,2019,2221,1214,1007,120.6,1907,1044,863,121
'35370, 고창군,'030001, 25세,2019,475,244,231,105.6,418,211,207,101.9
'35370, 고창군,'030002, 26세,2019,446,254,192,132.3,382,226,156,144.9
'35370, 고창군,'030003, 27세,2019,439,249,190,131.1,379,215,164,131.1
'35370, 고창군,'030004, 28세,2019,420,237,183,129.5,356,197,159,123.9
'35370, 고창군,'030005, 29세,2019,441,230,211,109,372,195,177,110.2
'35370, 고창군,'035,30~34세,2019,2018,1091,927,117.7,1749,927,822,112.8
'35370, 고창군,'035001, 30세,2019,407,232,175,132.6,346,192,154,124.7
'35370, 고창군,'035002, 31세,2019,398,213,185,115.1,351,184,167,110.2
'35370, 고창군,'035003, 32세,2019,391,207,184,112.5,339,173,166,104.2
'35370, 고창군,'035004, 33세,2019,376,212,164,129.3,323,181,142,127.5
'35370, 고창군,'035005, 34세,2019,446,227,219,103.7,390,197,193,102.1
'35370, 고창군,'040,35~39세,2019,2303,1260,1043,120.8,2123,1168,955,122.3
'35370, 고창군,'040001, 35세,2019,421,233,188,123.9,372,214,158,135.4
'35370, 고창군,'040002, 36세,2019,428,245,183,133.9,389,219,170,128.8
'35370, 고창군,'040003, 37세,2019,447,241,206,117,420,224,196,114.3
'35370, 고창군,'040004, 38세,2019,518,286,232,123.3,487,271,216,125.5
'35370, 고창군,'040005, 39세,2019,489,255,234,109,455,240,215,111.6
'35370, 고창군,'045,40~44세,2019,2620,1491,1129,132.1,2506,1428,1078,132.5
'35370, 고창군,'045001, 40세,2019,519,294,225,130.7,493,281,212,132.5
'35370, 고창군,'045002, 41세,2019,502,280,222,126.1,479,266,213,124.9
'35370, 고창군,'045003, 42세,2019,517,282,235,120,499,272,227,119.8
'35370, 고창군,'045004, 43세,2019,508,290,218,133,485,279,206,135.4
'35370, 고창군,'045005, 44세,2019,574,345,229,150.7,550,330,220,150
'35370, 고창군,'050,45~49세,2019,3576,2007,1569,127.9,3476,1965,1511,130
'35370, 고창군,'050001, 45세,2019,665,369,296,124.7,648,363,285,127.4
'35370, 고창군,'050002, 46세,2019,713,419,294,142.5,696,410,286,143.4
'35370, 고창군,'050003, 47세,2019,702,380,322,118,679,373,306,121.9
'35370, 고창군,'050004, 48세,2019,754,435,319,136.4,731,425,306,138.9
'35370, 고창군,'050005, 49세,2019,742,404,338,119.5,722,394,328,120.1
'35370, 고창군,'055,50~54세,2019,4116,2286,1830,124.9,4013,2237,1776,126
'35370, 고창군,'055001, 50세,2019,804,429,375,114.4,780,417,363,114.9
'35370, 고창군,'055002, 51세,2019,848,471,377,124.9,829,465,364,127.7
'35370, 고창군,'055003, 52세,2019,754,418,336,124.4,730,405,325,124.6
'35370, 고창군,'055004, 53세,2019,835,478,357,133.9,820,470,350,134.3
'35370, 고창군,'055005, 54세,2019,875,490,385,127.3,854,480,374,128.3
'35370, 고창군,'060,55~59세,2019,4730,2420,2310,104.8,4649,2377,2272,104.6
'35370, 고창군,'060001, 55세,2019,803,424,379,111.9,777,412,365,112.9
'35370, 고창군,'060002, 56세,2019,837,447,390,114.6,822,436,386,113
'35370, 고창군,'060003, 57세,2019,916,455,461,98.7,904,450,454,99.1
'35370, 고창군,'060004, 58세,2019,1072,548,524,104.6,1062,544,518,105
'35370, 고창군,'060005, 59세,2019,1102,546,556,98.2,1084,535,549,97.4
'35370, 고창군,'065,60~64세,2019,4926,2462,2464,99.9,4879,2434,2445,99.6
'35370, 고창군,'065001, 60세,2019,973,481,492,97.8,958,473,485,97.5
'35370, 고창군,'065002, 61세,2019,1033,535,498,107.4,1025,531,494,107.5
'35370, 고창군,'065003, 62세,2019,1043,520,523,99.4,1034,515,519,99.2
'35370, 고창군,'065004, 63세,2019,908,444,464,95.7,896,435,461,94.4
'35370, 고창군,'065005, 64세,2019,969,482,487,99,966,480,486,98.8
'35370, 고창군,'070,65~69세,2019,3961,1900,2061,92.2,3940,1892,2048,92.4
'35370, 고창군,'070001, 65세,2019,855,412,443,93,851,411,440,93.4
'35370, 고창군,'070002, 66세,2019,702,332,370,89.7,694,328,366,89.6
'35370, 고창군,'070003, 67세,2019,824,392,432,90.7,820,391,429,91.1
'35370, 고창군,'070004, 68세,2019,734,352,382,92.1,732,351,381,92.1
'35370, 고창군,'070005, 69세,2019,846,412,434,94.9,843,411,432,95.1
'35370, 고창군,'075,70~74세,2019,3910,1786,2124,84.1,3895,1778,2117,84
'35370, 고창군,'075001, 70세,2019,864,399,465,85.8,861,398,463,86
'35370, 고창군,'075002, 71세,2019,802,378,424,89.2,800,376,424,88.7
'35370, 고창군,'075003, 72세,2019,900,427,473,90.3,896,426,470,90.6
'35370, 고창군,'075004, 73세,2019,700,316,384,82.3,697,315,382,82.5
'35370, 고창군,'075005, 74세,2019,644,266,378,70.4,641,263,378,69.6
'35370, 고창군,'080,75~79세,2019,4207,1621,2586,62.7,4198,1617,2581,62.7
'35370, 고창군,'080001, 75세,2019,720,306,414,73.9,716,304,412,73.8
'35370, 고창군,'080002, 76세,2019,802,328,474,69.2,800,328,472,69.5
'35370, 고창군,'080003, 77세,2019,1109,416,693,60,1109,416,693,60
'35370, 고창군,'080004, 78세,2019,841,311,530,58.7,839,310,529,58.6
'35370, 고창군,'080005, 79세,2019,735,260,475,54.7,734,259,475,54.5
'35370, 고창군,'085,80~84세,2019,3187,1099,2088,52.6,3186,1099,2087,52.7
'35370, 고창군,'085001, 80세,2019,799,308,491,62.7,799,308,491,62.7
'35370, 고창군,'085002, 81세,2019,714,255,459,55.6,713,255,458,55.7
'35370, 고창군,'085003, 82세,2019,592,188,404,46.5,592,188,404,46.5
'35370, 고창군,'085004, 83세,2019,520,156,364,42.9,520,156,364,42.9
'35370, 고창군,'085005, 84세,2019,562,192,370,51.9,562,192,370,51.9
'35370, 고창군,'086,85세이상,2019,2216,568,1648,34.5,2215,568,1647,34.5
'35370, 고창군,'090,85~89세,2019,1592,453,1139,39.8,1592,453,1139,39.8
'35370, 고창군,'090001, 85세,2019,462,155,307,50.5,462,155,307,50.5
'35370, 고창군,'090002, 86세,2019,323,93,230,40.4,323,93,230,40.4
'35370, 고창군,'090003, 87세,2019,310,83,227,36.6,310,83,227,36.6
'35370, 고창군,'090004, 88세,2019,255,65,190,34.2,255,65,190,34.2
'35370, 고창군,'090005, 89세,2019,242,57,185,30.8,242,57,185,30.8
'35370, 고창군,'095,90~94세,2019,501,101,400,25.3,500,101,399,25.3
'35370, 고창군,'095001, 90세,2019,158,36,122,29.5,158,36,122,29.5
'35370, 고창군,'095002, 91세,2019,139,28,111,25.2,139,28,111,25.2
'35370, 고창군,'095003, 92세,2019,102,14,88,15.9,102,14,88,15.9
'35370, 고창군,'095004, 93세,2019,66,13,53,24.5,65,13,52,25
'35370, 고창군,'095005, 94세,2019,36,10,26,38.5,36,10,26,38.5
'35370, 고창군,'100,95~99세,2019,113,14,99,14.1,113,14,99,14.1
'35370, 고창군,'100001, 95세,2019,19,6,13,46.2,19,6,13,46.2
'35370, 고창군,'100002, 96세,2019,38,X,34,11.8,38,X,34,11.8
'35370, 고창군,'100003, 97세,2019,32,X,30,6.7,32,X,30,6.7
'35370, 고창군,'100004, 98세,2019,15,X,13,15.4,15,X,13,15.4
'35370, 고창군,'100005, 99세,2019,9,X,9,0,9,X,9,0
'35370, 고창군,'101,100세이상,2019,10,X,10,0,10,X,10,0
'35370, 고창군,'102,15세미만,2019,4678,2484,2194,113.2,4667,2473,2194,112.7
'35370, 고창군,'103,15~64세,2019,31101,16947,14154,119.7,29749,16237,13512,120.2
'35370, 고창군,'104,65세이상,2019,17481,6974,10507,66.4,17434,6954,10480,66.4
'35370, 고창군,'126,평균연령,2019,51.7,48.7,54.7,,52.1,49,55.2,
'35370, 고창군,'127,중위연령,2019,55.6,52.1,59.2,,56.3,52.7,59.7,
'35380, 부안군,'000,합계,2019,49733,24795,24938,99.4,48508,24124,24384,98.9
'35380, 부안군,'005,0~4세,2019,1179,621,558,111.3,1177,620,557,111.3
'35380, 부안군,'005001, 0세,2019,217,99,118,83.9,217,99,118,83.9
'35380, 부안군,'005002, 1세,2019,202,100,102,98,201,99,102,97.1
'35380, 부안군,'005003, 2세,2019,233,139,94,147.9,233,139,94,147.9
'35380, 부안군,'005004, 3세,2019,257,137,120,114.2,256,137,119,115.1
'35380, 부안군,'005005, 4세,2019,270,146,124,117.7,270,146,124,117.7
'35380, 부안군,'010,5~9세,2019,1518,794,724,109.7,1517,794,723,109.8
'35380, 부안군,'010001, 5세,2019,288,142,146,97.3,287,142,145,97.9
'35380, 부안군,'010002, 6세,2019,295,157,138,113.8,295,157,138,113.8
'35380, 부안군,'010003, 7세,2019,305,164,141,116.3,305,164,141,116.3
'35380, 부안군,'010004, 8세,2019,338,176,162,108.6,338,176,162,108.6
'35380, 부안군,'010005, 9세,2019,292,155,137,113.1,292,155,137,113.1
'35380, 부안군,'015,10~14세,2019,1562,791,771,102.6,1556,788,768,102.6
'35380, 부안군,'015001, 10세,2019,303,139,164,84.8,302,139,163,85.3
'35380, 부안군,'015002, 11세,2019,288,151,137,110.2,286,149,137,108.8
'35380, 부안군,'015003, 12세,2019,327,175,152,115.1,326,175,151,115.9
'35380, 부안군,'015004, 13세,2019,316,164,152,107.9,315,163,152,107.2
'35380, 부안군,'015005, 14세,2019,328,162,166,97.6,327,162,165,98.2
'35380, 부안군,'020,15~19세,2019,1966,1171,795,147.3,1954,1166,788,148
'35380, 부안군,'020001, 15세,2019,373,229,144,159,371,229,142,161.3
'35380, 부안군,'020002, 16세,2019,379,202,177,114.1,376,200,176,113.6
'35380, 부안군,'020003, 17세,2019,431,248,183,135.5,429,247,182,135.7
'35380, 부안군,'020004, 18세,2019,496,312,184,169.6,495,312,183,170.5
'35380, 부안군,'020005, 19세,2019,287,180,107,168.2,283,178,105,169.5
'35380, 부안군,'025,20~24세,2019,1949,1138,811,140.3,1817,1067,750,142.3
'35380, 부안군,'025001, 20세,2019,360,228,132,172.7,351,226,125,180.8
'35380, 부안군,'025002, 21세,2019,404,238,166,143.4,369,221,148,149.3
'35380, 부안군,'025003, 22세,2019,377,233,144,161.8,353,222,131,169.5
'35380, 부안군,'025004, 23세,2019,386,209,177,118.1,362,192,170,112.9
'35380, 부안군,'025005, 24세,2019,422,230,192,119.8,382,206,176,117
'35380, 부안군,'030,25~29세,2019,2036,1140,896,127.2,1790,992,798,124.3
'35380, 부안군,'030001, 25세,2019,442,250,192,130.2,397,224,173,129.5
'35380, 부안군,'030002, 26세,2019,423,236,187,126.2,370,205,165,124.2
'35380, 부안군,'030003, 27세,2019,382,208,174,119.5,343,186,157,118.5
'35380, 부안군,'030004, 28세,2019,420,232,188,123.4,361,196,165,118.8
'35380, 부안군,'030005, 29세,2019,369,214,155,138.1,319,181,138,131.2
'35380, 부안군,'035,30~34세,2019,1883,1072,811,132.2,1664,929,735,126.4
'35380, 부안군,'035001, 30세,2019,394,222,172,129.1,348,189,159,118.9
'35380, 부안군,'035002, 31세,2019,361,215,146,147.3,313,183,130,140.8
'35380, 부안군,'035003, 32세,2019,358,209,149,140.3,313,182,131,138.9
'35380, 부안군,'035004, 33세,2019,391,212,179,118.4,351,188,163,115.3
'35380, 부안군,'035005, 34세,2019,379,214,165,129.7,339,187,152,123
'35380, 부안군,'040,35~39세,2019,2395,1276,1119,114,2235,1180,1055,111.8
'35380, 부안군,'040001, 35세,2019,427,239,188,127.1,387,210,177,118.6
'35380, 부안군,'040002, 36세,2019,452,244,208,117.3,421,226,195,115.9
'35380, 부안군,'040003, 37세,2019,499,240,259,92.7,470,223,247,90.3
'35380, 부안군,'040004, 38세,2019,448,249,199,125.1,420,233,187,124.6
'35380, 부안군,'040005, 39세,2019,569,304,265,114.7,537,288,249,115.7
'35380, 부안군,'045,40~44세,2019,2553,1429,1124,127.1,2443,1383,1060,130.5
'35380, 부안군,'045001, 40세,2019,485,264,221,119.5,460,250,210,119
'35380, 부안군,'045002, 41세,2019,512,277,235,117.9,488,271,217,124.9
'35380, 부안군,'045003, 42세,2019,494,287,207,138.6,470,277,193,143.5
'35380, 부안군,'045004, 43세,2019,542,308,234,131.6,527,300,227,132.2
'35380, 부안군,'045005, 44세,2019,520,293,227,129.1,498,285,213,133.8
'35380, 부안군,'050,45~49세,2019,3453,1891,1562,121.1,3346,1840,1506,122.2
'35380, 부안군,'050001, 45세,2019,685,385,300,128.3,666,379,287,132.1
'35380, 부안군,'050002, 46세,2019,664,353,311,113.5,644,344,300,114.7
'35380, 부안군,'050003, 47세,2019,641,353,288,122.6,607,336,271,124
'35380, 부안군,'050004, 48세,2019,752,426,326,130.7,736,418,318,131.4
'35380, 부안군,'050005, 49세,2019,711,374,337,111,693,363,330,110
'35380, 부안군,'055,50~54세,2019,3894,2174,1720,126.4,3795,2131,1664,128.1
'35380, 부안군,'055001, 50세,2019,745,435,310,140.3,726,426,300,142
'35380, 부안군,'055002, 51세,2019,795,444,351,126.5,771,431,340,126.8
'35380, 부안군,'055003, 52세,2019,752,397,355,111.8,735,391,344,113.7
'35380, 부안군,'055004, 53세,2019,816,464,352,131.8,796,455,341,133.4
'35380, 부안군,'055005, 54세,2019,786,434,352,123.3,767,428,339,126.3
'35380, 부안군,'060,55~59세,2019,4601,2332,2269,102.8,4539,2299,2240,102.6
'35380, 부안군,'060001, 55세,2019,800,416,384,108.3,791,410,381,107.6
'35380, 부안군,'060002, 56세,2019,841,445,396,112.4,822,435,387,112.4
'35380, 부안군,'060003, 57세,2019,910,486,424,114.6,892,478,414,115.5
'35380, 부안군,'060004, 58세,2019,993,455,538,84.6,987,451,536,84.1
'35380, 부안군,'060005, 59세,2019,1057,530,527,100.6,1047,525,522,100.6
'35380, 부안군,'065,60~64세,2019,4815,2433,2382,102.1,4768,2412,2356,102.4
'35380, 부안군,'065001, 60세,2019,989,496,493,100.6,978,491,487,100.8
'35380, 부안군,'065002, 61세,2019,951,483,468,103.2,942,480,462,103.9
'35380, 부안군,'065003, 62세,2019,1035,551,484,113.8,1024,547,477,114.7
'35380, 부안군,'065004, 63세,2019,869,442,427,103.5,858,437,421,103.8
'35380, 부안군,'065005, 64세,2019,971,461,510,90.4,966,457,509,89.8
'35380, 부안군,'070,65~69세,2019,3944,1884,2060,91.5,3929,1877,2052,91.5
'35380, 부안군,'070001, 65세,2019,878,425,453,93.8,876,424,452,93.8
'35380, 부안군,'070002, 66세,2019,666,337,329,102.4,663,336,327,102.8
'35380, 부안군,'070003, 67세,2019,824,398,426,93.4,820,396,424,93.4
'35380, 부안군,'070004, 68세,2019,752,343,409,83.9,748,341,407,83.8
'35380, 부안군,'070005, 69세,2019,824,381,443,86,822,380,442,86
'35380, 부안군,'075,70~74세,2019,3720,1743,1977,88.2,3717,1742,1975,88.2
'35380, 부안군,'075001, 70세,2019,828,396,432,91.7,827,396,431,91.9
'35380, 부안군,'075002, 71세,2019,741,373,368,101.4,740,373,367,101.6
'35380, 부안군,'075003, 72세,2019,880,400,480,83.3,880,400,480,83.3
'35380, 부안군,'075004, 73세,2019,674,306,368,83.2,673,305,368,82.9
'35380, 부안군,'075005, 74세,2019,597,268,329,81.5,597,268,329,81.5
'35380, 부안군,'080,75~79세,2019,3515,1389,2126,65.3,3514,1389,2125,65.4
'35380, 부안군,'080001, 75세,2019,659,271,388,69.8,659,271,388,69.8
'35380, 부안군,'080002, 76세,2019,693,292,401,72.8,693,292,401,72.8
'35380, 부안군,'080003, 77세,2019,913,355,558,63.6,913,355,558,63.6
'35380, 부안군,'080004, 78세,2019,653,240,413,58.1,653,240,413,58.1
'35380, 부안군,'080005, 79세,2019,597,231,366,63.1,596,231,365,63.3
'35380, 부안군,'085,80~84세,2019,2841,1005,1836,54.7,2840,1004,1836,54.7
'35380, 부안군,'085001, 80세,2019,694,262,432,60.6,694,262,432,60.6
'35380, 부안군,'085002, 81세,2019,617,232,385,60.3,617,232,385,60.3
'35380, 부안군,'085003, 82세,2019,534,207,327,63.3,534,207,327,63.3
'35380, 부안군,'085004, 83세,2019,503,156,347,45,502,155,347,44.7
'35380, 부안군,'085005, 84세,2019,493,148,345,42.9,493,148,345,42.9
'35380, 부안군,'086,85세이상,2019,1909,512,1397,36.6,1907,511,1396,36.6
'35380, 부안군,'090,85~89세,2019,1421,404,1017,39.7,1419,403,1016,39.7
'35380, 부안군,'090001, 85세,2019,425,134,291,46,424,134,290,46.2
'35380, 부안군,'090002, 86세,2019,362,110,252,43.7,362,110,252,43.7
'35380, 부안군,'090003, 87세,2019,237,50,187,26.7,237,50,187,26.7
'35380, 부안군,'090004, 88세,2019,223,65,158,41.1,223,65,158,41.1
'35380, 부안군,'090005, 89세,2019,174,45,129,34.9,173,44,129,34.1
'35380, 부안군,'095,90~94세,2019,405,90,315,28.6,405,90,315,28.6
'35380, 부안군,'095001, 90세,2019,136,35,101,34.7,136,35,101,34.7
'35380, 부안군,'095002, 91세,2019,111,19,92,20.7,111,19,92,20.7
'35380, 부안군,'095003, 92세,2019,86,15,71,21.1,86,15,71,21.1
'35380, 부안군,'095004, 93세,2019,38,12,26,46.2,38,12,26,46.2
'35380, 부안군,'095005, 94세,2019,34,9,25,36,34,9,25,36
'35380, 부안군,'100,95~99세,2019,68,15,53,28.3,68,15,53,28.3
'35380, 부안군,'100001, 95세,2019,12,5,7,71.4,12,5,7,71.4
'35380, 부안군,'100002, 96세,2019,27,X,24,12.5,27,X,24,12.5
'35380, 부안군,'100003, 97세,2019,15,5,10,50,15,5,10,50
'35380, 부안군,'100004, 98세,2019,5,X,X,66.7,5,X,X,66.7
'35380, 부안군,'100005, 99세,2019,9,X,9,0,9,X,9,0
'35380, 부안군,'101,100세이상,2019,15,X,12,25,15,X,12,25
'35380, 부안군,'102,15세미만,2019,4259,2206,2053,107.5,4250,2202,2048,107.5
'35380, 부안군,'103,15~64세,2019,29545,16056,13489,119,28351,15399,12952,118.9
'35380, 부안군,'104,65세이상,2019,15929,6533,9396,69.5,15907,6523,9384,69.5
'35380, 부안군,'126,평균연령,2019,51.7,49.1,54.4,,52.1,49.4,54.7,
'35380, 부안군,'127,중위연령,2019,55.6,52.5,58.7,,56.2,53.1,59.1,
'36,전라남도,'000,합계,2019,1787543,901813,885730,101.8,1739765,872070,867695,100.5
'36,전라남도,'005,0~4세,2019,61430,31393,30037,104.5,61206,31274,29932,104.5
'36,전라남도,'005001, 0세,2019,10825,5462,5363,101.8,10786,5436,5350,101.6
'36,전라남도,'005002, 1세,2019,11124,5690,5434,104.7,11069,5659,5410,104.6
'36,전라남도,'005003, 2세,2019,11911,6190,5721,108.2,11864,6164,5700,108.1
'36,전라남도,'005004, 3세,2019,13507,6840,6667,102.6,13457,6818,6639,102.7
'36,전라남도,'005005, 4세,2019,14063,7211,6852,105.2,14030,7197,6833,105.3
'36,전라남도,'010,5~9세,2019,76356,38929,37427,104,76181,38845,37336,104
'36,전라남도,'010001, 5세,2019,14078,7136,6942,102.8,14034,7113,6921,102.8
'36,전라남도,'010002, 6세,2019,14812,7615,7197,105.8,14780,7601,7179,105.9
'36,전라남도,'010003, 7세,2019,16171,8114,8057,100.7,16128,8089,8039,100.6
'36,전라남도,'010004, 8세,2019,16318,8250,8068,102.3,16287,8240,8047,102.4
'36,전라남도,'010005, 9세,2019,14977,7814,7163,109.1,14952,7802,7150,109.1
'36,전라남도,'015,10~14세,2019,74812,38532,36280,106.2,74669,38459,36210,106.2
'36,전라남도,'015001, 10세,2019,14667,7521,7146,105.2,14636,7508,7128,105.3
'36,전라남도,'015002, 11세,2019,15235,7834,7401,105.9,15208,7819,7389,105.8
'36,전라남도,'015003, 12세,2019,15775,8119,7656,106,15746,8106,7640,106.1
'36,전라남도,'015004, 13세,2019,14717,7609,7108,107,14690,7595,7095,107
'36,전라남도,'015005, 14세,2019,14418,7449,6969,106.9,14389,7431,6958,106.8
'36,전라남도,'020,15~19세,2019,89719,48107,41612,115.6,88939,47680,41259,115.6
'36,전라남도,'020001, 15세,2019,16257,8499,7758,109.6,16221,8480,7741,109.5
'36,전라남도,'020002, 16세,2019,17048,8810,8238,106.9,17016,8794,8222,107
'36,전라남도,'020003, 17세,2019,17931,9310,8621,108,17886,9289,8597,108
'36,전라남도,'020004, 18세,2019,19827,10614,9213,115.2,19677,10530,9147,115.1
'36,전라남도,'020005, 19세,2019,18656,10874,7782,139.7,18139,10587,7552,140.2
'36,전라남도,'025,20~24세,2019,98558,58143,40415,143.9,92121,53950,38171,141.3
'36,전라남도,'025001, 20세,2019,19096,11727,7369,159.1,18351,11294,7057,160
'36,전라남도,'025002, 21세,2019,19772,11948,7824,152.7,18740,11296,7444,151.7
'36,전라남도,'025003, 22세,2019,19821,11462,8359,137.1,18558,10667,7891,135.2
'36,전라남도,'025004, 23세,2019,19876,11488,8388,137,18384,10474,7910,132.4
'36,전라남도,'025005, 24세,2019,19993,11518,8475,135.9,18088,10219,7869,129.9
'36,전라남도,'030,25~29세,2019,93860,52690,41170,128,83292,45384,37908,119.7
'36,전라남도,'030001, 25세,2019,19610,11291,8319,135.7,17592,9872,7720,127.9
'36,전라남도,'030002, 26세,2019,19544,11063,8481,130.4,17384,9576,7808,122.6
'36,전라남도,'030003, 27세,2019,19341,10698,8643,123.8,17167,9178,7989,114.9
'36,전라남도,'030004, 28세,2019,17840,9955,7885,126.3,15707,8483,7224,117.4
'36,전라남도,'030005, 29세,2019,17525,9683,7842,123.5,15442,8275,7167,115.5
'36,전라남도,'035,30~34세,2019,85624,45848,39776,115.3,76911,40159,36752,109.3
'36,전라남도,'035001, 30세,2019,16549,9069,7480,121.2,14636,7775,6861,113.3
'36,전라남도,'035002, 31세,2019,16519,8913,7606,117.2,14691,7724,6967,110.9
'36,전라남도,'035003, 32세,2019,16937,8891,8046,110.5,15161,7756,7405,104.7
'36,전라남도,'035004, 33세,2019,17545,9374,8171,114.7,15858,8257,7601,108.6
'36,전라남도,'035005, 34세,2019,18074,9601,8473,113.3,16565,8647,7918,109.2
'36,전라남도,'040,35~39세,2019,112547,59756,52791,113.2,106345,55787,50558,110.3
'36,전라남도,'040001, 35세,2019,19621,10324,9297,111,18175,9380,8795,106.7
'36,전라남도,'040002, 36세,2019,21648,11485,10163,113,20328,10630,9698,109.6
'36,전라남도,'040003, 37세,2019,23977,12858,11119,115.6,22717,12057,10660,113.1
'36,전라남도,'040004, 38세,2019,22853,12278,10575,116.1,21680,11524,10156,113.5
'36,전라남도,'040005, 39세,2019,24448,12811,11637,110.1,23445,12196,11249,108.4
'36,전라남도,'045,40~44세,2019,115357,61069,54288,112.5,111174,58494,52680,111
'36,전라남도,'045001, 40세,2019,23710,12462,11248,110.8,22736,11842,10894,108.7
'36,전라남도,'045002, 41세,2019,22082,11726,10356,113.2,21214,11195,10019,111.7
'36,전라남도,'045003, 42세,2019,23031,12051,10980,109.8,22227,11549,10678,108.2
'36,전라남도,'045004, 43세,2019,22852,12304,10548,116.6,22052,11836,10216,115.9
'36,전라남도,'045005, 44세,2019,23682,12526,11156,112.3,22945,12072,10873,111
'36,전라남도,'050,45~49세,2019,140542,75064,65478,114.6,137121,73159,63962,114.4
'36,전라남도,'050001, 45세,2019,26591,14226,12365,115.1,25885,13817,12068,114.5
'36,전라남도,'050002, 46세,2019,27382,14463,12919,112,26692,14080,12612,111.6
'36,전라남도,'050003, 47세,2019,27578,14813,12765,116,26866,14400,12466,115.5
'36,전라남도,'050004, 48세,2019,29955,16078,13877,115.9,29307,15742,13565,116
'36,전라남도,'050005, 49세,2019,29036,15484,13552,114.3,28371,15120,13251,114.1
'36,전라남도,'055,50~54세,2019,147736,78917,68819,114.7,144898,77492,67406,115
'36,전라남도,'055001, 50세,2019,29330,15561,13769,113,28698,15248,13450,113.4
'36,전라남도,'055002, 51세,2019,30853,16458,14395,114.3,30233,16143,14090,114.6
'36,전라남도,'055003, 52세,2019,28630,15155,13475,112.5,28098,14884,13214,112.6
'36,전라남도,'055004, 53세,2019,29499,16112,13387,120.4,28999,15858,13141,120.7
'36,전라남도,'055005, 54세,2019,29424,15631,13793,113.3,28870,15359,13511,113.7
'36,전라남도,'060,55~59세,2019,153304,79092,74212,106.6,151261,78106,73155,106.8
'36,전라남도,'060001, 55세,2019,27620,14450,13170,109.7,27139,14239,12900,110.4
'36,전라남도,'060002, 56세,2019,30239,15916,14323,111.1,29726,15675,14051,111.6
'36,전라남도,'060003, 57세,2019,29195,15327,13868,110.5,28803,15112,13691,110.4
'36,전라남도,'060004, 58세,2019,32229,16279,15950,102.1,31931,16133,15798,102.1
'36,전라남도,'060005, 59세,2019,34021,17120,16901,101.3,33662,16947,16715,101.4
'36,전라남도,'065,60~64세,2019,137983,69758,68225,102.2,136825,69191,67634,102.3
'36,전라남도,'065001, 60세,2019,30679,15395,15284,100.7,30431,15280,15151,100.9
'36,전라남도,'065002, 61세,2019,28284,14473,13811,104.8,27989,14319,13670,104.7
'36,전라남도,'065003, 62세,2019,28037,14287,13750,103.9,27798,14178,13620,104.1
'36,전라남도,'065004, 63세,2019,24522,12398,12124,102.3,24333,12305,12028,102.3
'36,전라남도,'065005, 64세,2019,26461,13205,13256,99.6,26274,13109,13165,99.6
'36,전라남도,'070,65~69세,2019,104778,51130,53648,95.3,104279,50880,53399,95.3
'36,전라남도,'070001, 65세,2019,22136,10892,11244,96.9,21997,10830,11167,97
'36,전라남도,'070002, 66세,2019,19309,9459,9850,96,19202,9399,9803,95.9
'36,전라남도,'070003, 67세,2019,22824,11067,11757,94.1,22734,11018,11716,94
'36,전라남도,'070004, 68세,2019,19972,9774,10198,95.8,19892,9740,10152,95.9
'36,전라남도,'070005, 69세,2019,20537,9938,10599,93.8,20454,9893,10561,93.7
'36,전라남도,'075,70~74세,2019,93776,43483,50293,86.5,93579,43385,50194,86.4
'36,전라남도,'075001, 70세,2019,20415,9896,10519,94.1,20349,9856,10493,93.9
'36,전라남도,'075002, 71세,2019,19934,9440,10494,90,19889,9420,10469,90
'36,전라남도,'075003, 72세,2019,21176,9814,11362,86.4,21150,9801,11349,86.4
'36,전라남도,'075004, 73세,2019,15956,7298,8658,84.3,15931,7286,8645,84.3
'36,전라남도,'075005, 74세,2019,16295,7035,9260,76,16260,7022,9238,76
'36,전라남도,'080,75~79세,2019,89749,36064,53685,67.2,89650,36025,53625,67.2
'36,전라남도,'080001, 75세,2019,15388,6498,8890,73.1,15372,6489,8883,73
'36,전라남도,'080002, 76세,2019,17322,7149,10173,70.3,17292,7138,10154,70.3
'36,전라남도,'080003, 77세,2019,22282,9050,13232,68.4,22268,9044,13224,68.4
'36,전라남도,'080004, 78세,2019,17964,7071,10893,64.9,17938,7063,10875,64.9
'36,전라남도,'080005, 79세,2019,16793,6296,10497,60,16780,6291,10489,60
'36,전라남도,'085,80~84세,2019,65352,22437,42915,52.3,65287,22410,42877,52.3
'36,전라남도,'085001, 80세,2019,15952,5907,10045,58.8,15933,5900,10033,58.8
'36,전라남도,'085002, 81세,2019,14526,5153,9373,55,14513,5147,9366,55
'36,전라남도,'085003, 82세,2019,13118,4502,8616,52.3,13100,4495,8605,52.2
'36,전라남도,'085004, 83세,2019,11225,3631,7594,47.8,11218,3628,7590,47.8
'36,전라남도,'085005, 84세,2019,10531,3244,7287,44.5,10523,3240,7283,44.5
'36,전라남도,'086,85세이상,2019,46060,11401,34659,32.9,46027,11390,34637,32.9
'36,전라남도,'090,85~89세,2019,33277,8733,24544,35.6,33257,8726,24531,35.6
'36,전라남도,'090001, 85세,2019,9264,2713,6551,41.4,9262,2712,6550,41.4
'36,전라남도,'090002, 86세,2019,7536,2053,5483,37.4,7529,2050,5479,37.4
'36,전라남도,'090003, 87세,2019,6395,1674,4721,35.5,6391,1673,4718,35.5
'36,전라남도,'090004, 88세,2019,5060,1223,3837,31.9,5057,1223,3834,31.9
'36,전라남도,'090005, 89세,2019,5022,1070,3952,27.1,5018,1068,3950,27
'36,전라남도,'095,90~94세,2019,10091,2244,7847,28.6,10080,2241,7839,28.6
'36,전라남도,'095001, 90세,2019,3421,840,2581,32.5,3418,839,2579,32.5
'36,전라남도,'095002, 91세,2019,2537,571,1966,29,2533,569,1964,29
'36,전라남도,'095003, 92세,2019,1911,380,1531,24.8,1910,380,1530,24.8
'36,전라남도,'095004, 93세,2019,1268,263,1005,26.2,1268,263,1005,26.2
'36,전라남도,'095005, 94세,2019,954,190,764,24.9,951,190,761,25
'36,전라남도,'100,95~99세,2019,2424,390,2034,19.2,2423,389,2034,19.1
'36,전라남도,'100001, 95세,2019,674,130,544,23.9,673,129,544,23.7
'36,전라남도,'100002, 96세,2019,809,116,693,16.7,809,116,693,16.7
'36,전라남도,'100003, 97세,2019,485,82,403,20.3,485,82,403,20.3
'36,전라남도,'100004, 98세,2019,273,36,237,15.2,273,36,237,15.2
'36,전라남도,'100005, 99세,2019,183,26,157,16.6,183,26,157,16.6
'36,전라남도,'101,100세이상,2019,268,34,234,14.5,267,34,233,14.6
'36,전라남도,'102,15세미만,2019,212598,108854,103744,104.9,212056,108578,103478,104.9
'36,전라남도,'103,15~64세,2019,1175230,628444,546786,114.9,1128887,599402,529485,113.2
'36,전라남도,'104,65세이상,2019,399715,164515,235200,69.9,398822,164090,234732,69.9
'36,전라남도,'126,평균연령,2019,45.9,44,48,,46.2,44.3,48.2,
'36,전라남도,'127,중위연령,2019,48.1,46.2,50.3,,48.7,46.9,50.7,
'36004, 읍부,'000,합계,2019,434488,219553,214935,102.1,419627,209944,209683,100.1
'36004, 읍부,'005,0~4세,2019,16637,8405,8232,102.1,16532,8346,8186,102
'36004, 읍부,'005001, 0세,2019,3111,1546,1565,98.8,3095,1535,1560,98.4
'36004, 읍부,'005002, 1세,2019,3013,1537,1476,104.1,2990,1522,1468,103.7
'36004, 읍부,'005003, 2세,2019,3259,1623,1636,99.2,3239,1610,1629,98.8
'36004, 읍부,'005004, 3세,2019,3556,1815,1741,104.3,3527,1801,1726,104.3
'36004, 읍부,'005005, 4세,2019,3698,1884,1814,103.9,3681,1878,1803,104.2
'36004, 읍부,'010,5~9세,2019,20703,10567,10136,104.3,20620,10523,10097,104.2
'36004, 읍부,'010001, 5세,2019,3800,1914,1886,101.5,3778,1903,1875,101.5
'36004, 읍부,'010002, 6세,2019,4083,2112,1971,107.2,4069,2104,1965,107.1
'36004, 읍부,'010003, 7세,2019,4406,2232,2174,102.7,4385,2219,2166,102.4
'36004, 읍부,'010004, 8세,2019,4453,2265,2188,103.5,4438,2260,2178,103.8
'36004, 읍부,'010005, 9세,2019,3961,2044,1917,106.6,3950,2037,1913,106.5
'36004, 읍부,'015,10~14세,2019,19961,10265,9696,105.9,19891,10232,9659,105.9
'36004, 읍부,'015001, 10세,2019,3926,2013,1913,105.2,3911,2006,1905,105.3
'36004, 읍부,'015002, 11세,2019,4057,2064,1993,103.6,4048,2060,1988,103.6
'36004, 읍부,'015003, 12세,2019,4221,2151,2070,103.9,4203,2144,2059,104.1
'36004, 읍부,'015004, 13세,2019,3932,2046,1886,108.5,3918,2039,1879,108.5
'36004, 읍부,'015005, 14세,2019,3825,1991,1834,108.6,3811,1983,1828,108.5
'36004, 읍부,'020,15~19세,2019,24869,13164,11705,112.5,24700,13078,11622,112.5
'36004, 읍부,'020001, 15세,2019,4370,2293,2077,110.4,4355,2285,2070,110.4
'36004, 읍부,'020002, 16세,2019,5037,2564,2473,103.7,5020,2555,2465,103.7
'36004, 읍부,'020003, 17세,2019,5289,2702,2587,104.4,5266,2690,2576,104.4
'36004, 읍부,'020004, 18세,2019,5674,2944,2730,107.8,5640,2925,2715,107.7
'36004, 읍부,'020005, 19세,2019,4499,2661,1838,144.8,4419,2623,1796,146
'36004, 읍부,'025,20~24세,2019,23584,14003,9581,146.2,21923,12872,9051,142.2
'36004, 읍부,'025001, 20세,2019,4728,2905,1823,159.4,4572,2816,1756,160.4
'36004, 읍부,'025002, 21세,2019,4773,2948,1825,161.5,4513,2785,1728,161.2
'36004, 읍부,'025003, 22세,2019,4628,2692,1936,139,4309,2467,1842,133.9
'36004, 읍부,'025004, 23세,2019,4733,2779,1954,142.2,4310,2481,1829,135.6
'36004, 읍부,'025005, 24세,2019,4722,2679,2043,131.1,4219,2323,1896,122.5
'36004, 읍부,'030,25~29세,2019,21971,12148,9823,123.7,18906,9940,8966,110.9
'36004, 읍부,'030001, 25세,2019,4557,2591,1966,131.8,4011,2194,1817,120.7
'36004, 읍부,'030002, 26세,2019,4508,2536,1972,128.6,3893,2078,1815,114.5
'36004, 읍부,'030003, 27세,2019,4504,2460,2044,120.4,3878,2008,1870,107.4
'36004, 읍부,'030004, 28세,2019,4145,2256,1889,119.4,3507,1795,1712,104.8
'36004, 읍부,'030005, 29세,2019,4257,2305,1952,118.1,3617,1865,1752,106.4
'36004, 읍부,'035,30~34세,2019,21191,11166,10025,111.4,18401,9236,9165,100.8
'36004, 읍부,'035001, 30세,2019,3990,2162,1828,118.3,3395,1732,1663,104.1
'36004, 읍부,'035002, 31세,2019,4081,2164,1917,112.9,3503,1769,1734,102
'36004, 읍부,'035003, 32세,2019,4189,2150,2039,105.4,3609,1751,1858,94.2
'36004, 읍부,'035004, 33세,2019,4361,2306,2055,112.2,3821,1932,1889,102.3
'36004, 읍부,'035005, 34세,2019,4570,2384,2186,109.1,4073,2052,2021,101.5
'36004, 읍부,'040,35~39세,2019,28862,15090,13772,109.6,26862,13722,13140,104.4
'36004, 읍부,'040001, 35세,2019,4948,2521,2427,103.9,4469,2190,2279,96.1
'36004, 읍부,'040002, 36세,2019,5508,2915,2593,112.4,5083,2605,2478,105.1
'36004, 읍부,'040003, 37세,2019,6277,3327,2950,112.8,5887,3062,2825,108.4
'36004, 읍부,'040004, 38세,2019,5837,3109,2728,114,5446,2851,2595,109.9
'36004, 읍부,'040005, 39세,2019,6292,3218,3074,104.7,5977,3014,2963,101.7
'36004, 읍부,'045,40~44세,2019,30037,15808,14229,111.1,28697,14920,13777,108.3
'36004, 읍부,'045001, 40세,2019,6211,3207,3004,106.8,5931,3019,2912,103.7
'36004, 읍부,'045002, 41세,2019,5820,3056,2764,110.6,5549,2874,2675,107.4
'36004, 읍부,'045003, 42세,2019,5973,3113,2860,108.8,5708,2933,2775,105.7
'36004, 읍부,'045004, 43세,2019,5919,3194,2725,117.2,5649,3019,2630,114.8
'36004, 읍부,'045005, 44세,2019,6114,3238,2876,112.6,5860,3075,2785,110.4
'36004, 읍부,'050,45~49세,2019,35456,19185,16271,117.9,34301,18538,15763,117.6
'36004, 읍부,'050001, 45세,2019,6960,3734,3226,115.7,6716,3596,3120,115.3
'36004, 읍부,'050002, 46세,2019,6915,3673,3242,113.3,6678,3531,3147,112.2
'36004, 읍부,'050003, 47세,2019,6904,3729,3175,117.4,6669,3585,3084,116.2
'36004, 읍부,'050004, 48세,2019,7532,4168,3364,123.9,7310,4064,3246,125.2
'36004, 읍부,'050005, 49세,2019,7145,3881,3264,118.9,6928,3762,3166,118.8
'36004, 읍부,'055,50~54세,2019,34560,18672,15888,117.5,33578,18153,15425,117.7
'36004, 읍부,'055001, 50세,2019,7030,3812,3218,118.5,6822,3712,3110,119.4
'36004, 읍부,'055002, 51세,2019,7340,3994,3346,119.4,7109,3869,3240,119.4
'36004, 읍부,'055003, 52세,2019,6599,3541,3058,115.8,6412,3436,2976,115.5
'36004, 읍부,'055004, 53세,2019,6944,3820,3124,122.3,6776,3732,3044,122.6
'36004, 읍부,'055005, 54세,2019,6647,3505,3142,111.6,6459,3404,3055,111.4
'36004, 읍부,'060,55~59세,2019,35139,18252,16887,108.1,34430,17903,16527,108.3
'36004, 읍부,'060001, 55세,2019,6282,3299,2983,110.6,6111,3223,2888,111.6
'36004, 읍부,'060002, 56세,2019,6944,3624,3320,109.2,6758,3536,3222,109.7
'36004, 읍부,'060003, 57세,2019,6771,3554,3217,110.5,6633,3476,3157,110.1
'36004, 읍부,'060004, 58세,2019,7391,3790,3601,105.2,7302,3745,3557,105.3
'36004, 읍부,'060005, 59세,2019,7751,3985,3766,105.8,7626,3923,3703,105.9
'36004, 읍부,'065,60~64세,2019,31059,15748,15311,102.9,30655,15545,15110,102.9
'36004, 읍부,'065001, 60세,2019,6908,3522,3386,104,6826,3478,3348,103.9
'36004, 읍부,'065002, 61세,2019,6315,3248,3067,105.9,6209,3191,3018,105.7
'36004, 읍부,'065003, 62세,2019,6362,3221,3141,102.5,6270,3177,3093,102.7
'36004, 읍부,'065004, 63세,2019,5530,2830,2700,104.8,5463,2802,2661,105.3
'36004, 읍부,'065005, 64세,2019,5944,2927,3017,97,5887,2897,2990,96.9
'36004, 읍부,'070,65~69세,2019,23861,11420,12441,91.8,23670,11331,12339,91.8
'36004, 읍부,'070001, 65세,2019,5014,2401,2613,91.9,4949,2376,2573,92.3
'36004, 읍부,'070002, 66세,2019,4402,2091,2311,90.5,4369,2074,2295,90.4
'36004, 읍부,'070003, 67세,2019,5165,2499,2666,93.7,5126,2478,2648,93.6
'36004, 읍부,'070004, 68세,2019,4562,2185,2377,91.9,4539,2175,2364,92
'36004, 읍부,'070005, 69세,2019,4718,2244,2474,90.7,4687,2228,2459,90.6
'36004, 읍부,'075,70~74세,2019,21367,10006,11361,88.1,21307,9981,11326,88.1
'36004, 읍부,'075001, 70세,2019,4639,2250,2389,94.2,4619,2239,2380,94.1
'36004, 읍부,'075002, 71세,2019,4516,2142,2374,90.2,4501,2137,2364,90.4
'36004, 읍부,'075003, 72세,2019,4863,2317,2546,91,4855,2313,2542,91
'36004, 읍부,'075004, 73세,2019,3640,1659,1981,83.7,3634,1657,1977,83.8
'36004, 읍부,'075005, 74세,2019,3709,1638,2071,79.1,3698,1635,2063,79.3
'36004, 읍부,'080,75~79세,2019,19857,8025,11832,67.8,19815,8007,11808,67.8
'36004, 읍부,'080001, 75세,2019,3404,1466,1938,75.6,3394,1460,1934,75.5
'36004, 읍부,'080002, 76세,2019,3848,1593,2255,70.6,3838,1590,2248,70.7
'36004, 읍부,'080003, 77세,2019,4923,2018,2905,69.5,4916,2015,2901,69.5
'36004, 읍부,'080004, 78세,2019,3963,1559,2404,64.9,3951,1555,2396,64.9
'36004, 읍부,'080005, 79세,2019,3719,1389,2330,59.6,3716,1387,2329,59.6
'36004, 읍부,'085,80~84세,2019,14460,5000,9460,52.9,14437,4993,9444,52.9
'36004, 읍부,'085001, 80세,2019,3494,1292,2202,58.7,3487,1291,2196,58.8
'36004, 읍부,'085002, 81세,2019,3207,1159,2048,56.6,3201,1156,2045,56.5
'36004, 읍부,'085003, 82세,2019,2906,974,1932,50.4,2899,972,1927,50.4
'36004, 읍부,'085004, 83세,2019,2515,834,1681,49.6,2514,833,1681,49.6
'36004, 읍부,'085005, 84세,2019,2338,741,1597,46.4,2336,741,1595,46.5
'36004, 읍부,'086,85세이상,2019,10914,2629,8285,31.7,10902,2624,8278,31.7
'36004, 읍부,'090,85~89세,2019,7699,1991,5708,34.9,7689,1987,5702,34.8
'36004, 읍부,'090001, 85세,2019,2135,656,1479,44.4,2135,656,1479,44.4
'36004, 읍부,'090002, 86세,2019,1659,438,1221,35.9,1655,437,1218,35.9
'36004, 읍부,'090003, 87세,2019,1531,380,1151,33,1529,379,1150,33
'36004, 읍부,'090004, 88세,2019,1211,274,937,29.2,1210,274,936,29.3
'36004, 읍부,'090005, 89세,2019,1163,243,920,26.4,1160,241,919,26.2
'36004, 읍부,'095,90~94세,2019,2497,541,1956,27.7,2495,540,1955,27.6
'36004, 읍부,'095001, 90세,2019,846,205,641,32,846,205,641,32
'36004, 읍부,'095002, 91세,2019,628,135,493,27.4,627,134,493,27.2
'36004, 읍부,'095003, 92세,2019,482,92,390,23.6,482,92,390,23.6
'36004, 읍부,'095004, 93세,2019,300,57,243,23.5,300,57,243,23.5
'36004, 읍부,'095005, 94세,2019,241,52,189,27.5,240,52,188,27.7
'36004, 읍부,'100,95~99세,2019,647,86,561,15.3,647,86,561,15.3
'36004, 읍부,'100001, 95세,2019,173,29,144,20.1,173,29,144,20.1
'36004, 읍부,'100002, 96세,2019,210,22,188,11.7,210,22,188,11.7
'36004, 읍부,'100003, 97세,2019,140,22,118,18.6,140,22,118,18.6
'36004, 읍부,'100004, 98세,2019,76,9,67,13.4,76,9,67,13.4
'36004, 읍부,'100005, 99세,2019,48,X,44,9.1,48,X,44,9.1
'36004, 읍부,'101,100세이상,2019,71,11,60,18.3,71,11,60,18.3
'36004, 읍부,'102,15세미만,2019,57301,29237,28064,104.2,57043,29101,27942,104.1
'36004, 읍부,'103,15~64세,2019,286728,153236,133492,114.8,272453,143907,128546,111.9
'36004, 읍부,'104,65세이상,2019,90459,37080,53379,69.5,90131,36936,53195,69.4
'36004, 읍부,'126,평균연령,2019,44.6,42.8,46.5,,44.9,43.1,46.7,
'36004, 읍부,'127,중위연령,2019,46.4,44.7,48.2,,47,45.6,48.6,
'36005, 면부,'000,합계,2019,572417,286705,285712,100.3,553321,274216,279105,98.2
'36005, 면부,'005,0~4세,2019,14073,7209,6864,105,14048,7193,6855,104.9
'36005, 면부,'005001, 0세,2019,2652,1352,1300,104,2646,1349,1297,104
'36005, 면부,'005002, 1세,2019,2588,1326,1262,105.1,2581,1322,1259,105
'36005, 면부,'005003, 2세,2019,2754,1471,1283,114.7,2749,1467,1282,114.4
'36005, 면부,'005004, 3세,2019,2976,1480,1496,98.9,2972,1477,1495,98.8
'36005, 면부,'005005, 4세,2019,3103,1580,1523,103.7,3100,1578,1522,103.7
'36005, 면부,'010,5~9세,2019,15573,7978,7595,105,15551,7970,7581,105.1
'36005, 면부,'010001, 5세,2019,2993,1498,1495,100.2,2990,1496,1494,100.1
'36005, 면부,'010002, 6세,2019,3036,1548,1488,104,3029,1545,1484,104.1
'36005, 면부,'010003, 7세,2019,3225,1627,1598,101.8,3223,1625,1598,101.7
'36005, 면부,'010004, 8세,2019,3269,1697,1572,108,3265,1697,1568,108.2
'36005, 면부,'010005, 9세,2019,3050,1608,1442,111.5,3044,1607,1437,111.8
'36005, 면부,'015,10~14세,2019,15669,8176,7493,109.1,15643,8160,7483,109
'36005, 면부,'015001, 10세,2019,3002,1556,1446,107.6,2997,1555,1442,107.8
'36005, 면부,'015002, 11세,2019,3117,1635,1482,110.3,3111,1631,1480,110.2
'36005, 면부,'015003, 12세,2019,3286,1689,1597,105.8,3282,1686,1596,105.6
'36005, 면부,'015004, 13세,2019,3070,1609,1461,110.1,3064,1605,1459,110
'36005, 면부,'015005, 14세,2019,3194,1687,1507,111.9,3189,1683,1506,111.8
'36005, 면부,'020,15~19세,2019,19091,10649,8442,126.1,18941,10571,8370,126.3
'36005, 면부,'020001, 15세,2019,3541,1865,1676,111.3,3531,1860,1671,111.3
'36005, 면부,'020002, 16세,2019,3404,1868,1536,121.6,3395,1864,1531,121.8
'36005, 면부,'020003, 17세,2019,3663,1974,1689,116.9,3656,1971,1685,117
'36005, 면부,'020004, 18세,2019,4169,2340,1829,127.9,4144,2328,1816,128.2
'36005, 면부,'020005, 19세,2019,4314,2602,1712,152,4215,2548,1667,152.8
'36005, 면부,'025,20~24세,2019,24588,15015,9573,156.8,21841,13051,8790,148.5
'36005, 면부,'025001, 20세,2019,4691,2937,1754,167.4,4478,2801,1677,167
'36005, 면부,'025002, 21세,2019,4817,2974,1843,161.4,4432,2700,1732,155.9
'36005, 면부,'025003, 22세,2019,5001,2985,2016,148.1,4418,2601,1817,143.1
'36005, 면부,'025004, 23세,2019,4991,3024,1967,153.7,4321,2535,1786,141.9
'36005, 면부,'025005, 24세,2019,5088,3095,1993,155.3,4192,2414,1778,135.8
'36005, 면부,'030,25~29세,2019,24605,14816,9789,151.4,19688,11206,8482,132.1
'36005, 면부,'030001, 25세,2019,5064,3148,1916,164.3,4092,2409,1683,143.1
'36005, 면부,'030002, 26세,2019,5178,3154,2024,155.8,4132,2406,1726,139.4
'36005, 면부,'030003, 27세,2019,5068,3030,2038,148.7,4036,2256,1780,126.7
'36005, 면부,'030004, 28세,2019,4705,2799,1906,146.9,3747,2102,1645,127.8
'36005, 면부,'030005, 29세,2019,4590,2685,1905,140.9,3681,2033,1648,123.4
'36005, 면부,'035,30~34세,2019,21891,12339,9552,129.2,18127,9784,8343,117.3
'36005, 면부,'035001, 30세,2019,4294,2458,1836,133.9,3432,1855,1577,117.6
'36005, 면부,'035002, 31세,2019,4342,2442,1900,128.5,3564,1911,1653,115.6
'36005, 면부,'035003, 32세,2019,4389,2420,1969,122.9,3622,1913,1709,111.9
'36005, 면부,'035004, 33세,2019,4457,2517,1940,129.7,3726,2016,1710,117.9
'36005, 면부,'035005, 34세,2019,4409,2502,1907,131.2,3783,2089,1694,123.3
'36005, 면부,'040,35~39세,2019,25866,14661,11205,130.8,23402,13122,10280,127.6
'36005, 면부,'040001, 35세,2019,4679,2564,2115,121.2,4124,2205,1919,114.9
'36005, 면부,'040002, 36세,2019,5105,2879,2226,129.3,4560,2542,2018,126
'36005, 면부,'040003, 37세,2019,5430,3147,2283,137.8,4909,2818,2091,134.8
'36005, 면부,'040004, 38세,2019,5112,2954,2158,136.9,4666,2673,1993,134.1
'36005, 면부,'040005, 39세,2019,5540,3117,2423,128.6,5143,2884,2259,127.7
'36005, 면부,'045,40~44세,2019,26724,15556,11168,139.3,25201,14628,10573,138.4
'36005, 면부,'045001, 40세,2019,5304,3069,2235,137.3,4900,2809,2091,134.3
'36005, 면부,'045002, 41세,2019,5056,2947,2109,139.7,4727,2752,1975,139.3
'36005, 면부,'045003, 42세,2019,5386,3077,2309,133.3,5105,2906,2199,132.2
'36005, 면부,'045004, 43세,2019,5432,3220,2212,145.6,5163,3071,2092,146.8
'36005, 면부,'045005, 44세,2019,5546,3243,2303,140.8,5306,3090,2216,139.4
'36005, 면부,'050,45~49세,2019,35461,20792,14669,141.7,34342,20175,14167,142.4
'36005, 면부,'050001, 45세,2019,6535,3929,2606,150.8,6304,3792,2512,151
'36005, 면부,'050002, 46세,2019,6725,3923,2802,140,6496,3801,2695,141
'36005, 면부,'050003, 47세,2019,6910,4072,2838,143.5,6671,3937,2734,144
'36005, 면부,'050004, 48세,2019,7684,4479,3205,139.8,7476,4374,3102,141
'36005, 면부,'050005, 49세,2019,7607,4389,3218,136.4,7395,4271,3124,136.7
'36005, 면부,'055,50~54세,2019,43527,24398,19129,127.5,42519,23900,18619,128.4
'36005, 면부,'055001, 50세,2019,8075,4542,3533,128.6,7849,4425,3424,129.2
'36005, 면부,'055002, 51세,2019,8774,4982,3792,131.4,8565,4877,3688,132.2
'36005, 면부,'055003, 52세,2019,8422,4636,3786,122.5,8242,4547,3695,123.1
'36005, 면부,'055004, 53세,2019,9007,5098,3909,130.4,8820,5000,3820,130.9
'36005, 면부,'055005, 54세,2019,9249,5140,4109,125.1,9043,5051,3992,126.5
'36005, 면부,'060,55~59세,2019,52834,28075,24759,113.4,52151,27736,24415,113.6
'36005, 면부,'060001, 55세,2019,9085,5007,4078,122.8,8922,4934,3988,123.7
'36005, 면부,'060002, 56세,2019,9979,5450,4529,120.3,9810,5372,4438,121
'36005, 면부,'060003, 57세,2019,10004,5382,4622,116.4,9879,5311,4568,116.3
'36005, 면부,'060004, 58세,2019,11364,5885,5479,107.4,11254,5827,5427,107.4
'36005, 면부,'060005, 59세,2019,12402,6351,6051,105,12286,6292,5994,105
'36005, 면부,'065,60~64세,2019,53658,27495,26163,105.1,53268,27307,25961,105.2
'36005, 면부,'065001, 60세,2019,11584,5945,5639,105.4,11500,5912,5588,105.8
'36005, 면부,'065002, 61세,2019,10939,5652,5287,106.9,10847,5604,5243,106.9
'36005, 면부,'065003, 62세,2019,10813,5595,5218,107.2,10732,5559,5173,107.5
'36005, 면부,'065004, 63세,2019,9692,4978,4714,105.6,9627,4942,4685,105.5
'36005, 면부,'065005, 64세,2019,10630,5325,5305,100.4,10562,5290,5272,100.3
'36005, 면부,'070,65~69세,2019,44381,21633,22748,95.1,44248,21564,22684,95.1
'36005, 면부,'070001, 65세,2019,8916,4405,4511,97.7,8883,4388,4495,97.6
'36005, 면부,'070002, 66세,2019,8073,4009,4064,98.6,8046,3995,4051,98.6
'36005, 면부,'070003, 67세,2019,9661,4675,4986,93.8,9637,4658,4979,93.6
'36005, 면부,'070004, 68세,2019,8584,4150,4434,93.6,8561,4140,4421,93.6
'36005, 면부,'070005, 69세,2019,9147,4394,4753,92.4,9121,4383,4738,92.5
'36005, 면부,'075,70~74세,2019,43921,20084,23837,84.3,43848,20044,23804,84.2
'36005, 면부,'075001, 70세,2019,9220,4519,4701,96.1,9194,4504,4690,96
'36005, 면부,'075002, 71세,2019,9240,4349,4891,88.9,9225,4341,4884,88.9
'36005, 면부,'075003, 72세,2019,9871,4504,5367,83.9,9862,4499,5363,83.9
'36005, 면부,'075004, 73세,2019,7566,3411,4155,82.1,7554,3404,4150,82
'36005, 면부,'075005, 74세,2019,8024,3301,4723,69.9,8013,3296,4717,69.9
'36005, 면부,'080,75~79세,2019,47937,18774,29163,64.4,47913,18763,29150,64.4
'36005, 면부,'080001, 75세,2019,7845,3185,4660,68.3,7842,3184,4658,68.4
'36005, 면부,'080002, 76세,2019,8918,3560,5358,66.4,8910,3557,5353,66.4
'36005, 면부,'080003, 77세,2019,11992,4771,7221,66.1,11987,4768,7219,66
'36005, 면부,'080004, 78세,2019,9930,3871,6059,63.9,9926,3869,6057,63.9
'36005, 면부,'080005, 79세,2019,9252,3387,5865,57.7,9248,3385,5863,57.7
'36005, 면부,'085,80~84세,2019,37262,12620,24642,51.2,37245,12611,24634,51.2
'36005, 면부,'085001, 80세,2019,9049,3327,5722,58.1,9046,3326,5720,58.1
'36005, 면부,'085002, 81세,2019,8192,2861,5331,53.7,8188,2859,5329,53.6
'36005, 면부,'085003, 82세,2019,7480,2535,4945,51.3,7474,2532,4942,51.2
'36005, 면부,'085004, 83세,2019,6434,2060,4374,47.1,6431,2058,4373,47.1
'36005, 면부,'085005, 84세,2019,6107,1837,4270,43,6106,1836,4270,43
'36005, 면부,'086,85세이상,2019,25356,6435,18921,34,25345,6431,18914,34
'36005, 면부,'090,85~89세,2019,18509,4915,13594,36.2,18505,4913,13592,36.1
'36005, 면부,'090001, 85세,2019,5224,1513,3711,40.8,5223,1512,3711,40.7
'36005, 면부,'090002, 86세,2019,4297,1174,3123,37.6,4296,1173,3123,37.6
'36005, 면부,'090003, 87세,2019,3525,951,2574,36.9,3525,951,2574,36.9
'36005, 면부,'090004, 88세,2019,2723,671,2052,32.7,2721,671,2050,32.7
'36005, 면부,'090005, 89세,2019,2740,606,2134,28.4,2740,606,2134,28.4
'36005, 면부,'095,90~94세,2019,5432,1269,4163,30.5,5427,1268,4159,30.5
'36005, 면부,'095001, 90세,2019,1876,483,1393,34.7,1875,482,1393,34.6
'36005, 면부,'095002, 91세,2019,1388,329,1059,31.1,1386,329,1057,31.1
'36005, 면부,'095003, 92세,2019,986,202,784,25.8,985,202,783,25.8
'36005, 면부,'095004, 93세,2019,692,155,537,28.9,692,155,537,28.9
'36005, 면부,'095005, 94세,2019,490,100,390,25.6,489,100,389,25.7
'36005, 면부,'100,95~99세,2019,1252,230,1022,22.5,1251,229,1022,22.4
'36005, 면부,'100001, 95세,2019,366,77,289,26.6,365,76,289,26.3
'36005, 면부,'100002, 96세,2019,415,72,343,21,415,72,343,21
'36005, 면부,'100003, 97세,2019,246,43,203,21.2,246,43,203,21.2
'36005, 면부,'100004, 98세,2019,136,22,114,19.3,136,22,114,19.3
'36005, 면부,'100005, 99세,2019,89,16,73,21.9,89,16,73,21.9
'36005, 면부,'101,100세이상,2019,163,21,142,14.8,162,21,141,14.9
'36005, 면부,'102,15세미만,2019,45315,23363,21952,106.4,45242,23323,21919,106.4
'36005, 면부,'103,15~64세,2019,328245,183796,144449,127.2,309480,171480,138000,124.3
'36005, 면부,'104,65세이상,2019,198857,79546,119311,66.7,198599,79413,119186,66.6
'36005, 면부,'126,평균연령,2019,53,49.9,56,,53.6,50.6,56.5,
'36005, 면부,'127,중위연령,2019,57,53.4,60.5,,57.9,54.5,61,
'36003, 동부,'000,합계,2019,780638,395555,385083,102.7,766817,387910,378907,102.4
'36003, 동부,'005,0~4세,2019,30720,15779,14941,105.6,30626,15735,14891,105.7
'36003, 동부,'005001, 0세,2019,5062,2564,2498,102.6,5045,2552,2493,102.4
'36003, 동부,'005002, 1세,2019,5523,2827,2696,104.9,5498,2815,2683,104.9
'36003, 동부,'005003, 2세,2019,5898,3096,2802,110.5,5876,3087,2789,110.7
'36003, 동부,'005004, 3세,2019,6975,3545,3430,103.4,6958,3540,3418,103.6
'36003, 동부,'005005, 4세,2019,7262,3747,3515,106.6,7249,3741,3508,106.6
'36003, 동부,'010,5~9세,2019,40080,20384,19696,103.5,40010,20352,19658,103.5
'36003, 동부,'010001, 5세,2019,7285,3724,3561,104.6,7266,3714,3552,104.6
'36003, 동부,'010002, 6세,2019,7693,3955,3738,105.8,7682,3952,3730,106
'36003, 동부,'010003, 7세,2019,8540,4255,4285,99.3,8520,4245,4275,99.3
'36003, 동부,'010004, 8세,2019,8596,4288,4308,99.5,8584,4283,4301,99.6
'36003, 동부,'010005, 9세,2019,7966,4162,3804,109.4,7958,4158,3800,109.4
'36003, 동부,'015,10~14세,2019,39182,20091,19091,105.2,39135,20067,19068,105.2
'36003, 동부,'015001, 10세,2019,7739,3952,3787,104.4,7728,3947,3781,104.4
'36003, 동부,'015002, 11세,2019,8061,4135,3926,105.3,8049,4128,3921,105.3
'36003, 동부,'015003, 12세,2019,8268,4279,3989,107.3,8261,4276,3985,107.3
'36003, 동부,'015004, 13세,2019,7715,3954,3761,105.1,7708,3951,3757,105.2
'36003, 동부,'015005, 14세,2019,7399,3771,3628,103.9,7389,3765,3624,103.9
'36003, 동부,'020,15~19세,2019,45759,24294,21465,113.2,45298,24031,21267,113
'36003, 동부,'020001, 15세,2019,8346,4341,4005,108.4,8335,4335,4000,108.4
'36003, 동부,'020002, 16세,2019,8607,4378,4229,103.5,8601,4375,4226,103.5
'36003, 동부,'020003, 17세,2019,8979,4634,4345,106.7,8964,4628,4336,106.7
'36003, 동부,'020004, 18세,2019,9984,5330,4654,114.5,9893,5277,4616,114.3
'36003, 동부,'020005, 19세,2019,9843,5611,4232,132.6,9505,5416,4089,132.5
'36003, 동부,'025,20~24세,2019,50386,29125,21261,137,48357,28027,20330,137.9
'36003, 동부,'025001, 20세,2019,9677,5885,3792,155.2,9301,5677,3624,156.7
'36003, 동부,'025002, 21세,2019,10182,6026,4156,145,9795,5811,3984,145.9
'36003, 동부,'025003, 22세,2019,10192,5785,4407,131.3,9831,5599,4232,132.3
'36003, 동부,'025004, 23세,2019,10152,5685,4467,127.3,9753,5458,4295,127.1
'36003, 동부,'025005, 24세,2019,10183,5744,4439,129.4,9677,5482,4195,130.7
'36003, 동부,'030,25~29세,2019,47284,25726,21558,119.3,44698,24238,20460,118.5
'36003, 동부,'030001, 25세,2019,9989,5552,4437,125.1,9489,5269,4220,124.9
'36003, 동부,'030002, 26세,2019,9858,5373,4485,119.8,9359,5092,4267,119.3
'36003, 동부,'030003, 27세,2019,9769,5208,4561,114.2,9253,4914,4339,113.3
'36003, 동부,'030004, 28세,2019,8990,4900,4090,119.8,8453,4586,3867,118.6
'36003, 동부,'030005, 29세,2019,8678,4693,3985,117.8,8144,4377,3767,116.2
'36003, 동부,'035,30~34세,2019,42542,22343,20199,110.6,40383,21139,19244,109.8
'36003, 동부,'035001, 30세,2019,8265,4449,3816,116.6,7809,4188,3621,115.7
'36003, 동부,'035002, 31세,2019,8096,4307,3789,113.7,7624,4044,3580,113
'36003, 동부,'035003, 32세,2019,8359,4321,4038,107,7930,4092,3838,106.6
'36003, 동부,'035004, 33세,2019,8727,4551,4176,109,8311,4309,4002,107.7
'36003, 동부,'035005, 34세,2019,9095,4715,4380,107.6,8709,4506,4203,107.2
'36003, 동부,'040,35~39세,2019,57819,30005,27814,107.9,56081,28943,27138,106.7
'36003, 동부,'040001, 35세,2019,9994,5239,4755,110.2,9582,4985,4597,108.4
'36003, 동부,'040002, 36세,2019,11035,5691,5344,106.5,10685,5483,5202,105.4
'36003, 동부,'040003, 37세,2019,12270,6384,5886,108.5,11921,6177,5744,107.5
'36003, 동부,'040004, 38세,2019,11904,6215,5689,109.2,11568,6000,5568,107.8
'36003, 동부,'040005, 39세,2019,12616,6476,6140,105.5,12325,6298,6027,104.5
'36003, 동부,'045,40~44세,2019,58596,29705,28891,102.8,57276,28946,28330,102.2
'36003, 동부,'045001, 40세,2019,12195,6186,6009,102.9,11905,6014,5891,102.1
'36003, 동부,'045002, 41세,2019,11206,5723,5483,104.4,10938,5569,5369,103.7
'36003, 동부,'045003, 42세,2019,11672,5861,5811,100.9,11414,5710,5704,100.1
'36003, 동부,'045004, 43세,2019,11501,5890,5611,105,11240,5746,5494,104.6
'36003, 동부,'045005, 44세,2019,12022,6045,5977,101.1,11779,5907,5872,100.6
'36003, 동부,'050,45~49세,2019,69625,35087,34538,101.6,68478,34446,34032,101.2
'36003, 동부,'050001, 45세,2019,13096,6563,6533,100.5,12865,6429,6436,99.9
'36003, 동부,'050002, 46세,2019,13742,6867,6875,99.9,13518,6748,6770,99.7
'36003, 동부,'050003, 47세,2019,13764,7012,6752,103.9,13526,6878,6648,103.5
'36003, 동부,'050004, 48세,2019,14739,7431,7308,101.7,14521,7304,7217,101.2
'36003, 동부,'050005, 49세,2019,14284,7214,7070,102,14048,7087,6961,101.8
'36003, 동부,'055,50~54세,2019,69649,35847,33802,106,68801,35439,33362,106.2
'36003, 동부,'055001, 50세,2019,14225,7207,7018,102.7,14027,7111,6916,102.8
'36003, 동부,'055002, 51세,2019,14739,7482,7257,103.1,14559,7397,7162,103.3
'36003, 동부,'055003, 52세,2019,13609,6978,6631,105.2,13444,6901,6543,105.5
'36003, 동부,'055004, 53세,2019,13548,7194,6354,113.2,13403,7126,6277,113.5
'36003, 동부,'055005, 54세,2019,13528,6986,6542,106.8,13368,6904,6464,106.8
'36003, 동부,'060,55~59세,2019,65331,32765,32566,100.6,64680,32467,32213,100.8
'36003, 동부,'060001, 55세,2019,12253,6144,6109,100.6,12106,6082,6024,101
'36003, 동부,'060002, 56세,2019,13316,6842,6474,105.7,13158,6767,6391,105.9
'36003, 동부,'060003, 57세,2019,12420,6391,6029,106,12291,6325,5966,106
'36003, 동부,'060004, 58세,2019,13474,6604,6870,96.1,13375,6561,6814,96.3
'36003, 동부,'060005, 59세,2019,13868,6784,7084,95.8,13750,6732,7018,95.9
'36003, 동부,'065,60~64세,2019,53266,26515,26751,99.1,52902,26339,26563,99.2
'36003, 동부,'065001, 60세,2019,12187,5928,6259,94.7,12105,5890,6215,94.8
'36003, 동부,'065002, 61세,2019,11030,5573,5457,102.1,10933,5524,5409,102.1
'36003, 동부,'065003, 62세,2019,10862,5471,5391,101.5,10796,5442,5354,101.6
'36003, 동부,'065004, 63세,2019,9300,4590,4710,97.5,9243,4561,4682,97.4
'36003, 동부,'065005, 64세,2019,9887,4953,4934,100.4,9825,4922,4903,100.4
'36003, 동부,'070,65~69세,2019,36536,18077,18459,97.9,36361,17985,18376,97.9
'36003, 동부,'070001, 65세,2019,8206,4086,4120,99.2,8165,4066,4099,99.2
'36003, 동부,'070002, 66세,2019,6834,3359,3475,96.7,6787,3330,3457,96.3
'36003, 동부,'070003, 67세,2019,7998,3893,4105,94.8,7971,3882,4089,94.9
'36003, 동부,'070004, 68세,2019,6826,3439,3387,101.5,6792,3425,3367,101.7
'36003, 동부,'070005, 69세,2019,6672,3300,3372,97.9,6646,3282,3364,97.6
'36003, 동부,'075,70~74세,2019,28488,13393,15095,88.7,28424,13360,15064,88.7
'36003, 동부,'075001, 70세,2019,6556,3127,3429,91.2,6536,3113,3423,90.9
'36003, 동부,'075002, 71세,2019,6178,2949,3229,91.3,6163,2942,3221,91.3
'36003, 동부,'075003, 72세,2019,6442,2993,3449,86.8,6433,2989,3444,86.8
'36003, 동부,'075004, 73세,2019,4750,2228,2522,88.3,4743,2225,2518,88.4
'36003, 동부,'075005, 74세,2019,4562,2096,2466,85,4549,2091,2458,85.1
'36003, 동부,'080,75~79세,2019,21955,9265,12690,73,21922,9255,12667,73.1
'36003, 동부,'080001, 75세,2019,4139,1847,2292,80.6,4136,1845,2291,80.5
'36003, 동부,'080002, 76세,2019,4556,1996,2560,78,4544,1991,2553,78
'36003, 동부,'080003, 77세,2019,5367,2261,3106,72.8,5365,2261,3104,72.8
'36003, 동부,'080004, 78세,2019,4071,1641,2430,67.5,4061,1639,2422,67.7
'36003, 동부,'080005, 79세,2019,3822,1520,2302,66,3816,1519,2297,66.1
'36003, 동부,'085,80~84세,2019,13630,4817,8813,54.7,13605,4806,8799,54.6
'36003, 동부,'085001, 80세,2019,3409,1288,2121,60.7,3400,1283,2117,60.6
'36003, 동부,'085002, 81세,2019,3127,1133,1994,56.8,3124,1132,1992,56.8
'36003, 동부,'085003, 82세,2019,2732,993,1739,57.1,2727,991,1736,57.1
'36003, 동부,'085004, 83세,2019,2276,737,1539,47.9,2273,737,1536,48
'36003, 동부,'085005, 84세,2019,2086,666,1420,46.9,2081,663,1418,46.8
'36003, 동부,'086,85세이상,2019,9790,2337,7453,31.4,9780,2335,7445,31.4
'36003, 동부,'090,85~89세,2019,7069,1827,5242,34.9,7063,1826,5237,34.9
'36003, 동부,'090001, 85세,2019,1905,544,1361,40,1904,544,1360,40
'36003, 동부,'090002, 86세,2019,1580,441,1139,38.7,1578,440,1138,38.7
'36003, 동부,'090003, 87세,2019,1339,343,996,34.4,1337,343,994,34.5
'36003, 동부,'090004, 88세,2019,1126,278,848,32.8,1126,278,848,32.8
'36003, 동부,'090005, 89세,2019,1119,221,898,24.6,1118,221,897,24.6
'36003, 동부,'095,90~94세,2019,2162,434,1728,25.1,2158,433,1725,25.1
'36003, 동부,'095001, 90세,2019,699,152,547,27.8,697,152,545,27.9
'36003, 동부,'095002, 91세,2019,521,107,414,25.8,520,106,414,25.6
'36003, 동부,'095003, 92세,2019,443,86,357,24.1,443,86,357,24.1
'36003, 동부,'095004, 93세,2019,276,51,225,22.7,276,51,225,22.7
'36003, 동부,'095005, 94세,2019,223,38,185,20.5,222,38,184,20.7
'36003, 동부,'100,95~99세,2019,525,74,451,16.4,525,74,451,16.4
'36003, 동부,'100001, 95세,2019,135,24,111,21.6,135,24,111,21.6
'36003, 동부,'100002, 96세,2019,184,22,162,13.6,184,22,162,13.6
'36003, 동부,'100003, 97세,2019,99,17,82,20.7,99,17,82,20.7
'36003, 동부,'100004, 98세,2019,61,5,56,8.9,61,5,56,8.9
'36003, 동부,'100005, 99세,2019,46,6,40,15,46,6,40,15
'36003, 동부,'101,100세이상,2019,34,X,32,6.3,34,X,32,6.3
'36003, 동부,'102,15세미만,2019,109982,56254,53728,104.7,109771,56154,53617,104.7
'36003, 동부,'103,15~64세,2019,560257,291412,268845,108.4,546954,284015,262939,108
'36003, 동부,'104,65세이상,2019,110399,47889,62510,76.6,110092,47741,62351,76.6
'36003, 동부,'126,평균연령,2019,41.5,40.3,42.8,,41.6,40.4,42.9,
'36003, 동부,'127,중위연령,2019,43.1,41.7,44.6,,43.4,42,44.8,
'36010, 목포시,'000,합계,2019,228876,114854,114022,100.7,224344,112269,112075,100.2
'36010, 목포시,'005,0~4세,2019,8128,4232,3896,108.6,8102,4221,3881,108.8
'36010, 목포시,'005001, 0세,2019,1258,640,618,103.6,1251,636,615,103.4
'36010, 목포시,'005002, 1세,2019,1381,735,646,113.8,1378,734,644,114
'36010, 목포시,'005003, 2세,2019,1505,778,727,107,1497,774,723,107.1
'36010, 목포시,'005004, 3세,2019,1980,1029,951,108.2,1975,1028,947,108.6
'36010, 목포시,'005005, 4세,2019,2004,1050,954,110.1,2001,1049,952,110.2
'36010, 목포시,'010,5~9세,2019,12144,6182,5962,103.7,12118,6168,5950,103.7
'36010, 목포시,'010001, 5세,2019,2123,1094,1029,106.3,2116,1089,1027,106
'36010, 목포시,'010002, 6세,2019,2314,1180,1134,104.1,2310,1179,1131,104.2
'36010, 목포시,'010003, 7세,2019,2644,1338,1306,102.5,2635,1333,1302,102.4
'36010, 목포시,'010004, 8세,2019,2576,1269,1307,97.1,2572,1267,1305,97.1
'36010, 목포시,'010005, 9세,2019,2487,1301,1186,109.7,2485,1300,1185,109.7
'36010, 목포시,'015,10~14세,2019,11761,6008,5753,104.4,11743,5999,5744,104.4
'36010, 목포시,'015001, 10세,2019,2384,1220,1164,104.8,2380,1218,1162,104.8
'36010, 목포시,'015002, 11세,2019,2407,1231,1176,104.7,2402,1229,1173,104.8
'36010, 목포시,'015003, 12세,2019,2519,1315,1204,109.2,2514,1313,1201,109.3
'36010, 목포시,'015004, 13세,2019,2261,1132,1129,100.3,2259,1131,1128,100.3
'36010, 목포시,'015005, 14세,2019,2190,1110,1080,102.8,2188,1108,1080,102.6
'36010, 목포시,'020,15~19세,2019,13148,7026,6122,114.8,12948,6904,6044,114.2
'36010, 목포시,'020001, 15세,2019,2389,1213,1176,103.1,2387,1212,1175,103.1
'36010, 목포시,'020002, 16세,2019,2401,1243,1158,107.3,2400,1242,1158,107.3
'36010, 목포시,'020003, 17세,2019,2532,1309,1223,107,2527,1307,1220,107.1
'36010, 목포시,'020004, 18세,2019,2816,1522,1294,117.6,2791,1506,1285,117.2
'36010, 목포시,'020005, 19세,2019,3010,1739,1271,136.8,2843,1637,1206,135.7
'36010, 목포시,'025,20~24세,2019,14788,8619,6169,139.7,14190,8294,5896,140.7
'36010, 목포시,'025001, 20세,2019,2975,1877,1098,170.9,2858,1808,1050,172.2
'36010, 목포시,'025002, 21세,2019,3141,1911,1230,155.4,3012,1838,1174,156.6
'36010, 목포시,'025003, 22세,2019,3031,1728,1303,132.6,2922,1667,1255,132.8
'36010, 목포시,'025004, 23세,2019,2889,1601,1288,124.3,2791,1551,1240,125.1
'36010, 목포시,'025005, 24세,2019,2752,1502,1250,120.2,2607,1430,1177,121.5
'36010, 목포시,'030,25~29세,2019,12283,6440,5843,110.2,11449,5940,5509,107.8
'36010, 목포시,'030001, 25세,2019,2652,1411,1241,113.7,2511,1334,1177,113.3
'36010, 목포시,'030002, 26세,2019,2536,1333,1203,110.8,2377,1234,1143,108
'36010, 목포시,'030003, 27세,2019,2517,1276,1241,102.8,2355,1180,1175,100.4
'36010, 목포시,'030004, 28세,2019,2351,1246,1105,112.8,2167,1126,1041,108.2
'36010, 목포시,'030005, 29세,2019,2227,1174,1053,111.5,2039,1066,973,109.6
'36010, 목포시,'035,30~34세,2019,11502,5852,5650,103.6,10793,5432,5361,101.3
'36010, 목포시,'035001, 30세,2019,2116,1092,1024,106.6,1979,1007,972,103.6
'36010, 목포시,'035002, 31세,2019,2104,1070,1034,103.5,1955,979,976,100.3
'36010, 목포시,'035003, 32세,2019,2276,1140,1136,100.4,2121,1052,1069,98.4
'36010, 목포시,'035004, 33세,2019,2362,1216,1146,106.1,2233,1137,1096,103.7
'36010, 목포시,'035005, 34세,2019,2644,1334,1310,101.8,2505,1257,1248,100.7
'36010, 목포시,'040,35~39세,2019,17318,9022,8296,108.8,16756,8661,8095,107
'36010, 목포시,'040001, 35세,2019,2967,1543,1424,108.4,2828,1452,1376,105.5
'36010, 목포시,'040002, 36세,2019,3285,1665,1620,102.8,3174,1599,1575,101.5
'36010, 목포시,'040003, 37세,2019,3637,1934,1703,113.6,3528,1860,1668,111.5
'36010, 목포시,'040004, 38세,2019,3575,1905,1670,114.1,3467,1834,1633,112.3
'36010, 목포시,'040005, 39세,2019,3854,1975,1879,105.1,3759,1916,1843,104
'36010, 목포시,'045,40~44세,2019,17984,9355,8629,108.4,17562,9100,8462,107.5
'36010, 목포시,'045001, 40세,2019,3769,1985,1784,111.3,3682,1928,1754,109.9
'36010, 목포시,'045002, 41세,2019,3464,1810,1654,109.4,3379,1762,1617,109
'36010, 목포시,'045003, 42세,2019,3552,1797,1755,102.4,3469,1748,1721,101.6
'36010, 목포시,'045004, 43세,2019,3490,1844,1646,112,3400,1792,1608,111.4
'36010, 목포시,'045005, 44세,2019,3709,1919,1790,107.2,3632,1870,1762,106.1
'36010, 목포시,'050,45~49세,2019,20412,10464,9948,105.2,20033,10252,9781,104.8
'36010, 목포시,'050001, 45세,2019,3936,2009,1927,104.3,3865,1970,1895,104
'36010, 목포시,'050002, 46세,2019,4120,2078,2042,101.8,4048,2039,2009,101.5
'36010, 목포시,'050003, 47세,2019,4067,2116,1951,108.5,3994,2074,1920,108
'36010, 목포시,'050004, 48세,2019,4236,2193,2043,107.3,4162,2147,2015,106.6
'36010, 목포시,'050005, 49세,2019,4053,2068,1985,104.2,3964,2022,1942,104.1
'36010, 목포시,'055,50~54세,2019,18678,9598,9080,105.7,18402,9471,8931,106
'36010, 목포시,'055001, 50세,2019,3910,2005,1905,105.2,3848,1980,1868,106
'36010, 목포시,'055002, 51세,2019,3793,1962,1831,107.2,3738,1934,1804,107.2
'36010, 목포시,'055003, 52세,2019,3575,1813,1762,102.9,3526,1789,1737,103
'36010, 목포시,'055004, 53세,2019,3678,1927,1751,110.1,3624,1902,1722,110.5
'36010, 목포시,'055005, 54세,2019,3722,1891,1831,103.3,3666,1866,1800,103.7
'36010, 목포시,'060,55~59세,2019,18334,8837,9497,93.1,18088,8721,9367,93.1
'36010, 목포시,'060001, 55세,2019,3355,1614,1741,92.7,3300,1591,1709,93.1
'36010, 목포시,'060002, 56세,2019,3625,1756,1869,94,3561,1723,1838,93.7
'36010, 목포시,'060003, 57세,2019,3474,1717,1757,97.7,3425,1692,1733,97.6
'36010, 목포시,'060004, 58세,2019,3907,1868,2039,91.6,3875,1851,2024,91.5
'36010, 목포시,'060005, 59세,2019,3973,1882,2091,90,3927,1864,2063,90.4
'36010, 목포시,'065,60~64세,2019,16207,7910,8297,95.3,16081,7845,8236,95.3
'36010, 목포시,'065001, 60세,2019,3670,1763,1907,92.4,3636,1746,1890,92.4
'36010, 목포시,'065002, 61세,2019,3338,1679,1659,101.2,3314,1667,1647,101.2
'36010, 목포시,'065003, 62세,2019,3316,1658,1658,100,3293,1649,1644,100.3
'36010, 목포시,'065004, 63세,2019,2882,1391,1491,93.3,2861,1378,1483,92.9
'36010, 목포시,'065005, 64세,2019,3001,1419,1582,89.7,2977,1405,1572,89.4
'36010, 목포시,'070,65~69세,2019,11291,5383,5908,91.1,11229,5355,5874,91.2
'36010, 목포시,'070001, 65세,2019,2318,1149,1169,98.3,2306,1145,1161,98.6
'36010, 목포시,'070002, 66세,2019,2170,1049,1121,93.6,2153,1038,1115,93.1
'36010, 목포시,'070003, 67세,2019,2522,1173,1349,87,2510,1168,1342,87
'36010, 목포시,'070004, 68세,2019,2223,1036,1187,87.3,2214,1034,1180,87.6
'36010, 목포시,'070005, 69세,2019,2058,976,1082,90.2,2046,970,1076,90.1
'36010, 목포시,'075,70~74세,2019,9688,4445,5243,84.8,9663,4433,5230,84.8
'36010, 목포시,'075001, 70세,2019,2137,956,1181,80.9,2129,951,1178,80.7
'36010, 목포시,'075002, 71세,2019,1953,913,1040,87.8,1947,910,1037,87.8
'36010, 목포시,'075003, 72세,2019,2094,961,1133,84.8,2091,960,1131,84.9
'36010, 목포시,'075004, 73세,2019,1796,824,972,84.8,1793,823,970,84.8
'36010, 목포시,'075005, 74세,2019,1708,791,917,86.3,1703,789,914,86.3
'36010, 목포시,'080,75~79세,2019,7527,3168,4359,72.7,7516,3165,4351,72.7
'36010, 목포시,'080001, 75세,2019,1438,621,817,76,1437,621,816,76.1
'36010, 목포시,'080002, 76세,2019,1440,641,799,80.2,1437,639,798,80.1
'36010, 목포시,'080003, 77세,2019,1902,806,1096,73.5,1902,806,1096,73.5
'36010, 목포시,'080004, 78세,2019,1419,568,851,66.7,1415,567,848,66.9
'36010, 목포시,'080005, 79세,2019,1328,532,796,66.8,1325,532,793,67.1
'36010, 목포시,'085,80~84세,2019,4565,1575,2990,52.7,4555,1570,2985,52.6
'36010, 목포시,'085001, 80세,2019,1118,428,690,62,1113,425,688,61.8
'36010, 목포시,'085002, 81세,2019,1130,383,747,51.3,1128,382,746,51.2
'36010, 목포시,'085003, 82세,2019,946,333,613,54.3,944,332,612,54.2
'36010, 목포시,'085004, 83세,2019,697,226,471,48,696,226,470,48.1
'36010, 목포시,'085005, 84세,2019,674,205,469,43.7,674,205,469,43.7
'36010, 목포시,'086,85세이상,2019,3118,738,2380,31,3116,738,2378,31
'36010, 목포시,'090,85~89세,2019,2248,576,1672,34.4,2247,576,1671,34.5
'36010, 목포시,'090001, 85세,2019,607,168,439,38.3,607,168,439,38.3
'36010, 목포시,'090002, 86세,2019,502,139,363,38.3,502,139,363,38.3
'36010, 목포시,'090003, 87세,2019,437,113,324,34.9,436,113,323,35
'36010, 목포시,'090004, 88세,2019,334,87,247,35.2,334,87,247,35.2
'36010, 목포시,'090005, 89세,2019,368,69,299,23.1,368,69,299,23.1
'36010, 목포시,'095,90~94세,2019,679,142,537,26.4,678,142,536,26.5
'36010, 목포시,'095001, 90세,2019,211,41,170,24.1,210,41,169,24.3
'36010, 목포시,'095002, 91세,2019,160,37,123,30.1,160,37,123,30.1
'36010, 목포시,'095003, 92세,2019,140,28,112,25,140,28,112,25
'36010, 목포시,'095004, 93세,2019,93,19,74,25.7,93,19,74,25.7
'36010, 목포시,'095005, 94세,2019,75,17,58,29.3,75,17,58,29.3
'36010, 목포시,'100,95~99세,2019,182,19,163,11.7,182,19,163,11.7
'36010, 목포시,'100001, 95세,2019,43,X,39,10.3,43,X,39,10.3
'36010, 목포시,'100002, 96세,2019,70,6,64,9.4,70,6,64,9.4
'36010, 목포시,'100003, 97세,2019,33,X,30,10,33,X,30,10
'36010, 목포시,'100004, 98세,2019,19,X,17,11.8,19,X,17,11.8
'36010, 목포시,'100005, 99세,2019,17,X,13,30.8,17,X,13,30.8
'36010, 목포시,'101,100세이상,2019,9,X,8,12.5,9,X,8,12.5
'36010, 목포시,'102,15세미만,2019,32033,16422,15611,105.2,31963,16388,15575,105.2
'36010, 목포시,'103,15~64세,2019,160654,83123,77531,107.2,156302,80620,75682,106.5
'36010, 목포시,'104,65세이상,2019,36189,15309,20880,73.3,36079,15261,20818,73.3
'36010, 목포시,'126,평균연령,2019,42.2,40.8,43.7,,42.4,40.9,43.8,
'36010, 목포시,'127,중위연령,2019,43.7,42.1,45.4,,44,42.5,45.6,
'36020, 여수시,'000,합계,2019,270283,139231,131052,106.2,263850,134667,129183,104.2
'36020, 여수시,'005,0~4세,2019,9779,4964,4815,103.1,9762,4956,4806,103.1
'36020, 여수시,'005001, 0세,2019,1572,818,754,108.5,1569,816,753,108.4
'36020, 여수시,'005002, 1세,2019,1745,855,890,96.1,1737,853,884,96.5
'36020, 여수시,'005003, 2세,2019,1930,1013,917,110.5,1926,1011,915,110.5
'36020, 여수시,'005004, 3세,2019,2231,1124,1107,101.5,2230,1123,1107,101.4
'36020, 여수시,'005005, 4세,2019,2301,1154,1147,100.6,2300,1153,1147,100.5
'36020, 여수시,'010,5~9세,2019,12030,6123,5907,103.7,12020,6122,5898,103.8
'36020, 여수시,'010001, 5세,2019,2241,1173,1068,109.8,2237,1173,1064,110.2
'36020, 여수시,'010002, 6세,2019,2364,1241,1123,110.5,2363,1241,1122,110.6
'36020, 여수시,'010003, 7세,2019,2495,1186,1309,90.6,2494,1185,1309,90.5
'36020, 여수시,'010004, 8세,2019,2642,1331,1311,101.5,2639,1331,1308,101.8
'36020, 여수시,'010005, 9세,2019,2288,1192,1096,108.8,2287,1192,1095,108.9
'36020, 여수시,'015,10~14세,2019,11810,6049,5761,105,11804,6047,5757,105
'36020, 여수시,'015001, 10세,2019,2246,1166,1080,108,2245,1166,1079,108.1
'36020, 여수시,'015002, 11세,2019,2417,1230,1187,103.6,2416,1230,1186,103.7
'36020, 여수시,'015003, 12세,2019,2519,1262,1257,100.4,2519,1262,1257,100.4
'36020, 여수시,'015004, 13세,2019,2315,1205,1110,108.6,2313,1204,1109,108.6
'36020, 여수시,'015005, 14세,2019,2313,1186,1127,105.2,2311,1185,1126,105.2
'36020, 여수시,'020,15~19세,2019,13641,7555,6086,124.1,13521,7492,6029,124.3
'36020, 여수시,'020001, 15세,2019,2659,1418,1241,114.3,2653,1413,1240,114
'36020, 여수시,'020002, 16세,2019,2546,1321,1225,107.8,2541,1318,1223,107.8
'36020, 여수시,'020003, 17세,2019,2768,1441,1327,108.6,2763,1440,1323,108.8
'36020, 여수시,'020004, 18세,2019,3012,1692,1320,128.2,2986,1682,1304,129
'36020, 여수시,'020005, 19세,2019,2656,1683,973,173,2578,1639,939,174.5
'36020, 여수시,'025,20~24세,2019,14925,9205,5720,160.9,14235,8700,5535,157.2
'36020, 여수시,'025001, 20세,2019,2681,1775,906,195.9,2611,1722,889,193.7
'36020, 여수시,'025002, 21세,2019,2846,1816,1030,176.3,2738,1738,1000,173.8
'36020, 여수시,'025003, 22세,2019,2939,1745,1194,146.1,2814,1664,1150,144.7
'36020, 여수시,'025004, 23세,2019,3175,1884,1291,145.9,3011,1758,1253,140.3
'36020, 여수시,'025005, 24세,2019,3284,1985,1299,152.8,3061,1818,1243,146.3
'36020, 여수시,'030,25~29세,2019,15701,9027,6674,135.3,14399,8053,6346,126.9
'36020, 여수시,'030001, 25세,2019,3164,1853,1311,141.3,2956,1703,1253,135.9
'36020, 여수시,'030002, 26세,2019,3269,1878,1391,135,3001,1687,1314,128.4
'36020, 여수시,'030003, 27세,2019,3325,1898,1427,133,3051,1692,1359,124.5
'36020, 여수시,'030004, 28세,2019,2997,1737,1260,137.9,2722,1523,1199,127
'36020, 여수시,'030005, 29세,2019,2946,1661,1285,129.3,2669,1448,1221,118.6
'36020, 여수시,'035,30~34세,2019,14345,8079,6266,128.9,13043,7105,5938,119.7
'36020, 여수시,'035001, 30세,2019,2778,1598,1180,135.4,2505,1393,1112,125.3
'36020, 여수시,'035002, 31세,2019,2773,1594,1179,135.2,2504,1391,1113,125
'36020, 여수시,'035003, 32세,2019,2832,1576,1256,125.5,2570,1384,1186,116.7
'36020, 여수시,'035004, 33세,2019,3008,1668,1340,124.5,2748,1477,1271,116.2
'36020, 여수시,'035005, 34세,2019,2954,1643,1311,125.3,2716,1460,1256,116.2
'36020, 여수시,'040,35~39세,2019,18672,10098,8574,117.8,17678,9347,8331,112.2
'36020, 여수시,'040001, 35세,2019,3159,1751,1408,124.4,2950,1589,1361,116.8
'36020, 여수시,'040002, 36세,2019,3666,1944,1722,112.9,3444,1787,1657,107.8
'36020, 여수시,'040003, 37세,2019,4040,2193,1847,118.7,3821,2038,1783,114.3
'36020, 여수시,'040004, 38세,2019,3872,2121,1751,121.1,3684,1970,1714,114.9
'36020, 여수시,'040005, 39세,2019,3935,2089,1846,113.2,3779,1963,1816,108.1
'36020, 여수시,'045,40~44세,2019,18855,9935,8920,111.4,18147,9416,8731,107.8
'36020, 여수시,'045001, 40세,2019,3911,2029,1882,107.8,3747,1910,1837,104
'36020, 여수시,'045002, 41세,2019,3670,1924,1746,110.2,3522,1813,1709,106.1
'36020, 여수시,'045003, 42세,2019,3720,1966,1754,112.1,3591,1867,1724,108.3
'36020, 여수시,'045004, 43세,2019,3749,2021,1728,117,3622,1932,1690,114.3
'36020, 여수시,'045005, 44세,2019,3805,1995,1810,110.2,3665,1894,1771,106.9
'36020, 여수시,'050,45~49세,2019,22900,12095,10805,111.9,22347,11708,10639,110
'36020, 여수시,'050001, 45세,2019,4344,2265,2079,108.9,4213,2162,2051,105.4
'36020, 여수시,'050002, 46세,2019,4513,2392,2121,112.8,4417,2326,2091,111.2
'36020, 여수시,'050003, 47세,2019,4498,2400,2098,114.4,4378,2311,2067,111.8
'36020, 여수시,'050004, 48세,2019,4879,2572,2307,111.5,4780,2506,2274,110.2
'36020, 여수시,'050005, 49세,2019,4666,2466,2200,112.1,4559,2403,2156,111.5
'36020, 여수시,'055,50~54세,2019,23087,12024,11063,108.7,22740,11836,10904,108.5
'36020, 여수시,'055001, 50세,2019,4645,2481,2164,114.6,4544,2423,2121,114.2
'36020, 여수시,'055002, 51세,2019,4826,2476,2350,105.4,4751,2436,2315,105.2
'36020, 여수시,'055003, 52세,2019,4482,2271,2211,102.7,4422,2237,2185,102.4
'36020, 여수시,'055004, 53세,2019,4592,2424,2168,111.8,4553,2400,2153,111.5
'36020, 여수시,'055005, 54세,2019,4542,2372,2170,109.3,4470,2340,2130,109.9
'36020, 여수시,'060,55~59세,2019,23908,12091,11817,102.3,23694,11984,11710,102.3
'36020, 여수시,'060001, 55세,2019,4303,2235,2068,108.1,4239,2202,2037,108.1
'36020, 여수시,'060002, 56세,2019,4894,2529,2365,106.9,4851,2507,2344,107
'36020, 여수시,'060003, 57세,2019,4541,2377,2164,109.8,4500,2357,2143,110
'36020, 여수시,'060004, 58세,2019,4952,2400,2552,94,4917,2382,2535,94
'36020, 여수시,'060005, 59세,2019,5218,2550,2668,95.6,5187,2536,2651,95.7
'36020, 여수시,'065,60~64세,2019,20983,10395,10588,98.2,20889,10350,10539,98.2
'36020, 여수시,'065001, 60세,2019,4643,2285,2358,96.9,4627,2280,2347,97.1
'36020, 여수시,'065002, 61세,2019,4227,2104,2123,99.1,4199,2088,2111,98.9
'36020, 여수시,'065003, 62세,2019,4284,2124,2160,98.3,4262,2112,2150,98.2
'36020, 여수시,'065004, 63세,2019,3685,1819,1866,97.5,3673,1816,1857,97.8
'36020, 여수시,'065005, 64세,2019,4144,2063,2081,99.1,4128,2054,2074,99
'36020, 여수시,'070,65~69세,2019,15889,7904,7985,99,15845,7881,7964,99
'36020, 여수시,'070001, 65세,2019,3528,1759,1769,99.4,3513,1751,1762,99.4
'36020, 여수시,'070002, 66세,2019,2786,1359,1427,95.2,2775,1354,1421,95.3
'36020, 여수시,'070003, 67세,2019,3521,1719,1802,95.4,3514,1717,1797,95.5
'36020, 여수시,'070004, 68세,2019,3037,1564,1473,106.2,3031,1561,1470,106.2
'36020, 여수시,'070005, 69세,2019,3017,1503,1514,99.3,3012,1498,1514,98.9
'36020, 여수시,'075,70~74세,2019,12614,6004,6610,90.8,12599,5994,6605,90.7
'36020, 여수시,'075001, 70세,2019,2867,1431,1436,99.7,2863,1428,1435,99.5
'36020, 여수시,'075002, 71세,2019,2780,1329,1451,91.6,2776,1326,1450,91.4
'36020, 여수시,'075003, 72세,2019,2950,1373,1577,87.1,2947,1371,1576,87
'36020, 여수시,'075004, 73세,2019,2078,1004,1074,93.5,2076,1003,1073,93.5
'36020, 여수시,'075005, 74세,2019,1939,867,1072,80.9,1937,866,1071,80.9
'36020, 여수시,'080,75~79세,2019,10145,4274,5871,72.8,10137,4270,5867,72.8
'36020, 여수시,'080001, 75세,2019,1872,855,1017,84.1,1871,854,1017,84
'36020, 여수시,'080002, 76세,2019,2147,928,1219,76.1,2146,927,1219,76
'36020, 여수시,'080003, 77세,2019,2400,993,1407,70.6,2399,992,1407,70.5
'36020, 여수시,'080004, 78세,2019,1915,779,1136,68.6,1911,778,1133,68.7
'36020, 여수시,'080005, 79세,2019,1811,719,1092,65.8,1810,719,1091,65.9
'36020, 여수시,'085,80~84세,2019,6311,2293,4018,57.1,6303,2290,4013,57.1
'36020, 여수시,'085001, 80세,2019,1608,617,991,62.3,1606,617,989,62.4
'36020, 여수시,'085002, 81세,2019,1407,540,867,62.3,1407,540,867,62.3
'36020, 여수시,'085003, 82세,2019,1258,480,778,61.7,1257,480,777,61.8
'36020, 여수시,'085004, 83세,2019,1064,341,723,47.2,1061,339,722,47
'36020, 여수시,'085005, 84세,2019,974,315,659,47.8,972,314,658,47.7
'36020, 여수시,'086,85세이상,2019,4688,1116,3572,31.2,4687,1116,3571,31.3
'36020, 여수시,'090,85~89세,2019,3381,888,2493,35.6,3381,888,2493,35.6
'36020, 여수시,'090001, 85세,2019,866,261,605,43.1,866,261,605,43.1
'36020, 여수시,'090002, 86세,2019,750,213,537,39.7,750,213,537,39.7
'36020, 여수시,'090003, 87세,2019,686,174,512,34,686,174,512,34
'36020, 여수시,'090004, 88세,2019,557,127,430,29.5,557,127,430,29.5
'36020, 여수시,'090005, 89세,2019,522,113,409,27.6,522,113,409,27.6
'36020, 여수시,'095,90~94세,2019,1033,192,841,22.8,1032,192,840,22.9
'36020, 여수시,'095001, 90세,2019,323,72,251,28.7,323,72,251,28.7
'36020, 여수시,'095002, 91세,2019,260,49,211,23.2,260,49,211,23.2
'36020, 여수시,'095003, 92세,2019,208,37,171,21.6,208,37,171,21.6
'36020, 여수시,'095004, 93세,2019,133,17,116,14.7,133,17,116,14.7
'36020, 여수시,'095005, 94세,2019,109,17,92,18.5,108,17,91,18.7
'36020, 여수시,'100,95~99세,2019,251,34,217,15.7,251,34,217,15.7
'36020, 여수시,'100001, 95세,2019,62,13,49,26.5,62,13,49,26.5
'36020, 여수시,'100002, 96세,2019,96,10,86,11.6,96,10,86,11.6
'36020, 여수시,'100003, 97세,2019,50,7,43,16.3,50,7,43,16.3
'36020, 여수시,'100004, 98세,2019,24,X,23,4.3,24,X,23,4.3
'36020, 여수시,'100005, 99세,2019,19,X,16,18.8,19,X,16,18.8
'36020, 여수시,'101,100세이상,2019,23,X,21,9.5,23,X,21,9.5
'36020, 여수시,'102,15세미만,2019,33619,17136,16483,104,33586,17125,16461,104
'36020, 여수시,'103,15~64세,2019,187017,100504,86513,116.2,180693,95991,84702,113.3
'36020, 여수시,'104,65세이상,2019,49647,21591,28056,77,49571,21551,28020,76.9
'36020, 여수시,'126,평균연령,2019,44.2,42.5,45.9,,44.4,42.8,46,
'36020, 여수시,'127,중위연령,2019,46.2,44.3,48.2,,46.7,45,48.4,
'36030, 순천시,'000,합계,2019,270202,134542,135660,99.2,267315,133190,134125,99.3
'36030, 순천시,'005,0~4세,2019,10559,5512,5047,109.2,10542,5502,5040,109.2
'36030, 순천시,'005001, 0세,2019,1812,929,883,105.2,1808,926,882,105
'36030, 순천시,'005002, 1세,2019,1847,985,862,114.3,1841,980,861,113.8
'36030, 순천시,'005003, 2세,2019,2062,1110,952,116.6,2060,1110,950,116.8
'36030, 순천시,'005004, 3세,2019,2307,1148,1159,99.1,2304,1147,1157,99.1
'36030, 순천시,'005005, 4세,2019,2531,1340,1191,112.5,2529,1339,1190,112.5
'36030, 순천시,'010,5~9세,2019,13541,6937,6604,105,13522,6929,6593,105.1
'36030, 순천시,'010001, 5세,2019,2547,1282,1265,101.3,2543,1281,1262,101.5
'36030, 순천시,'010002, 6세,2019,2647,1336,1311,101.9,2641,1333,1308,101.9
'36030, 순천시,'010003, 7세,2019,2844,1435,1409,101.8,2841,1434,1407,101.9
'36030, 순천시,'010004, 8세,2019,2846,1467,1379,106.4,2844,1465,1379,106.2
'36030, 순천시,'010005, 9세,2019,2657,1417,1240,114.3,2653,1416,1237,114.5
'36030, 순천시,'015,10~14세,2019,13712,7061,6651,106.2,13700,7053,6647,106.1
'36030, 순천시,'015001, 10세,2019,2684,1347,1337,100.7,2683,1346,1337,100.7
'36030, 순천시,'015002, 11세,2019,2778,1458,1320,110.5,2774,1454,1320,110.2
'36030, 순천시,'015003, 12세,2019,2870,1491,1379,108.1,2869,1490,1379,108
'36030, 순천시,'015004, 13세,2019,2730,1386,1344,103.1,2725,1384,1341,103.2
'36030, 순천시,'015005, 14세,2019,2650,1379,1271,108.5,2649,1379,1270,108.6
'36030, 순천시,'020,15~19세,2019,16139,8581,7558,113.5,16047,8521,7526,113.2
'36030, 순천시,'020001, 15세,2019,2983,1521,1462,104,2981,1520,1461,104
'36030, 순천시,'020002, 16세,2019,2948,1553,1395,111.3,2945,1552,1393,111.4
'36030, 순천시,'020003, 17세,2019,3038,1627,1411,115.3,3033,1624,1409,115.3
'36030, 순천시,'020004, 18세,2019,3585,1959,1626,120.5,3554,1938,1616,119.9
'36030, 순천시,'020005, 19세,2019,3585,1921,1664,115.4,3534,1887,1647,114.6
'36030, 순천시,'025,20~24세,2019,18209,10009,8200,122.1,17804,9822,7982,123.1
'36030, 순천시,'025001, 20세,2019,3504,1940,1564,124,3423,1896,1527,124.2
'36030, 순천시,'025002, 21세,2019,3561,1956,1605,121.9,3495,1919,1576,121.8
'36030, 순천시,'025003, 22세,2019,3776,2078,1698,122.4,3704,2051,1653,124.1
'36030, 순천시,'025004, 23세,2019,3670,1979,1691,117,3589,1941,1648,117.8
'36030, 순천시,'025005, 24세,2019,3698,2056,1642,125.2,3593,2015,1578,127.7
'36030, 순천시,'030,25~29세,2019,16182,8623,7559,114.1,15616,8328,7288,114.3
'36030, 순천시,'030001, 25세,2019,3586,2023,1563,129.4,3471,1963,1508,130.2
'36030, 순천시,'030002, 26세,2019,3430,1829,1601,114.2,3323,1776,1547,114.8
'36030, 순천시,'030003, 27세,2019,3276,1684,1592,105.8,3177,1630,1547,105.4
'36030, 순천시,'030004, 28세,2019,2971,1549,1422,108.9,2859,1494,1365,109.5
'36030, 순천시,'030005, 29세,2019,2919,1538,1381,111.4,2786,1465,1321,110.9
'36030, 순천시,'035,30~34세,2019,14174,7232,6942,104.2,13728,7039,6689,105.2
'36030, 순천시,'035001, 30세,2019,2754,1421,1333,106.6,2653,1381,1272,108.6
'36030, 순천시,'035002, 31세,2019,2737,1403,1334,105.2,2645,1362,1283,106.2
'36030, 순천시,'035003, 32세,2019,2756,1386,1370,101.2,2665,1343,1322,101.6
'36030, 순천시,'035004, 33세,2019,2909,1468,1441,101.9,2820,1427,1393,102.4
'36030, 순천시,'035005, 34세,2019,3018,1554,1464,106.1,2945,1526,1419,107.5
'36030, 순천시,'040,35~39세,2019,18700,9301,9399,99,18397,9171,9226,99.4
'36030, 순천시,'040001, 35세,2019,3402,1682,1720,97.8,3333,1651,1682,98.2
'36030, 순천시,'040002, 36세,2019,3571,1810,1761,102.8,3513,1789,1724,103.8
'36030, 순천시,'040003, 37세,2019,3901,1951,1950,100.1,3835,1922,1913,100.5
'36030, 순천시,'040004, 38세,2019,3691,1809,1882,96.1,3638,1787,1851,96.5
'36030, 순천시,'040005, 39세,2019,4135,2049,2086,98.2,4078,2022,2056,98.3
'36030, 순천시,'045,40~44세,2019,19128,9231,9897,93.3,18879,9120,9759,93.5
'36030, 순천시,'045001, 40세,2019,3873,1916,1957,97.9,3806,1883,1923,97.9
'36030, 순천시,'045002, 41세,2019,3583,1758,1825,96.3,3542,1738,1804,96.3
'36030, 순천시,'045003, 42세,2019,3849,1828,2021,90.5,3811,1811,2000,90.6
'36030, 순천시,'045004, 43세,2019,3822,1827,1995,91.6,3769,1803,1966,91.7
'36030, 순천시,'045005, 44세,2019,4001,1902,2099,90.6,3951,1885,2066,91.2
'36030, 순천시,'050,45~49세,2019,23597,11679,11918,98,23358,11571,11787,98.2
'36030, 순천시,'050001, 45세,2019,4524,2248,2276,98.8,4484,2231,2253,99
'36030, 순천시,'050002, 46세,2019,4681,2259,2422,93.3,4632,2239,2393,93.6
'36030, 순천시,'050003, 47세,2019,4617,2299,2318,99.2,4557,2276,2281,99.8
'36030, 순천시,'050004, 48세,2019,4939,2474,2465,100.4,4887,2446,2441,100.2
'36030, 순천시,'050005, 49세,2019,4836,2399,2437,98.4,4798,2379,2419,98.3
'36030, 순천시,'055,50~54세,2019,24369,12108,12261,98.8,24173,12021,12152,98.9
'36030, 순천시,'055001, 50세,2019,4900,2370,2530,93.7,4860,2355,2505,94
'36030, 순천시,'055002, 51세,2019,5344,2642,2702,97.8,5305,2623,2682,97.8
'36030, 순천시,'055003, 52세,2019,4697,2338,2359,99.1,4649,2316,2333,99.3
'36030, 순천시,'055004, 53세,2019,4647,2382,2265,105.2,4614,2370,2244,105.6
'36030, 순천시,'055005, 54세,2019,4781,2376,2405,98.8,4745,2357,2388,98.7
'36030, 순천시,'060,55~59세,2019,23076,11763,11313,104,22918,11692,11226,104.2
'36030, 순천시,'060001, 55세,2019,4350,2202,2148,102.5,4315,2189,2126,103
'36030, 순천시,'060002, 56세,2019,4692,2446,2246,108.9,4658,2430,2228,109.1
'36030, 순천시,'060003, 57세,2019,4401,2295,2106,109,4365,2276,2089,109
'36030, 순천시,'060004, 58세,2019,4713,2349,2364,99.4,4689,2339,2350,99.5
'36030, 순천시,'060005, 59세,2019,4920,2471,2449,100.9,4891,2458,2433,101
'36030, 순천시,'065,60~64세,2019,18006,9124,8882,102.7,17912,9085,8827,102.9
'36030, 순천시,'065001, 60세,2019,4302,2101,2201,95.5,4278,2090,2188,95.5
'36030, 순천시,'065002, 61세,2019,3803,1992,1811,110,3775,1980,1795,110.3
'36030, 순천시,'065003, 62세,2019,3643,1829,1814,100.8,3629,1825,1804,101.2
'36030, 순천시,'065004, 63세,2019,3035,1536,1499,102.5,3023,1530,1493,102.5
'36030, 순천시,'065005, 64세,2019,3223,1666,1557,107,3207,1660,1547,107.3
'36030, 순천시,'070,65~69세,2019,12198,6096,6102,99.9,12156,6076,6080,99.9
'36030, 순천시,'070001, 65세,2019,2785,1362,1423,95.7,2780,1359,1421,95.6
'36030, 순천시,'070002, 66세,2019,2267,1153,1114,103.5,2259,1150,1109,103.7
'36030, 순천시,'070003, 67세,2019,2642,1306,1336,97.8,2634,1301,1333,97.6
'36030, 순천시,'070004, 68세,2019,2219,1128,1091,103.4,2209,1123,1086,103.4
'36030, 순천시,'070005, 69세,2019,2285,1147,1138,100.8,2274,1143,1131,101.1
'36030, 순천시,'075,70~74세,2019,9554,4539,5015,90.5,9530,4524,5006,90.4
'36030, 순천시,'075001, 70세,2019,2247,1108,1139,97.3,2237,1100,1137,96.7
'36030, 순천시,'075002, 71세,2019,2117,1024,1093,93.7,2113,1022,1091,93.7
'36030, 순천시,'075003, 72세,2019,2175,1009,1166,86.5,2172,1007,1165,86.4
'36030, 순천시,'075004, 73세,2019,1555,748,807,92.7,1552,745,807,92.3
'36030, 순천시,'075005, 74세,2019,1460,650,810,80.2,1456,650,806,80.6
'36030, 순천시,'080,75~79세,2019,8395,3444,4951,69.6,8380,3439,4941,69.6
'36030, 순천시,'080001, 75세,2019,1468,650,818,79.5,1467,649,818,79.3
'36030, 순천시,'080002, 76세,2019,1802,742,1060,70,1796,740,1056,70.1
'36030, 순천시,'080003, 77세,2019,1989,811,1178,68.8,1987,811,1176,69
'36030, 순천시,'080004, 78세,2019,1657,667,990,67.4,1653,666,987,67.5
'36030, 순천시,'080005, 79세,2019,1479,574,905,63.4,1477,573,904,63.4
'36030, 순천시,'085,80~84세,2019,6102,2131,3971,53.7,6096,2127,3969,53.6
'36030, 순천시,'085001, 80세,2019,1460,564,896,62.9,1459,563,896,62.8
'36030, 순천시,'085002, 81세,2019,1317,481,836,57.5,1316,481,835,57.6
'36030, 순천시,'085003, 82세,2019,1209,421,788,53.4,1207,419,788,53.2
'36030, 순천시,'085004, 83세,2019,1085,337,748,45.1,1084,337,747,45.1
'36030, 순천시,'085005, 84세,2019,1031,328,703,46.7,1030,327,703,46.5
'36030, 순천시,'086,85세이상,2019,4561,1171,3390,34.5,4557,1170,3387,34.5
'36030, 순천시,'090,85~89세,2019,3281,897,2384,37.6,3277,896,2381,37.6
'36030, 순천시,'090001, 85세,2019,932,274,658,41.6,931,274,657,41.7
'36030, 순천시,'090002, 86세,2019,759,213,546,39,757,212,545,38.9
'36030, 순천시,'090003, 87세,2019,608,167,441,37.9,607,167,440,38
'36030, 순천시,'090004, 88세,2019,481,132,349,37.8,481,132,349,37.8
'36030, 순천시,'090005, 89세,2019,501,111,390,28.5,501,111,390,28.5
'36030, 순천시,'095,90~94세,2019,1019,237,782,30.3,1019,237,782,30.3
'36030, 순천시,'095001, 90세,2019,367,96,271,35.4,367,96,271,35.4
'36030, 순천시,'095002, 91세,2019,230,57,173,32.9,230,57,173,32.9
'36030, 순천시,'095003, 92세,2019,190,39,151,25.8,190,39,151,25.8
'36030, 순천시,'095004, 93세,2019,126,23,103,22.3,126,23,103,22.3
'36030, 순천시,'095005, 94세,2019,106,22,84,26.2,106,22,84,26.2
'36030, 순천시,'100,95~99세,2019,237,34,203,16.7,237,34,203,16.7
'36030, 순천시,'100001, 95세,2019,69,12,57,21.1,69,12,57,21.1
'36030, 순천시,'100002, 96세,2019,64,12,52,23.1,64,12,52,23.1
'36030, 순천시,'100003, 97세,2019,57,7,50,14,57,7,50,14
'36030, 순천시,'100004, 98세,2019,27,X,25,8,27,X,25,8
'36030, 순천시,'100005, 99세,2019,20,X,19,5.3,20,X,19,5.3
'36030, 순천시,'101,100세이상,2019,24,X,21,14.3,24,X,21,14.3
'36030, 순천시,'102,15세미만,2019,37812,19510,18302,106.6,37764,19484,18280,106.6
'36030, 순천시,'103,15~64세,2019,191580,97651,93929,104,188832,96370,92462,104.2
'36030, 순천시,'104,65세이상,2019,40810,17381,23429,74.2,40719,17336,23383,74.1
'36030, 순천시,'126,평균연령,2019,42,40.6,43.3,,42,40.7,43.4,
'36030, 순천시,'127,중위연령,2019,43.7,42.2,45,,43.8,42.3,45.1,
'36040, 나주시,'000,합계,2019,112101,55881,56220,99.4,108239,53686,54553,98.4
'36040, 나주시,'005,0~4세,2019,4974,2526,2448,103.2,4928,2500,2428,103
'36040, 나주시,'005001, 0세,2019,808,399,409,97.6,802,394,408,96.6
'36040, 나주시,'005002, 1세,2019,938,491,447,109.8,926,483,443,109
'36040, 나주시,'005003, 2세,2019,995,509,486,104.7,987,505,482,104.8
'36040, 나주시,'005004, 3세,2019,1117,566,551,102.7,1106,561,545,102.9
'36040, 나주시,'005005, 4세,2019,1116,561,555,101.1,1107,557,550,101.3
'36040, 나주시,'010,5~9세,2019,5305,2706,2599,104.1,5282,2692,2590,103.9
'36040, 나주시,'010001, 5세,2019,1068,550,518,106.2,1061,544,517,105.2
'36040, 나주시,'010002, 6세,2019,1038,531,507,104.7,1034,531,503,105.6
'36040, 나주시,'010003, 7세,2019,1171,606,565,107.3,1166,603,563,107.1
'36040, 나주시,'010004, 8세,2019,1074,517,557,92.8,1071,515,556,92.6
'36040, 나주시,'010005, 9세,2019,954,502,452,111.1,950,499,451,110.6
'36040, 나주시,'015,10~14세,2019,4332,2258,2074,108.9,4316,2249,2067,108.8
'36040, 나주시,'015001, 10세,2019,927,477,450,106,922,475,447,106.3
'36040, 나주시,'015002, 11세,2019,935,472,463,101.9,932,469,463,101.3
'36040, 나주시,'015003, 12세,2019,900,465,435,106.9,899,465,434,107.1
'36040, 나주시,'015004, 13세,2019,836,454,382,118.8,834,453,381,118.9
'36040, 나주시,'015005, 14세,2019,734,390,344,113.4,729,387,342,113.2
'36040, 나주시,'020,15~19세,2019,5371,2697,2674,100.9,5292,2657,2635,100.8
'36040, 나주시,'020001, 15세,2019,835,430,405,106.2,834,430,404,106.4
'36040, 나주시,'020002, 16세,2019,1169,570,599,95.2,1168,570,598,95.3
'36040, 나주시,'020003, 17세,2019,1074,533,541,98.5,1072,532,540,98.5
'36040, 나주시,'020004, 18세,2019,1066,542,524,103.4,1049,533,516,103.3
'36040, 나주시,'020005, 19세,2019,1227,622,605,102.8,1169,592,577,102.6
'36040, 나주시,'025,20~24세,2019,6274,3416,2858,119.5,5455,2916,2539,114.8
'36040, 나주시,'025001, 20세,2019,1236,673,563,119.5,1095,597,498,119.9
'36040, 나주시,'025002, 21세,2019,1340,690,650,106.2,1177,594,583,101.9
'36040, 나주시,'025003, 22세,2019,1221,667,554,120.4,1062,565,497,113.7
'36040, 나주시,'025004, 23세,2019,1222,674,548,123,1049,568,481,118.1
'36040, 나주시,'025005, 24세,2019,1255,712,543,131.1,1072,592,480,123.3
'36040, 나주시,'030,25~29세,2019,6618,3507,3111,112.7,5796,2990,2806,106.6
'36040, 나주시,'030001, 25세,2019,1292,704,588,119.7,1093,564,529,106.6
'36040, 나주시,'030002, 26세,2019,1325,707,618,114.4,1163,605,558,108.4
'36040, 나주시,'030003, 27세,2019,1380,704,676,104.1,1200,596,604,98.7
'36040, 나주시,'030004, 28세,2019,1301,669,632,105.9,1158,588,570,103.2
'36040, 나주시,'030005, 29세,2019,1320,723,597,121.1,1182,637,545,116.9
'36040, 나주시,'035,30~34세,2019,6679,3374,3305,102.1,6081,3061,3020,101.4
'36040, 나주시,'035001, 30세,2019,1292,655,637,102.8,1175,589,586,100.5
'36040, 나주시,'035002, 31세,2019,1306,681,625,109,1160,603,557,108.3
'36040, 나주시,'035003, 32세,2019,1340,667,673,99.1,1208,600,608,98.7
'36040, 나주시,'035004, 33세,2019,1338,687,651,105.5,1242,630,612,102.9
'36040, 나주시,'035005, 34세,2019,1403,684,719,95.1,1296,639,657,97.3
'36040, 나주시,'040,35~39세,2019,8389,4414,3975,111,7967,4165,3802,109.5
'36040, 나주시,'040001, 35세,2019,1453,768,685,112.1,1349,702,647,108.5
'36040, 나주시,'040002, 36세,2019,1615,859,756,113.6,1522,799,723,110.5
'36040, 나주시,'040003, 37세,2019,1777,937,840,111.5,1696,892,804,110.9
'36040, 나주시,'040004, 38세,2019,1781,951,830,114.6,1702,908,794,114.4
'36040, 나주시,'040005, 39세,2019,1763,899,864,104.1,1698,864,834,103.6
'36040, 나주시,'045,40~44세,2019,7757,4243,3514,120.7,7458,4089,3369,121.4
'36040, 나주시,'045001, 40세,2019,1716,923,793,116.4,1651,888,763,116.4
'36040, 나주시,'045002, 41세,2019,1518,811,707,114.7,1444,780,664,117.5
'36040, 나주시,'045003, 42세,2019,1511,822,689,119.3,1458,789,669,117.9
'36040, 나주시,'045004, 43세,2019,1496,859,637,134.9,1434,825,609,135.5
'36040, 나주시,'045005, 44세,2019,1516,828,688,120.3,1471,807,664,121.5
'36040, 나주시,'050,45~49세,2019,7857,4429,3428,129.2,7619,4302,3317,129.7
'36040, 나주시,'050001, 45세,2019,1568,883,685,128.9,1520,858,662,129.6
'36040, 나주시,'050002, 46세,2019,1553,898,655,137.1,1505,873,632,138.1
'36040, 나주시,'050003, 47세,2019,1571,877,694,126.4,1524,849,675,125.8
'36040, 나주시,'050004, 48세,2019,1590,894,696,128.4,1544,869,675,128.7
'36040, 나주시,'050005, 49세,2019,1575,877,698,125.6,1526,853,673,126.7
'36040, 나주시,'055,50~54세,2019,7809,4185,3624,115.5,7595,4077,3518,115.9
'36040, 나주시,'055001, 50세,2019,1481,772,709,108.9,1434,746,688,108.4
'36040, 나주시,'055002, 51세,2019,1606,865,741,116.7,1558,841,717,117.3
'36040, 나주시,'055003, 52세,2019,1503,798,705,113.2,1466,784,682,115
'36040, 나주시,'055004, 53세,2019,1605,856,749,114.3,1565,839,726,115.6
'36040, 나주시,'055005, 54세,2019,1614,894,720,124.2,1572,867,705,123
'36040, 나주시,'060,55~59세,2019,8501,4390,4111,106.8,8356,4320,4036,107
'36040, 나주시,'060001, 55세,2019,1521,767,754,101.7,1480,750,730,102.7
'36040, 나주시,'060002, 56세,2019,1648,896,752,119.1,1620,884,736,120.1
'36040, 나주시,'060003, 57세,2019,1599,847,752,112.6,1575,833,742,112.3
'36040, 나주시,'060004, 58세,2019,1773,885,888,99.7,1754,876,878,99.8
'36040, 나주시,'060005, 59세,2019,1960,995,965,103.1,1927,977,950,102.8
'36040, 나주시,'065,60~64세,2019,8055,4063,3992,101.8,7975,4026,3949,101.9
'36040, 나주시,'065001, 60세,2019,1733,883,850,103.9,1718,877,841,104.3
'36040, 나주시,'065002, 61세,2019,1688,840,848,99.1,1666,830,836,99.3
'36040, 나주시,'065003, 62세,2019,1628,838,790,106.1,1613,831,782,106.3
'36040, 나주시,'065004, 63세,2019,1479,749,730,102.6,1462,740,722,102.5
'36040, 나주시,'065005, 64세,2019,1527,753,774,97.3,1516,748,768,97.4
'36040, 나주시,'070,65~69세,2019,6041,2966,3075,96.5,6004,2940,3064,96
'36040, 나주시,'070001, 65세,2019,1347,671,676,99.3,1338,665,673,98.8
'36040, 나주시,'070002, 66세,2019,1123,553,570,97,1110,544,566,96.1
'36040, 나주시,'070003, 67세,2019,1310,622,688,90.4,1306,620,686,90.4
'36040, 나주시,'070004, 68세,2019,1083,541,542,99.8,1077,537,540,99.4
'36040, 나주시,'070005, 69세,2019,1178,579,599,96.7,1173,574,599,95.8
'36040, 나주시,'075,70~74세,2019,5487,2488,2999,83,5479,2485,2994,83
'36040, 나주시,'075001, 70세,2019,1230,576,654,88.1,1228,575,653,88.1
'36040, 나주시,'075002, 71세,2019,1148,550,598,92,1146,550,596,92.3
'36040, 나주시,'075003, 72세,2019,1195,557,638,87.3,1195,557,638,87.3
'36040, 나주시,'075004, 73세,2019,869,376,493,76.3,866,375,491,76.4
'36040, 나주시,'075005, 74세,2019,1045,429,616,69.6,1044,428,616,69.5
'36040, 나주시,'080,75~79세,2019,5482,2183,3299,66.2,5477,2182,3295,66.2
'36040, 나주시,'080001, 75세,2019,974,421,553,76.1,973,421,552,76.3
'36040, 나주시,'080002, 76세,2019,1065,428,637,67.2,1062,427,635,67.2
'36040, 나주시,'080003, 77세,2019,1384,546,838,65.2,1384,546,838,65.2
'36040, 나주시,'080004, 78세,2019,1064,425,639,66.5,1063,425,638,66.6
'36040, 나주시,'080005, 79세,2019,995,363,632,57.4,995,363,632,57.4
'36040, 나주시,'085,80~84세,2019,4007,1296,2711,47.8,4000,1295,2705,47.9
'36040, 나주시,'085001, 80세,2019,934,303,631,48,932,302,630,47.9
'36040, 나주시,'085002, 81세,2019,879,297,582,51,879,297,582,51
'36040, 나주시,'085003, 82세,2019,843,264,579,45.6,841,264,577,45.8
'36040, 나주시,'085004, 83세,2019,684,227,457,49.7,683,227,456,49.8
'36040, 나주시,'085005, 84세,2019,667,205,462,44.4,665,205,460,44.6
'36040, 나주시,'086,85세이상,2019,3163,740,2423,30.5,3159,740,2419,30.6
'36040, 나주시,'090,85~89세,2019,2227,547,1680,32.6,2224,547,1677,32.6
'36040, 나주시,'090001, 85세,2019,630,175,455,38.5,630,175,455,38.5
'36040, 나주시,'090002, 86세,2019,513,130,383,33.9,511,130,381,34.1
'36040, 나주시,'090003, 87세,2019,405,111,294,37.8,405,111,294,37.8
'36040, 나주시,'090004, 88세,2019,342,74,268,27.6,342,74,268,27.6
'36040, 나주시,'090005, 89세,2019,337,57,280,20.4,336,57,279,20.4
'36040, 나주시,'095,90~94세,2019,734,150,584,25.7,733,150,583,25.7
'36040, 나주시,'095001, 90세,2019,234,47,187,25.1,233,47,186,25.3
'36040, 나주시,'095002, 91세,2019,189,43,146,29.5,189,43,146,29.5
'36040, 나주시,'095003, 92세,2019,134,24,110,21.8,134,24,110,21.8
'36040, 나주시,'095004, 93세,2019,111,18,93,19.4,111,18,93,19.4
'36040, 나주시,'095005, 94세,2019,66,18,48,37.5,66,18,48,37.5
'36040, 나주시,'100,95~99세,2019,184,39,145,26.9,184,39,145,26.9
'36040, 나주시,'100001, 95세,2019,38,10,28,35.7,38,10,28,35.7
'36040, 나주시,'100002, 96세,2019,67,10,57,17.5,67,10,57,17.5
'36040, 나주시,'100003, 97세,2019,33,12,21,57.1,33,12,21,57.1
'36040, 나주시,'100004, 98세,2019,26,X,23,13,26,X,23,13
'36040, 나주시,'100005, 99세,2019,20,X,16,25,20,X,16,25
'36040, 나주시,'101,100세이상,2019,18,X,14,28.6,18,X,14,28.6
'36040, 나주시,'102,15세미만,2019,14611,7490,7121,105.2,14526,7441,7085,105
'36040, 나주시,'103,15~64세,2019,73310,38718,34592,111.9,69594,36603,32991,110.9
'36040, 나주시,'104,65세이상,2019,24180,9673,14507,66.7,24119,9642,14477,66.6
'36040, 나주시,'126,평균연령,2019,44.6,42.8,46.5,,45,43.2,46.8,
'36040, 나주시,'127,중위연령,2019,45.2,43.6,47.3,,46,44.4,48.1,
'36060, 광양시,'000,합계,2019,143656,74523,69133,107.8,141404,73488,67916,108.2
'36060, 광양시,'005,0~4세,2019,6343,3229,3114,103.7,6329,3223,3106,103.8
'36060, 광양시,'005001, 0세,2019,1139,553,586,94.4,1138,552,586,94.2
'36060, 광양시,'005002, 1세,2019,1162,586,576,101.7,1158,585,573,102.1
'36060, 광양시,'005003, 2세,2019,1228,655,573,114.3,1224,654,570,114.7
'36060, 광양시,'005004, 3세,2019,1342,683,659,103.6,1339,681,658,103.5
'36060, 광양시,'005005, 4세,2019,1472,752,720,104.4,1470,751,719,104.5
'36060, 광양시,'010,5~9세,2019,7732,3947,3785,104.3,7715,3941,3774,104.4
'36060, 광양시,'010001, 5세,2019,1401,679,722,94,1398,677,721,93.9
'36060, 광양시,'010002, 6세,2019,1529,790,739,106.9,1527,789,738,106.9
'36060, 광양시,'010003, 7세,2019,1616,828,788,105.1,1610,826,784,105.4
'36060, 광양시,'010004, 8세,2019,1634,823,811,101.5,1631,823,808,101.9
'36060, 광양시,'010005, 9세,2019,1552,827,725,114.1,1549,826,723,114.2
'36060, 광양시,'015,10~14세,2019,7271,3724,3547,105,7262,3722,3540,105.1
'36060, 광양시,'015001, 10세,2019,1437,730,707,103.3,1435,730,705,103.5
'36060, 광양시,'015002, 11세,2019,1515,780,735,106.1,1514,780,734,106.3
'36060, 광양시,'015003, 12세,2019,1489,776,713,108.8,1485,775,710,109.2
'36060, 광양시,'015004, 13세,2019,1433,734,699,105,1432,734,698,105.2
'36060, 광양시,'015005, 14세,2019,1397,704,693,101.6,1396,703,693,101.4
'36060, 광양시,'020,15~19세,2019,8107,4287,3820,112.2,8084,4278,3806,112.4
'36060, 광양시,'020001, 15세,2019,1518,797,721,110.5,1515,796,719,110.7
'36060, 광양시,'020002, 16세,2019,1631,835,796,104.9,1629,835,794,105.2
'36060, 광양시,'020003, 17세,2019,1765,903,862,104.8,1762,901,861,104.6
'36060, 광양시,'020004, 18세,2019,1836,934,902,103.5,1832,931,901,103.3
'36060, 광양시,'020005, 19세,2019,1357,818,539,151.8,1346,815,531,153.5
'36060, 광양시,'025,20~24세,2019,8261,4976,3285,151.5,8038,4886,3152,155
'36060, 광양시,'025001, 20세,2019,1530,997,533,187.1,1511,996,515,193.4
'36060, 광양시,'025002, 21세,2019,1663,1086,577,188.2,1637,1080,557,193.9
'36060, 광양시,'025003, 22세,2019,1651,957,694,137.9,1605,938,667,140.6
'36060, 광양시,'025004, 23세,2019,1629,961,668,143.9,1575,933,642,145.3
'36060, 광양시,'025005, 24세,2019,1788,975,813,119.9,1710,939,771,121.8
'36060, 광양시,'030,25~29세,2019,8775,5030,3745,134.3,8359,4818,3541,136.1
'36060, 광양시,'030001, 25세,2019,1761,1016,745,136.4,1685,975,710,137.3
'36060, 광양시,'030002, 26세,2019,1818,1050,768,136.7,1730,1004,726,138.3
'36060, 광양시,'030003, 27세,2019,1766,1022,744,137.4,1684,979,705,138.9
'36060, 광양시,'030004, 28세,2019,1740,1011,729,138.7,1651,967,684,141.4
'36060, 광양시,'030005, 29세,2019,1690,931,759,122.7,1609,893,716,124.7
'36060, 광양시,'035,30~34세,2019,8242,4399,3843,114.5,7882,4240,3642,116.4
'36060, 광양시,'035001, 30세,2019,1614,918,696,131.9,1538,878,660,133
'36060, 광양시,'035002, 31세,2019,1569,844,725,116.4,1501,819,682,120.1
'36060, 광양시,'035003, 32세,2019,1609,841,768,109.5,1525,801,724,110.6
'36060, 광양시,'035004, 33세,2019,1698,894,804,111.2,1623,862,761,113.3
'36060, 광양시,'035005, 34세,2019,1752,902,850,106.1,1695,880,815,108
'36060, 광양시,'040,35~39세,2019,10711,5711,5000,114.2,10403,5561,4842,114.8
'36060, 광양시,'040001, 35세,2019,1857,950,907,104.7,1776,913,863,105.8
'36060, 광양시,'040002, 36세,2019,2093,1131,962,117.6,2028,1094,934,117.1
'36060, 광양시,'040003, 37세,2019,2316,1239,1077,115,2264,1215,1049,115.8
'36060, 광양시,'040004, 38세,2019,2117,1155,962,120.1,2054,1125,929,121.1
'36060, 광양시,'040005, 39세,2019,2328,1236,1092,113.2,2281,1214,1067,113.8
'36060, 광양시,'045,40~44세,2019,10566,5383,5183,103.9,10349,5277,5072,104
'36060, 광양시,'045001, 40세,2019,2248,1152,1096,105.1,2196,1127,1069,105.4
'36060, 광양시,'045002, 41세,2019,2046,1084,962,112.7,2002,1058,944,112.1
'36060, 광양시,'045003, 42세,2019,2116,1060,1056,100.4,2070,1038,1032,100.6
'36060, 광양시,'045004, 43세,2019,2037,1014,1023,99.1,1995,995,1000,99.5
'36060, 광양시,'045005, 44세,2019,2119,1073,1046,102.6,2086,1059,1027,103.1
'36060, 광양시,'050,45~49세,2019,13113,6465,6648,97.2,12909,6374,6535,97.5
'36060, 광양시,'050001, 45세,2019,2318,1161,1157,100.3,2283,1147,1136,101
'36060, 광양시,'050002, 46세,2019,2461,1201,1260,95.3,2411,1182,1229,96.2
'36060, 광양시,'050003, 47세,2019,2509,1262,1247,101.2,2470,1241,1229,101
'36060, 광양시,'050004, 48세,2019,2946,1420,1526,93.1,2901,1400,1501,93.3
'36060, 광양시,'050005, 49세,2019,2879,1421,1458,97.5,2844,1404,1440,97.5
'36060, 광양시,'055,50~54세,2019,15230,8395,6835,122.8,15047,8310,6737,123.3
'36060, 광양시,'055001, 50세,2019,3062,1560,1502,103.9,3028,1547,1481,104.5
'36060, 광양시,'055002, 51세,2019,3323,1802,1521,118.5,3281,1785,1496,119.3
'36060, 광양시,'055003, 52세,2019,3128,1740,1388,125.4,3090,1720,1370,125.5
'36060, 광양시,'055004, 53세,2019,2942,1728,1214,142.3,2911,1713,1198,143
'36060, 광양시,'055005, 54세,2019,2775,1565,1210,129.3,2737,1545,1192,129.6
'36060, 광양시,'060,55~59세,2019,12246,6553,5693,115.1,12113,6495,5618,115.6
'36060, 광양시,'060001, 55세,2019,2338,1265,1073,117.9,2312,1253,1059,118.3
'36060, 광양시,'060002, 56세,2019,2548,1415,1133,124.9,2511,1398,1113,125.6
'36060, 광양시,'060003, 57세,2019,2311,1265,1046,120.9,2286,1250,1036,120.7
'36060, 광양시,'060004, 58세,2019,2545,1330,1215,109.5,2521,1325,1196,110.8
'36060, 광양시,'060005, 59세,2019,2504,1278,1226,104.2,2483,1269,1214,104.5
'36060, 광양시,'065,60~64세,2019,8909,4707,4202,112,8824,4672,4152,112.5
'36060, 광양시,'065001, 60세,2019,2114,1073,1041,103.1,2098,1068,1030,103.7
'36060, 광양시,'065002, 61세,2019,1897,1015,882,115.1,1872,1004,868,115.7
'36060, 광양시,'065003, 62세,2019,1791,995,796,125,1774,988,786,125.7
'36060, 광양시,'065004, 63세,2019,1515,806,709,113.7,1502,799,703,113.7
'36060, 광양시,'065005, 64세,2019,1592,818,774,105.7,1578,813,765,106.3
'36060, 광양시,'070,65~69세,2019,5681,2955,2726,108.4,5641,2934,2707,108.4
'36060, 광양시,'070001, 65세,2019,1422,725,697,104,1412,722,690,104.6
'36060, 광양시,'070002, 66세,2019,1051,553,498,111,1040,546,494,110.5
'36060, 광양시,'070003, 67세,2019,1139,607,532,114.1,1133,603,530,113.8
'36060, 광양시,'070004, 68세,2019,1034,542,492,110.2,1026,539,487,110.7
'36060, 광양시,'070005, 69세,2019,1035,528,507,104.1,1030,524,506,103.6
'36060, 광양시,'075,70~74세,2019,4081,1950,2131,91.5,4068,1948,2120,91.9
'36060, 광양시,'075001, 70세,2019,932,465,467,99.6,929,464,465,99.8
'36060, 광양시,'075002, 71세,2019,982,472,510,92.5,979,472,507,93.1
'36060, 광양시,'075003, 72세,2019,977,475,502,94.6,975,475,500,95
'36060, 광양시,'075004, 73세,2019,596,283,313,90.4,594,283,311,91
'36060, 광양시,'075005, 74세,2019,594,255,339,75.2,591,254,337,75.4
'36060, 광양시,'080,75~79세,2019,3513,1338,2175,61.5,3509,1337,2172,61.6
'36060, 광양시,'080001, 75세,2019,628,239,389,61.4,628,239,389,61.4
'36060, 광양시,'080002, 76세,2019,710,291,419,69.5,708,291,417,69.8
'36060, 광양시,'080003, 77세,2019,834,325,509,63.9,833,325,508,64
'36060, 광양시,'080004, 78세,2019,693,246,447,55,692,245,447,54.8
'36060, 광양시,'080005, 79세,2019,648,237,411,57.7,648,237,411,57.7
'36060, 광양시,'085,80~84세,2019,2836,997,1839,54.2,2835,996,1839,54.2
'36060, 광양시,'085001, 80세,2019,674,253,421,60.1,674,253,421,60.1
'36060, 광양시,'085002, 81세,2019,607,213,394,54.1,607,213,394,54.1
'36060, 광양시,'085003, 82세,2019,553,195,358,54.5,553,195,358,54.5
'36060, 광양시,'085004, 83세,2019,528,191,337,56.7,528,191,337,56.7
'36060, 광양시,'085005, 84세,2019,474,145,329,44.1,473,144,329,43.8
'36060, 광양시,'086,85세이상,2019,2039,477,1562,30.5,2037,476,1561,30.5
'36060, 광양시,'090,85~89세,2019,1445,358,1087,32.9,1445,358,1087,32.9
'36060, 광양시,'090001, 85세,2019,383,114,269,42.4,383,114,269,42.4
'36060, 광양시,'090002, 86세,2019,317,80,237,33.8,317,80,237,33.8
'36060, 광양시,'090003, 87세,2019,289,73,216,33.8,289,73,216,33.8
'36060, 광양시,'090004, 88세,2019,257,53,204,26,257,53,204,26
'36060, 광양시,'090005, 89세,2019,199,38,161,23.6,199,38,161,23.6
'36060, 광양시,'095,90~94세,2019,474,105,369,28.5,472,104,368,28.3
'36060, 광양시,'095001, 90세,2019,147,36,111,32.4,147,36,111,32.4
'36060, 광양시,'095002, 91세,2019,135,37,98,37.8,134,36,98,36.7
'36060, 광양시,'095003, 92세,2019,91,13,78,16.7,91,13,78,16.7
'36060, 광양시,'095004, 93세,2019,63,14,49,28.6,63,14,49,28.6
'36060, 광양시,'095005, 94세,2019,38,5,33,15.2,37,5,32,15.6
'36060, 광양시,'100,95~99세,2019,114,13,101,12.9,114,13,101,12.9
'36060, 광양시,'100001, 95세,2019,35,X,31,12.9,35,X,31,12.9
'36060, 광양시,'100002, 96세,2019,36,X,32,12.5,36,X,32,12.5
'36060, 광양시,'100003, 97세,2019,21,X,17,23.5,21,X,17,23.5
'36060, 광양시,'100004, 98세,2019,17,X,17,0,17,X,17,0
'36060, 광양시,'100005, 99세,2019,5,X,X,25,5,X,X,25
'36060, 광양시,'101,100세이상,2019,6,X,5,20,6,X,5,20
'36060, 광양시,'102,15세미만,2019,21346,10900,10446,104.3,21306,10886,10420,104.5
'36060, 광양시,'103,15~64세,2019,104160,55906,48254,115.9,102008,54911,47097,116.6
'36060, 광양시,'104,65세이상,2019,18150,7717,10433,74,18090,7691,10399,74
'36060, 광양시,'126,평균연령,2019,41.1,40,42.2,,41.1,40,42.3,
'36060, 광양시,'127,중위연령,2019,43,41.7,44.3,,43.2,41.9,44.5,
'36310, 담양군,'000,합계,2019,43804,21950,21854,100.4,42345,21207,21138,100.3
'36310, 담양군,'005,0~4세,2019,1078,504,574,87.8,1075,504,571,88.3
'36310, 담양군,'005001, 0세,2019,211,97,114,85.1,211,97,114,85.1
'36310, 담양군,'005002, 1세,2019,216,99,117,84.6,215,99,116,85.3
'36310, 담양군,'005003, 2세,2019,204,101,103,98.1,204,101,103,98.1
'36310, 담양군,'005004, 3세,2019,220,109,111,98.2,220,109,111,98.2
'36310, 담양군,'005005, 4세,2019,227,98,129,76,225,98,127,77.2
'36310, 담양군,'010,5~9세,2019,1206,630,576,109.4,1205,629,576,109.2
'36310, 담양군,'010001, 5세,2019,240,126,114,110.5,239,125,114,109.6
'36310, 담양군,'010002, 6세,2019,213,107,106,100.9,213,107,106,100.9
'36310, 담양군,'010003, 7세,2019,250,123,127,96.9,250,123,127,96.9
'36310, 담양군,'010004, 8세,2019,254,156,98,159.2,254,156,98,159.2
'36310, 담양군,'010005, 9세,2019,249,118,131,90.1,249,118,131,90.1
'36310, 담양군,'015,10~14세,2019,1219,627,592,105.9,1216,627,589,106.5
'36310, 담양군,'015001, 10세,2019,247,132,115,114.8,247,132,115,114.8
'36310, 담양군,'015002, 11세,2019,242,127,115,110.4,242,127,115,110.4
'36310, 담양군,'015003, 12세,2019,229,113,116,97.4,228,113,115,98.3
'36310, 담양군,'015004, 13세,2019,242,121,121,100,240,121,119,101.7
'36310, 담양군,'015005, 14세,2019,259,134,125,107.2,259,134,125,107.2
'36310, 담양군,'020,15~19세,2019,2386,1334,1052,126.8,2371,1325,1046,126.7
'36310, 담양군,'020001, 15세,2019,331,172,159,108.2,329,170,159,106.9
'36310, 담양군,'020002, 16세,2019,460,251,209,120.1,459,250,209,119.6
'36310, 담양군,'020003, 17세,2019,495,270,225,120,495,270,225,120
'36310, 담양군,'020004, 18세,2019,627,348,279,124.7,626,348,278,125.2
'36310, 담양군,'020005, 19세,2019,473,293,180,162.8,462,287,175,164
'36310, 담양군,'025,20~24세,2019,2511,1585,926,171.2,2265,1444,821,175.9
'36310, 담양군,'025001, 20세,2019,469,297,172,172.7,457,288,169,170.4
'36310, 담양군,'025002, 21세,2019,461,294,167,176,423,273,150,182
'36310, 담양군,'025003, 22세,2019,485,324,161,201.2,432,294,138,213
'36310, 담양군,'025004, 23세,2019,581,370,211,175.4,511,330,181,182.3
'36310, 담양군,'025005, 24세,2019,515,300,215,139.5,442,259,183,141.5
'36310, 담양군,'030,25~29세,2019,2183,1175,1008,116.6,1805,981,824,119.1
'36310, 담양군,'030001, 25세,2019,446,253,193,131.1,370,212,158,134.2
'36310, 담양군,'030002, 26세,2019,454,250,204,122.5,367,207,160,129.4
'36310, 담양군,'030003, 27세,2019,491,270,221,122.2,395,216,179,120.7
'36310, 담양군,'030004, 28세,2019,389,200,189,105.8,323,170,153,111.1
'36310, 담양군,'030005, 29세,2019,403,202,201,100.5,350,176,174,101.1
'36310, 담양군,'035,30~34세,2019,1774,933,841,110.9,1498,791,707,111.9
'36310, 담양군,'035001, 30세,2019,356,178,178,100,287,149,138,108
'36310, 담양군,'035002, 31세,2019,349,182,167,109,289,150,139,107.9
'36310, 담양군,'035003, 32세,2019,353,195,158,123.4,309,170,139,122.3
'36310, 담양군,'035004, 33세,2019,348,184,164,112.2,297,155,142,109.2
'36310, 담양군,'035005, 34세,2019,368,194,174,111.5,316,167,149,112.1
'36310, 담양군,'040,35~39세,2019,2000,1067,933,114.4,1819,985,834,118.1
'36310, 담양군,'040001, 35세,2019,370,197,173,113.9,321,170,151,112.6
'36310, 담양군,'040002, 36세,2019,399,225,174,129.3,354,206,148,139.2
'36310, 담양군,'040003, 37세,2019,408,214,194,110.3,383,201,182,110.4
'36310, 담양군,'040004, 38세,2019,400,202,198,102,371,192,179,107.3
'36310, 담양군,'040005, 39세,2019,423,229,194,118,390,216,174,124.1
'36310, 담양군,'045,40~44세,2019,2063,1151,912,126.2,1942,1089,853,127.7
'36310, 담양군,'045001, 40세,2019,382,211,171,123.4,352,194,158,122.8
'36310, 담양군,'045002, 41세,2019,402,220,182,120.9,379,209,170,122.9
'36310, 담양군,'045003, 42세,2019,401,216,185,116.8,380,207,173,119.7
'36310, 담양군,'045004, 43세,2019,409,240,169,142,386,228,158,144.3
'36310, 담양군,'045005, 44세,2019,469,264,205,128.8,445,251,194,129.4
'36310, 담양군,'050,45~49세,2019,2898,1668,1230,135.6,2822,1631,1191,136.9
'36310, 담양군,'050001, 45세,2019,558,339,219,154.8,535,328,207,158.5
'36310, 담양군,'050002, 46세,2019,525,277,248,111.7,507,269,238,113
'36310, 담양군,'050003, 47세,2019,567,346,221,156.6,555,339,216,156.9
'36310, 담양군,'050004, 48세,2019,643,367,276,133,627,361,266,135.7
'36310, 담양군,'050005, 49세,2019,605,339,266,127.4,598,334,264,126.5
'36310, 담양군,'055,50~54세,2019,3403,1791,1612,111.1,3335,1758,1577,111.5
'36310, 담양군,'055001, 50세,2019,646,328,318,103.1,631,316,315,100.3
'36310, 담양군,'055002, 51세,2019,691,372,319,116.6,676,365,311,117.4
'36310, 담양군,'055003, 52세,2019,648,350,298,117.4,636,344,292,117.8
'36310, 담양군,'055004, 53세,2019,681,372,309,120.4,671,369,302,122.2
'36310, 담양군,'055005, 54세,2019,737,369,368,100.3,721,364,357,102
'36310, 담양군,'060,55~59세,2019,4119,2169,1950,111.2,4074,2147,1927,111.4
'36310, 담양군,'060001, 55세,2019,719,387,332,116.6,714,386,328,117.7
'36310, 담양군,'060002, 56세,2019,785,432,353,122.4,776,427,349,122.3
'36310, 담양군,'060003, 57세,2019,786,423,363,116.5,775,417,358,116.5
'36310, 담양군,'060004, 58세,2019,892,449,443,101.4,882,443,439,100.9
'36310, 담양군,'060005, 59세,2019,937,478,459,104.1,927,474,453,104.6
'36310, 담양군,'065,60~64세,2019,3887,1990,1897,104.9,3864,1979,1885,105
'36310, 담양군,'065001, 60세,2019,870,458,412,111.2,865,456,409,111.5
'36310, 담양군,'065002, 61세,2019,776,395,381,103.7,770,393,377,104.2
'36310, 담양군,'065003, 62세,2019,830,430,400,107.5,824,427,397,107.6
'36310, 담양군,'065004, 63세,2019,670,348,322,108.1,666,346,320,108.1
'36310, 담양군,'065005, 64세,2019,741,359,382,94,739,357,382,93.5
'36310, 담양군,'070,65~69세,2019,3169,1533,1636,93.7,3159,1530,1629,93.9
'36310, 담양군,'070001, 65세,2019,685,324,361,89.8,681,324,357,90.8
'36310, 담양군,'070002, 66세,2019,583,286,297,96.3,582,285,297,96
'36310, 담양군,'070003, 67세,2019,707,351,356,98.6,705,350,355,98.6
'36310, 담양군,'070004, 68세,2019,567,266,301,88.4,565,265,300,88.3
'36310, 담양군,'070005, 69세,2019,627,306,321,95.3,626,306,320,95.6
'36310, 담양군,'075,70~74세,2019,2917,1372,1545,88.8,2906,1367,1539,88.8
'36310, 담양군,'075001, 70세,2019,602,275,327,84.1,597,273,324,84.3
'36310, 담양군,'075002, 71세,2019,647,319,328,97.3,645,318,327,97.2
'36310, 담양군,'075003, 72세,2019,705,333,372,89.5,704,332,372,89.2
'36310, 담양군,'075004, 73세,2019,490,232,258,89.9,488,231,257,89.9
'36310, 담양군,'075005, 74세,2019,473,213,260,81.9,472,213,259,82.2
'36310, 담양군,'080,75~79세,2019,3058,1197,1861,64.3,3057,1197,1860,64.4
'36310, 담양군,'080001, 75세,2019,473,161,312,51.6,473,161,312,51.6
'36310, 담양군,'080002, 76세,2019,587,255,332,76.8,587,255,332,76.8
'36310, 담양군,'080003, 77세,2019,838,332,506,65.6,838,332,506,65.6
'36310, 담양군,'080004, 78세,2019,608,249,359,69.4,608,249,359,69.4
'36310, 담양군,'080005, 79세,2019,552,200,352,56.8,551,200,351,57
'36310, 담양군,'085,80~84세,2019,2312,802,1510,53.1,2311,801,1510,53
'36310, 담양군,'085001, 80세,2019,615,237,378,62.7,615,237,378,62.7
'36310, 담양군,'085002, 81세,2019,502,183,319,57.4,502,183,319,57.4
'36310, 담양군,'085003, 82세,2019,427,135,292,46.2,426,134,292,45.9
'36310, 담양군,'085004, 83세,2019,402,134,268,50,402,134,268,50
'36310, 담양군,'085005, 84세,2019,366,113,253,44.7,366,113,253,44.7
'36310, 담양군,'086,85세이상,2019,1621,422,1199,35.2,1621,422,1199,35.2
'36310, 담양군,'090,85~89세,2019,1133,313,820,38.2,1133,313,820,38.2
'36310, 담양군,'090001, 85세,2019,305,92,213,43.2,305,92,213,43.2
'36310, 담양군,'090002, 86세,2019,273,74,199,37.2,273,74,199,37.2
'36310, 담양군,'090003, 87세,2019,214,56,158,35.4,214,56,158,35.4
'36310, 담양군,'090004, 88세,2019,168,44,124,35.5,168,44,124,35.5
'36310, 담양군,'090005, 89세,2019,173,47,126,37.3,173,47,126,37.3
'36310, 담양군,'095,90~94세,2019,378,85,293,29,378,85,293,29
'36310, 담양군,'095001, 90세,2019,126,31,95,32.6,126,31,95,32.6
'36310, 담양군,'095002, 91세,2019,100,25,75,33.3,100,25,75,33.3
'36310, 담양군,'095003, 92세,2019,67,11,56,19.6,67,11,56,19.6
'36310, 담양군,'095004, 93세,2019,50,9,41,22,50,9,41,22
'36310, 담양군,'095005, 94세,2019,35,9,26,34.6,35,9,26,34.6
'36310, 담양군,'100,95~99세,2019,93,21,72,29.2,93,21,72,29.2
'36310, 담양군,'100001, 95세,2019,26,5,21,23.8,26,5,21,23.8
'36310, 담양군,'100002, 96세,2019,23,X,19,21.1,23,X,19,21.1
'36310, 담양군,'100003, 97세,2019,19,7,12,58.3,19,7,12,58.3
'36310, 담양군,'100004, 98세,2019,16,5,11,45.5,16,5,11,45.5
'36310, 담양군,'100005, 99세,2019,9,X,9,0,9,X,9,0
'36310, 담양군,'101,100세이상,2019,17,X,14,21.4,17,X,14,21.4
'36310, 담양군,'102,15세미만,2019,3503,1761,1742,101.1,3496,1760,1736,101.4
'36310, 담양군,'103,15~64세,2019,27224,14863,12361,120.2,25795,14130,11665,121.1
'36310, 담양군,'104,65세이상,2019,13077,5326,7751,68.7,13054,5317,7737,68.7
'36310, 담양군,'126,평균연령,2019,50.2,47.7,52.8,,50.8,48.1,53.4,
'36310, 담양군,'127,중위연령,2019,53.9,50.9,57,,54.7,51.8,57.8,
'36320, 곡성군,'000,합계,2019,27858,13690,14168,96.6,27151,13296,13855,96
'36320, 곡성군,'005,0~4세,2019,536,256,280,91.4,534,255,279,91.4
'36320, 곡성군,'005001, 0세,2019,86,43,43,100,85,43,42,102.4
'36320, 곡성군,'005002, 1세,2019,114,56,58,96.6,114,56,58,96.6
'36320, 곡성군,'005003, 2세,2019,96,49,47,104.3,95,48,47,102.1
'36320, 곡성군,'005004, 3세,2019,116,56,60,93.3,116,56,60,93.3
'36320, 곡성군,'005005, 4세,2019,124,52,72,72.2,124,52,72,72.2
'36320, 곡성군,'010,5~9세,2019,677,355,322,110.2,677,355,322,110.2
'36320, 곡성군,'010001, 5세,2019,114,61,53,115.1,114,61,53,115.1
'36320, 곡성군,'010002, 6세,2019,117,70,47,148.9,117,70,47,148.9
'36320, 곡성군,'010003, 7세,2019,141,79,62,127.4,141,79,62,127.4
'36320, 곡성군,'010004, 8세,2019,163,75,88,85.2,163,75,88,85.2
'36320, 곡성군,'010005, 9세,2019,142,70,72,97.2,142,70,72,97.2
'36320, 곡성군,'015,10~14세,2019,781,432,349,123.8,781,432,349,123.8
'36320, 곡성군,'015001, 10세,2019,144,82,62,132.3,144,82,62,132.3
'36320, 곡성군,'015002, 11세,2019,163,104,59,176.3,163,104,59,176.3
'36320, 곡성군,'015003, 12세,2019,155,76,79,96.2,155,76,79,96.2
'36320, 곡성군,'015004, 13세,2019,155,88,67,131.3,155,88,67,131.3
'36320, 곡성군,'015005, 14세,2019,164,82,82,100,164,82,82,100
'36320, 곡성군,'020,15~19세,2019,1594,866,728,119,1571,850,721,117.9
'36320, 곡성군,'020001, 15세,2019,190,101,89,113.5,189,100,89,112.4
'36320, 곡성군,'020002, 16세,2019,273,148,125,118.4,273,148,125,118.4
'36320, 곡성군,'020003, 17세,2019,263,112,151,74.2,263,112,151,74.2
'36320, 곡성군,'020004, 18세,2019,376,203,173,117.3,371,199,172,115.7
'36320, 곡성군,'020005, 19세,2019,492,302,190,158.9,475,291,184,158.2
'36320, 곡성군,'025,20~24세,2019,1805,1026,779,131.7,1650,922,728,126.6
'36320, 곡성군,'025001, 20세,2019,459,286,173,165.3,438,271,167,162.3
'36320, 곡성군,'025002, 21세,2019,383,206,177,116.4,350,185,165,112.1
'36320, 곡성군,'025003, 22세,2019,358,185,173,106.9,325,162,163,99.4
'36320, 곡성군,'025004, 23세,2019,326,188,138,136.2,289,164,125,131.2
'36320, 곡성군,'025005, 24세,2019,279,161,118,136.4,248,140,108,129.6
'36320, 곡성군,'030,25~29세,2019,1161,664,497,133.6,1016,583,433,134.6
'36320, 곡성군,'030001, 25세,2019,244,138,106,130.2,219,123,96,128.1
'36320, 곡성군,'030002, 26세,2019,255,142,113,125.7,223,125,98,127.6
'36320, 곡성군,'030003, 27세,2019,241,149,92,162,204,126,78,161.5
'36320, 곡성군,'030004, 28세,2019,224,129,95,135.8,202,117,85,137.6
'36320, 곡성군,'030005, 29세,2019,197,106,91,116.5,168,92,76,121.1
'36320, 곡성군,'035,30~34세,2019,814,451,363,124.2,729,399,330,120.9
'36320, 곡성군,'035001, 30세,2019,145,79,66,119.7,125,66,59,111.9
'36320, 곡성군,'035002, 31세,2019,195,118,77,153.2,168,97,71,136.6
'36320, 곡성군,'035003, 32세,2019,167,86,81,106.2,153,81,72,112.5
'36320, 곡성군,'035004, 33세,2019,143,78,65,120,130,72,58,124.1
'36320, 곡성군,'035005, 34세,2019,164,90,74,121.6,153,83,70,118.6
'36320, 곡성군,'040,35~39세,2019,1064,602,462,130.3,994,567,427,132.8
'36320, 곡성군,'040001, 35세,2019,190,102,88,115.9,176,92,84,109.5
'36320, 곡성군,'040002, 36세,2019,206,123,83,148.2,189,115,74,155.4
'36320, 곡성군,'040003, 37세,2019,221,127,94,135.1,206,120,86,139.5
'36320, 곡성군,'040004, 38세,2019,221,121,100,121,210,119,91,130.8
'36320, 곡성군,'040005, 39세,2019,226,129,97,133,213,121,92,131.5
'36320, 곡성군,'045,40~44세,2019,1243,670,573,116.9,1193,647,546,118.5
'36320, 곡성군,'045001, 40세,2019,234,120,114,105.3,219,114,105,108.6
'36320, 곡성군,'045002, 41세,2019,221,125,96,130.2,217,123,94,130.9
'36320, 곡성군,'045003, 42세,2019,253,133,120,110.8,237,125,112,111.6
'36320, 곡성군,'045004, 43세,2019,266,152,114,133.3,253,146,107,136.4
'36320, 곡성군,'045005, 44세,2019,269,140,129,108.5,267,139,128,108.6
'36320, 곡성군,'050,45~49세,2019,1787,985,802,122.8,1735,968,767,126.2
'36320, 곡성군,'050001, 45세,2019,339,184,155,118.7,333,182,151,120.5
'36320, 곡성군,'050002, 46세,2019,321,192,129,148.8,306,187,119,157.1
'36320, 곡성군,'050003, 47세,2019,367,208,159,130.8,358,205,153,134
'36320, 곡성군,'050004, 48세,2019,365,182,183,99.5,359,181,178,101.7
'36320, 곡성군,'050005, 49세,2019,395,219,176,124.4,379,213,166,128.3
'36320, 곡성군,'055,50~54세,2019,2085,1172,913,128.4,2033,1144,889,128.7
'36320, 곡성군,'055001, 50세,2019,407,244,163,149.7,398,237,161,147.2
'36320, 곡성군,'055002, 51세,2019,406,219,187,117.1,398,217,181,119.9
'36320, 곡성군,'055003, 52세,2019,400,223,177,126,389,219,170,128.8
'36320, 곡성군,'055004, 53세,2019,431,232,199,116.6,418,223,195,114.4
'36320, 곡성군,'055005, 54세,2019,441,254,187,135.8,430,248,182,136.3
'36320, 곡성군,'060,55~59세,2019,2450,1270,1180,107.6,2420,1258,1162,108.3
'36320, 곡성군,'060001, 55세,2019,412,220,192,114.6,402,215,187,115
'36320, 곡성군,'060002, 56세,2019,439,228,211,108.1,431,225,206,109.2
'36320, 곡성군,'060003, 57세,2019,468,238,230,103.5,463,236,227,104
'36320, 곡성군,'060004, 58세,2019,546,279,267,104.5,543,278,265,104.9
'36320, 곡성군,'060005, 59세,2019,585,305,280,108.9,581,304,277,109.7
'36320, 곡성군,'065,60~64세,2019,2410,1253,1157,108.3,2390,1239,1151,107.6
'36320, 곡성군,'065001, 60세,2019,547,274,273,100.4,542,272,270,100.7
'36320, 곡성군,'065002, 61세,2019,502,278,224,124.1,498,275,223,123.3
'36320, 곡성군,'065003, 62세,2019,499,271,228,118.9,497,270,227,118.9
'36320, 곡성군,'065004, 63세,2019,384,195,189,103.2,381,193,188,102.7
'36320, 곡성군,'065005, 64세,2019,478,235,243,96.7,472,229,243,94.2
'36320, 곡성군,'070,65~69세,2019,1980,973,1007,96.6,1971,970,1001,96.9
'36320, 곡성군,'070001, 65세,2019,397,195,202,96.5,393,195,198,98.5
'36320, 곡성군,'070002, 66세,2019,347,184,163,112.9,347,184,163,112.9
'36320, 곡성군,'070003, 67세,2019,442,218,224,97.3,440,217,223,97.3
'36320, 곡성군,'070004, 68세,2019,379,169,210,80.5,378,168,210,80
'36320, 곡성군,'070005, 69세,2019,415,207,208,99.5,413,206,207,99.5
'36320, 곡성군,'075,70~74세,2019,1982,878,1104,79.5,1976,874,1102,79.3
'36320, 곡성군,'075001, 70세,2019,413,198,215,92.1,412,197,215,91.6
'36320, 곡성군,'075002, 71세,2019,433,189,244,77.5,433,189,244,77.5
'36320, 곡성군,'075003, 72세,2019,449,209,240,87.1,446,207,239,86.6
'36320, 곡성군,'075004, 73세,2019,366,157,209,75.1,366,157,209,75.1
'36320, 곡성군,'075005, 74세,2019,321,125,196,63.8,319,124,195,63.6
'36320, 곡성군,'080,75~79세,2019,2200,826,1374,60.1,2194,824,1370,60.1
'36320, 곡성군,'080001, 75세,2019,336,135,201,67.2,335,135,200,67.5
'36320, 곡성군,'080002, 76세,2019,386,162,224,72.3,385,161,224,71.9
'36320, 곡성군,'080003, 77세,2019,572,210,362,58,570,210,360,58.3
'36320, 곡성군,'080004, 78세,2019,466,168,298,56.4,465,167,298,56
'36320, 곡성군,'080005, 79세,2019,440,151,289,52.2,439,151,288,52.4
'36320, 곡성군,'085,80~84세,2019,1946,654,1292,50.6,1944,652,1292,50.5
'36320, 곡성군,'085001, 80세,2019,431,156,275,56.7,431,156,275,56.7
'36320, 곡성군,'085002, 81세,2019,398,144,254,56.7,397,143,254,56.3
'36320, 곡성군,'085003, 82세,2019,412,149,263,56.7,411,148,263,56.3
'36320, 곡성군,'085004, 83세,2019,361,101,260,38.8,361,101,260,38.8
'36320, 곡성군,'085005, 84세,2019,344,104,240,43.3,344,104,240,43.3
'36320, 곡성군,'086,85세이상,2019,1343,357,986,36.2,1343,357,986,36.2
'36320, 곡성군,'090,85~89세,2019,949,272,677,40.2,949,272,677,40.2
'36320, 곡성군,'090001, 85세,2019,280,98,182,53.8,280,98,182,53.8
'36320, 곡성군,'090002, 86세,2019,197,56,141,39.7,197,56,141,39.7
'36320, 곡성군,'090003, 87세,2019,184,51,133,38.3,184,51,133,38.3
'36320, 곡성군,'090004, 88세,2019,153,34,119,28.6,153,34,119,28.6
'36320, 곡성군,'090005, 89세,2019,135,33,102,32.4,135,33,102,32.4
'36320, 곡성군,'095,90~94세,2019,326,75,251,29.9,326,75,251,29.9
'36320, 곡성군,'095001, 90세,2019,94,24,70,34.3,94,24,70,34.3
'36320, 곡성군,'095002, 91세,2019,87,12,75,16,87,12,75,16
'36320, 곡성군,'095003, 92세,2019,62,19,43,44.2,62,19,43,44.2
'36320, 곡성군,'095004, 93세,2019,57,13,44,29.5,57,13,44,29.5
'36320, 곡성군,'095005, 94세,2019,26,7,19,36.8,26,7,19,36.8
'36320, 곡성군,'100,95~99세,2019,62,10,52,19.2,62,10,52,19.2
'36320, 곡성군,'100001, 95세,2019,18,X,14,28.6,18,X,14,28.6
'36320, 곡성군,'100002, 96세,2019,23,X,21,9.5,23,X,21,9.5
'36320, 곡성군,'100003, 97세,2019,9,X,7,28.6,9,X,7,28.6
'36320, 곡성군,'100004, 98세,2019,7,X,6,16.7,7,X,6,16.7
'36320, 곡성군,'100005, 99세,2019,5,X,X,25,5,X,X,25
'36320, 곡성군,'101,100세이상,2019,6,X,6,0,6,X,6,0
'36320, 곡성군,'102,15세미만,2019,1994,1043,951,109.7,1992,1042,950,109.7
'36320, 곡성군,'103,15~64세,2019,16413,8959,7454,120.2,15731,8577,7154,119.9
'36320, 곡성군,'104,65세이상,2019,9451,3688,5763,64,9428,3677,5751,63.9
'36320, 곡성군,'126,평균연령,2019,52.1,48.9,55.1,,52.5,49.3,55.5,
'36320, 곡성군,'127,중위연령,2019,55.9,52.3,59.4,,56.6,53,59.9,
'36330, 구례군,'000,합계,2019,23836,11471,12365,92.8,23499,11354,12145,93.5
'36330, 구례군,'005,0~4세,2019,492,237,255,92.9,492,237,255,92.9
'36330, 구례군,'005001, 0세,2019,99,47,52,90.4,99,47,52,90.4
'36330, 구례군,'005002, 1세,2019,68,30,38,78.9,68,30,38,78.9
'36330, 구례군,'005003, 2세,2019,102,49,53,92.5,102,49,53,92.5
'36330, 구례군,'005004, 3세,2019,106,53,53,100,106,53,53,100
'36330, 구례군,'005005, 4세,2019,117,58,59,98.3,117,58,59,98.3
'36330, 구례군,'010,5~9세,2019,697,350,347,100.9,697,350,347,100.9
'36330, 구례군,'010001, 5세,2019,107,63,44,143.2,107,63,44,143.2
'36330, 구례군,'010002, 6세,2019,150,75,75,100,150,75,75,100
'36330, 구례군,'010003, 7세,2019,140,61,79,77.2,140,61,79,77.2
'36330, 구례군,'010004, 8세,2019,169,82,87,94.3,169,82,87,94.3
'36330, 구례군,'010005, 9세,2019,131,69,62,111.3,131,69,62,111.3
'36330, 구례군,'015,10~14세,2019,751,396,355,111.5,751,396,355,111.5
'36330, 구례군,'015001, 10세,2019,139,78,61,127.9,139,78,61,127.9
'36330, 구례군,'015002, 11세,2019,149,82,67,122.4,149,82,67,122.4
'36330, 구례군,'015003, 12세,2019,160,77,83,92.8,160,77,83,92.8
'36330, 구례군,'015004, 13세,2019,140,72,68,105.9,140,72,68,105.9
'36330, 구례군,'015005, 14세,2019,163,87,76,114.5,163,87,76,114.5
'36330, 구례군,'020,15~19세,2019,707,372,335,111,707,372,335,111
'36330, 구례군,'020001, 15세,2019,144,82,62,132.3,144,82,62,132.3
'36330, 구례군,'020002, 16세,2019,123,57,66,86.4,123,57,66,86.4
'36330, 구례군,'020003, 17세,2019,140,72,68,105.9,140,72,68,105.9
'36330, 구례군,'020004, 18세,2019,169,87,82,106.1,169,87,82,106.1
'36330, 구례군,'020005, 19세,2019,131,74,57,129.8,131,74,57,129.8
'36330, 구례군,'025,20~24세,2019,876,492,384,128.1,829,473,356,132.9
'36330, 구례군,'025001, 20세,2019,175,115,60,191.7,169,114,55,207.3
'36330, 구례군,'025002, 21세,2019,186,109,77,141.6,177,107,70,152.9
'36330, 구례군,'025003, 22세,2019,170,95,75,126.7,164,93,71,131
'36330, 구례군,'025004, 23세,2019,162,81,81,100,155,79,76,103.9
'36330, 구례군,'025005, 24세,2019,183,92,91,101.1,164,80,84,95.2
'36330, 구례군,'030,25~29세,2019,813,418,395,105.8,763,399,364,109.6
'36330, 구례군,'030001, 25세,2019,165,96,69,139.1,162,94,68,138.2
'36330, 구례군,'030002, 26세,2019,184,94,90,104.4,166,88,78,112.8
'36330, 구례군,'030003, 27세,2019,166,92,74,124.3,159,87,72,120.8
'36330, 구례군,'030004, 28세,2019,156,58,98,59.2,145,56,89,62.9
'36330, 구례군,'030005, 29세,2019,142,78,64,121.9,131,74,57,129.8
'36330, 구례군,'035,30~34세,2019,730,367,363,101.1,682,351,331,106
'36330, 구례군,'035001, 30세,2019,139,70,69,101.4,127,66,61,108.2
'36330, 구례군,'035002, 31세,2019,145,68,77,88.3,136,67,69,97.1
'36330, 구례군,'035003, 32세,2019,139,78,61,127.9,131,74,57,129.8
'36330, 구례군,'035004, 33세,2019,150,68,82,82.9,139,63,76,82.9
'36330, 구례군,'035005, 34세,2019,157,83,74,112.2,149,81,68,119.1
'36330, 구례군,'040,35~39세,2019,1014,549,465,118.1,971,540,431,125.3
'36330, 구례군,'040001, 35세,2019,162,77,85,90.6,152,76,76,100
'36330, 구례군,'040002, 36세,2019,203,106,97,109.3,188,103,85,121.2
'36330, 구례군,'040003, 37세,2019,223,122,101,120.8,216,121,95,127.4
'36330, 구례군,'040004, 38세,2019,204,127,77,164.9,200,125,75,166.7
'36330, 구례군,'040005, 39세,2019,222,117,105,111.4,215,115,100,115
'36330, 구례군,'045,40~44세,2019,1177,592,585,101.2,1137,579,558,103.8
'36330, 구례군,'045001, 40세,2019,230,110,120,91.7,217,106,111,95.5
'36330, 구례군,'045002, 41세,2019,227,121,106,114.2,220,119,101,117.8
'36330, 구례군,'045003, 42세,2019,229,119,110,108.2,220,115,105,109.5
'36330, 구례군,'045004, 43세,2019,252,116,136,85.3,246,114,132,86.4
'36330, 구례군,'045005, 44세,2019,239,126,113,111.5,234,125,109,114.7
'36330, 구례군,'050,45~49세,2019,1657,939,718,130.8,1636,930,706,131.7
'36330, 구례군,'050001, 45세,2019,305,172,133,129.3,298,171,127,134.6
'36330, 구례군,'050002, 46세,2019,339,178,161,110.6,334,177,157,112.7
'36330, 구례군,'050003, 47세,2019,282,160,122,131.1,279,157,122,128.7
'36330, 구례군,'050004, 48세,2019,363,216,147,146.9,361,215,146,147.3
'36330, 구례군,'050005, 49세,2019,368,213,155,137.4,364,210,154,136.4
'36330, 구례군,'055,50~54세,2019,2027,1115,912,122.3,1993,1105,888,124.4
'36330, 구례군,'055001, 50세,2019,432,240,192,125,425,238,187,127.3
'36330, 구례군,'055002, 51세,2019,389,219,170,128.8,377,215,162,132.7
'36330, 구례군,'055003, 52세,2019,387,215,172,125,385,215,170,126.5
'36330, 구례군,'055004, 53세,2019,393,219,174,125.9,384,216,168,128.6
'36330, 구례군,'055005, 54세,2019,426,222,204,108.8,422,221,201,110
'36330, 구례군,'060,55~59세,2019,2339,1247,1092,114.2,2315,1235,1080,114.4
'36330, 구례군,'060001, 55세,2019,388,210,178,118,384,208,176,118.2
'36330, 구례군,'060002, 56세,2019,399,211,188,112.2,393,209,184,113.6
'36330, 구례군,'060003, 57세,2019,477,260,217,119.8,470,257,213,120.7
'36330, 구례군,'060004, 58세,2019,510,267,243,109.9,508,265,243,109.1
'36330, 구례군,'060005, 59세,2019,565,299,266,112.4,560,296,264,112.1
'36330, 구례군,'065,60~64세,2019,2269,1135,1134,100.1,2250,1129,1121,100.7
'36330, 구례군,'065001, 60세,2019,527,266,261,101.9,521,264,257,102.7
'36330, 구례군,'065002, 61세,2019,473,230,243,94.7,471,230,241,95.4
'36330, 구례군,'065003, 62세,2019,429,221,208,106.3,422,218,204,106.9
'36330, 구례군,'065004, 63세,2019,377,180,197,91.4,375,180,195,92.3
'36330, 구례군,'065005, 64세,2019,463,238,225,105.8,461,237,224,105.8
'36330, 구례군,'070,65~69세,2019,1865,881,984,89.5,1861,879,982,89.5
'36330, 구례군,'070001, 65세,2019,409,192,217,88.5,407,190,217,87.6
'36330, 구례군,'070002, 66세,2019,330,145,185,78.4,330,145,185,78.4
'36330, 구례군,'070003, 67세,2019,398,197,201,98,398,197,201,98
'36330, 구례군,'070004, 68세,2019,364,169,195,86.7,363,169,194,87.1
'36330, 구례군,'070005, 69세,2019,364,178,186,95.7,363,178,185,96.2
'36330, 구례군,'075,70~74세,2019,1769,784,985,79.6,1765,782,983,79.6
'36330, 구례군,'075001, 70세,2019,364,161,203,79.3,363,161,202,79.7
'36330, 구례군,'075002, 71세,2019,339,161,178,90.4,338,160,178,89.9
'36330, 구례군,'075003, 72세,2019,411,175,236,74.2,410,175,235,74.5
'36330, 구례군,'075004, 73세,2019,343,158,185,85.4,342,157,185,84.9
'36330, 구례군,'075005, 74세,2019,312,129,183,70.5,312,129,183,70.5
'36330, 구례군,'080,75~79세,2019,1989,746,1243,60,1988,746,1242,60.1
'36330, 구례군,'080001, 75세,2019,344,141,203,69.5,344,141,203,69.5
'36330, 구례군,'080002, 76세,2019,345,128,217,59,344,128,216,59.3
'36330, 구례군,'080003, 77세,2019,514,186,328,56.7,514,186,328,56.7
'36330, 구례군,'080004, 78세,2019,428,170,258,65.9,428,170,258,65.9
'36330, 구례군,'080005, 79세,2019,358,121,237,51.1,358,121,237,51.1
'36330, 구례군,'085,80~84세,2019,1556,567,989,57.3,1556,567,989,57.3
'36330, 구례군,'085001, 80세,2019,391,149,242,61.6,391,149,242,61.6
'36330, 구례군,'085002, 81세,2019,311,124,187,66.3,311,124,187,66.3
'36330, 구례군,'085003, 82세,2019,325,109,216,50.5,325,109,216,50.5
'36330, 구례군,'085004, 83세,2019,276,98,178,55.1,276,98,178,55.1
'36330, 구례군,'085005, 84세,2019,253,87,166,52.4,253,87,166,52.4
'36330, 구례군,'086,85세이상,2019,1108,284,824,34.5,1106,284,822,34.5
'36330, 구례군,'090,85~89세,2019,789,218,571,38.2,788,218,570,38.2
'36330, 구례군,'090001, 85세,2019,216,58,158,36.7,216,58,158,36.7
'36330, 구례군,'090002, 86세,2019,160,40,120,33.3,159,40,119,33.6
'36330, 구례군,'090003, 87세,2019,163,53,110,48.2,163,53,110,48.2
'36330, 구례군,'090004, 88세,2019,103,32,71,45.1,103,32,71,45.1
'36330, 구례군,'090005, 89세,2019,147,35,112,31.3,147,35,112,31.3
'36330, 구례군,'095,90~94세,2019,261,55,206,26.7,260,55,205,26.8
'36330, 구례군,'095001, 90세,2019,83,19,64,29.7,83,19,64,29.7
'36330, 구례군,'095002, 91세,2019,76,17,59,28.8,75,17,58,29.3
'36330, 구례군,'095003, 92세,2019,51,11,40,27.5,51,11,40,27.5
'36330, 구례군,'095004, 93세,2019,26,X,24,8.3,26,X,24,8.3
'36330, 구례군,'095005, 94세,2019,25,6,19,31.6,25,6,19,31.6
'36330, 구례군,'100,95~99세,2019,54,10,44,22.7,54,10,44,22.7
'36330, 구례군,'100001, 95세,2019,17,X,13,30.8,17,X,13,30.8
'36330, 구례군,'100002, 96세,2019,11,X,10,10,11,X,10,10
'36330, 구례군,'100003, 97세,2019,11,X,10,10,11,X,10,10
'36330, 구례군,'100004, 98세,2019,9,X,6,50,9,X,6,50
'36330, 구례군,'100005, 99세,2019,6,X,5,20,6,X,5,20
'36330, 구례군,'101,100세이상,2019,X,X,X,33.3,X,X,X,33.3
'36330, 구례군,'102,15세미만,2019,1940,983,957,102.7,1940,983,957,102.7
'36330, 구례군,'103,15~64세,2019,13609,7226,6383,113.2,13283,7113,6170,115.3
'36330, 구례군,'104,65세이상,2019,8287,3262,5025,64.9,8276,3258,5018,64.9
'36330, 구례군,'126,평균연령,2019,53.7,51.2,56,,53.9,51.3,56.3,
'36330, 구례군,'127,중위연령,2019,57.4,54.6,59.9,,57.7,54.7,60.3,
'36350, 고흥군,'000,합계,2019,60332,29496,30836,95.7,58821,28509,30312,94.1
'36350, 고흥군,'005,0~4세,2019,1200,574,626,91.7,1199,573,626,91.5
'36350, 고흥군,'005001, 0세,2019,245,116,129,89.9,245,116,129,89.9
'36350, 고흥군,'005002, 1세,2019,230,104,126,82.5,230,104,126,82.5
'36350, 고흥군,'005003, 2세,2019,232,113,119,95,231,112,119,94.1
'36350, 고흥군,'005004, 3세,2019,249,120,129,93,249,120,129,93
'36350, 고흥군,'005005, 4세,2019,244,121,123,98.4,244,121,123,98.4
'36350, 고흥군,'010,5~9세,2019,1438,736,702,104.8,1437,735,702,104.7
'36350, 고흥군,'010001, 5세,2019,247,119,128,93,247,119,128,93
'36350, 고흥군,'010002, 6세,2019,276,147,129,114,276,147,129,114
'36350, 고흥군,'010003, 7세,2019,311,156,155,100.6,310,155,155,100
'36350, 고흥군,'010004, 8세,2019,307,162,145,111.7,307,162,145,111.7
'36350, 고흥군,'010005, 9세,2019,297,152,145,104.8,297,152,145,104.8
'36350, 고흥군,'015,10~14세,2019,1621,859,762,112.7,1617,856,761,112.5
'36350, 고흥군,'015001, 10세,2019,296,153,143,107,296,153,143,107
'36350, 고흥군,'015002, 11세,2019,304,159,145,109.7,304,159,145,109.7
'36350, 고흥군,'015003, 12세,2019,341,185,156,118.6,340,184,156,117.9
'36350, 고흥군,'015004, 13세,2019,333,183,150,122,332,182,150,121.3
'36350, 고흥군,'015005, 14세,2019,347,179,168,106.5,345,178,167,106.6
'36350, 고흥군,'020,15~19세,2019,1680,960,720,133.3,1670,957,713,134.2
'36350, 고흥군,'020001, 15세,2019,326,181,145,124.8,326,181,145,124.8
'36350, 고흥군,'020002, 16세,2019,331,193,138,139.9,330,192,138,139.1
'36350, 고흥군,'020003, 17세,2019,383,202,181,111.6,382,202,180,112.2
'36350, 고흥군,'020004, 18세,2019,354,199,155,128.4,352,198,154,128.6
'36350, 고흥군,'020005, 19세,2019,286,185,101,183.2,280,184,96,191.7
'36350, 고흥군,'025,20~24세,2019,1991,1262,729,173.1,1787,1113,674,165.1
'36350, 고흥군,'025001, 20세,2019,391,275,116,237.1,373,263,110,239.1
'36350, 고흥군,'025002, 21세,2019,408,262,146,179.5,385,247,138,179
'36350, 고흥군,'025003, 22세,2019,375,231,144,160.4,344,210,134,156.7
'36350, 고흥군,'025004, 23세,2019,388,240,148,162.2,332,199,133,149.6
'36350, 고흥군,'025005, 24세,2019,429,254,175,145.1,353,194,159,122
'36350, 고흥군,'030,25~29세,2019,2067,1224,843,145.2,1633,892,741,120.4
'36350, 고흥군,'030001, 25세,2019,456,283,173,163.6,368,214,154,139
'36350, 고흥군,'030002, 26세,2019,436,261,175,149.1,336,183,153,119.6
'36350, 고흥군,'030003, 27세,2019,424,254,170,149.4,327,175,152,115.1
'36350, 고흥군,'030004, 28세,2019,367,215,152,141.4,280,154,126,122.2
'36350, 고흥군,'030005, 29세,2019,384,211,173,122,322,166,156,106.4
'36350, 고흥군,'035,30~34세,2019,1769,988,781,126.5,1483,797,686,116.2
'36350, 고흥군,'035001, 30세,2019,312,179,133,134.6,253,137,116,118.1
'36350, 고흥군,'035002, 31세,2019,392,230,162,142,324,183,141,129.8
'36350, 고흥군,'035003, 32세,2019,361,180,181,99.4,302,144,158,91.1
'36350, 고흥군,'035004, 33세,2019,353,201,152,132.2,302,166,136,122.1
'36350, 고흥군,'035005, 34세,2019,351,198,153,129.4,302,167,135,123.7
'36350, 고흥군,'040,35~39세,2019,2199,1184,1015,116.7,2053,1105,948,116.6
'36350, 고흥군,'040001, 35세,2019,399,207,192,107.8,364,187,177,105.6
'36350, 고흥군,'040002, 36세,2019,373,192,181,106.1,344,176,168,104.8
'36350, 고흥군,'040003, 37세,2019,480,278,202,137.6,451,262,189,138.6
'36350, 고흥군,'040004, 38세,2019,454,256,198,129.3,431,244,187,130.5
'36350, 고흥군,'040005, 39세,2019,493,251,242,103.7,463,236,227,104
'36350, 고흥군,'045,40~44세,2019,2595,1478,1117,132.3,2487,1414,1073,131.8
'36350, 고흥군,'045001, 40세,2019,502,278,224,124.1,481,265,216,122.7
'36350, 고흥군,'045002, 41세,2019,471,274,197,139.1,448,260,188,138.3
'36350, 고흥군,'045003, 42세,2019,521,283,238,118.9,504,275,229,120.1
'36350, 고흥군,'045004, 43세,2019,565,340,225,151.1,546,326,220,148.2
'36350, 고흥군,'045005, 44세,2019,536,303,233,130,508,288,220,130.9
'36350, 고흥군,'050,45~49세,2019,3651,2148,1503,142.9,3561,2102,1459,144.1
'36350, 고흥군,'050001, 45세,2019,698,396,302,131.1,678,385,293,131.4
'36350, 고흥군,'050002, 46세,2019,673,415,258,160.9,652,402,250,160.8
'36350, 고흥군,'050003, 47세,2019,702,417,285,146.3,684,409,275,148.7
'36350, 고흥군,'050004, 48세,2019,765,461,304,151.6,746,455,291,156.4
'36350, 고흥군,'050005, 49세,2019,813,459,354,129.7,801,451,350,128.9
'36350, 고흥군,'055,50~54세,2019,4329,2429,1900,127.8,4246,2391,1855,128.9
'36350, 고흥군,'055001, 50세,2019,811,482,329,146.5,794,478,316,151.3
'36350, 고흥군,'055002, 51세,2019,921,529,392,134.9,903,518,385,134.5
'36350, 고흥군,'055003, 52세,2019,813,456,357,127.7,792,444,348,127.6
'36350, 고흥군,'055004, 53세,2019,876,484,392,123.5,862,478,384,124.5
'36350, 고흥군,'055005, 54세,2019,908,478,430,111.2,895,473,422,112.1
'36350, 고흥군,'060,55~59세,2019,5585,2909,2676,108.7,5514,2871,2643,108.6
'36350, 고흥군,'060001, 55세,2019,909,479,430,111.4,890,470,420,111.9
'36350, 고흥군,'060002, 56세,2019,1062,587,475,123.6,1046,579,467,124
'36350, 고흥군,'060003, 57세,2019,1058,564,494,114.2,1041,554,487,113.8
'36350, 고흥군,'060004, 58세,2019,1224,616,608,101.3,1213,609,604,100.8
'36350, 고흥군,'060005, 59세,2019,1332,663,669,99.1,1324,659,665,99.1
'36350, 고흥군,'065,60~64세,2019,6051,3017,3034,99.4,6007,2992,3015,99.2
'36350, 고흥군,'065001, 60세,2019,1311,666,645,103.3,1302,662,640,103.4
'36350, 고흥군,'065002, 61세,2019,1204,601,603,99.7,1198,598,600,99.7
'36350, 고흥군,'065003, 62세,2019,1178,584,594,98.3,1172,579,593,97.6
'36350, 고흥군,'065004, 63세,2019,1064,523,541,96.7,1052,517,535,96.6
'36350, 고흥군,'065005, 64세,2019,1294,643,651,98.8,1283,636,647,98.3
'36350, 고흥군,'070,65~69세,2019,5542,2649,2893,91.6,5523,2638,2885,91.4
'36350, 고흥군,'070001, 65세,2019,1099,518,581,89.2,1092,513,579,88.6
'36350, 고흥군,'070002, 66세,2019,989,476,513,92.8,987,475,512,92.8
'36350, 고흥군,'070003, 67세,2019,1148,560,588,95.2,1144,558,586,95.2
'36350, 고흥군,'070004, 68세,2019,1138,549,589,93.2,1136,549,587,93.5
'36350, 고흥군,'070005, 69세,2019,1168,546,622,87.8,1164,543,621,87.4
'36350, 고흥군,'075,70~74세,2019,5321,2415,2906,83.1,5317,2411,2906,83
'36350, 고흥군,'075001, 70세,2019,1139,544,595,91.4,1138,543,595,91.3
'36350, 고흥군,'075002, 71세,2019,1104,538,566,95.1,1104,538,566,95.1
'36350, 고흥군,'075003, 72세,2019,1289,587,702,83.6,1288,586,702,83.5
'36350, 고흥군,'075004, 73세,2019,837,364,473,77,836,363,473,76.7
'36350, 고흥군,'075005, 74세,2019,952,382,570,67,951,381,570,66.8
'36350, 고흥군,'080,75~79세,2019,5608,2307,3301,69.9,5605,2306,3299,69.9
'36350, 고흥군,'080001, 75세,2019,914,394,520,75.8,914,394,520,75.8
'36350, 고흥군,'080002, 76세,2019,1053,435,618,70.4,1053,435,618,70.4
'36350, 고흥군,'080003, 77세,2019,1371,600,771,77.8,1368,599,769,77.9
'36350, 고흥군,'080004, 78세,2019,1169,467,702,66.5,1169,467,702,66.5
'36350, 고흥군,'080005, 79세,2019,1101,411,690,59.6,1101,411,690,59.6
'36350, 고흥군,'085,80~84세,2019,4329,1494,2835,52.7,4326,1493,2833,52.7
'36350, 고흥군,'085001, 80세,2019,1052,364,688,52.9,1052,364,688,52.9
'36350, 고흥군,'085002, 81세,2019,871,298,573,52,871,298,573,52
'36350, 고흥군,'085003, 82세,2019,934,320,614,52.1,932,320,612,52.3
'36350, 고흥군,'085004, 83세,2019,784,270,514,52.5,783,269,514,52.3
'36350, 고흥군,'085005, 84세,2019,688,242,446,54.3,688,242,446,54.3
'36350, 고흥군,'086,85세이상,2019,3356,863,2493,34.6,3356,863,2493,34.6
'36350, 고흥군,'090,85~89세,2019,2399,663,1736,38.2,2399,663,1736,38.2
'36350, 고흥군,'090001, 85세,2019,626,181,445,40.7,626,181,445,40.7
'36350, 고흥군,'090002, 86세,2019,581,172,409,42.1,581,172,409,42.1
'36350, 고흥군,'090003, 87세,2019,490,128,362,35.4,490,128,362,35.4
'36350, 고흥군,'090004, 88세,2019,342,88,254,34.6,342,88,254,34.6
'36350, 고흥군,'090005, 89세,2019,360,94,266,35.3,360,94,266,35.3
'36350, 고흥군,'095,90~94세,2019,739,171,568,30.1,739,171,568,30.1
'36350, 고흥군,'095001, 90세,2019,296,85,211,40.3,296,85,211,40.3
'36350, 고흥군,'095002, 91세,2019,169,41,128,32,169,41,128,32
'36350, 고흥군,'095003, 92세,2019,119,18,101,17.8,119,18,101,17.8
'36350, 고흥군,'095004, 93세,2019,84,15,69,21.7,84,15,69,21.7
'36350, 고흥군,'095005, 94세,2019,71,12,59,20.3,71,12,59,20.3
'36350, 고흥군,'100,95~99세,2019,193,25,168,14.9,193,25,168,14.9
'36350, 고흥군,'100001, 95세,2019,50,9,41,22,50,9,41,22
'36350, 고흥군,'100002, 96세,2019,66,6,60,10,66,6,60,10
'36350, 고흥군,'100003, 97세,2019,43,8,35,22.9,43,8,35,22.9
'36350, 고흥군,'100004, 98세,2019,20,X,19,5.3,20,X,19,5.3
'36350, 고흥군,'100005, 99세,2019,14,X,13,7.7,14,X,13,7.7
'36350, 고흥군,'101,100세이상,2019,25,X,21,19,25,X,21,19
'36350, 고흥군,'102,15세미만,2019,4259,2169,2090,103.8,4253,2164,2089,103.6
'36350, 고흥군,'103,15~64세,2019,31917,17599,14318,122.9,30441,16634,13807,120.5
'36350, 고흥군,'104,65세이상,2019,24156,9728,14428,67.4,24127,9711,14416,67.4
'36350, 고흥군,'126,평균연령,2019,55.8,52.7,58.8,,56.3,53.3,59.1,
'36350, 고흥군,'127,중위연령,2019,60,56.7,63.4,,60.6,57.5,63.8,
'36360, 보성군,'000,합계,2019,38339,18442,19897,92.7,37654,18157,19497,93.1
'36360, 보성군,'005,0~4세,2019,897,449,448,100.2,895,449,446,100.7
'36360, 보성군,'005001, 0세,2019,156,75,81,92.6,156,75,81,92.6
'36360, 보성군,'005002, 1세,2019,165,83,82,101.2,165,83,82,101.2
'36360, 보성군,'005003, 2세,2019,194,102,92,110.9,194,102,92,110.9
'36360, 보성군,'005004, 3세,2019,191,86,105,81.9,190,86,104,82.7
'36360, 보성군,'005005, 4세,2019,191,103,88,117,190,103,87,118.4
'36360, 보성군,'010,5~9세,2019,1016,527,489,107.8,1013,526,487,108
'36360, 보성군,'010001, 5세,2019,185,98,87,112.6,184,98,86,114
'36360, 보성군,'010002, 6세,2019,195,101,94,107.4,195,101,94,107.4
'36360, 보성군,'010003, 7세,2019,190,105,85,123.5,188,104,84,123.8
'36360, 보성군,'010004, 8세,2019,240,125,115,108.7,240,125,115,108.7
'36360, 보성군,'010005, 9세,2019,206,98,108,90.7,206,98,108,90.7
'36360, 보성군,'015,10~14세,2019,1087,545,542,100.6,1086,545,541,100.7
'36360, 보성군,'015001, 10세,2019,194,91,103,88.3,194,91,103,88.3
'36360, 보성군,'015002, 11세,2019,195,88,107,82.2,195,88,107,82.2
'36360, 보성군,'015003, 12세,2019,250,128,122,104.9,250,128,122,104.9
'36360, 보성군,'015004, 13세,2019,217,113,104,108.7,216,113,103,109.7
'36360, 보성군,'015005, 14세,2019,231,125,106,117.9,231,125,106,117.9
'36360, 보성군,'020,15~19세,2019,1594,850,744,114.2,1583,849,734,115.7
'36360, 보성군,'020001, 15세,2019,280,145,135,107.4,280,145,135,107.4
'36360, 보성군,'020002, 16세,2019,338,180,158,113.9,338,180,158,113.9
'36360, 보성군,'020003, 17세,2019,372,194,178,109,369,194,175,110.9
'36360, 보성군,'020004, 18세,2019,387,188,199,94.5,383,188,195,96.4
'36360, 보성군,'020005, 19세,2019,217,143,74,193.2,213,142,71,200
'36360, 보성군,'025,20~24세,2019,1387,827,560,147.7,1291,782,509,153.6
'36360, 보성군,'025001, 20세,2019,254,174,80,217.5,245,174,71,245.1
'36360, 보성군,'025002, 21세,2019,279,179,100,179,269,175,94,186.2
'36360, 보성군,'025003, 22세,2019,289,153,136,112.5,270,144,126,114.3
'36360, 보성군,'025004, 23세,2019,307,173,134,129.1,284,160,124,129
'36360, 보성군,'025005, 24세,2019,258,148,110,134.5,223,129,94,137.2
'36360, 보성군,'030,25~29세,2019,1316,720,596,120.8,1146,644,502,128.3
'36360, 보성군,'030001, 25세,2019,296,169,127,133.1,259,153,106,144.3
'36360, 보성군,'030002, 26세,2019,242,131,111,118,209,114,95,120
'36360, 보성군,'030003, 27세,2019,283,160,123,130.1,243,144,99,145.5
'36360, 보성군,'030004, 28세,2019,243,120,123,97.6,215,109,106,102.8
'36360, 보성군,'030005, 29세,2019,252,140,112,125,220,124,96,129.2
'36360, 보성군,'035,30~34세,2019,1203,608,595,102.2,1078,554,524,105.7
'36360, 보성군,'035001, 30세,2019,212,120,92,130.4,180,106,74,143.2
'36360, 보성군,'035002, 31세,2019,223,113,110,102.7,206,107,99,108.1
'36360, 보성군,'035003, 32세,2019,273,133,140,95,240,117,123,95.1
'36360, 보성군,'035004, 33세,2019,277,138,139,99.3,249,126,123,102.4
'36360, 보성군,'035005, 34세,2019,218,104,114,91.2,203,98,105,93.3
'36360, 보성군,'040,35~39세,2019,1463,761,702,108.4,1377,732,645,113.5
'36360, 보성군,'040001, 35세,2019,236,118,118,100,219,114,105,108.6
'36360, 보성군,'040002, 36세,2019,275,139,136,102.2,255,130,125,104
'36360, 보성군,'040003, 37세,2019,339,169,170,99.4,320,164,156,105.1
'36360, 보성군,'040004, 38세,2019,295,164,131,125.2,276,157,119,131.9
'36360, 보성군,'040005, 39세,2019,318,171,147,116.3,307,167,140,119.3
'36360, 보성군,'045,40~44세,2019,1663,897,766,117.1,1619,881,738,119.4
'36360, 보성군,'045001, 40세,2019,310,168,142,118.3,305,165,140,117.9
'36360, 보성군,'045002, 41세,2019,329,180,149,120.8,317,177,140,126.4
'36360, 보성군,'045003, 42세,2019,380,194,186,104.3,367,189,178,106.2
'36360, 보성군,'045004, 43세,2019,357,194,163,119,348,192,156,123.1
'36360, 보성군,'045005, 44세,2019,287,161,126,127.8,282,158,124,127.4
'36360, 보성군,'050,45~49세,2019,2374,1354,1020,132.7,2330,1337,993,134.6
'36360, 보성군,'050001, 45세,2019,436,247,189,130.7,425,245,180,136.1
'36360, 보성군,'050002, 46세,2019,440,270,170,158.8,435,268,167,160.5
'36360, 보성군,'050003, 47세,2019,455,250,205,122,444,245,199,123.1
'36360, 보성군,'050004, 48세,2019,522,291,231,126,513,288,225,128
'36360, 보성군,'050005, 49세,2019,521,296,225,131.6,513,291,222,131.1
'36360, 보성군,'055,50~54세,2019,2817,1582,1235,128.1,2766,1554,1212,128.2
'36360, 보성군,'055001, 50세,2019,517,296,221,133.9,505,287,218,131.7
'36360, 보성군,'055002, 51세,2019,619,348,271,128.4,608,342,266,128.6
'36360, 보성군,'055003, 52세,2019,547,299,248,120.6,534,294,240,122.5
'36360, 보성군,'055004, 53세,2019,560,336,224,150,551,330,221,149.3
'36360, 보성군,'055005, 54세,2019,574,303,271,111.8,568,301,267,112.7
'36360, 보성군,'060,55~59세,2019,3419,1779,1640,108.5,3389,1768,1621,109.1
'36360, 보성군,'060001, 55세,2019,603,332,271,122.5,593,328,265,123.8
'36360, 보성군,'060002, 56세,2019,641,316,325,97.2,632,313,319,98.1
'36360, 보성군,'060003, 57세,2019,700,368,332,110.8,697,367,330,111.2
'36360, 보성군,'060004, 58세,2019,694,359,335,107.2,691,358,333,107.5
'36360, 보성군,'060005, 59세,2019,781,404,377,107.2,776,402,374,107.5
'36360, 보성군,'065,60~64세,2019,3672,1860,1812,102.6,3658,1853,1805,102.7
'36360, 보성군,'065001, 60세,2019,820,422,398,106,817,420,397,105.8
'36360, 보성군,'065002, 61세,2019,706,347,359,96.7,705,346,359,96.4
'36360, 보성군,'065003, 62세,2019,749,382,367,104.1,745,380,365,104.1
'36360, 보성군,'065004, 63세,2019,671,344,327,105.2,668,343,325,105.5
'36360, 보성군,'065005, 64세,2019,726,365,361,101.1,723,364,359,101.4
'36360, 보성군,'070,65~69세,2019,3159,1482,1677,88.4,3156,1482,1674,88.5
'36360, 보성군,'070001, 65세,2019,621,296,325,91.1,621,296,325,91.1
'36360, 보성군,'070002, 66세,2019,566,258,308,83.8,564,258,306,84.3
'36360, 보성군,'070003, 67세,2019,691,327,364,89.8,691,327,364,89.8
'36360, 보성군,'070004, 68세,2019,639,307,332,92.5,639,307,332,92.5
'36360, 보성군,'070005, 69세,2019,642,294,348,84.5,641,294,347,84.7
'36360, 보성군,'075,70~74세,2019,3052,1409,1643,85.8,3049,1409,1640,85.9
'36360, 보성군,'075001, 70세,2019,661,309,352,87.8,661,309,352,87.8
'36360, 보성군,'075002, 71세,2019,656,319,337,94.7,655,319,336,94.9
'36360, 보성군,'075003, 72세,2019,703,321,382,84,702,321,381,84.3
'36360, 보성군,'075004, 73세,2019,499,238,261,91.2,498,238,260,91.5
'36360, 보성군,'075005, 74세,2019,533,222,311,71.4,533,222,311,71.4
'36360, 보성군,'080,75~79세,2019,3322,1307,2015,64.9,3322,1307,2015,64.9
'36360, 보성군,'080001, 75세,2019,492,209,283,73.9,492,209,283,73.9
'36360, 보성군,'080002, 76세,2019,668,253,415,61,668,253,415,61
'36360, 보성군,'080003, 77세,2019,823,335,488,68.6,823,335,488,68.6
'36360, 보성군,'080004, 78세,2019,700,269,431,62.4,700,269,431,62.4
'36360, 보성군,'080005, 79세,2019,639,241,398,60.6,639,241,398,60.6
'36360, 보성군,'085,80~84세,2019,2740,941,1799,52.3,2739,941,1798,52.3
'36360, 보성군,'085001, 80세,2019,654,252,402,62.7,654,252,402,62.7
'36360, 보성군,'085002, 81세,2019,613,210,403,52.1,612,210,402,52.2
'36360, 보성군,'085003, 82세,2019,571,194,377,51.5,571,194,377,51.5
'36360, 보성군,'085004, 83세,2019,459,156,303,51.5,459,156,303,51.5
'36360, 보성군,'085005, 84세,2019,443,129,314,41.1,443,129,314,41.1
'36360, 보성군,'086,85세이상,2019,2158,544,1614,33.7,2157,544,1613,33.7
'36360, 보성군,'090,85~89세,2019,1539,400,1139,35.1,1539,400,1139,35.1
'36360, 보성군,'090001, 85세,2019,414,108,306,35.3,414,108,306,35.3
'36360, 보성군,'090002, 86세,2019,315,103,212,48.6,315,103,212,48.6
'36360, 보성군,'090003, 87세,2019,330,79,251,31.5,330,79,251,31.5
'36360, 보성군,'090004, 88세,2019,244,59,185,31.9,244,59,185,31.9
'36360, 보성군,'090005, 89세,2019,236,51,185,27.6,236,51,185,27.6
'36360, 보성군,'095,90~94세,2019,482,114,368,31,481,114,367,31.1
'36360, 보성군,'095001, 90세,2019,143,33,110,30,143,33,110,30
'36360, 보성군,'095002, 91세,2019,135,34,101,33.7,135,34,101,33.7
'36360, 보성군,'095003, 92세,2019,102,26,76,34.2,101,26,75,34.7
'36360, 보성군,'095004, 93세,2019,61,14,47,29.8,61,14,47,29.8
'36360, 보성군,'095005, 94세,2019,41,7,34,20.6,41,7,34,20.6
'36360, 보성군,'100,95~99세,2019,111,25,86,29.1,111,25,86,29.1
'36360, 보성군,'100001, 95세,2019,32,10,22,45.5,32,10,22,45.5
'36360, 보성군,'100002, 96세,2019,36,6,30,20,36,6,30,20
'36360, 보성군,'100003, 97세,2019,27,5,22,22.7,27,5,22,22.7
'36360, 보성군,'100004, 98세,2019,8,X,5,60,8,X,5,60
'36360, 보성군,'100005, 99세,2019,8,X,7,14.3,8,X,7,14.3
'36360, 보성군,'101,100세이상,2019,26,5,21,23.8,26,5,21,23.8
'36360, 보성군,'102,15세미만,2019,3000,1521,1479,102.8,2994,1520,1474,103.1
'36360, 보성군,'103,15~64세,2019,20908,11238,9670,116.2,20237,10954,9283,118
'36360, 보성군,'104,65세이상,2019,14431,5683,8748,65,14423,5683,8740,65
'36360, 보성군,'126,평균연령,2019,54.3,51.3,57,,54.6,51.6,57.4,
'36360, 보성군,'127,중위연령,2019,58.6,55.3,61.6,,59,55.7,62.1,
'36370, 화순군,'000,합계,2019,59671,28900,30771,93.9,58369,28290,30079,94.1
'36370, 화순군,'005,0~4세,2019,1474,741,733,101.1,1464,735,729,100.8
'36370, 화순군,'005001, 0세,2019,259,139,120,115.8,258,138,120,115
'36370, 화순군,'005002, 1세,2019,259,122,137,89.1,257,122,135,90.4
'36370, 화순군,'005003, 2세,2019,306,160,146,109.6,303,157,146,107.5
'36370, 화순군,'005004, 3세,2019,298,148,150,98.7,296,148,148,100
'36370, 화순군,'005005, 4세,2019,352,172,180,95.6,350,170,180,94.4
'36370, 화순군,'010,5~9세,2019,2117,1083,1034,104.7,2114,1082,1032,104.8
'36370, 화순군,'010001, 5세,2019,366,177,189,93.7,366,177,189,93.7
'36370, 화순군,'010002, 6세,2019,397,215,182,118.1,396,214,182,117.6
'36370, 화순군,'010003, 7세,2019,451,230,221,104.1,451,230,221,104.1
'36370, 화순군,'010004, 8세,2019,464,234,230,101.7,462,234,228,102.6
'36370, 화순군,'010005, 9세,2019,439,227,212,107.1,439,227,212,107.1
'36370, 화순군,'015,10~14세,2019,2468,1306,1162,112.4,2464,1304,1160,112.4
'36370, 화순군,'015001, 10세,2019,465,241,224,107.6,464,241,223,108.1
'36370, 화순군,'015002, 11세,2019,473,252,221,114,472,251,221,113.6
'36370, 화순군,'015003, 12세,2019,546,285,261,109.2,545,285,260,109.6
'36370, 화순군,'015004, 13세,2019,493,264,229,115.3,492,263,229,114.8
'36370, 화순군,'015005, 14세,2019,491,264,227,116.3,491,264,227,116.3
'36370, 화순군,'020,15~19세,2019,3438,1779,1659,107.2,3433,1776,1657,107.2
'36370, 화순군,'020001, 15세,2019,600,330,270,122.2,599,330,269,122.7
'36370, 화순군,'020002, 16세,2019,608,331,277,119.5,608,331,277,119.5
'36370, 화순군,'020003, 17세,2019,671,322,349,92.3,669,320,349,91.7
'36370, 화순군,'020004, 18세,2019,776,372,404,92.1,776,372,404,92.1
'36370, 화순군,'020005, 19세,2019,783,424,359,118.1,781,423,358,118.2
'36370, 화순군,'025,20~24세,2019,3218,1756,1462,120.1,3041,1654,1387,119.3
'36370, 화순군,'025001, 20세,2019,714,396,318,124.5,700,385,315,122.2
'36370, 화순군,'025002, 21세,2019,582,361,221,163.3,568,353,215,164.2
'36370, 화순군,'025003, 22세,2019,644,366,278,131.7,608,346,262,132.1
'36370, 화순군,'025004, 23세,2019,643,325,318,102.2,596,296,300,98.7
'36370, 화순군,'025005, 24세,2019,635,308,327,94.2,569,274,295,92.9
'36370, 화순군,'030,25~29세,2019,2853,1500,1353,110.9,2545,1344,1201,111.9
'36370, 화순군,'030001, 25세,2019,628,332,296,112.2,572,303,269,112.6
'36370, 화순군,'030002, 26세,2019,656,333,323,103.1,578,298,280,106.4
'36370, 화순군,'030003, 27세,2019,556,301,255,118,502,274,228,120.2
'36370, 화순군,'030004, 28세,2019,504,256,248,103.2,452,228,224,101.8
'36370, 화순군,'030005, 29세,2019,509,278,231,120.3,441,241,200,120.5
'36370, 화순군,'035,30~34세,2019,2122,1086,1036,104.8,1885,975,910,107.1
'36370, 화순군,'035001, 30세,2019,434,243,191,127.2,388,218,170,128.2
'36370, 화순군,'035002, 31세,2019,446,231,215,107.4,394,204,190,107.4
'36370, 화순군,'035003, 32세,2019,390,181,209,86.6,343,160,183,87.4
'36370, 화순군,'035004, 33세,2019,412,201,211,95.3,360,180,180,100
'36370, 화순군,'035005, 34세,2019,440,230,210,109.5,400,213,187,113.9
'36370, 화순군,'040,35~39세,2019,2806,1395,1411,98.9,2657,1332,1325,100.5
'36370, 화순군,'040001, 35세,2019,474,243,231,105.2,449,232,217,106.9
'36370, 화순군,'040002, 36세,2019,509,259,250,103.6,480,245,235,104.3
'36370, 화순군,'040003, 37세,2019,589,281,308,91.2,557,270,287,94.1
'36370, 화순군,'040004, 38세,2019,576,284,292,97.3,546,272,274,99.3
'36370, 화순군,'040005, 39세,2019,658,328,330,99.4,625,313,312,100.3
'36370, 화순군,'045,40~44세,2019,3403,1706,1697,100.5,3302,1662,1640,101.3
'36370, 화순군,'045001, 40세,2019,659,315,344,91.6,638,305,333,91.6
'36370, 화순군,'045002, 41세,2019,643,316,327,96.6,624,307,317,96.8
'36370, 화순군,'045003, 42세,2019,685,352,333,105.7,667,347,320,108.4
'36370, 화순군,'045004, 43세,2019,666,336,330,101.8,643,326,317,102.8
'36370, 화순군,'045005, 44세,2019,750,387,363,106.6,730,377,353,106.8
'36370, 화순군,'050,45~49세,2019,4854,2521,2333,108.1,4766,2477,2289,108.2
'36370, 화순군,'050001, 45세,2019,925,491,434,113.1,897,474,423,112.1
'36370, 화순군,'050002, 46세,2019,885,413,472,87.5,870,403,467,86.3
'36370, 화순군,'050003, 47세,2019,928,480,448,107.1,911,473,438,108
'36370, 화순군,'050004, 48세,2019,1031,567,464,122.2,1016,559,457,122.3
'36370, 화순군,'050005, 49세,2019,1085,570,515,110.7,1072,568,504,112.7
'36370, 화순군,'055,50~54세,2019,5131,2730,2401,113.7,5052,2707,2345,115.4
'36370, 화순군,'055001, 50세,2019,1017,532,485,109.7,1001,526,475,110.7
'36370, 화순군,'055002, 51세,2019,1062,567,495,114.5,1041,562,479,117.3
'36370, 화순군,'055003, 52세,2019,1009,524,485,108,993,520,473,109.9
'36370, 화순군,'055004, 53세,2019,1054,574,480,119.6,1041,569,472,120.6
'36370, 화순군,'055005, 54세,2019,989,533,456,116.9,976,530,446,118.8
'36370, 화순군,'060,55~59세,2019,5369,2809,2560,109.7,5300,2787,2513,110.9
'36370, 화순군,'060001, 55세,2019,997,528,469,112.6,977,527,450,117.1
'36370, 화순군,'060002, 56세,2019,1075,575,500,115,1059,568,491,115.7
'36370, 화순군,'060003, 57세,2019,999,514,485,106,989,510,479,106.5
'36370, 화순군,'060004, 58세,2019,1149,611,538,113.6,1138,607,531,114.3
'36370, 화순군,'060005, 59세,2019,1149,581,568,102.3,1137,575,562,102.3
'36370, 화순군,'065,60~64세,2019,4711,2412,2299,104.9,4668,2395,2273,105.4
'36370, 화순군,'065001, 60세,2019,1067,556,511,108.8,1059,553,506,109.3
'36370, 화순군,'065002, 61세,2019,993,508,485,104.7,977,501,476,105.3
'36370, 화순군,'065003, 62세,2019,991,497,494,100.6,983,495,488,101.4
'36370, 화순군,'065004, 63세,2019,781,411,370,111.1,778,411,367,112
'36370, 화순군,'065005, 64세,2019,879,440,439,100.2,871,435,436,99.8
'36370, 화순군,'070,65~69세,2019,3567,1702,1865,91.3,3553,1696,1857,91.3
'36370, 화순군,'070001, 65세,2019,738,360,378,95.2,735,360,375,96
'36370, 화순군,'070002, 66세,2019,704,350,354,98.9,703,349,354,98.6
'36370, 화순군,'070003, 67세,2019,789,363,426,85.2,784,361,423,85.3
'36370, 화순군,'070004, 68세,2019,647,300,347,86.5,645,299,346,86.4
'36370, 화순군,'070005, 69세,2019,689,329,360,91.4,686,327,359,91.1
'36370, 화순군,'075,70~74세,2019,3493,1512,1981,76.3,3485,1506,1979,76.1
'36370, 화순군,'075001, 70세,2019,750,357,393,90.8,747,356,391,91
'36370, 화순군,'075002, 71세,2019,746,329,417,78.9,744,327,417,78.4
'36370, 화순군,'075003, 72세,2019,775,342,433,79,775,342,433,79
'36370, 화순군,'075004, 73세,2019,568,239,329,72.6,568,239,329,72.6
'36370, 화순군,'075005, 74세,2019,654,245,409,59.9,651,242,409,59.2
'36370, 화순군,'080,75~79세,2019,3792,1408,2384,59.1,3787,1406,2381,59.1
'36370, 화순군,'080001, 75세,2019,603,235,368,63.9,603,235,368,63.9
'36370, 화순군,'080002, 76세,2019,723,279,444,62.8,722,279,443,63
'36370, 화순군,'080003, 77세,2019,989,374,615,60.8,988,373,615,60.7
'36370, 화순군,'080004, 78세,2019,777,277,500,55.4,775,277,498,55.6
'36370, 화순군,'080005, 79세,2019,700,243,457,53.2,699,242,457,53
'36370, 화순군,'085,80~84세,2019,2878,943,1935,48.7,2877,942,1935,48.7
'36370, 화순군,'085001, 80세,2019,680,237,443,53.5,680,237,443,53.5
'36370, 화순군,'085002, 81세,2019,638,211,427,49.4,637,210,427,49.2
'36370, 화순군,'085003, 82세,2019,573,201,372,54,573,201,372,54
'36370, 화순군,'085004, 83세,2019,526,161,365,44.1,526,161,365,44.1
'36370, 화순군,'085005, 84세,2019,461,133,328,40.5,461,133,328,40.5
'36370, 화순군,'086,85세이상,2019,1977,511,1466,34.9,1976,510,1466,34.8
'36370, 화순군,'090,85~89세,2019,1428,379,1049,36.1,1427,378,1049,36
'36370, 화순군,'090001, 85세,2019,398,112,286,39.2,397,111,286,38.8
'36370, 화순군,'090002, 86세,2019,315,88,227,38.8,315,88,227,38.8
'36370, 화순군,'090003, 87세,2019,269,70,199,35.2,269,70,199,35.2
'36370, 화순군,'090004, 88세,2019,213,60,153,39.2,213,60,153,39.2
'36370, 화순군,'090005, 89세,2019,233,49,184,26.6,233,49,184,26.6
'36370, 화순군,'095,90~94세,2019,425,111,314,35.4,425,111,314,35.4
'36370, 화순군,'095001, 90세,2019,133,38,95,40,133,38,95,40
'36370, 화순군,'095002, 91세,2019,111,32,79,40.5,111,32,79,40.5
'36370, 화순군,'095003, 92세,2019,77,16,61,26.2,77,16,61,26.2
'36370, 화순군,'095004, 93세,2019,67,17,50,34,67,17,50,34
'36370, 화순군,'095005, 94세,2019,37,8,29,27.6,37,8,29,27.6
'36370, 화순군,'100,95~99세,2019,107,21,86,24.4,107,21,86,24.4
'36370, 화순군,'100001, 95세,2019,34,9,25,36,34,9,25,36
'36370, 화순군,'100002, 96세,2019,41,7,34,20.6,41,7,34,20.6
'36370, 화순군,'100003, 97세,2019,14,X,12,16.7,14,X,12,16.7
'36370, 화순군,'100004, 98세,2019,12,X,9,33.3,12,X,9,33.3
'36370, 화순군,'100005, 99세,2019,6,X,6,0,6,X,6,0
'36370, 화순군,'101,100세이상,2019,17,X,17,0,17,X,17,0
'36370, 화순군,'102,15세미만,2019,6059,3130,2929,106.9,6042,3121,2921,106.8
'36370, 화순군,'103,15~64세,2019,37905,19694,18211,108.1,36649,19109,17540,108.9
'36370, 화순군,'104,65세이상,2019,15707,6076,9631,63.1,15678,6060,9618,63
'36370, 화순군,'126,평균연령,2019,48.3,46,50.5,,48.6,46.3,50.8,
'36370, 화순군,'127,중위연령,2019,51.1,49.3,53.1,,51.5,49.7,53.6,
'36380, 장흥군,'000,합계,2019,35494,17250,18244,94.6,34665,16827,17838,94.3
'36380, 장흥군,'005,0~4세,2019,930,494,436,113.3,929,494,435,113.6
'36380, 장흥군,'005001, 0세,2019,210,106,104,101.9,210,106,104,101.9
'36380, 장흥군,'005002, 1세,2019,163,91,72,126.4,163,91,72,126.4
'36380, 장흥군,'005003, 2세,2019,154,91,63,144.4,153,91,62,146.8
'36380, 장흥군,'005004, 3세,2019,190,100,90,111.1,190,100,90,111.1
'36380, 장흥군,'005005, 4세,2019,213,106,107,99.1,213,106,107,99.1
'36380, 장흥군,'010,5~9세,2019,1120,566,554,102.2,1119,566,553,102.4
'36380, 장흥군,'010001, 5세,2019,206,94,112,83.9,206,94,112,83.9
'36380, 장흥군,'010002, 6세,2019,246,119,127,93.7,245,119,126,94.4
'36380, 장흥군,'010003, 7세,2019,225,121,104,116.3,225,121,104,116.3
'36380, 장흥군,'010004, 8세,2019,236,127,109,116.5,236,127,109,116.5
'36380, 장흥군,'010005, 9세,2019,207,105,102,102.9,207,105,102,102.9
'36380, 장흥군,'015,10~14세,2019,1122,593,529,112.1,1118,589,529,111.3
'36380, 장흥군,'015001, 10세,2019,213,97,116,83.6,213,97,116,83.6
'36380, 장흥군,'015002, 11세,2019,224,106,118,89.8,224,106,118,89.8
'36380, 장흥군,'015003, 12세,2019,237,130,107,121.5,236,129,107,120.6
'36380, 장흥군,'015004, 13세,2019,227,134,93,144.1,227,134,93,144.1
'36380, 장흥군,'015005, 14세,2019,221,126,95,132.6,218,123,95,129.5
'36380, 장흥군,'020,15~19세,2019,1304,707,597,118.4,1289,703,586,120
'36380, 장흥군,'020001, 15세,2019,272,156,116,134.5,271,155,116,133.6
'36380, 장흥군,'020002, 16세,2019,266,143,123,116.3,264,143,121,118.2
'36380, 장흥군,'020003, 17세,2019,269,138,131,105.3,267,137,130,105.4
'36380, 장흥군,'020004, 18세,2019,294,156,138,113,290,155,135,114.8
'36380, 장흥군,'020005, 19세,2019,203,114,89,128.1,197,113,84,134.5
'36380, 장흥군,'025,20~24세,2019,1429,844,585,144.3,1340,794,546,145.4
'36380, 장흥군,'025001, 20세,2019,282,181,101,179.2,278,179,99,180.8
'36380, 장흥군,'025002, 21세,2019,312,188,124,151.6,294,181,113,160.2
'36380, 장흥군,'025003, 22세,2019,271,158,113,139.8,255,146,109,133.9
'36380, 장흥군,'025004, 23세,2019,280,164,116,141.4,252,145,107,135.5
'36380, 장흥군,'025005, 24세,2019,284,153,131,116.8,261,143,118,121.2
'36380, 장흥군,'030,25~29세,2019,1403,759,644,117.9,1227,648,579,111.9
'36380, 장흥군,'030001, 25세,2019,301,169,132,128,264,148,116,127.6
'36380, 장흥군,'030002, 26세,2019,293,162,131,123.7,259,139,120,115.8
'36380, 장흥군,'030003, 27세,2019,286,157,129,121.7,246,128,118,108.5
'36380, 장흥군,'030004, 28세,2019,265,150,115,130.4,232,128,104,123.1
'36380, 장흥군,'030005, 29세,2019,258,121,137,88.3,226,105,121,86.8
'36380, 장흥군,'035,30~34세,2019,1310,671,639,105,1165,591,574,103
'36380, 장흥군,'035001, 30세,2019,267,141,126,111.9,236,126,110,114.5
'36380, 장흥군,'035002, 31세,2019,266,135,131,103.1,235,117,118,99.2
'36380, 장흥군,'035003, 32세,2019,258,126,132,95.5,227,111,116,95.7
'36380, 장흥군,'035004, 33세,2019,272,147,125,117.6,239,122,117,104.3
'36380, 장흥군,'035005, 34세,2019,247,122,125,97.6,228,115,113,101.8
'36380, 장흥군,'040,35~39세,2019,1710,923,787,117.3,1588,864,724,119.3
'36380, 장흥군,'040001, 35세,2019,296,149,147,101.4,267,133,134,99.3
'36380, 장흥군,'040002, 36세,2019,325,176,149,118.1,297,167,130,128.5
'36380, 장흥군,'040003, 37세,2019,360,200,160,125,340,191,149,128.2
'36380, 장흥군,'040004, 38세,2019,350,192,158,121.5,325,176,149,118.1
'36380, 장흥군,'040005, 39세,2019,379,206,173,119.1,359,197,162,121.6
'36380, 장흥군,'045,40~44세,2019,1687,915,772,118.5,1626,891,735,121.2
'36380, 장흥군,'045001, 40세,2019,332,179,153,117,321,176,145,121.4
'36380, 장흥군,'045002, 41세,2019,291,140,151,92.7,278,134,144,93.1
'36380, 장흥군,'045003, 42세,2019,357,200,157,127.4,342,194,148,131.1
'36380, 장흥군,'045004, 43세,2019,352,209,143,146.2,345,204,141,144.7
'36380, 장흥군,'045005, 44세,2019,355,187,168,111.3,340,183,157,116.6
'36380, 장흥군,'050,45~49세,2019,2391,1308,1083,120.8,2326,1283,1043,123
'36380, 장흥군,'050001, 45세,2019,416,233,183,127.3,406,231,175,132
'36380, 장흥군,'050002, 46세,2019,451,239,212,112.7,442,232,210,110.5
'36380, 장흥군,'050003, 47세,2019,453,238,215,110.7,438,234,204,114.7
'36380, 장흥군,'050004, 48세,2019,566,306,260,117.7,547,301,246,122.4
'36380, 장흥군,'050005, 49세,2019,505,292,213,137.1,493,285,208,137
'36380, 장흥군,'055,50~54세,2019,2799,1508,1291,116.8,2743,1487,1256,118.4
'36380, 장흥군,'055001, 50세,2019,542,288,254,113.4,529,284,245,115.9
'36380, 장흥군,'055002, 51세,2019,542,293,249,117.7,528,287,241,119.1
'36380, 장흥군,'055003, 52세,2019,541,296,245,120.8,531,292,239,122.2
'36380, 장흥군,'055004, 53세,2019,580,323,257,125.7,570,318,252,126.2
'36380, 장흥군,'055005, 54세,2019,594,308,286,107.7,585,306,279,109.7
'36380, 장흥군,'060,55~59세,2019,3273,1684,1589,106,3227,1665,1562,106.6
'36380, 장흥군,'060001, 55세,2019,556,291,265,109.8,547,289,258,112
'36380, 장흥군,'060002, 56세,2019,633,329,304,108.2,621,325,296,109.8
'36380, 장흥군,'060003, 57세,2019,616,321,295,108.8,612,320,292,109.6
'36380, 장흥군,'060004, 58세,2019,689,341,348,98,680,335,345,97.1
'36380, 장흥군,'060005, 59세,2019,779,402,377,106.6,767,396,371,106.7
'36380, 장흥군,'065,60~64세,2019,3268,1630,1638,99.5,3240,1614,1626,99.3
'36380, 장흥군,'065001, 60세,2019,696,350,346,101.2,692,347,345,100.6
'36380, 장흥군,'065002, 61세,2019,675,330,345,95.7,666,327,339,96.5
'36380, 장흥군,'065003, 62세,2019,649,328,321,102.2,641,324,317,102.2
'36380, 장흥군,'065004, 63세,2019,601,295,306,96.4,599,293,306,95.8
'36380, 장흥군,'065005, 64세,2019,647,327,320,102.2,642,323,319,101.3
'36380, 장흥군,'070,65~69세,2019,2626,1267,1359,93.2,2611,1259,1352,93.1
'36380, 장흥군,'070001, 65세,2019,539,244,295,82.7,537,243,294,82.7
'36380, 장흥군,'070002, 66세,2019,476,222,254,87.4,471,220,251,87.6
'36380, 장흥군,'070003, 67세,2019,552,279,273,102.2,549,277,272,101.8
'36380, 장흥군,'070004, 68세,2019,513,268,245,109.4,509,265,244,108.6
'36380, 장흥군,'070005, 69세,2019,546,254,292,87,545,254,291,87.3
'36380, 장흥군,'075,70~74세,2019,2548,1136,1412,80.5,2545,1134,1411,80.4
'36380, 장흥군,'075001, 70세,2019,500,230,270,85.2,500,230,270,85.2
'36380, 장흥군,'075002, 71세,2019,570,267,303,88.1,568,265,303,87.5
'36380, 장흥군,'075003, 72세,2019,595,261,334,78.1,595,261,334,78.1
'36380, 장흥군,'075004, 73세,2019,434,183,251,72.9,434,183,251,72.9
'36380, 장흥군,'075005, 74세,2019,449,195,254,76.8,448,195,253,77.1
'36380, 장흥군,'080,75~79세,2019,2675,1093,1582,69.1,2674,1093,1581,69.1
'36380, 장흥군,'080001, 75세,2019,427,205,222,92.3,427,205,222,92.3
'36380, 장흥군,'080002, 76세,2019,476,185,291,63.6,476,185,291,63.6
'36380, 장흥군,'080003, 77세,2019,679,256,423,60.5,678,256,422,60.7
'36380, 장흥군,'080004, 78세,2019,551,239,312,76.6,551,239,312,76.6
'36380, 장흥군,'080005, 79세,2019,542,208,334,62.3,542,208,334,62.3
'36380, 장흥군,'085,80~84세,2019,2235,752,1483,50.7,2234,752,1482,50.7
'36380, 장흥군,'085001, 80세,2019,541,189,352,53.7,540,189,351,53.8
'36380, 장흥군,'085002, 81세,2019,486,182,304,59.9,486,182,304,59.9
'36380, 장흥군,'085003, 82세,2019,406,134,272,49.3,406,134,272,49.3
'36380, 장흥군,'085004, 83세,2019,413,128,285,44.9,413,128,285,44.9
'36380, 장흥군,'085005, 84세,2019,389,119,270,44.1,389,119,270,44.1
'36380, 장흥군,'086,85세이상,2019,1664,400,1264,31.6,1664,400,1264,31.6
'36380, 장흥군,'090,85~89세,2019,1211,309,902,34.3,1211,309,902,34.3
'36380, 장흥군,'090001, 85세,2019,343,95,248,38.3,343,95,248,38.3
'36380, 장흥군,'090002, 86세,2019,267,70,197,35.5,267,70,197,35.5
'36380, 장흥군,'090003, 87세,2019,242,70,172,40.7,242,70,172,40.7
'36380, 장흥군,'090004, 88세,2019,191,39,152,25.7,191,39,152,25.7
'36380, 장흥군,'090005, 89세,2019,168,35,133,26.3,168,35,133,26.3
'36380, 장흥군,'095,90~94세,2019,358,74,284,26.1,358,74,284,26.1
'36380, 장흥군,'095001, 90세,2019,152,36,116,31,152,36,116,31
'36380, 장흥군,'095002, 91세,2019,85,14,71,19.7,85,14,71,19.7
'36380, 장흥군,'095003, 92세,2019,55,11,44,25,55,11,44,25
'36380, 장흥군,'095004, 93세,2019,42,10,32,31.3,42,10,32,31.3
'36380, 장흥군,'095005, 94세,2019,24,X,21,14.3,24,X,21,14.3
'36380, 장흥군,'100,95~99세,2019,85,16,69,23.2,85,16,69,23.2
'36380, 장흥군,'100001, 95세,2019,20,X,17,17.6,20,X,17,17.6
'36380, 장흥군,'100002, 96세,2019,37,8,29,27.6,37,8,29,27.6
'36380, 장흥군,'100003, 97세,2019,17,X,13,30.8,17,X,13,30.8
'36380, 장흥군,'100004, 98세,2019,7,X,6,16.7,7,X,6,16.7
'36380, 장흥군,'100005, 99세,2019,X,X,X,0,X,X,X,0
'36380, 장흥군,'101,100세이상,2019,10,X,9,11.1,10,X,9,11.1
'36380, 장흥군,'102,15세미만,2019,3172,1653,1519,108.8,3166,1649,1517,108.7
'36380, 장흥군,'103,15~64세,2019,20574,10949,9625,113.8,19771,10540,9231,114.2
'36380, 장흥군,'104,65세이상,2019,11748,4648,7100,65.5,11728,4638,7090,65.4
'36380, 장흥군,'126,평균연령,2019,52.2,49.3,54.9,,52.5,49.6,55.2,
'36380, 장흥군,'127,중위연령,2019,56,52.9,59,,56.5,53.4,59.5,
'36390, 강진군,'000,합계,2019,32805,15757,17048,92.4,32141,15462,16679,92.7
'36390, 강진군,'005,0~4세,2019,899,440,459,95.9,897,439,458,95.9
'36390, 강진군,'005001, 0세,2019,184,95,89,106.7,184,95,89,106.7
'36390, 강진군,'005002, 1세,2019,192,89,103,86.4,192,89,103,86.4
'36390, 강진군,'005003, 2세,2019,158,72,86,83.7,158,72,86,83.7
'36390, 강진군,'005004, 3세,2019,169,87,82,106.1,167,86,81,106.2
'36390, 강진군,'005005, 4세,2019,196,97,99,98,196,97,99,98
'36390, 강진군,'010,5~9세,2019,1010,527,483,109.1,1008,526,482,109.1
'36390, 강진군,'010001, 5세,2019,190,92,98,93.9,189,91,98,92.9
'36390, 강진군,'010002, 6세,2019,190,104,86,120.9,189,104,85,122.4
'36390, 강진군,'010003, 7세,2019,201,97,104,93.3,201,97,104,93.3
'36390, 강진군,'010004, 8세,2019,228,127,101,125.7,228,127,101,125.7
'36390, 강진군,'010005, 9세,2019,201,107,94,113.8,201,107,94,113.8
'36390, 강진군,'015,10~14세,2019,1185,610,575,106.1,1179,606,573,105.8
'36390, 강진군,'015001, 10세,2019,194,97,97,100,193,97,96,101
'36390, 강진군,'015002, 11세,2019,251,123,128,96.1,249,122,127,96.1
'36390, 강진군,'015003, 12세,2019,241,121,120,100.8,239,119,120,99.2
'36390, 강진군,'015004, 13세,2019,247,128,119,107.6,246,127,119,106.7
'36390, 강진군,'015005, 14세,2019,252,141,111,127,252,141,111,127
'36390, 강진군,'020,15~19세,2019,1341,709,632,112.2,1337,709,628,112.9
'36390, 강진군,'020001, 15세,2019,276,134,142,94.4,275,134,141,95
'36390, 강진군,'020002, 16세,2019,271,132,139,95,271,132,139,95
'36390, 강진군,'020003, 17세,2019,246,129,117,110.3,246,129,117,110.3
'36390, 강진군,'020004, 18세,2019,314,169,145,116.6,314,169,145,116.6
'36390, 강진군,'020005, 19세,2019,234,145,89,162.9,231,145,86,168.6
'36390, 강진군,'025,20~24세,2019,1308,776,532,145.9,1228,735,493,149.1
'36390, 강진군,'025001, 20세,2019,227,153,74,206.8,222,152,70,217.1
'36390, 강진군,'025002, 21세,2019,267,165,102,161.8,256,160,96,166.7
'36390, 강진군,'025003, 22세,2019,293,167,126,132.5,274,156,118,132.2
'36390, 강진군,'025004, 23세,2019,248,130,118,110.2,235,124,111,111.7
'36390, 강진군,'025005, 24세,2019,273,161,112,143.8,241,143,98,145.9
'36390, 강진군,'030,25~29세,2019,1265,662,603,109.8,1130,592,538,110
'36390, 강진군,'030001, 25세,2019,263,130,133,97.7,237,117,120,97.5
'36390, 강진군,'030002, 26세,2019,262,146,116,125.9,233,130,103,126.2
'36390, 강진군,'030003, 27세,2019,243,131,112,117,214,115,99,116.2
'36390, 강진군,'030004, 28세,2019,244,130,114,114,218,116,102,113.7
'36390, 강진군,'030005, 29세,2019,253,125,128,97.7,228,114,114,100
'36390, 강진군,'035,30~34세,2019,1153,567,586,96.8,1047,515,532,96.8
'36390, 강진군,'035001, 30세,2019,221,104,117,88.9,199,92,107,86
'36390, 강진군,'035002, 31세,2019,237,109,128,85.2,215,97,118,82.2
'36390, 강진군,'035003, 32세,2019,203,100,103,97.1,175,90,85,105.9
'36390, 강진군,'035004, 33세,2019,261,120,141,85.1,240,108,132,81.8
'36390, 강진군,'035005, 34세,2019,231,134,97,138.1,218,128,90,142.2
'36390, 강진군,'040,35~39세,2019,1423,706,717,98.5,1336,674,662,101.8
'36390, 강진군,'040001, 35세,2019,224,105,119,88.2,206,99,107,92.5
'36390, 강진군,'040002, 36세,2019,291,137,154,89,279,134,145,92.4
'36390, 강진군,'040003, 37세,2019,317,163,154,105.8,295,152,143,106.3
'36390, 강진군,'040004, 38세,2019,296,159,137,116.1,276,150,126,119
'36390, 강진군,'040005, 39세,2019,295,142,153,92.8,280,139,141,98.6
'36390, 강진군,'045,40~44세,2019,1526,824,702,117.4,1479,806,673,119.8
'36390, 강진군,'045001, 40세,2019,276,146,130,112.3,263,140,123,113.8
'36390, 강진군,'045002, 41세,2019,274,148,126,117.5,262,141,121,116.5
'36390, 강진군,'045003, 42세,2019,326,172,154,111.7,319,171,148,115.5
'36390, 강진군,'045004, 43세,2019,306,172,134,128.4,297,169,128,132
'36390, 강진군,'045005, 44세,2019,344,186,158,117.7,338,185,153,120.9
'36390, 강진군,'050,45~49세,2019,2084,1156,928,124.6,2028,1134,894,126.8
'36390, 강진군,'050001, 45세,2019,355,196,159,123.3,347,193,154,125.3
'36390, 강진군,'050002, 46세,2019,375,207,168,123.2,365,202,163,123.9
'36390, 강진군,'050003, 47세,2019,461,254,207,122.7,448,245,203,120.7
'36390, 강진군,'050004, 48세,2019,475,272,203,134,459,267,192,139.1
'36390, 강진군,'050005, 49세,2019,418,227,191,118.8,409,227,182,124.7
'36390, 강진군,'055,50~54세,2019,2457,1347,1110,121.4,2398,1326,1072,123.7
'36390, 강진군,'055001, 50세,2019,459,237,222,106.8,449,233,216,107.9
'36390, 강진군,'055002, 51세,2019,507,286,221,129.4,493,280,213,131.5
'36390, 강진군,'055003, 52세,2019,437,251,186,134.9,425,245,180,136.1
'36390, 강진군,'055004, 53세,2019,510,284,226,125.7,499,282,217,130
'36390, 강진군,'055005, 54세,2019,544,289,255,113.3,532,286,246,116.3
'36390, 강진군,'060,55~59세,2019,3028,1517,1511,100.4,2987,1500,1487,100.9
'36390, 강진군,'060001, 55세,2019,507,252,255,98.8,500,250,250,100
'36390, 강진군,'060002, 56세,2019,568,285,283,100.7,558,279,279,100
'36390, 강진군,'060003, 57세,2019,605,325,280,116.1,597,322,275,117.1
'36390, 강진군,'060004, 58세,2019,632,305,327,93.3,626,303,323,93.8
'36390, 강진군,'060005, 59세,2019,716,350,366,95.6,706,346,360,96.1
'36390, 강진군,'065,60~64세,2019,3106,1551,1555,99.7,3076,1538,1538,100
'36390, 강진군,'065001, 60세,2019,707,360,347,103.7,701,358,343,104.4
'36390, 강진군,'065002, 61세,2019,637,327,310,105.5,629,323,306,105.6
'36390, 강진군,'065003, 62세,2019,626,302,324,93.2,621,299,322,92.9
'36390, 강진군,'065004, 63세,2019,552,275,277,99.3,549,274,275,99.6
'36390, 강진군,'065005, 64세,2019,584,287,297,96.6,576,284,292,97.3
'36390, 강진군,'070,65~69세,2019,2492,1195,1297,92.1,2485,1193,1292,92.3
'36390, 강진군,'070001, 65세,2019,472,232,240,96.7,470,232,238,97.5
'36390, 강진군,'070002, 66세,2019,470,241,229,105.2,470,241,229,105.2
'36390, 강진군,'070003, 67세,2019,545,247,298,82.9,545,247,298,82.9
'36390, 강진군,'070004, 68세,2019,472,226,246,91.9,469,225,244,92.2
'36390, 강진군,'070005, 69세,2019,533,249,284,87.7,531,248,283,87.6
'36390, 강진군,'075,70~74세,2019,2518,1119,1399,80,2517,1118,1399,79.9
'36390, 강진군,'075001, 70세,2019,515,256,259,98.8,515,256,259,98.8
'36390, 강진군,'075002, 71세,2019,561,249,312,79.8,560,248,312,79.5
'36390, 강진군,'075003, 72세,2019,533,235,298,78.9,533,235,298,78.9
'36390, 강진군,'075004, 73세,2019,438,184,254,72.4,438,184,254,72.4
'36390, 강진군,'075005, 74세,2019,471,195,276,70.7,471,195,276,70.7
'36390, 강진군,'080,75~79세,2019,2539,1013,1526,66.4,2539,1013,1526,66.4
'36390, 강진군,'080001, 75세,2019,421,187,234,79.9,421,187,234,79.9
'36390, 강진군,'080002, 76세,2019,447,197,250,78.8,447,197,250,78.8
'36390, 강진군,'080003, 77세,2019,617,237,380,62.4,617,237,380,62.4
'36390, 강진군,'080004, 78세,2019,505,197,308,64,505,197,308,64
'36390, 강진군,'080005, 79세,2019,549,195,354,55.1,549,195,354,55.1
'36390, 강진군,'085,80~84세,2019,2076,723,1353,53.4,2075,723,1352,53.5
'36390, 강진군,'085001, 80세,2019,496,182,314,58,495,182,313,58.1
'36390, 강진군,'085002, 81세,2019,488,177,311,56.9,488,177,311,56.9
'36390, 강진군,'085003, 82세,2019,401,147,254,57.9,401,147,254,57.9
'36390, 강진군,'085004, 83세,2019,351,104,247,42.1,351,104,247,42.1
'36390, 강진군,'085005, 84세,2019,340,113,227,49.8,340,113,227,49.8
'36390, 강진군,'086,85세이상,2019,1395,315,1080,29.2,1395,315,1080,29.2
'36390, 강진군,'090,85~89세,2019,1040,240,800,30,1040,240,800,30
'36390, 강진군,'090001, 85세,2019,256,66,190,34.7,256,66,190,34.7
'36390, 강진군,'090002, 86세,2019,223,63,160,39.4,223,63,160,39.4
'36390, 강진군,'090003, 87세,2019,202,43,159,27,202,43,159,27
'36390, 강진군,'090004, 88세,2019,183,33,150,22,183,33,150,22
'36390, 강진군,'090005, 89세,2019,176,35,141,24.8,176,35,141,24.8
'36390, 강진군,'095,90~94세,2019,292,62,230,27,292,62,230,27
'36390, 강진군,'095001, 90세,2019,102,23,79,29.1,102,23,79,29.1
'36390, 강진군,'095002, 91세,2019,74,10,64,15.6,74,10,64,15.6
'36390, 강진군,'095003, 92세,2019,64,12,52,23.1,64,12,52,23.1
'36390, 강진군,'095004, 93세,2019,26,8,18,44.4,26,8,18,44.4
'36390, 강진군,'095005, 94세,2019,26,9,17,52.9,26,9,17,52.9
'36390, 강진군,'100,95~99세,2019,61,12,49,24.5,61,12,49,24.5
'36390, 강진군,'100001, 95세,2019,23,X,21,9.5,23,X,21,9.5
'36390, 강진군,'100002, 96세,2019,17,X,15,13.3,17,X,15,13.3
'36390, 강진군,'100003, 97세,2019,10,X,7,42.9,10,X,7,42.9
'36390, 강진군,'100004, 98세,2019,6,X,X,200,6,X,X,200
'36390, 강진군,'100005, 99세,2019,5,X,X,25,5,X,X,25
'36390, 강진군,'101,100세이상,2019,X,X,X,100,X,X,X,100
'36390, 강진군,'102,15세미만,2019,3094,1577,1517,104,3084,1571,1513,103.8
'36390, 강진군,'103,15~64세,2019,18691,9815,8876,110.6,18046,9529,8517,111.9
'36390, 강진군,'104,65세이상,2019,11020,4365,6655,65.6,11011,4362,6649,65.6
'36390, 강진군,'126,평균연령,2019,52.1,49.4,54.5,,52.3,49.7,54.8,
'36390, 강진군,'127,중위연령,2019,56.4,53.4,59.1,,56.9,53.8,59.6,
'36400, 해남군,'000,합계,2019,65175,32434,32741,99.1,63166,31217,31949,97.7
'36400, 해남군,'005,0~4세,2019,2237,1150,1087,105.8,2234,1148,1086,105.7
'36400, 해남군,'005001, 0세,2019,495,248,247,100.4,493,246,247,99.6
'36400, 해남군,'005002, 1세,2019,479,255,224,113.8,479,255,224,113.8
'36400, 해남군,'005003, 2세,2019,442,234,208,112.5,441,234,207,113
'36400, 해남군,'005004, 3세,2019,409,203,206,98.5,409,203,206,98.5
'36400, 해남군,'005005, 4세,2019,412,210,202,104,412,210,202,104
'36400, 해남군,'010,5~9세,2019,2103,1025,1078,95.1,2101,1023,1078,94.9
'36400, 해남군,'010001, 5세,2019,399,195,204,95.6,399,195,204,95.6
'36400, 해남군,'010002, 6세,2019,405,187,218,85.8,405,187,218,85.8
'36400, 해남군,'010003, 7세,2019,457,212,245,86.5,455,210,245,85.7
'36400, 해남군,'010004, 8세,2019,462,229,233,98.3,462,229,233,98.3
'36400, 해남군,'010005, 9세,2019,380,202,178,113.5,380,202,178,113.5
'36400, 해남군,'015,10~14세,2019,2172,1106,1066,103.8,2172,1106,1066,103.8
'36400, 해남군,'015001, 10세,2019,421,230,191,120.4,421,230,191,120.4
'36400, 해남군,'015002, 11세,2019,479,237,242,97.9,479,237,242,97.9
'36400, 해남군,'015003, 12세,2019,420,208,212,98.1,420,208,212,98.1
'36400, 해남군,'015004, 13세,2019,451,232,219,105.9,451,232,219,105.9
'36400, 해남군,'015005, 14세,2019,401,199,202,98.5,401,199,202,98.5
'36400, 해남군,'020,15~19세,2019,2211,1234,977,126.3,2201,1232,969,127.1
'36400, 해남군,'020001, 15세,2019,462,262,200,131,462,262,200,131
'36400, 해남군,'020002, 16세,2019,407,202,205,98.5,407,202,205,98.5
'36400, 해남군,'020003, 17세,2019,436,230,206,111.7,436,230,206,111.7
'36400, 해남군,'020004, 18세,2019,521,296,225,131.6,519,295,224,131.7
'36400, 해남군,'020005, 19세,2019,385,244,141,173,377,243,134,181.3
'36400, 해남군,'025,20~24세,2019,2562,1548,1014,152.7,2322,1388,934,148.6
'36400, 해남군,'025001, 20세,2019,502,332,170,195.3,481,326,155,210.3
'36400, 해남군,'025002, 21세,2019,505,339,166,204.2,477,321,156,205.8
'36400, 해남군,'025003, 22세,2019,471,272,199,136.7,429,239,190,125.8
'36400, 해남군,'025004, 23세,2019,544,299,245,122,470,250,220,113.6
'36400, 해남군,'025005, 24세,2019,540,306,234,130.8,465,252,213,118.3
'36400, 해남군,'030,25~29세,2019,2560,1457,1103,132.1,2104,1142,962,118.7
'36400, 해남군,'030001, 25세,2019,503,297,206,144.2,416,234,182,128.6
'36400, 해남군,'030002, 26세,2019,534,294,240,122.5,445,229,216,106
'36400, 해남군,'030003, 27세,2019,526,292,234,124.8,439,236,203,116.3
'36400, 해남군,'030004, 28세,2019,506,296,210,141,406,228,178,128.1
'36400, 해남군,'030005, 29세,2019,491,278,213,130.5,398,215,183,117.5
'36400, 해남군,'035,30~34세,2019,2558,1342,1216,110.4,2171,1093,1078,101.4
'36400, 해남군,'035001, 30세,2019,465,249,216,115.3,390,196,194,101
'36400, 해남군,'035002, 31세,2019,475,243,232,104.7,389,190,199,95.5
'36400, 해남군,'035003, 32세,2019,560,278,282,98.6,475,226,249,90.8
'36400, 해남군,'035004, 33세,2019,547,285,262,108.8,476,244,232,105.2
'36400, 해남군,'035005, 34세,2019,511,287,224,128.1,441,237,204,116.2
'36400, 해남군,'040,35~39세,2019,3255,1675,1580,106,2965,1511,1454,103.9
'36400, 해남군,'040001, 35세,2019,590,297,293,101.4,521,254,267,95.1
'36400, 해남군,'040002, 36세,2019,614,324,290,111.7,551,289,262,110.3
'36400, 해남군,'040003, 37세,2019,705,368,337,109.2,636,324,312,103.8
'36400, 해남군,'040004, 38세,2019,656,335,321,104.4,606,307,299,102.7
'36400, 해남군,'040005, 39세,2019,690,351,339,103.5,651,337,314,107.3
'36400, 해남군,'045,40~44세,2019,3518,1957,1561,125.4,3348,1857,1491,124.5
'36400, 해남군,'045001, 40세,2019,689,374,315,118.7,643,347,296,117.2
'36400, 해남군,'045002, 41세,2019,675,369,306,120.6,625,338,287,117.8
'36400, 해남군,'045003, 42세,2019,685,373,312,119.6,656,354,302,117.2
'36400, 해남군,'045004, 43세,2019,761,441,320,137.8,733,427,306,139.5
'36400, 해남군,'045005, 44세,2019,708,400,308,129.9,691,391,300,130.3
'36400, 해남군,'050,45~49세,2019,4442,2550,1892,134.8,4310,2485,1825,136.2
'36400, 해남군,'050001, 45세,2019,777,448,329,136.2,754,435,319,136.4
'36400, 해남군,'050002, 46세,2019,884,478,406,117.7,868,472,396,119.2
'36400, 해남군,'050003, 47세,2019,863,500,363,137.7,830,481,349,137.8
'36400, 해남군,'050004, 48세,2019,988,584,404,144.6,959,571,388,147.2
'36400, 해남군,'050005, 49세,2019,930,540,390,138.5,899,526,373,141
'36400, 해남군,'055,50~54세,2019,5129,2844,2285,124.5,4990,2778,2212,125.6
'36400, 해남군,'055001, 50세,2019,938,507,431,117.6,904,493,411,120
'36400, 해남군,'055002, 51세,2019,1023,565,458,123.4,999,552,447,123.5
'36400, 해남군,'055003, 52세,2019,1035,564,471,119.7,1008,550,458,120.1
'36400, 해남군,'055004, 53세,2019,1075,596,479,124.4,1049,583,466,125.1
'36400, 해남군,'055005, 54세,2019,1058,612,446,137.2,1030,600,430,139.5
'36400, 해남군,'060,55~59세,2019,5930,3146,2784,113,5844,3103,2741,113.2
'36400, 해남군,'060001, 55세,2019,1076,568,508,111.8,1061,561,500,112.2
'36400, 해남군,'060002, 56세,2019,1104,603,501,120.4,1079,589,490,120.2
'36400, 해남군,'060003, 57세,2019,1097,572,525,109,1076,560,516,108.5
'36400, 해남군,'060004, 58세,2019,1272,655,617,106.2,1259,650,609,106.7
'36400, 해남군,'060005, 59세,2019,1381,748,633,118.2,1369,743,626,118.7
'36400, 해남군,'065,60~64세,2019,6085,3082,3003,102.6,6028,3051,2977,102.5
'36400, 해남군,'065001, 60세,2019,1355,672,683,98.4,1341,661,680,97.2
'36400, 해남군,'065002, 61세,2019,1268,653,615,106.2,1250,642,608,105.6
'36400, 해남군,'065003, 62세,2019,1211,620,591,104.9,1201,617,584,105.7
'36400, 해남군,'065004, 63세,2019,1151,581,570,101.9,1139,577,562,102.7
'36400, 해남군,'065005, 64세,2019,1100,556,544,102.2,1097,554,543,102
'36400, 해남군,'070,65~69세,2019,4925,2361,2564,92.1,4909,2354,2555,92.1
'36400, 해남군,'070001, 65세,2019,959,464,495,93.7,956,463,493,93.9
'36400, 해남군,'070002, 66세,2019,929,428,501,85.4,926,427,499,85.6
'36400, 해남군,'070003, 67세,2019,1092,544,548,99.3,1091,543,548,99.1
'36400, 해남군,'070004, 68세,2019,957,441,516,85.5,950,438,512,85.5
'36400, 해남군,'070005, 69세,2019,988,484,504,96,986,483,503,96
'36400, 해남군,'075,70~74세,2019,4780,2242,2538,88.3,4770,2236,2534,88.2
'36400, 해남군,'075001, 70세,2019,1054,531,523,101.5,1049,527,522,101
'36400, 해남군,'075002, 71세,2019,983,472,511,92.4,982,471,511,92.2
'36400, 해남군,'075003, 72세,2019,1041,484,557,86.9,1040,484,556,87.1
'36400, 해남군,'075004, 73세,2019,803,372,431,86.3,802,372,430,86.5
'36400, 해남군,'075005, 74세,2019,899,383,516,74.2,897,382,515,74.2
'36400, 해남군,'080,75~79세,2019,4814,1935,2879,67.2,4810,1933,2877,67.2
'36400, 해남군,'080001, 75세,2019,800,331,469,70.6,798,329,469,70.1
'36400, 해남군,'080002, 76세,2019,960,409,551,74.2,960,409,551,74.2
'36400, 해남군,'080003, 77세,2019,1170,470,700,67.1,1170,470,700,67.1
'36400, 해남군,'080004, 78세,2019,952,368,584,63,951,368,583,63.1
'36400, 해남군,'080005, 79세,2019,932,357,575,62.1,931,357,574,62.2
'36400, 해남군,'085,80~84세,2019,3515,1210,2305,52.5,3511,1209,2302,52.5
'36400, 해남군,'085001, 80세,2019,888,350,538,65.1,887,350,537,65.2
'36400, 해남군,'085002, 81세,2019,767,280,487,57.5,765,279,486,57.4
'36400, 해남군,'085003, 82세,2019,742,258,484,53.3,741,258,483,53.4
'36400, 해남군,'085004, 83세,2019,595,178,417,42.7,595,178,417,42.7
'36400, 해남군,'085005, 84세,2019,523,144,379,38,523,144,379,38
'36400, 해남군,'086,85세이상,2019,2379,570,1809,31.5,2376,568,1808,31.4
'36400, 해남군,'090,85~89세,2019,1751,440,1311,33.6,1750,439,1311,33.5
'36400, 해남군,'090001, 85세,2019,487,149,338,44.1,487,149,338,44.1
'36400, 해남군,'090002, 86세,2019,401,103,298,34.6,401,103,298,34.6
'36400, 해남군,'090003, 87세,2019,331,83,248,33.5,331,83,248,33.5
'36400, 해남군,'090004, 88세,2019,271,55,216,25.5,271,55,216,25.5
'36400, 해남군,'090005, 89세,2019,261,50,211,23.7,260,49,211,23.2
'36400, 해남군,'095,90~94세,2019,485,111,374,29.7,484,111,373,29.8
'36400, 해남군,'095001, 90세,2019,179,48,131,36.6,179,48,131,36.6
'36400, 해남군,'095002, 91세,2019,123,23,100,23,123,23,100,23
'36400, 해남군,'095003, 92세,2019,97,18,79,22.8,97,18,79,22.8
'36400, 해남군,'095004, 93세,2019,63,18,45,40,63,18,45,40
'36400, 해남군,'095005, 94세,2019,23,X,19,21.1,22,X,18,22.2
'36400, 해남군,'100,95~99세,2019,131,19,112,17,130,18,112,16.1
'36400, 해남군,'100001, 95세,2019,51,9,42,21.4,50,8,42,19
'36400, 해남군,'100002, 96세,2019,35,6,29,20.7,35,6,29,20.7
'36400, 해남군,'100003, 97세,2019,22,X,19,15.8,22,X,19,15.8
'36400, 해남군,'100004, 98세,2019,12,X,12,0,12,X,12,0
'36400, 해남군,'100005, 99세,2019,11,X,10,10,11,X,10,10
'36400, 해남군,'101,100세이상,2019,12,X,12,0,12,X,12,0
'36400, 해남군,'102,15세미만,2019,6512,3281,3231,101.5,6507,3277,3230,101.5
'36400, 해남군,'103,15~64세,2019,38250,20835,17415,119.6,36283,19640,16643,118
'36400, 해남군,'104,65세이상,2019,20413,8318,12095,68.8,20376,8300,12076,68.7
'36400, 해남군,'126,평균연령,2019,51,48.6,53.4,,51.5,49.1,53.8,
'36400, 해남군,'127,중위연령,2019,54.8,52.2,58,,55.6,53,58.5,
'36410, 영암군,'000,합계,2019,57476,30908,26568,116.3,51322,26362,24960,105.6
'36410, 영암군,'005,0~4세,2019,1942,985,957,102.9,1881,949,932,101.8
'36410, 영암군,'005001, 0세,2019,359,177,182,97.3,348,170,178,95.5
'36410, 영암군,'005002, 1세,2019,377,198,179,110.6,364,189,175,108
'36410, 영암군,'005003, 2세,2019,368,176,192,91.7,356,168,188,89.4
'36410, 영암군,'005004, 3세,2019,417,212,205,103.4,399,203,196,103.6
'36410, 영암군,'005005, 4세,2019,421,222,199,111.6,414,219,195,112.3
'36410, 영암군,'010,5~9세,2019,2122,1072,1050,102.1,2073,1047,1026,102
'36410, 영암군,'010001, 5세,2019,404,200,204,98,392,196,196,100
'36410, 영암군,'010002, 6세,2019,420,216,204,105.9,412,211,201,105
'36410, 영암군,'010003, 7세,2019,430,226,204,110.8,418,217,201,108
'36410, 영암군,'010004, 8세,2019,447,213,234,91,435,209,226,92.5
'36410, 영암군,'010005, 9세,2019,421,217,204,106.4,416,214,202,105.9
'36410, 영암군,'015,10~14세,2019,2014,1061,953,111.3,1969,1040,929,111.9
'36410, 영암군,'015001, 10세,2019,416,223,193,115.5,403,218,185,117.8
'36410, 영암군,'015002, 11세,2019,388,198,190,104.2,381,196,185,105.9
'36410, 영암군,'015003, 12세,2019,435,229,206,111.2,424,224,200,112
'36410, 영암군,'015004, 13세,2019,382,200,182,109.9,375,195,180,108.3
'36410, 영암군,'015005, 14세,2019,393,211,182,115.9,386,207,179,115.6
'36410, 영암군,'020,15~19세,2019,2619,1440,1179,122.1,2552,1400,1152,121.5
'36410, 영암군,'020001, 15세,2019,444,241,203,118.7,434,235,199,118.1
'36410, 영암군,'020002, 16세,2019,490,249,241,103.3,482,243,239,101.7
'36410, 영암군,'020003, 17세,2019,498,251,247,101.6,485,245,240,102.1
'36410, 영암군,'020004, 18세,2019,521,286,235,121.7,512,280,232,120.7
'36410, 영암군,'020005, 19세,2019,666,413,253,163.2,639,397,242,164
'36410, 영암군,'025,20~24세,2019,3335,2061,1274,161.8,2764,1600,1164,137.5
'36410, 영암군,'025001, 20세,2019,674,395,279,141.6,619,359,260,138.1
'36410, 영암군,'025002, 21세,2019,698,422,276,152.9,603,348,255,136.5
'36410, 영암군,'025003, 22세,2019,679,418,261,160.2,566,327,239,136.8
'36410, 영암군,'025004, 23세,2019,646,409,237,172.6,512,296,216,137
'36410, 영암군,'025005, 24세,2019,638,417,221,188.7,464,270,194,139.2
'36410, 영암군,'030,25~29세,2019,3205,2067,1138,181.6,2038,1110,928,119.6
'36410, 영암군,'030001, 25세,2019,635,435,200,217.5,444,266,178,149.4
'36410, 영암군,'030002, 26세,2019,656,434,222,195.5,418,233,185,125.9
'36410, 영암군,'030003, 27세,2019,669,423,246,172,437,230,207,111.1
'36410, 영암군,'030004, 28세,2019,607,390,217,179.7,368,195,173,112.7
'36410, 영암군,'030005, 29세,2019,638,385,253,152.2,371,186,185,100.5
'36410, 영암군,'035,30~34세,2019,3242,2044,1198,170.6,2036,1074,962,111.6
'36410, 영암군,'035001, 30세,2019,623,396,227,174.4,350,170,180,94.4
'36410, 영암군,'035002, 31세,2019,597,385,212,181.6,361,196,165,118.8
'36410, 영암군,'035003, 32세,2019,664,418,246,169.9,424,223,201,110.9
'36410, 영암군,'035004, 33세,2019,661,417,244,170.9,427,226,201,112.4
'36410, 영암군,'035005, 34세,2019,697,428,269,159.1,474,259,215,120.5
'36410, 영암군,'040,35~39세,2019,3916,2475,1441,171.8,3058,1786,1272,140.4
'36410, 영암군,'040001, 35세,2019,698,424,274,154.7,487,255,232,109.9
'36410, 영암군,'040002, 36세,2019,769,505,264,191.3,596,356,240,148.3
'36410, 영암군,'040003, 37세,2019,877,536,341,157.2,707,401,306,131
'36410, 영암군,'040004, 38세,2019,773,503,270,186.3,593,364,229,159
'36410, 영암군,'040005, 39세,2019,799,507,292,173.6,675,410,265,154.7
'36410, 영암군,'045,40~44세,2019,3783,2311,1472,157,3171,1860,1311,141.9
'36410, 영암군,'045001, 40세,2019,781,461,320,144.1,657,372,285,130.5
'36410, 영암군,'045002, 41세,2019,735,470,265,177.4,620,383,237,161.6
'36410, 영암군,'045003, 42세,2019,770,459,311,147.6,635,360,275,130.9
'36410, 영암군,'045004, 43세,2019,746,454,292,155.5,617,363,254,142.9
'36410, 영암군,'045005, 44세,2019,751,467,284,164.4,642,382,260,146.9
'36410, 영암군,'050,45~49세,2019,4441,2620,1821,143.9,3955,2321,1634,142
'36410, 영암군,'050001, 45세,2019,828,493,335,147.2,727,433,294,147.3
'36410, 영암군,'050002, 46세,2019,898,541,357,151.5,791,471,320,147.2
'36410, 영암군,'050003, 47세,2019,896,546,350,156,806,490,316,155.1
'36410, 영암군,'050004, 48세,2019,919,513,406,126.4,833,467,366,127.6
'36410, 영암군,'050005, 49세,2019,900,527,373,141.3,798,460,338,136.1
'36410, 영암군,'055,50~54세,2019,4679,2720,1959,138.8,4247,2441,1806,135.2
'36410, 영암군,'055001, 50세,2019,937,529,408,129.7,842,472,370,127.6
'36410, 영암군,'055002, 51세,2019,975,578,397,145.6,878,514,364,141.2
'36410, 영암군,'055003, 52세,2019,882,513,369,139,804,461,343,134.4
'36410, 영암군,'055004, 53세,2019,962,563,399,141.1,880,510,370,137.8
'36410, 영암군,'055005, 54세,2019,923,537,386,139.1,843,484,359,134.8
'36410, 영암군,'060,55~59세,2019,4792,2661,2131,124.9,4486,2482,2004,123.9
'36410, 영암군,'060001, 55세,2019,893,516,377,136.9,818,475,343,138.5
'36410, 영암군,'060002, 56세,2019,980,549,431,127.4,893,505,388,130.2
'36410, 영암군,'060003, 57세,2019,942,501,441,113.6,879,461,418,110.3
'36410, 영암군,'060004, 58세,2019,1025,584,441,132.4,990,562,428,131.3
'36410, 영암군,'060005, 59세,2019,952,511,441,115.9,906,479,427,112.2
'36410, 영암군,'065,60~64세,2019,4185,2149,2036,105.6,4025,2067,1958,105.6
'36410, 영암군,'065001, 60세,2019,935,491,444,110.6,903,474,429,110.5
'36410, 영암군,'065002, 61세,2019,841,456,385,118.4,798,430,368,116.8
'36410, 영암군,'065003, 62세,2019,847,436,411,106.1,813,420,393,106.9
'36410, 영암군,'065004, 63세,2019,796,387,409,94.6,768,376,392,95.9
'36410, 영암군,'065005, 64세,2019,766,379,387,97.9,743,367,376,97.6
'36410, 영암군,'070,65~69세,2019,3140,1484,1656,89.6,3069,1449,1620,89.4
'36410, 영암군,'070001, 65세,2019,670,323,347,93.1,644,310,334,92.8
'36410, 영암군,'070002, 66세,2019,596,284,312,91,587,280,307,91.2
'36410, 영암군,'070003, 67세,2019,675,329,346,95.1,654,317,337,94.1
'36410, 영암군,'070004, 68세,2019,577,265,312,84.9,573,263,310,84.8
'36410, 영암군,'070005, 69세,2019,622,283,339,83.5,611,279,332,84
'36410, 영암군,'075,70~74세,2019,2964,1340,1624,82.5,2940,1332,1608,82.8
'36410, 영암군,'075001, 70세,2019,634,317,317,100,628,314,314,100
'36410, 영암군,'075002, 71세,2019,587,275,312,88.1,579,273,306,89.2
'36410, 영암군,'075003, 72세,2019,627,278,349,79.7,623,275,348,79
'36410, 영암군,'075004, 73세,2019,532,214,318,67.3,530,214,316,67.7
'36410, 영암군,'075005, 74세,2019,584,256,328,78,580,256,324,79
'36410, 영암군,'080,75~79세,2019,3116,1201,1915,62.7,3090,1191,1899,62.7
'36410, 영암군,'080001, 75세,2019,555,212,343,61.8,548,209,339,61.7
'36410, 영암군,'080002, 76세,2019,570,217,353,61.5,561,215,346,62.1
'36410, 영암군,'080003, 77세,2019,755,332,423,78.5,753,330,423,78
'36410, 영암군,'080004, 78세,2019,632,228,404,56.4,624,225,399,56.4
'36410, 영암군,'080005, 79세,2019,604,212,392,54.1,604,212,392,54.1
'36410, 영암군,'085,80~84세,2019,2371,793,1578,50.3,2363,790,1573,50.2
'36410, 영암군,'085001, 80세,2019,596,224,372,60.2,593,222,371,59.8
'36410, 영암군,'085002, 81세,2019,508,172,336,51.2,506,172,334,51.5
'36410, 영암군,'085003, 82세,2019,460,157,303,51.8,458,156,302,51.7
'36410, 영암군,'085004, 83세,2019,405,123,282,43.6,405,123,282,43.6
'36410, 영암군,'085005, 84세,2019,402,117,285,41.1,401,117,284,41.2
'36410, 영암군,'086,85세이상,2019,1610,424,1186,35.8,1605,423,1182,35.8
'36410, 영암군,'090,85~89세,2019,1209,331,878,37.7,1205,331,874,37.9
'36410, 영암군,'090001, 85세,2019,344,100,244,41,344,100,244,41
'36410, 영암군,'090002, 86세,2019,281,86,195,44.1,281,86,195,44.1
'36410, 영암군,'090003, 87세,2019,236,65,171,38,235,65,170,38.2
'36410, 영암군,'090004, 88세,2019,184,43,141,30.5,182,43,139,30.9
'36410, 영암군,'090005, 89세,2019,164,37,127,29.1,163,37,126,29.4
'36410, 영암군,'095,90~94세,2019,320,73,247,29.6,319,72,247,29.1
'36410, 영암군,'095001, 90세,2019,126,25,101,24.8,126,25,101,24.8
'36410, 영암군,'095002, 91세,2019,69,18,51,35.3,68,17,51,33.3
'36410, 영암군,'095003, 92세,2019,62,13,49,26.5,62,13,49,26.5
'36410, 영암군,'095004, 93세,2019,33,9,24,37.5,33,9,24,37.5
'36410, 영암군,'095005, 94세,2019,30,8,22,36.4,30,8,22,36.4
'36410, 영암군,'100,95~99세,2019,75,19,56,33.9,75,19,56,33.9
'36410, 영암군,'100001, 95세,2019,25,6,19,31.6,25,6,19,31.6
'36410, 영암군,'100002, 96세,2019,28,8,20,40,28,8,20,40
'36410, 영암군,'100003, 97세,2019,11,X,9,22.2,11,X,9,22.2
'36410, 영암군,'100004, 98세,2019,6,X,X,50,6,X,X,50
'36410, 영암군,'100005, 99세,2019,5,X,X,25,5,X,X,25
'36410, 영암군,'101,100세이상,2019,6,X,5,20,6,X,5,20
'36410, 영암군,'102,15세미만,2019,6078,3118,2960,105.3,5923,3036,2887,105.2
'36410, 영암군,'103,15~64세,2019,38197,22548,15649,144.1,32332,18141,14191,127.8
'36410, 영암군,'104,65세이상,2019,13201,5242,7959,65.9,13067,5185,7882,65.8
'36410, 영암군,'126,평균연령,2019,46.4,43.9,49.3,,47.6,45.3,49.9,
'36410, 영암군,'127,중위연령,2019,47.9,44.9,52,,50.2,47.8,53.3,
'36420, 무안군,'000,합계,2019,81789,41571,40218,103.4,79466,40205,39261,102.4
'36420, 무안군,'005,0~4세,2019,2872,1502,1370,109.6,2861,1497,1364,109.8
'36420, 무안군,'005001, 0세,2019,429,213,216,98.6,428,213,215,99.1
'36420, 무안군,'005002, 1세,2019,484,258,226,114.2,479,254,225,112.9
'36420, 무안군,'005003, 2세,2019,547,276,271,101.8,547,276,271,101.8
'36420, 무안군,'005004, 3세,2019,667,352,315,111.7,665,351,314,111.8
'36420, 무안군,'005005, 4세,2019,745,403,342,117.8,742,403,339,118.9
'36420, 무안군,'010,5~9세,2019,4352,2190,2162,101.3,4343,2186,2157,101.3
'36420, 무안군,'010001, 5세,2019,739,375,364,103,736,373,363,102.8
'36420, 무안군,'010002, 6세,2019,852,444,408,108.8,851,443,408,108.6
'36420, 무안군,'010003, 7세,2019,967,495,472,104.9,966,495,471,105.1
'36420, 무안군,'010004, 8세,2019,895,440,455,96.7,895,440,455,96.7
'36420, 무안군,'010005, 9세,2019,899,436,463,94.2,895,435,460,94.6
'36420, 무안군,'015,10~14세,2019,4137,2109,2028,104,4130,2104,2026,103.8
'36420, 무안군,'015001, 10세,2019,858,448,410,109.3,856,446,410,108.8
'36420, 무안군,'015002, 11세,2019,836,426,410,103.9,835,425,410,103.7
'36420, 무안군,'015003, 12세,2019,875,459,416,110.3,875,459,416,110.3
'36420, 무안군,'015004, 13세,2019,797,405,392,103.3,796,405,391,103.6
'36420, 무안군,'015005, 14세,2019,771,371,400,92.8,768,369,399,92.5
'36420, 무안군,'020,15~19세,2019,5380,2876,2504,114.9,5347,2858,2489,114.8
'36420, 무안군,'020001, 15세,2019,846,436,410,106.3,845,436,409,106.6
'36420, 무안군,'020002, 16세,2019,844,422,422,100,841,421,420,100.2
'36420, 무안군,'020003, 17세,2019,872,456,416,109.6,871,456,415,109.9
'36420, 무안군,'020004, 18세,2019,1108,578,530,109.1,1095,571,524,109
'36420, 무안군,'020005, 19세,2019,1710,984,726,135.5,1695,974,721,135.1
'36420, 무안군,'025,20~24세,2019,6702,3929,2773,141.7,6254,3663,2591,141.4
'36420, 무안군,'025001, 20세,2019,1452,735,717,102.5,1394,701,693,101.2
'36420, 무안군,'025002, 21세,2019,1431,751,680,110.4,1353,708,645,109.8
'36420, 무안군,'025003, 22세,2019,1438,852,586,145.4,1323,790,533,148.2
'36420, 무안군,'025004, 23세,2019,1264,854,410,208.3,1162,792,370,214.1
'36420, 무안군,'025005, 24세,2019,1117,737,380,193.9,1022,672,350,192
'36420, 무안군,'030,25~29세,2019,4091,2274,1817,125.2,3583,1939,1644,117.9
'36420, 무안군,'030001, 25세,2019,949,547,402,136.1,834,475,359,132.3
'36420, 무안군,'030002, 26세,2019,835,485,350,138.6,721,408,313,130.4
'36420, 무안군,'030003, 27세,2019,781,427,354,120.6,696,370,326,113.5
'36420, 무안군,'030004, 28세,2019,776,415,361,115,675,351,324,108.3
'36420, 무안군,'030005, 29세,2019,750,400,350,114.3,657,335,322,104
'36420, 무안군,'035,30~34세,2019,3923,2061,1862,110.7,3518,1814,1704,106.5
'36420, 무안군,'035001, 30세,2019,774,415,359,115.6,678,355,323,109.9
'36420, 무안군,'035002, 31세,2019,705,374,331,113,613,318,295,107.8
'36420, 무안군,'035003, 32세,2019,745,365,380,96.1,672,321,351,91.5
'36420, 무안군,'035004, 33세,2019,806,440,366,120.2,724,394,330,119.4
'36420, 무안군,'035005, 34세,2019,893,467,426,109.6,831,426,405,105.2
'36420, 무안군,'040,35~39세,2019,5841,2942,2899,101.5,5568,2799,2769,101.1
'36420, 무안군,'040001, 35세,2019,1017,499,518,96.3,943,463,480,96.5
'36420, 무안군,'040002, 36세,2019,1077,525,552,95.1,1020,495,525,94.3
'36420, 무안군,'040003, 37세,2019,1230,646,584,110.6,1181,619,562,110.1
'36420, 무안군,'040004, 38세,2019,1206,617,589,104.8,1160,593,567,104.6
'36420, 무안군,'040005, 39세,2019,1311,655,656,99.8,1264,629,635,99.1
'36420, 무안군,'045,40~44세,2019,5903,3065,2838,108,5704,2941,2763,106.4
'36420, 무안군,'045001, 40세,2019,1251,659,592,111.3,1191,618,573,107.9
'36420, 무안군,'045002, 41세,2019,1135,577,558,103.4,1097,553,544,101.7
'36420, 무안군,'045003, 42세,2019,1207,596,611,97.5,1177,579,598,96.8
'36420, 무안군,'045004, 43세,2019,1151,624,527,118.4,1114,604,510,118.4
'36420, 무안군,'045005, 44세,2019,1159,609,550,110.7,1125,587,538,109.1
'36420, 무안군,'050,45~49세,2019,6148,3352,2796,119.9,6003,3269,2734,119.6
'36420, 무안군,'050001, 45세,2019,1261,693,568,122,1233,677,556,121.8
'36420, 무안군,'050002, 46세,2019,1216,641,575,111.5,1182,623,559,111.4
'36420, 무안군,'050003, 47세,2019,1170,626,544,115.1,1146,609,537,113.4
'36420, 무안군,'050004, 48세,2019,1299,739,560,132,1276,727,549,132.4
'36420, 무안군,'050005, 49세,2019,1202,653,549,118.9,1166,633,533,118.8
'36420, 무안군,'055,50~54세,2019,5756,3129,2627,119.1,5636,3074,2562,120
'36420, 무안군,'055001, 50세,2019,1193,667,526,126.8,1168,656,512,128.1
'36420, 무안군,'055002, 51세,2019,1229,666,563,118.3,1199,647,552,117.2
'36420, 무안군,'055003, 52세,2019,1103,573,530,108.1,1086,568,518,109.7
'36420, 무안군,'055004, 53세,2019,1148,631,517,122.1,1129,624,505,123.6
'36420, 무안군,'055005, 54세,2019,1083,592,491,120.6,1054,579,475,121.9
'36420, 무안군,'060,55~59세,2019,5725,3032,2693,112.6,5641,2996,2645,113.3
'36420, 무안군,'060001, 55세,2019,1041,587,454,129.3,1022,578,444,130.2
'36420, 무안군,'060002, 56세,2019,1109,570,539,105.8,1087,561,526,106.7
'36420, 무안군,'060003, 57세,2019,1116,602,514,117.1,1102,594,508,116.9
'36420, 무안군,'060004, 58세,2019,1206,628,578,108.7,1194,623,571,109.1
'36420, 무안군,'060005, 59세,2019,1253,645,608,106.1,1236,640,596,107.4
'36420, 무안군,'065,60~64세,2019,5200,2572,2628,97.9,5160,2549,2611,97.6
'36420, 무안군,'065001, 60세,2019,1099,543,556,97.7,1093,539,554,97.3
'36420, 무안군,'065002, 61세,2019,1077,550,527,104.4,1068,544,524,103.8
'36420, 무안군,'065003, 62세,2019,1072,519,553,93.9,1061,514,547,94
'36420, 무안군,'065004, 63세,2019,932,463,469,98.7,925,459,466,98.5
'36420, 무안군,'065005, 64세,2019,1020,497,523,95,1013,493,520,94.8
'36420, 무안군,'070,65~69세,2019,4188,2041,2147,95.1,4164,2030,2134,95.1
'36420, 무안군,'070001, 65세,2019,888,423,465,91,876,419,457,91.7
'36420, 무안군,'070002, 66세,2019,771,404,367,110.1,766,400,366,109.3
'36420, 무안군,'070003, 67세,2019,915,439,476,92.2,913,439,474,92.6
'36420, 무안군,'070004, 68세,2019,807,394,413,95.4,804,392,412,95.1
'36420, 무안군,'070005, 69세,2019,807,381,426,89.4,805,380,425,89.4
'36420, 무안군,'075,70~74세,2019,3842,1832,2010,91.1,3830,1824,2006,90.9
'36420, 무안군,'075001, 70세,2019,824,413,411,100.5,817,409,408,100.2
'36420, 무안군,'075002, 71세,2019,839,419,420,99.8,838,418,420,99.5
'36420, 무안군,'075003, 72세,2019,820,388,432,89.8,820,388,432,89.8
'36420, 무안군,'075004, 73세,2019,668,303,365,83,667,302,365,82.7
'36420, 무안군,'075005, 74세,2019,691,309,382,80.9,688,307,381,80.6
'36420, 무안군,'080,75~79세,2019,3598,1445,2153,67.1,3596,1443,2153,67
'36420, 무안군,'080001, 75세,2019,631,262,369,71,630,261,369,70.7
'36420, 무안군,'080002, 76세,2019,627,273,354,77.1,627,273,354,77.1
'36420, 무안군,'080003, 77세,2019,935,386,549,70.3,935,386,549,70.3
'36420, 무안군,'080004, 78세,2019,736,284,452,62.8,736,284,452,62.8
'36420, 무안군,'080005, 79세,2019,669,240,429,55.9,668,239,429,55.7
'36420, 무안군,'085,80~84세,2019,2460,822,1638,50.2,2459,822,1637,50.2
'36420, 무안군,'085001, 80세,2019,594,214,380,56.3,593,214,379,56.5
'36420, 무안군,'085002, 81세,2019,575,207,368,56.3,575,207,368,56.3
'36420, 무안군,'085003, 82세,2019,483,157,326,48.2,483,157,326,48.2
'36420, 무안군,'085004, 83세,2019,398,123,275,44.7,398,123,275,44.7
'36420, 무안군,'085005, 84세,2019,410,121,289,41.9,410,121,289,41.9
'36420, 무안군,'086,85세이상,2019,1671,398,1273,31.3,1669,397,1272,31.2
'36420, 무안군,'090,85~89세,2019,1208,308,900,34.2,1207,307,900,34.1
'36420, 무안군,'090001, 85세,2019,356,115,241,47.7,356,115,241,47.7
'36420, 무안군,'090002, 86세,2019,292,75,217,34.6,292,75,217,34.6
'36420, 무안군,'090003, 87세,2019,213,48,165,29.1,213,48,165,29.1
'36420, 무안군,'090004, 88세,2019,166,43,123,35,166,43,123,35
'36420, 무안군,'090005, 89세,2019,181,27,154,17.5,180,26,154,16.9
'36420, 무안군,'095,90~94세,2019,378,82,296,27.7,377,82,295,27.8
'36420, 무안군,'095001, 90세,2019,135,33,102,32.4,135,33,102,32.4
'36420, 무안군,'095002, 91세,2019,102,21,81,25.9,101,21,80,26.3
'36420, 무안군,'095003, 92세,2019,55,12,43,27.9,55,12,43,27.9
'36420, 무안군,'095004, 93세,2019,45,9,36,25,45,9,36,25
'36420, 무안군,'095005, 94세,2019,41,7,34,20.6,41,7,34,20.6
'36420, 무안군,'100,95~99세,2019,73,8,65,12.3,73,8,65,12.3
'36420, 무안군,'100001, 95세,2019,19,X,18,5.6,19,X,18,5.6
'36420, 무안군,'100002, 96세,2019,29,X,25,16,29,X,25,16
'36420, 무안군,'100003, 97세,2019,12,X,11,9.1,12,X,11,9.1
'36420, 무안군,'100004, 98세,2019,9,X,9,0,9,X,9,0
'36420, 무안군,'100005, 99세,2019,X,X,X,100,X,X,X,100
'36420, 무안군,'101,100세이상,2019,12,X,12,0,12,X,12,0
'36420, 무안군,'102,15세미만,2019,11361,5801,5560,104.3,11334,5787,5547,104.3
'36420, 무안군,'103,15~64세,2019,54669,29232,25437,114.9,52414,27902,24512,113.8
'36420, 무안군,'104,65세이상,2019,15759,6538,9221,70.9,15718,6516,9202,70.8
'36420, 무안군,'126,평균연령,2019,42.6,40.9,44.4,,42.9,41.1,44.7,
'36420, 무안군,'127,중위연령,2019,43,41.4,44.7,,43.6,42.1,45.2,
'36430, 함평군,'000,합계,2019,30556,15229,15327,99.4,29573,14681,14892,98.6
'36430, 함평군,'005,0~4세,2019,654,346,308,112.3,652,344,308,111.7
'36430, 함평군,'005001, 0세,2019,123,62,61,101.6,123,62,61,101.6
'36430, 함평군,'005002, 1세,2019,117,62,55,112.7,117,62,55,112.7
'36430, 함평군,'005003, 2세,2019,142,89,53,167.9,140,87,53,164.2
'36430, 함평군,'005004, 3세,2019,143,77,66,116.7,143,77,66,116.7
'36430, 함평군,'005005, 4세,2019,129,56,73,76.7,129,56,73,76.7
'36430, 함평군,'010,5~9세,2019,830,430,400,107.5,830,430,400,107.5
'36430, 함평군,'010001, 5세,2019,150,68,82,82.9,150,68,82,82.9
'36430, 함평군,'010002, 6세,2019,169,89,80,111.3,169,89,80,111.3
'36430, 함평군,'010003, 7세,2019,169,89,80,111.3,169,89,80,111.3
'36430, 함평군,'010004, 8세,2019,189,104,85,122.4,189,104,85,122.4
'36430, 함평군,'010005, 9세,2019,153,80,73,109.6,153,80,73,109.6
'36430, 함평군,'015,10~14세,2019,878,466,412,113.1,878,466,412,113.1
'36430, 함평군,'015001, 10세,2019,152,90,62,145.2,152,90,62,145.2
'36430, 함평군,'015002, 11세,2019,167,82,85,96.5,167,82,85,96.5
'36430, 함평군,'015003, 12세,2019,179,92,87,105.7,179,92,87,105.7
'36430, 함평군,'015004, 13세,2019,190,99,91,108.8,190,99,91,108.8
'36430, 함평군,'015005, 14세,2019,190,103,87,118.4,190,103,87,118.4
'36430, 함평군,'020,15~19세,2019,1471,751,720,104.3,1461,745,716,104.1
'36430, 함평군,'020001, 15세,2019,250,129,121,106.6,249,129,120,107.5
'36430, 함평군,'020002, 16세,2019,346,168,178,94.4,346,168,178,94.4
'36430, 함평군,'020003, 17세,2019,343,172,171,100.6,343,172,171,100.6
'36430, 함평군,'020004, 18세,2019,341,168,173,97.1,340,167,173,96.5
'36430, 함평군,'020005, 19세,2019,191,114,77,148.1,183,109,74,147.3
'36430, 함평군,'025,20~24세,2019,1224,770,454,169.6,1055,658,397,165.7
'36430, 함평군,'025001, 20세,2019,218,156,62,251.6,202,145,57,254.4
'36430, 함평군,'025002, 21세,2019,232,155,77,201.3,208,135,73,184.9
'36430, 함평군,'025003, 22세,2019,235,141,94,150,208,128,80,160
'36430, 함평군,'025004, 23세,2019,271,155,116,133.6,228,127,101,125.7
'36430, 함평군,'025005, 24세,2019,268,163,105,155.2,209,123,86,143
'36430, 함평군,'030,25~29세,2019,1206,706,500,141.2,963,564,399,141.4
'36430, 함평군,'030001, 25세,2019,258,162,96,168.8,203,129,74,174.3
'36430, 함평군,'030002, 26세,2019,225,132,93,141.9,185,107,78,137.2
'36430, 함평군,'030003, 27세,2019,264,157,107,146.7,208,117,91,128.6
'36430, 함평군,'030004, 28세,2019,236,133,103,129.1,186,111,75,148
'36430, 함평군,'030005, 29세,2019,223,122,101,120.8,181,100,81,123.5
'36430, 함평군,'035,30~34세,2019,1075,572,503,113.7,901,484,417,116.1
'36430, 함평군,'035001, 30세,2019,207,111,96,115.6,171,92,79,116.5
'36430, 함평군,'035002, 31세,2019,236,112,124,90.3,198,97,101,96
'36430, 함평군,'035003, 32세,2019,212,121,91,133,178,103,75,137.3
'36430, 함평군,'035004, 33세,2019,198,110,88,125,159,88,71,123.9
'36430, 함평군,'035005, 34세,2019,222,118,104,113.5,195,104,91,114.3
'36430, 함평군,'040,35~39세,2019,1220,674,546,123.4,1120,625,495,126.3
'36430, 함평군,'040001, 35세,2019,193,101,92,109.8,173,89,84,106
'36430, 함평군,'040002, 36세,2019,247,131,116,112.9,224,122,102,119.6
'36430, 함평군,'040003, 37세,2019,250,131,119,110.1,228,118,110,107.3
'36430, 함평군,'040004, 38세,2019,274,158,116,136.2,254,148,106,139.6
'36430, 함평군,'040005, 39세,2019,256,153,103,148.5,241,148,93,159.1
'36430, 함평군,'045,40~44세,2019,1424,793,631,125.7,1333,737,596,123.7
'36430, 함평군,'045001, 40세,2019,272,155,117,132.5,249,138,111,124.3
'36430, 함평군,'045002, 41세,2019,260,154,106,145.3,243,146,97,150.5
'36430, 함평군,'045003, 42세,2019,269,145,124,116.9,251,133,118,112.7
'36430, 함평군,'045004, 43세,2019,286,160,126,127,273,152,121,125.6
'36430, 함평군,'045005, 44세,2019,337,179,158,113.3,317,168,149,112.8
'36430, 함평군,'050,45~49세,2019,1897,1136,761,149.3,1839,1102,737,149.5
'36430, 함평군,'050001, 45세,2019,351,218,133,163.9,344,214,130,164.6
'36430, 함평군,'050002, 46세,2019,375,222,153,145.1,361,213,148,143.9
'36430, 함평군,'050003, 47세,2019,379,229,150,152.7,363,220,143,153.8
'36430, 함평군,'050004, 48세,2019,407,240,167,143.7,396,234,162,144.4
'36430, 함평군,'050005, 49세,2019,385,227,158,143.7,375,221,154,143.5
'36430, 함평군,'055,50~54세,2019,2370,1380,990,139.4,2318,1356,962,141
'36430, 함평군,'055001, 50세,2019,434,236,198,119.2,425,234,191,122.5
'36430, 함평군,'055002, 51세,2019,474,281,193,145.6,463,279,184,151.6
'36430, 함평군,'055003, 52세,2019,470,275,195,141,460,269,191,140.8
'36430, 함평군,'055004, 53세,2019,499,306,193,158.5,489,299,190,157.4
'36430, 함평군,'055005, 54세,2019,493,282,211,133.6,481,275,206,133.5
'36430, 함평군,'060,55~59세,2019,2752,1486,1266,117.4,2717,1474,1243,118.6
'36430, 함평군,'060001, 55세,2019,447,243,204,119.1,441,241,200,120.5
'36430, 함평군,'060002, 56세,2019,545,300,245,122.4,535,296,239,123.8
'36430, 함평군,'060003, 57세,2019,533,293,240,122.1,527,291,236,123.3
'36430, 함평군,'060004, 58세,2019,600,320,280,114.3,592,319,273,116.8
'36430, 함평군,'060005, 59세,2019,627,330,297,111.1,622,327,295,110.8
'36430, 함평군,'065,60~64세,2019,2855,1475,1380,106.9,2826,1464,1362,107.5
'36430, 함평군,'065001, 60세,2019,576,317,259,122.4,569,315,254,124
'36430, 함평군,'065002, 61세,2019,565,288,277,104,558,285,273,104.4
'36430, 함평군,'065003, 62세,2019,616,313,303,103.3,609,310,299,103.7
'36430, 함평군,'065004, 63세,2019,525,281,244,115.2,521,279,242,115.3
'36430, 함평군,'065005, 64세,2019,573,276,297,92.9,569,275,294,93.5
'36430, 함평군,'070,65~69세,2019,2354,1138,1216,93.6,2339,1127,1212,93
'36430, 함평군,'070001, 65세,2019,456,247,209,118.2,451,242,209,115.8
'36430, 함평군,'070002, 66세,2019,461,215,246,87.4,458,213,245,86.9
'36430, 함평군,'070003, 67세,2019,518,242,276,87.7,515,239,276,86.6
'36430, 함평군,'070004, 68세,2019,428,206,222,92.8,427,206,221,93.2
'36430, 함평군,'070005, 69세,2019,491,228,263,86.7,488,227,261,87
'36430, 함평군,'075,70~74세,2019,2375,1068,1307,81.7,2371,1067,1304,81.8
'36430, 함평군,'075001, 70세,2019,479,240,239,100.4,478,239,239,100
'36430, 함평군,'075002, 71세,2019,486,211,275,76.7,484,211,273,77.3
'36430, 함평군,'075003, 72세,2019,514,246,268,91.8,514,246,268,91.8
'36430, 함평군,'075004, 73세,2019,473,204,269,75.8,473,204,269,75.8
'36430, 함평군,'075005, 74세,2019,423,167,256,65.2,422,167,255,65.5
'36430, 함평군,'080,75~79세,2019,2622,1025,1597,64.2,2622,1025,1597,64.2
'36430, 함평군,'080001, 75세,2019,421,154,267,57.7,421,154,267,57.7
'36430, 함평군,'080002, 76세,2019,455,182,273,66.7,455,182,273,66.7
'36430, 함평군,'080003, 77세,2019,673,274,399,68.7,673,274,399,68.7
'36430, 함평군,'080004, 78세,2019,544,213,331,64.4,544,213,331,64.4
'36430, 함평군,'080005, 79세,2019,529,202,327,61.8,529,202,327,61.8
'36430, 함평군,'085,80~84세,2019,2009,659,1350,48.8,2009,659,1350,48.8
'36430, 함평군,'085001, 80세,2019,459,160,299,53.5,459,160,299,53.5
'36430, 함평군,'085002, 81세,2019,481,162,319,50.8,481,162,319,50.8
'36430, 함평군,'085003, 82세,2019,397,126,271,46.5,397,126,271,46.5
'36430, 함평군,'085004, 83세,2019,335,116,219,53,335,116,219,53
'36430, 함평군,'085005, 84세,2019,337,95,242,39.3,337,95,242,39.3
'36430, 함평군,'086,85세이상,2019,1340,354,986,35.9,1339,354,985,35.9
'36430, 함평군,'090,85~89세,2019,965,269,696,38.6,965,269,696,38.6
'36430, 함평군,'090001, 85세,2019,287,89,198,44.9,287,89,198,44.9
'36430, 함평군,'090002, 86세,2019,211,57,154,37,211,57,154,37
'36430, 함평군,'090003, 87세,2019,166,40,126,31.7,166,40,126,31.7
'36430, 함평군,'090004, 88세,2019,160,42,118,35.6,160,42,118,35.6
'36430, 함평군,'090005, 89세,2019,141,41,100,41,141,41,100,41
'36430, 함평군,'095,90~94세,2019,295,73,222,32.9,295,73,222,32.9
'36430, 함평군,'095001, 90세,2019,100,30,70,42.9,100,30,70,42.9
'36430, 함평군,'095002, 91세,2019,78,17,61,27.9,78,17,61,27.9
'36430, 함평군,'095003, 92세,2019,56,14,42,33.3,56,14,42,33.3
'36430, 함평군,'095004, 93세,2019,33,9,24,37.5,33,9,24,37.5
'36430, 함평군,'095005, 94세,2019,28,X,25,12,28,X,25,12
'36430, 함평군,'100,95~99세,2019,72,12,60,20,72,12,60,20
'36430, 함평군,'100001, 95세,2019,16,X,12,33.3,16,X,12,33.3
'36430, 함평군,'100002, 96세,2019,25,X,21,19,25,X,21,19
'36430, 함평군,'100003, 97세,2019,15,X,13,15.4,15,X,13,15.4
'36430, 함평군,'100004, 98세,2019,9,X,8,12.5,9,X,8,12.5
'36430, 함평군,'100005, 99세,2019,7,X,6,16.7,7,X,6,16.7
'36430, 함평군,'101,100세이상,2019,8,X,8,0,7,X,7,0
'36430, 함평군,'102,15세미만,2019,2362,1242,1120,110.9,2360,1240,1120,110.7
'36430, 함평군,'103,15~64세,2019,17494,9743,7751,125.7,16533,9209,7324,125.7
'36430, 함평군,'104,65세이상,2019,10700,4244,6456,65.7,10680,4232,6448,65.6
'36430, 함평군,'126,평균연령,2019,52.9,50,55.9,,53.5,50.6,56.4,
'36430, 함평군,'127,중위연령,2019,57.1,53.6,60.7,,57.9,54.4,61.4,
'36440, 영광군,'000,합계,2019,50004,25007,24997,100,48700,24240,24460,99.1
'36440, 영광군,'005,0~4세,2019,1907,958,949,100.9,1905,957,948,100.9
'36440, 영광군,'005001, 0세,2019,523,270,253,106.7,523,270,253,106.7
'36440, 영광군,'005002, 1세,2019,346,169,177,95.5,346,169,177,95.5
'36440, 영광군,'005003, 2세,2019,352,175,177,98.9,352,175,177,98.9
'36440, 영광군,'005004, 3세,2019,373,189,184,102.7,371,188,183,102.7
'36440, 영광군,'005005, 4세,2019,313,155,158,98.1,313,155,158,98.1
'36440, 영광군,'010,5~9세,2019,1767,915,852,107.4,1763,913,850,107.4
'36440, 영광군,'010001, 5세,2019,337,173,164,105.5,336,172,164,104.9
'36440, 영광군,'010002, 6세,2019,315,165,150,110,314,165,149,110.7
'36440, 영광군,'010003, 7세,2019,394,202,192,105.2,394,202,192,105.2
'36440, 영광군,'010004, 8세,2019,372,187,185,101.1,371,187,184,101.6
'36440, 영광군,'010005, 9세,2019,349,188,161,116.8,348,187,161,116.1
'36440, 영광군,'015,10~14세,2019,1787,914,873,104.7,1784,913,871,104.8
'36440, 영광군,'015001, 10세,2019,326,159,167,95.2,326,159,167,95.2
'36440, 영광군,'015002, 11세,2019,382,193,189,102.1,382,193,189,102.1
'36440, 영광군,'015003, 12세,2019,385,193,192,100.5,384,193,191,101
'36440, 영광군,'015004, 13세,2019,357,189,168,112.5,356,188,168,111.9
'36440, 영광군,'015005, 14세,2019,337,180,157,114.6,336,180,156,115.4
'36440, 영광군,'020,15~19세,2019,2235,1192,1043,114.3,2224,1188,1036,114.7
'36440, 영광군,'020001, 15세,2019,390,199,191,104.2,389,198,191,103.7
'36440, 영광군,'020002, 16세,2019,465,240,225,106.7,465,240,225,106.7
'36440, 영광군,'020003, 17세,2019,533,282,251,112.4,533,282,251,112.4
'36440, 영광군,'020004, 18세,2019,525,272,253,107.5,523,271,252,107.5
'36440, 영광군,'020005, 19세,2019,322,199,123,161.8,314,197,117,168.4
'36440, 영광군,'025,20~24세,2019,2096,1302,794,164,1946,1191,755,157.7
'36440, 영광군,'025001, 20세,2019,370,257,113,227.4,359,250,109,229.4
'36440, 영광군,'025002, 21세,2019,423,290,133,218,401,273,128,213.3
'36440, 영광군,'025003, 22세,2019,421,249,172,144.8,384,220,164,134.1
'36440, 영광군,'025004, 23세,2019,433,254,179,141.9,400,227,173,131.2
'36440, 영광군,'025005, 24세,2019,449,252,197,127.9,402,221,181,122.1
'36440, 영광군,'030,25~29세,2019,2369,1281,1088,117.7,2079,1081,998,108.3
'36440, 영광군,'030001, 25세,2019,489,263,226,116.4,427,222,205,108.3
'36440, 영광군,'030002, 26세,2019,458,255,203,125.6,392,206,186,110.8
'36440, 영광군,'030003, 27세,2019,502,259,243,106.6,448,219,229,95.6
'36440, 영광군,'030004, 28세,2019,430,246,184,133.7,379,209,170,122.9
'36440, 영광군,'030005, 29세,2019,490,258,232,111.2,433,225,208,108.2
'36440, 영광군,'035,30~34세,2019,2294,1172,1122,104.5,2079,1061,1018,104.2
'36440, 영광군,'035001, 30세,2019,434,237,197,120.3,388,208,180,115.6
'36440, 영광군,'035002, 31세,2019,460,236,224,105.4,415,215,200,107.5
'36440, 영광군,'035003, 32세,2019,502,243,259,93.8,451,219,232,94.4
'36440, 영광군,'035004, 33세,2019,424,230,194,118.6,391,212,179,118.4
'36440, 영광군,'035005, 34세,2019,474,226,248,91.1,434,207,227,91.2
'36440, 영광군,'040,35~39세,2019,2635,1389,1246,111.5,2462,1291,1171,110.2
'36440, 영광군,'040001, 35세,2019,502,258,244,105.7,460,236,224,105.4
'36440, 영광군,'040002, 36세,2019,503,271,232,116.8,475,253,222,114
'36440, 영광군,'040003, 37세,2019,555,310,245,126.5,517,287,230,124.8
'36440, 영광군,'040004, 38세,2019,519,257,262,98.1,485,237,248,95.6
'36440, 영광군,'040005, 39세,2019,556,293,263,111.4,525,278,247,112.6
'36440, 영광군,'045,40~44세,2019,2772,1554,1218,127.6,2682,1500,1182,126.9
'36440, 영광군,'045001, 40세,2019,596,330,266,124.1,578,316,262,120.6
'36440, 영광군,'045002, 41세,2019,545,284,261,108.8,527,276,251,110
'36440, 영광군,'045003, 42세,2019,518,310,208,149,496,298,198,150.5
'36440, 영광군,'045004, 43세,2019,527,310,217,142.9,510,300,210,142.9
'36440, 영광군,'045005, 44세,2019,586,320,266,120.3,571,310,261,118.8
'36440, 영광군,'050,45~49세,2019,3625,2051,1574,130.3,3513,1992,1521,131
'36440, 영광군,'050001, 45세,2019,710,400,310,129,696,394,302,130.5
'36440, 영광군,'050002, 46세,2019,687,397,290,136.9,663,385,278,138.5
'36440, 영광군,'050003, 47세,2019,699,390,309,126.2,671,372,299,124.4
'36440, 영광군,'050004, 48세,2019,802,451,351,128.5,783,444,339,131
'36440, 영광군,'050005, 49세,2019,727,413,314,131.5,700,397,303,131
'36440, 영광군,'055,50~54세,2019,3888,2137,1751,122,3780,2082,1698,122.6
'36440, 영광군,'055001, 50세,2019,738,430,308,139.6,715,419,296,141.6
'36440, 영광군,'055002, 51세,2019,781,432,349,123.8,759,424,335,126.6
'36440, 영광군,'055003, 52세,2019,794,441,353,124.9,775,434,341,127.3
'36440, 영광군,'055004, 53세,2019,773,411,362,113.5,750,398,352,113.1
'36440, 영광군,'055005, 54세,2019,802,423,379,111.6,781,407,374,108.8
'36440, 영광군,'060,55~59세,2019,4332,2283,2049,111.4,4270,2254,2016,111.8
'36440, 영광군,'060001, 55세,2019,792,431,361,119.4,777,426,351,121.4
'36440, 영광군,'060002, 56세,2019,829,428,401,106.7,811,422,389,108.5
'36440, 영광군,'060003, 57세,2019,811,430,381,112.9,801,422,379,111.3
'36440, 영광군,'060004, 58세,2019,904,478,426,112.2,898,473,425,111.3
'36440, 영광군,'060005, 59세,2019,996,516,480,107.5,983,511,472,108.3
'36440, 영광군,'065,60~64세,2019,4207,2144,2063,103.9,4157,2120,2037,104.1
'36440, 영광군,'065001, 60세,2019,839,424,415,102.2,834,421,413,101.9
'36440, 영광군,'065002, 61세,2019,889,469,420,111.7,879,463,416,111.3
'36440, 영광군,'065003, 62세,2019,851,438,413,106.1,840,433,407,106.4
'36440, 영광군,'065004, 63세,2019,793,407,386,105.4,779,399,380,105
'36440, 영광군,'065005, 64세,2019,835,406,429,94.6,825,404,421,96
'36440, 영광군,'070,65~69세,2019,3432,1614,1818,88.8,3408,1601,1807,88.6
'36440, 영광군,'070001, 65세,2019,693,347,346,100.3,683,341,342,99.7
'36440, 영광군,'070002, 66세,2019,642,292,350,83.4,638,291,347,83.9
'36440, 영광군,'070003, 67세,2019,718,342,376,91,714,338,376,89.9
'36440, 영광군,'070004, 68세,2019,644,290,354,81.9,641,290,351,82.6
'36440, 영광군,'070005, 69세,2019,735,343,392,87.5,732,341,391,87.2
'36440, 영광군,'075,70~74세,2019,3349,1537,1812,84.8,3344,1534,1810,84.8
'36440, 영광군,'075001, 70세,2019,724,345,379,91,722,344,378,91
'36440, 영광군,'075002, 71세,2019,672,320,352,90.9,671,320,351,91.2
'36440, 영광군,'075003, 72세,2019,771,359,412,87.1,770,358,412,86.9
'36440, 영광군,'075004, 73세,2019,592,259,333,77.8,591,258,333,77.5
'36440, 영광군,'075005, 74세,2019,590,254,336,75.6,590,254,336,75.6
'36440, 영광군,'080,75~79세,2019,3448,1364,2084,65.5,3448,1364,2084,65.5
'36440, 영광군,'080001, 75세,2019,581,233,348,67,581,233,348,67
'36440, 영광군,'080002, 76세,2019,651,267,384,69.5,651,267,384,69.5
'36440, 영광군,'080003, 77세,2019,897,374,523,71.5,897,374,523,71.5
'36440, 영광군,'080004, 78세,2019,690,272,418,65.1,690,272,418,65.1
'36440, 영광군,'080005, 79세,2019,629,218,411,53,629,218,411,53
'36440, 영광군,'085,80~84세,2019,2451,828,1623,51,2449,828,1621,51.1
'36440, 영광군,'085001, 80세,2019,601,219,382,57.3,601,219,382,57.3
'36440, 영광군,'085002, 81세,2019,554,200,354,56.5,553,200,353,56.7
'36440, 영광군,'085003, 82세,2019,482,150,332,45.2,481,150,331,45.3
'36440, 영광군,'085004, 83세,2019,391,138,253,54.5,391,138,253,54.5
'36440, 영광군,'085005, 84세,2019,423,121,302,40.1,423,121,302,40.1
'36440, 영광군,'086,85세이상,2019,1410,372,1038,35.8,1407,370,1037,35.7
'36440, 영광군,'090,85~89세,2019,1001,285,716,39.8,998,283,715,39.6
'36440, 영광군,'090001, 85세,2019,311,107,204,52.5,311,107,204,52.5
'36440, 영광군,'090002, 86세,2019,235,59,176,33.5,234,58,176,33
'36440, 영광군,'090003, 87세,2019,172,51,121,42.1,171,50,121,41.3
'36440, 영광군,'090004, 88세,2019,132,42,90,46.7,131,42,89,47.2
'36440, 영광군,'090005, 89세,2019,151,26,125,20.8,151,26,125,20.8
'36440, 영광군,'095,90~94세,2019,309,74,235,31.5,309,74,235,31.5
'36440, 영광군,'095001, 90세,2019,109,36,73,49.3,109,36,73,49.3
'36440, 영광군,'095002, 91세,2019,78,17,61,27.9,78,17,61,27.9
'36440, 영광군,'095003, 92세,2019,68,16,52,30.8,68,16,52,30.8
'36440, 영광군,'095004, 93세,2019,24,X,21,14.3,24,X,21,14.3
'36440, 영광군,'095005, 94세,2019,30,X,28,7.1,30,X,28,7.1
'36440, 영광군,'100,95~99세,2019,87,12,75,16,87,12,75,16
'36440, 영광군,'100001, 95세,2019,23,5,18,27.8,23,5,18,27.8
'36440, 영광군,'100002, 96세,2019,29,5,24,20.8,29,5,24,20.8
'36440, 영광군,'100003, 97세,2019,19,X,18,5.6,19,X,18,5.6
'36440, 영광군,'100004, 98세,2019,12,X,12,0,12,X,12,0
'36440, 영광군,'100005, 99세,2019,X,X,X,33.3,X,X,X,33.3
'36440, 영광군,'101,100세이상,2019,13,X,12,8.3,13,X,12,8.3
'36440, 영광군,'102,15세미만,2019,5461,2787,2674,104.2,5452,2783,2669,104.3
'36440, 영광군,'103,15~64세,2019,30453,16505,13948,118.3,29192,15760,13432,117.3
'36440, 영광군,'104,65세이상,2019,14090,5715,8375,68.2,14056,5697,8359,68.2
'36440, 영광군,'126,평균연령,2019,48.8,46.5,51.1,,49.1,46.9,51.3,
'36440, 영광군,'127,중위연령,2019,52,49.5,55,,52.6,50.1,55.5,
'36450, 장성군,'000,합계,2019,42193,21369,20824,102.6,40650,20429,20221,101
'36450, 장성군,'005,0~4세,2019,1397,690,707,97.6,1395,689,706,97.6
'36450, 장성군,'005001, 0세,2019,250,138,112,123.2,249,138,111,124.3
'36450, 장성군,'005002, 1세,2019,275,132,143,92.3,274,131,143,91.6
'36450, 장성군,'005003, 2세,2019,269,136,133,102.3,269,136,133,102.3
'36450, 장성군,'005004, 3세,2019,310,145,165,87.9,310,145,165,87.9
'36450, 장성군,'005005, 4세,2019,293,139,154,90.3,293,139,154,90.3
'36450, 장성군,'010,5~9세,2019,1543,796,747,106.6,1542,795,747,106.4
'36450, 장성군,'010001, 5세,2019,300,158,142,111.3,300,158,142,111.3
'36450, 장성군,'010002, 6세,2019,288,143,145,98.6,288,143,145,98.6
'36450, 장성군,'010003, 7세,2019,312,148,164,90.2,312,148,164,90.2
'36450, 장성군,'010004, 8세,2019,335,175,160,109.4,335,175,160,109.4
'36450, 장성군,'010005, 9세,2019,308,172,136,126.5,307,171,136,125.7
'36450, 장성군,'015,10~14세,2019,1429,750,679,110.5,1424,747,677,110.3
'36450, 장성군,'015001, 10세,2019,275,138,137,100.7,274,137,137,100
'36450, 장성군,'015002, 11세,2019,291,156,135,115.6,289,155,134,115.7
'36450, 장성군,'015003, 12세,2019,307,161,146,110.3,307,161,146,110.3
'36450, 장성군,'015004, 13세,2019,256,138,118,116.9,256,138,118,116.9
'36450, 장성군,'015005, 14세,2019,300,157,143,109.8,298,156,142,109.9
'36450, 장성군,'020,15~19세,2019,2022,1069,953,112.2,2004,1057,947,111.6
'36450, 장성군,'020001, 15세,2019,373,198,175,113.1,372,198,174,113.8
'36450, 장성군,'020002, 16세,2019,452,216,236,91.5,451,215,236,91.1
'36450, 장성군,'020003, 17세,2019,476,254,222,114.4,475,253,222,114
'36450, 장성군,'020004, 18세,2019,463,251,212,118.4,461,250,211,118.5
'36450, 장성군,'020005, 19세,2019,258,150,108,138.9,245,141,104,135.6
'36450, 장성군,'025,20~24세,2019,1718,1048,670,156.4,1511,906,605,149.8
'36450, 장성군,'025001, 20세,2019,319,218,101,215.8,295,201,94,213.8
'36450, 장성군,'025002, 21세,2019,323,220,103,213.6,292,197,95,207.4
'36450, 장성군,'025003, 22세,2019,331,200,131,152.7,290,175,115,152.2
'36450, 장성군,'025004, 23세,2019,361,200,161,124.2,314,163,151,107.9
'36450, 장성군,'025005, 24세,2019,384,210,174,120.7,320,170,150,113.3
'36450, 장성군,'030,25~29세,2019,2419,1532,887,172.7,2080,1309,771,169.8
'36450, 장성군,'030001, 25세,2019,449,272,177,153.7,388,230,158,145.6
'36450, 장성군,'030002, 26세,2019,605,416,189,220.1,540,376,164,229.3
'36450, 장성군,'030003, 27세,2019,510,326,184,177.2,434,278,156,178.2
'36450, 장성군,'030004, 28세,2019,463,284,179,158.7,392,236,156,151.3
'36450, 장성군,'030005, 29세,2019,392,234,158,148.1,326,189,137,138
'36450, 장성군,'035,30~34세,2019,1757,935,822,113.7,1487,768,719,106.8
'36450, 장성군,'035001, 30세,2019,369,191,178,107.3,305,150,155,96.8
'36450, 장성군,'035002, 31세,2019,338,184,154,119.5,287,155,132,117.4
'36450, 장성군,'035003, 32세,2019,328,175,153,114.4,271,141,130,108.5
'36450, 장성군,'035004, 33세,2019,384,191,193,99,333,160,173,92.5
'36450, 장성군,'035005, 34세,2019,338,194,144,134.7,291,162,129,125.6
'36450, 장성군,'040,35~39세,2019,2283,1224,1059,115.6,2057,1096,961,114
'36450, 장성군,'040001, 35세,2019,378,205,173,118.5,328,184,144,127.8
'36450, 장성군,'040002, 36세,2019,452,239,213,112.2,395,200,195,102.6
'36450, 장성군,'040003, 37세,2019,505,277,228,121.5,459,250,209,119.6
'36450, 장성군,'040004, 38세,2019,446,249,197,126.4,408,226,182,124.2
'36450, 장성군,'040005, 39세,2019,502,254,248,102.4,467,236,231,102.2
'36450, 장성군,'045,40~44세,2019,2304,1311,993,132,2168,1225,943,129.9
'36450, 장성군,'045001, 40세,2019,437,240,197,121.8,410,220,190,115.8
'36450, 장성군,'045002, 41세,2019,446,258,188,137.2,417,242,175,138.3
'36450, 장성군,'045003, 42세,2019,479,275,204,134.8,446,253,193,131.1
'36450, 장성군,'045004, 43세,2019,454,267,187,142.8,431,257,174,147.7
'36450, 장성군,'045005, 44세,2019,488,271,217,124.9,464,253,211,119.9
'36450, 장성군,'050,45~49세,2019,2959,1664,1295,128.5,2841,1597,1244,128.4
'36450, 장성군,'050001, 45세,2019,549,302,247,122.3,521,285,236,120.8
'36450, 장성군,'050002, 46세,2019,566,323,243,132.9,533,306,227,134.8
'36450, 장성군,'050003, 47세,2019,570,318,252,126.2,547,307,240,127.9
'36450, 장성군,'050004, 48세,2019,652,373,279,133.7,636,362,274,132.1
'36450, 장성군,'050005, 49세,2019,622,348,274,127,604,337,267,126.2
'36450, 장성군,'055,50~54세,2019,3179,1771,1408,125.8,3092,1729,1363,126.9
'36450, 장성군,'055001, 50세,2019,623,349,274,127.4,605,340,265,128.3
'36450, 장성군,'055002, 51세,2019,650,366,284,128.9,631,355,276,128.6
'36450, 장성군,'055003, 52세,2019,579,321,258,124.4,565,314,251,125.1
'36450, 장성군,'055004, 53세,2019,661,373,288,129.5,648,366,282,129.8
'36450, 장성군,'055005, 54세,2019,666,362,304,119.1,643,354,289,122.5
'36450, 장성군,'060,55~59세,2019,3669,1946,1723,112.9,3602,1915,1687,113.5
'36450, 장성군,'060001, 55세,2019,653,353,300,117.7,636,348,288,120.8
'36450, 장성군,'060002, 56세,2019,734,400,334,119.8,720,393,327,120.2
'36450, 장성군,'060003, 57세,2019,648,336,312,107.7,637,331,306,108.2
'36450, 장성군,'060004, 58세,2019,772,410,362,113.3,758,402,356,112.9
'36450, 장성군,'060005, 59세,2019,862,447,415,107.7,851,441,410,107.6
'36450, 장성군,'065,60~64세,2019,3429,1758,1671,105.2,3387,1736,1651,105.1
'36450, 장성군,'065001, 60세,2019,683,342,341,100.3,673,338,335,100.9
'36450, 장성군,'065002, 61세,2019,675,338,337,100.3,664,331,333,99.4
'36450, 장성군,'065003, 62세,2019,718,389,329,118.2,707,383,324,118.2
'36450, 장성군,'065004, 63세,2019,612,319,293,108.9,607,316,291,108.6
'36450, 장성군,'065005, 64세,2019,741,370,371,99.7,736,368,368,100
'36450, 장성군,'070,65~69세,2019,2750,1308,1442,90.7,2740,1303,1437,90.7
'36450, 장성군,'070001, 65세,2019,495,241,254,94.9,493,241,252,95.6
'36450, 장성군,'070002, 66세,2019,546,275,271,101.5,542,273,269,101.5
'36450, 장성군,'070003, 67세,2019,634,301,333,90.4,633,300,333,90.1
'36450, 장성군,'070004, 68세,2019,503,237,266,89.1,502,237,265,89.4
'36450, 장성군,'070005, 69세,2019,572,254,318,79.9,570,252,318,79.2
'36450, 장성군,'075,70~74세,2019,2726,1246,1480,84.2,2719,1243,1476,84.2
'36450, 장성군,'075001, 70세,2019,608,289,319,90.6,606,288,318,90.6
'36450, 장성군,'075002, 71세,2019,596,262,334,78.4,594,261,333,78.4
'36450, 장성군,'075003, 72세,2019,579,270,309,87.4,578,270,308,87.7
'36450, 장성군,'075004, 73세,2019,494,228,266,85.7,493,227,266,85.3
'36450, 장성군,'075005, 74세,2019,449,197,252,78.2,448,197,251,78.5
'36450, 장성군,'080,75~79세,2019,2928,1170,1758,66.6,2926,1168,1758,66.4
'36450, 장성군,'080001, 75세,2019,473,195,278,70.1,472,194,278,69.8
'36450, 장성군,'080002, 76세,2019,559,217,342,63.5,559,217,342,63.5
'36450, 장성군,'080003, 77세,2019,727,297,430,69.1,726,296,430,68.8
'36450, 장성군,'080004, 78세,2019,612,259,353,73.4,612,259,353,73.4
'36450, 장성군,'080005, 79세,2019,557,202,355,56.9,557,202,355,56.9
'36450, 장성군,'085,80~84세,2019,2229,766,1463,52.4,2225,763,1462,52.2
'36450, 장성군,'085001, 80세,2019,509,183,326,56.1,508,183,325,56.3
'36450, 장성군,'085002, 81세,2019,487,170,317,53.6,486,169,317,53.3
'36450, 장성군,'085003, 82세,2019,436,154,282,54.6,435,153,282,54.3
'36450, 장성군,'085004, 83세,2019,388,137,251,54.6,388,137,251,54.6
'36450, 장성군,'085005, 84세,2019,409,122,287,42.5,408,121,287,42.2
'36450, 장성군,'086,85세이상,2019,1452,385,1067,36.1,1450,383,1067,35.9
'36450, 장성군,'090,85~89세,2019,1050,291,759,38.3,1049,290,759,38.2
'36450, 장성군,'090001, 85세,2019,337,102,235,43.4,337,102,235,43.4
'36450, 장성군,'090002, 86세,2019,247,67,180,37.2,246,66,180,36.7
'36450, 장성군,'090003, 87세,2019,176,50,126,39.7,176,50,126,39.7
'36450, 장성군,'090004, 88세,2019,146,32,114,28.1,146,32,114,28.1
'36450, 장성군,'090005, 89세,2019,144,40,104,38.5,144,40,104,38.5
'36450, 장성군,'095,90~94세,2019,318,77,241,32,317,76,241,31.5
'36450, 장성군,'095001, 90세,2019,101,25,76,32.9,100,24,76,31.6
'36450, 장성군,'095002, 91세,2019,82,22,60,36.7,82,22,60,36.7
'36450, 장성군,'095003, 92세,2019,61,11,50,22,61,11,50,22
'36450, 장성군,'095004, 93세,2019,37,10,27,37,37,10,27,37
'36450, 장성군,'095005, 94세,2019,37,9,28,32.1,37,9,28,32.1
'36450, 장성군,'100,95~99세,2019,73,16,57,28.1,73,16,57,28.1
'36450, 장성군,'100001, 95세,2019,26,9,17,52.9,26,9,17,52.9
'36450, 장성군,'100002, 96세,2019,21,X,17,23.5,21,X,17,23.5
'36450, 장성군,'100003, 97세,2019,15,X,15,0,15,X,15,0
'36450, 장성군,'100004, 98세,2019,9,X,7,28.6,9,X,7,28.6
'36450, 장성군,'100005, 99세,2019,X,X,X,100,X,X,X,100
'36450, 장성군,'101,100세이상,2019,11,X,10,10,11,X,10,10
'36450, 장성군,'102,15세미만,2019,4369,2236,2133,104.8,4361,2231,2130,104.7
'36450, 장성군,'103,15~64세,2019,25739,14258,11481,124.2,24229,13338,10891,122.5
'36450, 장성군,'104,65세이상,2019,12085,4875,7210,67.6,12060,4860,7200,67.5
'36450, 장성군,'126,평균연령,2019,49.1,46.5,51.7,,49.6,47,52.1,
'36450, 장성군,'127,중위연령,2019,52,49,55.6,,53,50.1,56.4,
'36460, 완도군,'000,합계,2019,48366,25336,23030,110,45517,23033,22484,102.4
'36460, 완도군,'005,0~4세,2019,1529,789,740,106.6,1528,788,740,106.5
'36460, 완도군,'005001, 0세,2019,296,143,153,93.5,295,142,153,92.8
'36460, 완도군,'005002, 1세,2019,281,134,147,91.2,281,134,147,91.2
'36460, 완도군,'005003, 2세,2019,309,167,142,117.6,309,167,142,117.6
'36460, 완도군,'005004, 3세,2019,337,179,158,113.3,337,179,158,113.3
'36460, 완도군,'005005, 4세,2019,306,166,140,118.6,306,166,140,118.6
'36460, 완도군,'010,5~9세,2019,1794,915,879,104.1,1792,914,878,104.1
'36460, 완도군,'010001, 5세,2019,376,189,187,101.1,376,189,187,101.1
'36460, 완도군,'010002, 6세,2019,337,175,162,108,336,174,162,107.4
'36460, 완도군,'010003, 7세,2019,389,188,201,93.5,388,188,200,94
'36460, 완도군,'010004, 8세,2019,347,192,155,123.9,347,192,155,123.9
'36460, 완도군,'010005, 9세,2019,345,171,174,98.3,345,171,174,98.3
'36460, 완도군,'015,10~14세,2019,1578,814,764,106.5,1578,814,764,106.5
'36460, 완도군,'015001, 10세,2019,296,148,148,100,296,148,148,100
'36460, 완도군,'015002, 11세,2019,298,167,131,127.5,298,167,131,127.5
'36460, 완도군,'015003, 12세,2019,338,163,175,93.1,338,163,175,93.1
'36460, 완도군,'015004, 13세,2019,339,175,164,106.7,339,175,164,106.7
'36460, 완도군,'015005, 14세,2019,307,161,146,110.3,307,161,146,110.3
'36460, 완도군,'020,15~19세,2019,1523,841,682,123.3,1507,834,673,123.9
'36460, 완도군,'020001, 15세,2019,364,191,173,110.4,362,191,171,111.7
'36460, 완도군,'020002, 16세,2019,300,164,136,120.6,299,164,135,121.5
'36460, 완도군,'020003, 17세,2019,301,159,142,112,300,158,142,111.3
'36460, 완도군,'020004, 18세,2019,332,181,151,119.9,331,180,151,119.2
'36460, 완도군,'020005, 19세,2019,226,146,80,182.5,215,141,74,190.5
'36460, 완도군,'025,20~24세,2019,1706,1183,523,226.2,1335,875,460,190.2
'36460, 완도군,'025001, 20세,2019,301,226,75,301.3,281,215,66,325.8
'36460, 완도군,'025002, 21세,2019,300,222,78,284.6,263,198,65,304.6
'36460, 완도군,'025003, 22세,2019,327,207,120,172.5,254,150,104,144.2
'36460, 완도군,'025004, 23세,2019,358,238,120,198.3,262,157,105,149.5
'36460, 완도군,'025005, 24세,2019,420,290,130,223.1,275,155,120,129.2
'36460, 완도군,'030,25~29세,2019,2294,1548,746,207.5,1433,807,626,128.9
'36460, 완도군,'030001, 25세,2019,480,330,150,220,304,172,132,130.3
'36460, 완도군,'030002, 26세,2019,457,314,143,219.6,299,180,119,151.3
'36460, 완도군,'030003, 27세,2019,463,293,170,172.4,284,147,137,107.3
'36460, 완도군,'030004, 28세,2019,464,311,153,203.3,273,148,125,118.4
'36460, 완도군,'030005, 29세,2019,430,300,130,230.8,273,160,113,141.6
'36460, 완도군,'035,30~34세,2019,2264,1415,849,166.7,1617,859,758,113.3
'36460, 완도군,'035001, 30세,2019,465,302,163,185.3,303,159,144,110.4
'36460, 완도군,'035002, 31세,2019,407,240,167,143.7,284,140,144,97.2
'36460, 완도군,'035003, 32세,2019,430,280,150,186.7,310,173,137,126.3
'36460, 완도군,'035004, 33세,2019,480,302,178,169.7,347,186,161,115.5
'36460, 완도군,'035005, 34세,2019,482,291,191,152.4,373,201,172,116.9
'36460, 완도군,'040,35~39세,2019,2805,1689,1116,151.3,2406,1343,1063,126.3
'36460, 완도군,'040001, 35세,2019,486,295,191,154.5,397,215,182,118.1
'36460, 완도군,'040002, 36세,2019,569,343,226,151.8,479,262,217,120.7
'36460, 완도군,'040003, 37세,2019,570,341,229,148.9,500,284,216,131.5
'36460, 완도군,'040004, 38세,2019,555,342,213,160.6,476,274,202,135.6
'36460, 완도군,'040005, 39세,2019,625,368,257,143.2,554,308,246,125.2
'36460, 완도군,'045,40~44세,2019,2783,1669,1114,149.8,2578,1516,1062,142.7
'36460, 완도군,'045001, 40세,2019,599,332,267,124.3,541,290,251,115.5
'36460, 완도군,'045002, 41세,2019,544,328,216,151.9,507,297,210,141.4
'36460, 완도군,'045003, 42세,2019,564,351,213,164.8,521,316,205,154.1
'36460, 완도군,'045004, 43세,2019,532,322,210,153.3,494,297,197,150.8
'36460, 완도군,'045005, 44세,2019,544,336,208,161.5,515,316,199,158.8
'36460, 완도군,'050,45~49세,2019,3322,1938,1384,140,3199,1859,1340,138.7
'36460, 완도군,'050001, 45세,2019,626,379,247,153.4,594,355,239,148.5
'36460, 완도군,'050002, 46세,2019,627,364,263,138.4,608,351,257,136.6
'36460, 완도군,'050003, 47세,2019,685,391,294,133,659,375,284,132
'36460, 완도군,'050004, 48세,2019,689,401,288,139.2,668,390,278,140.3
'36460, 완도군,'050005, 49세,2019,695,403,292,138,670,388,282,137.6
'36460, 완도군,'055,50~54세,2019,3528,2020,1508,134,3433,1971,1462,134.8
'36460, 완도군,'055001, 50세,2019,693,405,288,140.6,671,396,275,144
'36460, 완도군,'055002, 51세,2019,722,430,292,147.3,700,419,281,149.1
'36460, 완도군,'055003, 52세,2019,701,383,318,120.4,684,370,314,117.8
'36460, 완도군,'055004, 53세,2019,719,429,290,147.9,702,421,281,149.8
'36460, 완도군,'055005, 54세,2019,693,373,320,116.6,676,365,311,117.4
'36460, 완도군,'060,55~59세,2019,4330,2200,2130,103.3,4259,2166,2093,103.5
'36460, 완도군,'060001, 55세,2019,709,374,335,111.6,695,366,329,111.2
'36460, 완도군,'060002, 56세,2019,824,436,388,112.4,800,425,375,113.3
'36460, 완도군,'060003, 57세,2019,868,444,424,104.7,851,435,416,104.6
'36460, 완도군,'060004, 58세,2019,884,441,443,99.5,878,439,439,100
'36460, 완도군,'060005, 59세,2019,1045,505,540,93.5,1035,501,534,93.8
'36460, 완도군,'065,60~64세,2019,4285,2163,2122,101.9,4252,2144,2108,101.7
'36460, 완도군,'065001, 60세,2019,907,449,458,98,896,445,451,98.7
'36460, 완도군,'065002, 61세,2019,809,403,406,99.3,803,397,406,97.8
'36460, 완도군,'065003, 62세,2019,854,424,430,98.6,845,420,425,98.8
'36460, 완도군,'065004, 63세,2019,825,446,379,117.7,818,441,377,117
'36460, 완도군,'065005, 64세,2019,890,441,449,98.2,890,441,449,98.2
'36460, 완도군,'070,65~69세,2019,3452,1680,1772,94.8,3436,1675,1761,95.1
'36460, 완도군,'070001, 65세,2019,664,329,335,98.2,662,329,333,98.8
'36460, 완도군,'070002, 66세,2019,580,282,298,94.6,578,281,297,94.6
'36460, 완도군,'070003, 67세,2019,738,360,378,95.2,735,359,376,95.5
'36460, 완도군,'070004, 68세,2019,749,370,379,97.6,745,369,376,98.1
'36460, 완도군,'070005, 69세,2019,721,339,382,88.7,716,337,379,88.9
'36460, 완도군,'075,70~74세,2019,3528,1665,1863,89.4,3525,1665,1860,89.5
'36460, 완도군,'075001, 70세,2019,716,363,353,102.8,716,363,353,102.8
'36460, 완도군,'075002, 71세,2019,713,332,381,87.1,712,332,380,87.4
'36460, 완도군,'075003, 72세,2019,795,366,429,85.3,794,366,428,85.5
'36460, 완도군,'075004, 73세,2019,586,285,301,94.7,585,285,300,95
'36460, 완도군,'075005, 74세,2019,718,319,399,79.9,718,319,399,79.9
'36460, 완도군,'080,75~79세,2019,3560,1505,2055,73.2,3557,1502,2055,73.1
'36460, 완도군,'080001, 75세,2019,661,293,368,79.6,661,293,368,79.6
'36460, 완도군,'080002, 76세,2019,637,259,378,68.5,635,257,378,68
'36460, 완도군,'080003, 77세,2019,848,392,456,86,848,392,456,86
'36460, 완도군,'080004, 78세,2019,720,292,428,68.2,720,292,428,68.2
'36460, 완도군,'080005, 79세,2019,694,269,425,63.3,693,268,425,63.1
'36460, 완도군,'085,80~84세,2019,2492,899,1593,56.4,2489,898,1591,56.4
'36460, 완도군,'085001, 80세,2019,660,257,403,63.8,659,257,402,63.9
'36460, 완도군,'085002, 81세,2019,577,219,358,61.2,576,218,358,60.9
'36460, 완도군,'085003, 82세,2019,477,161,316,50.9,476,161,315,51.1
'36460, 완도군,'085004, 83세,2019,435,145,290,50,435,145,290,50
'36460, 완도군,'085005, 84세,2019,343,117,226,51.8,343,117,226,51.8
'36460, 완도군,'086,85세이상,2019,1593,403,1190,33.9,1593,403,1190,33.9
'36460, 완도군,'090,85~89세,2019,1205,330,875,37.7,1205,330,875,37.7
'36460, 완도군,'090001, 85세,2019,346,95,251,37.8,346,95,251,37.8
'36460, 완도군,'090002, 86세,2019,271,78,193,40.4,271,78,193,40.4
'36460, 완도군,'090003, 87세,2019,252,78,174,44.8,252,78,174,44.8
'36460, 완도군,'090004, 88세,2019,176,45,131,34.4,176,45,131,34.4
'36460, 완도군,'090005, 89세,2019,160,34,126,27,160,34,126,27
'36460, 완도군,'095,90~94세,2019,295,63,232,27.2,295,63,232,27.2
'36460, 완도군,'095001, 90세,2019,100,28,72,38.9,100,28,72,38.9
'36460, 완도군,'095002, 91세,2019,76,17,59,28.8,76,17,59,28.8
'36460, 완도군,'095003, 92세,2019,53,6,47,12.8,53,6,47,12.8
'36460, 완도군,'095004, 93세,2019,41,9,32,28.1,41,9,32,28.1
'36460, 완도군,'095005, 94세,2019,25,X,22,13.6,25,X,22,13.6
'36460, 완도군,'100,95~99세,2019,84,10,74,13.5,84,10,74,13.5
'36460, 완도군,'100001, 95세,2019,27,X,23,17.4,27,X,23,17.4
'36460, 완도군,'100002, 96세,2019,19,X,18,5.6,19,X,18,5.6
'36460, 완도군,'100003, 97세,2019,19,X,17,11.8,19,X,17,11.8
'36460, 완도군,'100004, 98세,2019,12,X,10,20,12,X,10,20
'36460, 완도군,'100005, 99세,2019,7,X,6,16.7,7,X,6,16.7
'36460, 완도군,'101,100세이상,2019,9,X,9,0,9,X,9,0
'36460, 완도군,'102,15세미만,2019,4901,2518,2383,105.7,4898,2516,2382,105.6
'36460, 완도군,'103,15~64세,2019,28840,16666,12174,136.9,26019,14374,11645,123.4
'36460, 완도군,'104,65세이상,2019,14625,6152,8473,72.6,14600,6143,8457,72.6
'36460, 완도군,'126,평균연령,2019,50.3,47.5,53.4,,51.4,49,53.8,
'36460, 완도군,'127,중위연령,2019,53.7,49.7,58.1,,55.5,52.2,58.7,
'36470, 진도군,'000,합계,2019,29295,15134,14161,106.9,27300,13481,13819,97.6
'36470, 진도군,'005,0~4세,2019,815,383,432,88.7,815,383,432,88.7
'36470, 진도군,'005001, 0세,2019,160,82,78,105.1,160,82,78,105.1
'36470, 진도군,'005002, 1세,2019,123,65,58,112.1,123,65,58,112.1
'36470, 진도군,'005003, 2세,2019,174,58,116,50,174,58,116,50
'36470, 진도군,'005004, 3세,2019,167,81,86,94.2,167,81,86,94.2
'36470, 진도군,'005005, 4세,2019,191,97,94,103.2,191,97,94,103.2
'36470, 진도군,'010,5~9세,2019,935,476,459,103.7,935,476,459,103.7
'36470, 진도군,'010001, 5세,2019,172,89,83,107.2,172,89,83,107.2
'36470, 진도군,'010002, 6세,2019,177,88,89,98.9,177,88,89,98.9
'36470, 진도군,'010003, 7세,2019,195,103,92,112,195,103,92,112
'36470, 진도군,'010004, 8세,2019,224,101,123,82.1,224,101,123,82.1
'36470, 진도군,'010005, 9세,2019,167,95,72,131.9,167,95,72,131.9
'36470, 진도군,'015,10~14세,2019,959,489,470,104,959,489,470,104
'36470, 진도군,'015001, 10세,2019,199,103,96,107.3,199,103,96,107.3
'36470, 진도군,'015002, 11세,2019,171,85,86,98.8,171,85,86,98.8
'36470, 진도군,'015003, 12세,2019,234,117,117,100,234,117,117,100
'36470, 진도군,'015004, 13세,2019,184,94,90,104.4,184,94,90,104.4
'36470, 진도군,'015005, 14세,2019,171,90,81,111.1,171,90,81,111.1
'36470, 진도군,'020,15~19세,2019,936,484,452,107.1,925,480,445,107.9
'36470, 진도군,'020001, 15세,2019,167,78,89,87.6,167,78,89,87.6
'36470, 진도군,'020002, 16세,2019,203,94,109,86.2,200,93,107,86.9
'36470, 진도군,'020003, 17세,2019,243,135,108,125,243,135,108,125
'36470, 진도군,'020004, 18세,2019,213,106,107,99.1,213,106,107,99.1
'36470, 진도군,'020005, 19세,2019,110,71,39,182.1,102,68,34,200
'36470, 진도군,'025,20~24세,2019,1121,780,341,228.7,819,520,299,173.9
'36470, 진도군,'025001, 20세,2019,173,135,38,355.3,158,123,35,351.4
'36470, 진도군,'025002, 21세,2019,215,159,56,283.9,174,122,52,234.6
'36470, 진도군,'025003, 22세,2019,197,132,65,203.1,146,95,51,186.3
'36470, 진도군,'025004, 23세,2019,243,160,83,192.8,162,90,72,125
'36470, 진도군,'025005, 24세,2019,293,194,99,196,179,90,89,101.1
'36470, 진도군,'030,25~29세,2019,1604,1139,465,244.9,926,521,405,128.6
'36470, 진도군,'030001, 25세,2019,282,200,82,243.9,169,95,74,128.4
'36470, 진도군,'030002, 26세,2019,328,242,86,281.4,181,108,73,147.9
'36470, 진도군,'030003, 27세,2019,384,260,124,209.7,225,119,106,112.3
'36470, 진도군,'030004, 28세,2019,302,213,89,239.3,171,94,77,122.1
'36470, 진도군,'030005, 29세,2019,308,224,84,266.7,180,105,75,140
'36470, 진도군,'035,30~34세,2019,1270,807,463,174.3,847,448,399,112.3
'36470, 진도군,'035001, 30세,2019,263,182,81,224.7,157,89,68,130.9
'36470, 진도군,'035002, 31세,2019,255,165,90,183.3,171,90,81,111.1
'36470, 진도군,'035003, 32세,2019,252,150,102,147.1,172,87,85,102.4
'36470, 진도군,'035004, 33세,2019,260,162,98,165.3,174,88,86,102.3
'36470, 진도군,'035005, 34세,2019,240,148,92,160.9,173,94,79,119
'36470, 진도군,'040,35~39세,2019,1488,910,578,157.4,1241,707,534,132.4
'36470, 진도군,'040001, 35세,2019,278,170,108,157.4,225,122,103,118.4
'36470, 진도군,'040002, 36세,2019,271,173,98,176.5,221,129,92,140.2
'36470, 진도군,'040003, 37세,2019,317,200,117,170.9,255,152,103,147.6
'36470, 진도군,'040004, 38세,2019,294,182,112,162.5,251,149,102,146.1
'36470, 진도군,'040005, 39세,2019,328,185,143,129.4,289,155,134,115.7
'36470, 진도군,'045,40~44세,2019,1535,901,634,142.1,1411,808,603,134
'36470, 진도군,'045001, 40세,2019,290,159,131,121.4,260,134,126,106.3
'36470, 진도군,'045002, 41세,2019,278,160,118,135.6,245,136,109,124.8
'36470, 진도군,'045003, 42세,2019,314,182,132,137.9,299,172,127,135.4
'36470, 진도군,'045004, 43세,2019,301,171,130,131.5,284,161,123,130.9
'36470, 진도군,'045005, 44세,2019,352,229,123,186.2,323,205,118,173.7
'36470, 진도군,'050,45~49세,2019,1887,1086,801,135.6,1805,1040,765,135.9
'36470, 진도군,'050001, 45세,2019,370,209,161,129.8,351,199,152,130.9
'36470, 진도군,'050002, 46세,2019,356,203,153,132.7,340,193,147,131.3
'36470, 진도군,'050003, 47세,2019,385,212,173,122.5,363,201,162,124.1
'36470, 진도군,'050004, 48세,2019,401,244,157,155.4,384,235,149,157.7
'36470, 진도군,'050005, 49세,2019,375,218,157,138.9,367,212,155,136.8
'36470, 진도군,'055,50~54세,2019,2192,1223,969,126.2,2138,1192,946,126
'36470, 진도군,'055001, 50세,2019,418,253,165,153.3,407,245,162,151.2
'36470, 진도군,'055002, 51세,2019,440,235,205,114.6,425,226,199,113.6
'36470, 진도군,'055003, 52세,2019,372,198,174,113.8,364,193,171,112.9
'36470, 진도군,'055004, 53세,2019,514,304,210,144.8,502,297,205,144.9
'36470, 진도군,'055005, 54세,2019,448,233,215,108.4,440,231,209,110.5
'36470, 진도군,'060,55~59세,2019,2619,1365,1254,108.9,2583,1346,1237,108.8
'36470, 진도군,'060001, 55세,2019,464,255,209,122,457,252,205,122.9
'36470, 진도군,'060002, 56세,2019,439,235,204,115.2,428,231,197,117.3
'36470, 진도군,'060003, 57세,2019,486,268,218,122.9,482,265,217,122.1
'36470, 진도군,'060004, 58세,2019,580,287,293,98,573,282,291,96.9
'36470, 진도군,'060005, 59세,2019,650,320,330,97,643,316,327,96.6
'36470, 진도군,'065,60~64세,2019,2616,1376,1240,111,2593,1366,1227,111.3
'36470, 진도군,'065001, 60세,2019,525,260,265,98.1,520,257,263,97.7
'36470, 진도군,'065002, 61세,2019,533,281,252,111.5,528,280,248,112.9
'36470, 진도군,'065003, 62세,2019,527,287,240,119.6,522,286,236,121.2
'36470, 진도군,'065004, 63세,2019,543,293,250,117.2,540,290,250,116
'36470, 진도군,'065005, 64세,2019,488,255,233,109.4,483,253,230,110
'36470, 진도군,'070,65~69세,2019,2085,1011,1074,94.1,2076,1004,1072,93.7
'36470, 진도군,'070001, 65세,2019,363,184,179,102.8,362,184,178,103.4
'36470, 진도군,'070002, 66세,2019,390,181,209,86.6,385,176,209,84.2
'36470, 진도군,'070003, 67세,2019,456,223,233,95.7,456,223,233,95.7
'36470, 진도군,'070004, 68세,2019,405,191,214,89.3,403,189,214,88.3
'36470, 진도군,'070005, 69세,2019,471,232,239,97.1,470,232,238,97.5
'36470, 진도군,'075,70~74세,2019,2196,1038,1158,89.6,2191,1036,1155,89.7
'36470, 진도군,'075001, 70세,2019,433,234,199,117.6,430,232,198,117.2
'36470, 진도군,'075002, 71세,2019,445,199,246,80.9,444,199,245,81.2
'36470, 진도군,'075003, 72세,2019,485,240,245,98,485,240,245,98
'36470, 진도군,'075004, 73세,2019,365,169,196,86.2,365,169,196,86.2
'36470, 진도군,'075005, 74세,2019,468,196,272,72.1,467,196,271,72.3
'36470, 진도군,'080,75~79세,2019,2364,904,1460,61.9,2363,903,1460,61.8
'36470, 진도군,'080001, 75세,2019,388,174,214,81.3,388,174,214,81.3
'36470, 진도군,'080002, 76세,2019,401,148,253,58.5,401,148,253,58.5
'36470, 진도군,'080003, 77세,2019,589,203,386,52.6,589,203,386,52.6
'36470, 진도군,'080004, 78세,2019,505,183,322,56.8,505,183,322,56.8
'36470, 진도군,'080005, 79세,2019,481,196,285,68.8,480,195,285,68.4
'36470, 진도군,'085,80~84세,2019,1650,544,1106,49.2,1650,544,1106,49.2
'36470, 진도군,'085001, 80세,2019,427,170,257,66.1,427,170,257,66.1
'36470, 진도군,'085002, 81세,2019,411,113,298,37.9,411,113,298,37.9
'36470, 진도군,'085003, 82세,2019,294,97,197,49.2,294,97,197,49.2
'36470, 진도군,'085004, 83세,2019,264,85,179,47.5,264,85,179,47.5
'36470, 진도군,'085005, 84세,2019,254,79,175,45.1,254,79,175,45.1
'36470, 진도군,'086,85세이상,2019,1023,218,805,27.1,1023,218,805,27.1
'36470, 진도군,'090,85~89세,2019,760,159,601,26.5,760,159,601,26.5
'36470, 진도군,'090001, 85세,2019,217,49,168,29.2,217,49,168,29.2
'36470, 진도군,'090002, 86세,2019,179,32,147,21.8,179,32,147,21.8
'36470, 진도군,'090003, 87세,2019,141,30,111,27,141,30,111,27
'36470, 진도군,'090004, 88세,2019,109,28,81,34.6,109,28,81,34.6
'36470, 진도군,'090005, 89세,2019,114,20,94,21.3,114,20,94,21.3
'36470, 진도군,'095,90~94세,2019,219,51,168,30.4,219,51,168,30.4
'36470, 진도군,'095001, 90세,2019,71,16,55,29.1,71,16,55,29.1
'36470, 진도군,'095002, 91세,2019,54,16,38,42.1,54,16,38,42.1
'36470, 진도군,'095003, 92세,2019,40,10,30,33.3,40,10,30,33.3
'36470, 진도군,'095004, 93세,2019,25,X,21,19,25,X,21,19
'36470, 진도군,'095005, 94세,2019,29,5,24,20.8,29,5,24,20.8
'36470, 진도군,'100,95~99세,2019,40,7,33,21.2,40,7,33,21.2
'36470, 진도군,'100001, 95세,2019,7,X,6,16.7,7,X,6,16.7
'36470, 진도군,'100002, 96세,2019,18,X,14,28.6,18,X,14,28.6
'36470, 진도군,'100003, 97세,2019,9,X,7,28.6,9,X,7,28.6
'36470, 진도군,'100004, 98세,2019,X,X,X,0,X,X,X,0
'36470, 진도군,'100005, 99세,2019,X,X,X,0,X,X,X,0
'36470, 진도군,'101,100세이상,2019,X,X,X,33.3,X,X,X,33.3
'36470, 진도군,'102,15세미만,2019,2709,1348,1361,99,2709,1348,1361,99
'36470, 진도군,'103,15~64세,2019,17268,10071,7197,139.9,15288,8428,6860,122.9
'36470, 진도군,'104,65세이상,2019,9318,3715,5603,66.3,9303,3705,5598,66.2
'36470, 진도군,'126,평균연령,2019,51.2,47.9,54.6,,52.5,49.9,55.1,
'36470, 진도군,'127,중위연령,2019,54.8,50.4,59.3,,56.9,53.7,59.7,
'36480, 신안군,'000,합계,2019,35432,18838,16594,113.5,34274,18020,16254,110.9
'36480, 신안군,'005,0~4세,2019,788,432,356,121.3,787,431,356,121.1
'36480, 신안군,'005001, 0세,2019,151,72,79,91.1,151,72,79,91.1
'36480, 신안군,'005002, 1세,2019,162,91,71,128.2,162,91,71,128.2
'36480, 신안군,'005003, 2세,2019,142,77,65,118.5,142,77,65,118.5
'36480, 신안군,'005004, 3세,2019,168,93,75,124,168,93,75,124
'36480, 신안군,'005005, 4세,2019,165,99,66,150,164,98,66,148.5
'36480, 신안군,'010,5~9세,2019,877,441,436,101.1,875,440,435,101.1
'36480, 신안군,'010001, 5세,2019,166,81,85,95.3,166,81,85,95.3
'36480, 신안군,'010002, 6세,2019,173,92,81,113.6,172,91,81,112.3
'36480, 신안군,'010003, 7세,2019,179,86,93,92.5,179,86,93,92.5
'36480, 신안군,'010004, 8세,2019,214,114,100,114,213,114,99,115.2
'36480, 신안군,'010005, 9세,2019,145,68,77,88.3,145,68,77,88.3
'36480, 신안군,'015,10~14세,2019,738,355,383,92.7,738,355,383,92.7
'36480, 신안군,'015001, 10세,2019,154,71,83,85.5,154,71,83,85.5
'36480, 신안군,'015002, 11세,2019,170,78,92,84.8,170,78,92,84.8
'36480, 신안군,'015003, 12세,2019,146,73,73,100,146,73,73,100
'36480, 신안군,'015004, 13세,2019,132,63,69,91.3,132,63,69,91.3
'36480, 신안군,'015005, 14세,2019,136,70,66,106.1,136,70,66,106.1
'36480, 신안군,'020,15~19세,2019,872,497,375,132.5,865,493,372,132.5
'36480, 신안군,'020001, 15세,2019,158,85,73,116.4,158,85,73,116.4
'36480, 신안군,'020002, 16세,2019,176,98,78,125.6,176,98,78,125.6
'36480, 신안군,'020003, 17세,2019,213,119,94,126.6,212,118,94,125.5
'36480, 신안군,'020004, 18세,2019,191,105,86,122.1,190,104,86,120.9
'36480, 신안군,'020005, 19세,2019,134,90,44,204.5,129,88,41,214.6
'36480, 신안군,'025,20~24세,2019,1112,729,383,190.3,962,614,348,176.4
'36480, 신안군,'025001, 20세,2019,190,134,56,239.3,182,129,53,243.4
'36480, 신안군,'025002, 21세,2019,216,167,49,340.8,188,144,44,327.3
'36480, 신안군,'025003, 22세,2019,219,137,82,167.1,179,107,72,148.6
'36480, 신안군,'025004, 23세,2019,236,149,87,171.3,205,124,81,153.1
'36480, 신안군,'025005, 24세,2019,251,142,109,130.3,208,110,98,112.2
'36480, 신안군,'030,25~29세,2019,1492,937,555,168.8,1202,699,503,139
'36480, 신안군,'030001, 25세,2019,311,208,103,201.9,240,146,94,155.3
'36480, 신안군,'030002, 26세,2019,286,175,111,157.7,238,139,99,140.4
'36480, 신안군,'030003, 27세,2019,288,163,125,130.4,239,120,119,100.8
'36480, 신안군,'030004, 28세,2019,304,197,107,184.1,233,135,98,137.8
'36480, 신안군,'030005, 29세,2019,303,194,109,178,252,159,93,171
'36480, 신안군,'035,30~34세,2019,1424,893,531,168.2,1161,708,453,156.3
'36480, 신안군,'035001, 30세,2019,309,188,121,155.4,249,148,101,146.5
'36480, 신안군,'035002, 31세,2019,304,196,108,181.5,241,147,94,156.4
'36480, 신안군,'035003, 32세,2019,287,172,115,149.6,239,136,103,132
'36480, 신안군,'035004, 33세,2019,254,167,87,192,205,134,71,188.7
'36480, 신안군,'035005, 34세,2019,270,170,100,170,227,143,84,170.2
'36480, 신안군,'040,35~39세,2019,1635,1045,590,177.1,1472,925,547,169.1
'36480, 신안군,'040001, 35세,2019,290,183,107,171,251,152,99,153.5
'36480, 신안군,'040002, 36세,2019,335,208,127,163.8,300,180,120,150
'36480, 신안군,'040003, 37세,2019,360,241,119,202.5,322,214,108,198.1
'36480, 신안군,'040004, 38세,2019,298,189,109,173.4,267,167,100,167
'36480, 신안군,'040005, 39세,2019,352,224,128,175,332,212,120,176.7
'36480, 신안군,'045,40~44세,2019,1688,1128,560,201.4,1599,1079,520,207.5
'36480, 신안군,'045001, 40세,2019,353,220,133,165.4,329,206,123,167.5
'36480, 신안군,'045002, 41세,2019,325,215,110,195.5,299,203,96,211.5
'36480, 신안군,'045003, 42세,2019,325,218,107,203.7,311,208,103,201.9
'36480, 신안군,'045004, 43세,2019,327,231,96,240.6,312,223,89,250.6
'36480, 신안군,'045005, 44세,2019,358,244,114,214,348,239,109,219.3
'36480, 신안군,'050,45~49세,2019,2246,1456,790,184.3,2186,1425,761,187.3
'36480, 신안군,'050001, 45세,2019,397,260,137,189.8,381,248,133,186.5
'36480, 신안군,'050002, 46세,2019,436,275,161,170.8,422,267,155,172.3
'36480, 신안군,'050003, 47세,2019,454,294,160,183.8,441,287,154,186.4
'36480, 신안군,'050004, 48세,2019,478,318,160,198.8,470,317,153,207.2
'36480, 신안군,'050005, 49세,2019,481,309,172,179.7,472,306,166,184.3
'36480, 신안군,'055,50~54세,2019,2794,1709,1085,157.5,2741,1682,1059,158.8
'36480, 신안군,'055001, 50세,2019,527,350,177,197.7,515,343,172,199.4
'36480, 신안군,'055002, 51세,2019,530,325,205,158.5,522,322,200,161
'36480, 신안군,'055003, 52세,2019,527,313,214,146.3,514,306,208,147.1
'36480, 신안군,'055004, 53세,2019,599,358,241,148.5,587,351,236,148.7
'36480, 신안군,'055005, 54세,2019,611,363,248,146.4,603,360,243,148.1
'36480, 신안군,'060,55~59세,2019,3508,1955,1553,125.9,3464,1927,1537,125.4
'36480, 신안군,'060001, 55세,2019,587,341,246,138.6,579,334,245,136.3
'36480, 신안군,'060002, 56세,2019,666,390,276,141.3,656,386,270,143
'36480, 신안군,'060003, 57세,2019,659,367,292,125.7,653,362,291,124.4
'36480, 신안군,'060004, 58세,2019,760,417,343,121.6,752,412,340,121.2
'36480, 신안군,'060005, 59세,2019,836,440,396,111.1,824,433,391,110.7
'36480, 신안군,'065,60~64세,2019,3587,1992,1595,124.9,3563,1977,1586,124.7
'36480, 신안군,'065001, 60세,2019,753,440,313,140.6,746,437,309,141.4
'36480, 신안군,'065002, 61세,2019,708,389,319,121.9,701,385,316,121.8
'36480, 신안군,'065003, 62세,2019,728,402,326,123.3,724,398,326,122.1
'36480, 신안군,'065004, 63세,2019,649,349,300,116.3,647,348,299,116.4
'36480, 신안군,'065005, 64세,2019,749,412,337,122.3,745,409,336,121.7
'36480, 신안군,'070,65~69세,2019,2952,1507,1445,104.3,2944,1504,1440,104.4
'36480, 신안군,'070001, 65세,2019,588,307,281,109.3,585,306,279,109.7
'36480, 신안군,'070002, 66세,2019,532,269,263,102.3,531,269,262,102.7
'36480, 신안군,'070003, 67세,2019,672,318,354,89.8,670,317,353,89.8
'36480, 신안군,'070004, 68세,2019,587,315,272,115.8,586,315,271,116.2
'36480, 신안군,'070005, 69세,2019,573,298,275,108.4,572,297,275,108
'36480, 신안군,'075,70~74세,2019,2992,1464,1528,95.8,2990,1463,1527,95.8
'36480, 신안군,'075001, 70세,2019,586,298,288,103.5,584,297,287,103.5
'36480, 신안군,'075002, 71세,2019,577,291,286,101.7,577,291,286,101.7
'36480, 신안군,'075003, 72세,2019,693,345,348,99.1,693,345,348,99.1
'36480, 신안군,'075004, 73세,2019,574,274,300,91.3,574,274,300,91.3
'36480, 신안군,'075005, 74세,2019,562,256,306,83.7,562,256,306,83.7
'36480, 신안군,'080,75~79세,2019,3054,1211,1843,65.7,3053,1211,1842,65.7
'36480, 신안군,'080001, 75세,2019,488,191,297,64.3,488,191,297,64.3
'36480, 신안군,'080002, 76세,2019,613,253,360,70.3,612,253,359,70.5
'36480, 신안군,'080003, 77세,2019,776,311,465,66.9,776,311,465,66.9
'36480, 신안군,'080004, 78세,2019,621,251,370,67.8,621,251,370,67.8
'36480, 신안군,'080005, 79세,2019,556,205,351,58.4,556,205,351,58.4
'36480, 신안군,'085,80~84세,2019,2282,748,1534,48.8,2281,748,1533,48.8
'36480, 신안군,'085001, 80세,2019,564,199,365,54.5,564,199,365,54.5
'36480, 신안군,'085002, 81세,2019,519,187,332,56.3,519,187,332,56.3
'36480, 신안군,'085003, 82세,2019,489,160,329,48.6,488,160,328,48.8
'36480, 신안군,'085004, 83세,2019,384,112,272,41.2,384,112,272,41.2
'36480, 신안군,'085005, 84세,2019,326,90,236,38.1,326,90,236,38.1
'36480, 신안군,'086,85세이상,2019,1391,339,1052,32.2,1391,339,1052,32.2
'36480, 신안군,'090,85~89세,2019,1058,260,798,32.6,1058,260,798,32.6
'36480, 신안군,'090001, 85세,2019,323,105,218,48.2,323,105,218,48.2
'36480, 신안군,'090002, 86세,2019,247,55,192,28.6,247,55,192,28.6
'36480, 신안군,'090003, 87세,2019,189,41,148,27.7,189,41,148,27.7
'36480, 신안군,'090004, 88세,2019,148,31,117,26.5,148,31,117,26.5
'36480, 신안군,'090005, 89세,2019,151,28,123,22.8,151,28,123,22.8
'36480, 신안군,'095,90~94세,2019,272,67,205,32.7,272,67,205,32.7
'36480, 신안군,'095001, 90세,2019,89,18,71,25.4,89,18,71,25.4
'36480, 신안군,'095002, 91세,2019,64,12,52,23.1,64,12,52,23.1
'36480, 신안군,'095003, 92세,2019,59,15,44,34.1,59,15,44,34.1
'36480, 신안군,'095004, 93세,2019,28,13,15,86.7,28,13,15,86.7
'36480, 신안군,'095005, 94세,2019,32,9,23,39.1,32,9,23,39.1
'36480, 신안군,'100,95~99세,2019,55,8,47,17,55,8,47,17
'36480, 신안군,'100001, 95세,2019,13,X,11,18.2,13,X,11,18.2
'36480, 신안군,'100002, 96세,2019,18,X,16,12.5,18,X,16,12.5
'36480, 신안군,'100003, 97세,2019,19,X,15,26.7,19,X,15,26.7
'36480, 신안군,'100004, 98세,2019,X,X,X,0,X,X,X,0
'36480, 신안군,'100005, 99세,2019,X,X,X,0,X,X,X,0
'36480, 신안군,'101,100세이상,2019,6,X,X,200,6,X,X,200
'36480, 신안군,'102,15세미만,2019,2403,1228,1175,104.5,2400,1226,1174,104.4
'36480, 신안군,'103,15~64세,2019,20358,12341,8017,153.9,19215,11529,7686,150
'36480, 신안군,'104,65세이상,2019,12671,5269,7402,71.2,12659,5265,7394,71.2
'36480, 신안군,'126,평균연령,2019,54.3,51.2,57.7,,54.9,52,58.1,
'36480, 신안군,'127,중위연령,2019,58.2,54.4,62.2,,58.9,55.5,62.7,
'37,경상북도,'000,합계,2019,2668154,1352404,1315750,102.8,2586314,1301956,1284358,101.4
'37,경상북도,'005,0~4세,2019,90733,46610,44123,105.6,89627,46045,43582,105.7
'37,경상북도,'005001, 0세,2019,14910,7649,7261,105.3,14721,7547,7174,105.2
'37,경상북도,'005002, 1세,2019,16240,8449,7791,108.4,16041,8344,7697,108.4
'37,경상북도,'005003, 2세,2019,17757,9121,8636,105.6,17492,8973,8519,105.3
'37,경상북도,'005004, 3세,2019,20445,10425,10020,104,20186,10314,9872,104.5
'37,경상북도,'005005, 4세,2019,21381,10966,10415,105.3,21187,10867,10320,105.3
'37,경상북도,'010,5~9세,2019,109118,56503,52615,107.4,108440,56155,52285,107.4
'37,경상북도,'010001, 5세,2019,20838,10804,10034,107.7,20668,10721,9947,107.8
'37,경상북도,'010002, 6세,2019,21411,11014,10397,105.9,21238,10925,10313,105.9
'37,경상북도,'010003, 7세,2019,23014,11977,11037,108.5,22879,11906,10973,108.5
'37,경상북도,'010004, 8세,2019,22592,11776,10816,108.9,22492,11727,10765,108.9
'37,경상북도,'010005, 9세,2019,21263,10932,10331,105.8,21163,10876,10287,105.7
'37,경상북도,'015,10~14세,2019,105725,55240,50485,109.4,105282,55022,50260,109.5
'37,경상북도,'015001, 10세,2019,20674,10804,9870,109.5,20586,10761,9825,109.5
'37,경상북도,'015002, 11세,2019,21833,11405,10428,109.4,21733,11354,10379,109.4
'37,경상북도,'015003, 12세,2019,22171,11444,10727,106.7,22084,11397,10687,106.6
'37,경상북도,'015004, 13세,2019,20609,10910,9699,112.5,20525,10871,9654,112.6
'37,경상북도,'015005, 14세,2019,20438,10677,9761,109.4,20354,10639,9715,109.5
'37,경상북도,'020,15~19세,2019,133650,71926,61724,116.5,131245,70774,60471,117
'37,경상북도,'020001, 15세,2019,22138,11780,10358,113.7,22080,11750,10330,113.7
'37,경상북도,'020002, 16세,2019,23405,12476,10929,114.2,23331,12442,10889,114.3
'37,경상북도,'020003, 17세,2019,24706,13313,11393,116.9,24598,13256,11342,116.9
'37,경상북도,'020004, 18세,2019,29234,15650,13584,115.2,28731,15419,13312,115.8
'37,경상북도,'020005, 19세,2019,34167,18707,15460,121,32505,17907,14598,122.7
'37,경상북도,'025,20~24세,2019,164796,94430,70366,134.2,151471,86515,64956,133.2
'37,경상북도,'025001, 20세,2019,32453,17978,14475,124.2,30241,16853,13388,125.9
'37,경상북도,'025002, 21세,2019,33114,18431,14683,125.5,30499,16970,13529,125.4
'37,경상북도,'025003, 22세,2019,33540,18957,14583,130,30814,17345,13469,128.8
'37,경상북도,'025004, 23세,2019,32968,19449,13519,143.9,30164,17675,12489,141.5
'37,경상북도,'025005, 24세,2019,32721,19615,13106,149.7,29753,17672,12081,146.3
'37,경상북도,'030,25~29세,2019,151259,87349,63910,136.7,135033,76591,58442,131.1
'37,경상북도,'030001, 25세,2019,31581,18598,12983,143.2,28472,16532,11940,138.5
'37,경상북도,'030002, 26세,2019,30720,17872,12848,139.1,27481,15726,11755,133.8
'37,경상북도,'030003, 27세,2019,30930,17588,13342,131.8,27561,15316,12245,125.1
'37,경상북도,'030004, 28세,2019,29198,16748,12450,134.5,25984,14592,11392,128.1
'37,경상북도,'030005, 29세,2019,28830,16543,12287,134.6,25535,14425,11110,129.8
'37,경상북도,'035,30~34세,2019,143954,80198,63756,125.8,129210,70562,58648,120.3
'37,경상북도,'035001, 30세,2019,28018,16188,11830,136.8,24839,14108,10731,131.5
'37,경상북도,'035002, 31세,2019,28132,15887,12245,129.7,25044,13892,11152,124.6
'37,경상북도,'035003, 32세,2019,29052,15908,13144,121,25980,13898,12082,115
'37,경상북도,'035004, 33세,2019,29247,16060,13187,121.8,26527,14283,12244,116.7
'37,경상북도,'035005, 34세,2019,29505,16155,13350,121,26820,14381,12439,115.6
'37,경상북도,'040,35~39세,2019,180096,95456,84640,112.8,169249,88277,80972,109
'37,경상북도,'040001, 35세,2019,30997,16602,14395,115.3,28524,14978,13546,110.6
'37,경상북도,'040002, 36세,2019,34547,18329,16218,113,32291,16804,15487,108.5
'37,경상북도,'040003, 37세,2019,38022,19999,18023,111,35730,18470,17260,107
'37,경상북도,'040004, 38세,2019,37768,20044,17724,113.1,35826,18764,17062,110
'37,경상북도,'040005, 39세,2019,38762,20482,18280,112,36878,19261,17617,109.3
'37,경상북도,'045,40~44세,2019,176851,92763,84088,110.3,169845,88331,81514,108.4
'37,경상북도,'045001, 40세,2019,36185,19163,17022,112.6,34497,18035,16462,109.6
'37,경상북도,'045002, 41세,2019,33638,17875,15763,113.4,32144,16931,15213,111.3
'37,경상북도,'045003, 42세,2019,35038,18261,16777,108.8,33692,17428,16264,107.2
'37,경상북도,'045004, 43세,2019,34631,18114,16517,109.7,33317,17298,16019,108
'37,경상북도,'045005, 44세,2019,37359,19350,18009,107.4,36195,18639,17556,106.2
'37,경상북도,'050,45~49세,2019,210989,109796,101193,108.5,205685,106617,99068,107.6
'37,경상북도,'050001, 45세,2019,40792,21168,19624,107.9,39652,20488,19164,106.9
'37,경상북도,'050002, 46세,2019,41188,21151,20037,105.6,40085,20464,19621,104.3
'37,경상북도,'050003, 47세,2019,41290,21758,19532,111.4,40228,21127,19101,110.6
'37,경상북도,'050004, 48세,2019,43866,23024,20842,110.5,42869,22438,20431,109.8
'37,경상북도,'050005, 49세,2019,43853,22695,21158,107.3,42851,22100,20751,106.5
'37,경상북도,'055,50~54세,2019,220540,113525,107015,106.1,216588,111396,105192,105.9
'37,경상북도,'055001, 50세,2019,44563,23121,21442,107.8,43669,22611,21058,107.4
'37,경상북도,'055002, 51세,2019,46630,23937,22693,105.5,45785,23494,22291,105.4
'37,경상북도,'055003, 52세,2019,42478,21571,20907,103.2,41723,21173,20550,103
'37,경상북도,'055004, 53세,2019,43103,22626,20477,110.5,42363,22229,20134,110.4
'37,경상북도,'055005, 54세,2019,43766,22270,21496,103.6,43048,21889,21159,103.5
'37,경상북도,'060,55~59세,2019,234911,119566,115345,103.7,232089,118092,113997,103.6
'37,경상북도,'060001, 55세,2019,41487,21367,20120,106.2,40791,21010,19781,106.2
'37,경상북도,'060002, 56세,2019,44679,23009,21670,106.2,44026,22646,21380,105.9
'37,경상북도,'060003, 57세,2019,46259,23766,22493,105.7,45692,23472,22220,105.6
'37,경상북도,'060004, 58세,2019,51289,26063,25226,103.3,50871,25846,25025,103.3
'37,경상북도,'060005, 59세,2019,51197,25361,25836,98.2,50709,25118,25591,98.2
'37,경상북도,'065,60~64세,2019,211954,105889,106065,99.8,210368,105070,105298,99.8
'37,경상북도,'065001, 60세,2019,46078,22921,23157,99,45700,22728,22972,98.9
'37,경상북도,'065002, 61세,2019,41845,21138,20707,102.1,41480,20943,20537,102
'37,경상북도,'065003, 62세,2019,43226,21957,21269,103.2,42895,21795,21100,103.3
'37,경상북도,'065004, 63세,2019,40648,20326,20322,100,40377,20179,20198,99.9
'37,경상북도,'065005, 64세,2019,40157,19547,20610,94.8,39916,19425,20491,94.8
'37,경상북도,'070,65~69세,2019,159098,77055,82043,93.9,158319,76669,81650,93.9
'37,경상북도,'070001, 65세,2019,35305,17399,17906,97.2,35096,17288,17808,97.1
'37,경상북도,'070002, 66세,2019,33398,16244,17154,94.7,33241,16174,17067,94.8
'37,경상북도,'070003, 67세,2019,35513,16963,18550,91.4,35353,16885,18468,91.4
'37,경상북도,'070004, 68세,2019,27162,13071,14091,92.8,27031,13005,14026,92.7
'37,경상북도,'070005, 69세,2019,27720,13378,14342,93.3,27598,13317,14281,93.2
'37,경상북도,'075,70~74세,2019,119058,56269,62789,89.6,118733,56123,62610,89.6
'37,경상북도,'075001, 70세,2019,29522,14403,15119,95.3,29433,14366,15067,95.3
'37,경상북도,'075002, 71세,2019,27827,13396,14431,92.8,27746,13356,14390,92.8
'37,경상북도,'075003, 72세,2019,26186,12341,13845,89.1,26126,12311,13815,89.1
'37,경상북도,'075004, 73세,2019,17084,8011,9073,88.3,17024,7988,9036,88.4
'37,경상북도,'075005, 74세,2019,18439,8118,10321,78.7,18404,8102,10302,78.6
'37,경상북도,'080,75~79세,2019,113723,45750,67973,67.3,113573,45688,67885,67.3
'37,경상북도,'080001, 75세,2019,21447,8967,12480,71.9,21406,8950,12456,71.9
'37,경상북도,'080002, 76세,2019,23872,9861,14011,70.4,23839,9845,13994,70.4
'37,경상북도,'080003, 77세,2019,27092,11018,16074,68.5,27064,11007,16057,68.5
'37,경상북도,'080004, 78세,2019,21112,8241,12871,64,21086,8230,12856,64
'37,경상북도,'080005, 79세,2019,20200,7663,12537,61.1,20178,7656,12522,61.1
'37,경상북도,'085,80~84세,2019,84217,29251,54966,53.2,84131,29221,54910,53.2
'37,경상북도,'085001, 80세,2019,20876,7722,13154,58.7,20858,7718,13140,58.7
'37,경상북도,'085002, 81세,2019,17937,6345,11592,54.7,17912,6334,11578,54.7
'37,경상북도,'085003, 82세,2019,16177,5593,10584,52.8,16156,5583,10573,52.8
'37,경상북도,'085004, 83세,2019,15142,5107,10035,50.9,15129,5104,10025,50.9
'37,경상북도,'085005, 84세,2019,14085,4484,9601,46.7,14076,4482,9594,46.7
'37,경상북도,'086,85세이상,2019,57482,14828,42654,34.8,57426,14808,42618,34.7
'37,경상북도,'090,85~89세,2019,40928,11501,29427,39.1,40901,11490,29411,39.1
'37,경상북도,'090001, 85세,2019,11671,3622,8049,45,11661,3618,8043,45
'37,경상북도,'090002, 86세,2019,9480,2738,6742,40.6,9474,2736,6738,40.6
'37,경상북도,'090003, 87세,2019,8271,2302,5969,38.6,8269,2301,5968,38.6
'37,경상북도,'090004, 88세,2019,6202,1587,4615,34.4,6198,1585,4613,34.4
'37,경상북도,'090005, 89세,2019,5304,1252,4052,30.9,5299,1250,4049,30.9
'37,경상북도,'095,90~94세,2019,13401,2814,10587,26.6,13379,2808,10571,26.6
'37,경상북도,'095001, 90세,2019,4170,946,3224,29.3,4164,943,3221,29.3
'37,경상북도,'095002, 91세,2019,3452,714,2738,26.1,3447,712,2735,26
'37,경상북도,'095003, 92세,2019,2642,552,2090,26.4,2638,552,2086,26.5
'37,경상북도,'095004, 93세,2019,1693,331,1362,24.3,1690,330,1360,24.3
'37,경상북도,'095005, 94세,2019,1444,271,1173,23.1,1440,271,1169,23.2
'37,경상북도,'100,95~99세,2019,2812,472,2340,20.2,2805,469,2336,20.1
'37,경상북도,'100001, 95세,2019,879,164,715,22.9,878,164,714,23
'37,경상북도,'100002, 96세,2019,786,135,651,20.7,785,135,650,20.8
'37,경상북도,'100003, 97세,2019,565,94,471,20,563,93,470,19.8
'37,경상북도,'100004, 98세,2019,340,49,291,16.8,338,48,290,16.6
'37,경상북도,'100005, 99세,2019,242,30,212,14.2,241,29,212,13.7
'37,경상북도,'101,100세이상,2019,341,41,300,13.7,341,41,300,13.7
'37,경상북도,'102,15세미만,2019,305576,158353,147223,107.6,303349,157222,146127,107.6
'37,경상북도,'103,15~64세,2019,1829000,970898,858102,113.1,1750783,922225,828558,111.3
'37,경상북도,'104,65세이상,2019,533578,223153,310425,71.9,532182,222509,309673,71.9
'37,경상북도,'126,평균연령,2019,45,43.2,46.9,,45.4,43.5,47.2,
'37,경상북도,'127,중위연령,2019,46.9,44.8,49.1,,47.6,45.6,49.6,
'37004, 읍부,'000,합계,2019,606582,310685,295897,105,581486,294514,286972,102.6
'37004, 읍부,'005,0~4세,2019,20379,10578,9801,107.9,20042,10392,9650,107.7
'37004, 읍부,'005001, 0세,2019,3329,1687,1642,102.7,3273,1656,1617,102.4
'37004, 읍부,'005002, 1세,2019,3587,1889,1698,111.2,3531,1858,1673,111.1
'37004, 읍부,'005003, 2세,2019,3997,2085,1912,109,3917,2042,1875,108.9
'37004, 읍부,'005004, 3세,2019,4587,2353,2234,105.3,4509,2314,2195,105.4
'37004, 읍부,'005005, 4세,2019,4879,2564,2315,110.8,4812,2522,2290,110.1
'37004, 읍부,'010,5~9세,2019,25340,13143,12197,107.8,25124,13026,12098,107.7
'37004, 읍부,'010001, 5세,2019,4813,2475,2338,105.9,4751,2440,2311,105.6
'37004, 읍부,'010002, 6세,2019,4998,2545,2453,103.8,4935,2510,2425,103.5
'37004, 읍부,'010003, 7세,2019,5283,2824,2459,114.8,5251,2807,2444,114.9
'37004, 읍부,'010004, 8세,2019,5288,2731,2557,106.8,5260,2720,2540,107.1
'37004, 읍부,'010005, 9세,2019,4958,2568,2390,107.4,4927,2549,2378,107.2
'37004, 읍부,'015,10~14세,2019,25175,13112,12063,108.7,25043,13044,11999,108.7
'37004, 읍부,'015001, 10세,2019,4939,2572,2367,108.7,4905,2553,2352,108.5
'37004, 읍부,'015002, 11세,2019,5099,2647,2452,108,5073,2635,2438,108.1
'37004, 읍부,'015003, 12세,2019,5309,2692,2617,102.9,5283,2676,2607,102.6
'37004, 읍부,'015004, 13세,2019,4991,2648,2343,113,4970,2638,2332,113.1
'37004, 읍부,'015005, 14세,2019,4837,2553,2284,111.8,4812,2542,2270,112
'37004, 읍부,'020,15~19세,2019,34194,17823,16371,108.9,33254,17377,15877,109.4
'37004, 읍부,'020001, 15세,2019,5305,2828,2477,114.2,5286,2820,2466,114.4
'37004, 읍부,'020002, 16세,2019,5676,2923,2753,106.2,5656,2916,2740,106.4
'37004, 읍부,'020003, 17세,2019,5945,3110,2835,109.7,5909,3089,2820,109.5
'37004, 읍부,'020004, 18세,2019,7438,3841,3597,106.8,7219,3740,3479,107.5
'37004, 읍부,'020005, 19세,2019,9830,5121,4709,108.7,9184,4812,4372,110.1
'37004, 읍부,'025,20~24세,2019,41489,23084,18405,125.4,37779,20939,16840,124.3
'37004, 읍부,'025001, 20세,2019,8728,4459,4269,104.5,8012,4128,3884,106.3
'37004, 읍부,'025002, 21세,2019,8688,4457,4231,105.3,7941,4066,3875,104.9
'37004, 읍부,'025003, 22세,2019,8553,4755,3798,125.2,7825,4317,3508,123.1
'37004, 읍부,'025004, 23세,2019,8011,4783,3228,148.2,7276,4308,2968,145.1
'37004, 읍부,'025005, 24세,2019,7509,4630,2879,160.8,6725,4120,2605,158.2
'37004, 읍부,'030,25~29세,2019,34282,20273,14009,144.7,29409,16854,12555,134.2
'37004, 읍부,'030001, 25세,2019,7245,4399,2846,154.6,6356,3783,2573,147
'37004, 읍부,'030002, 26세,2019,7067,4217,2850,148,6065,3509,2556,137.3
'37004, 읍부,'030003, 27세,2019,6935,4003,2932,136.5,5934,3307,2627,125.9
'37004, 읍부,'030004, 28세,2019,6447,3811,2636,144.6,5499,3134,2365,132.5
'37004, 읍부,'030005, 29세,2019,6588,3843,2745,140,5555,3121,2434,128.2
'37004, 읍부,'035,30~34세,2019,32671,18793,13878,135.4,27994,15533,12461,124.7
'37004, 읍부,'035001, 30세,2019,6340,3788,2552,148.4,5332,3075,2257,136.2
'37004, 읍부,'035002, 31세,2019,6416,3790,2626,144.3,5415,3083,2332,132.2
'37004, 읍부,'035003, 32세,2019,6632,3717,2915,127.5,5676,3061,2615,117.1
'37004, 읍부,'035004, 33세,2019,6573,3696,2877,128.5,5721,3103,2618,118.5
'37004, 읍부,'035005, 34세,2019,6710,3802,2908,130.7,5850,3211,2639,121.7
'37004, 읍부,'040,35~39세,2019,41646,22274,19372,115,38177,19827,18350,108
'37004, 읍부,'040001, 35세,2019,7067,3860,3207,120.4,6243,3280,2963,110.7
'37004, 읍부,'040002, 36세,2019,7837,4187,3650,114.7,7150,3694,3456,106.9
'37004, 읍부,'040003, 37세,2019,8741,4608,4133,111.5,8000,4093,3907,104.8
'37004, 읍부,'040004, 38세,2019,8828,4738,4090,115.8,8213,4297,3916,109.7
'37004, 읍부,'040005, 39세,2019,9173,4881,4292,113.7,8571,4463,4108,108.6
'37004, 읍부,'045,40~44세,2019,41850,22221,19629,113.2,39641,20736,18905,109.7
'37004, 읍부,'045001, 40세,2019,8572,4519,4053,111.5,8033,4142,3891,106.5
'37004, 읍부,'045002, 41세,2019,8039,4335,3704,117,7556,4009,3547,113
'37004, 읍부,'045003, 42세,2019,8407,4428,3979,111.3,7966,4137,3829,108
'37004, 읍부,'045004, 43세,2019,8082,4343,3739,116.2,7689,4076,3613,112.8
'37004, 읍부,'045005, 44세,2019,8750,4596,4154,110.6,8397,4372,4025,108.6
'37004, 읍부,'050,45~49세,2019,50477,26838,23639,113.5,48827,25794,23033,112
'37004, 읍부,'050001, 45세,2019,9907,5330,4577,116.5,9544,5095,4449,114.5
'37004, 읍부,'050002, 46세,2019,9909,5234,4675,112,9575,5002,4573,109.4
'37004, 읍부,'050003, 47세,2019,9887,5311,4576,116.1,9553,5097,4456,114.4
'37004, 읍부,'050004, 48세,2019,10526,5583,4943,112.9,10202,5402,4800,112.5
'37004, 읍부,'050005, 49세,2019,10248,5380,4868,110.5,9953,5198,4755,109.3
'37004, 읍부,'055,50~54세,2019,50566,26658,23908,111.5,49389,26002,23387,111.2
'37004, 읍부,'055001, 50세,2019,10382,5545,4837,114.6,10107,5386,4721,114.1
'37004, 읍부,'055002, 51세,2019,10732,5649,5083,111.1,10467,5505,4962,110.9
'37004, 읍부,'055003, 52세,2019,9755,5067,4688,108.1,9534,4941,4593,107.6
'37004, 읍부,'055004, 53세,2019,9872,5296,4576,115.7,9661,5177,4484,115.5
'37004, 읍부,'055005, 54세,2019,9825,5101,4724,108,9620,4993,4627,107.9
'37004, 읍부,'060,55~59세,2019,51687,26915,24772,108.7,50865,26472,24393,108.5
'37004, 읍부,'060001, 55세,2019,9362,4881,4481,108.9,9171,4784,4387,109
'37004, 읍부,'060002, 56세,2019,9999,5227,4772,109.5,9812,5119,4693,109.1
'37004, 읍부,'060003, 57세,2019,10150,5349,4801,111.4,9970,5255,4715,111.5
'37004, 읍부,'060004, 58세,2019,11162,5878,5284,111.2,11040,5808,5232,111
'37004, 읍부,'060005, 59세,2019,11014,5580,5434,102.7,10872,5506,5366,102.6
'37004, 읍부,'065,60~64세,2019,44807,22658,22149,102.3,44334,22405,21929,102.2
'37004, 읍부,'065001, 60세,2019,9839,5053,4786,105.6,9728,5000,4728,105.8
'37004, 읍부,'065002, 61세,2019,9001,4582,4419,103.7,8895,4522,4373,103.4
'37004, 읍부,'065003, 62세,2019,9216,4694,4522,103.8,9120,4640,4480,103.6
'37004, 읍부,'065004, 63세,2019,8331,4216,4115,102.5,8241,4163,4078,102.1
'37004, 읍부,'065005, 64세,2019,8420,4113,4307,95.5,8350,4080,4270,95.6
'37004, 읍부,'070,65~69세,2019,33055,16027,17028,94.1,32809,15893,16916,94
'37004, 읍부,'070001, 65세,2019,7356,3583,3773,95,7286,3546,3740,94.8
'37004, 읍부,'070002, 66세,2019,6952,3462,3490,99.2,6912,3439,3473,99
'37004, 읍부,'070003, 67세,2019,7292,3537,3755,94.2,7242,3512,3730,94.2
'37004, 읍부,'070004, 68세,2019,5665,2700,2965,91.1,5617,2670,2947,90.6
'37004, 읍부,'070005, 69세,2019,5790,2745,3045,90.1,5752,2726,3026,90.1
'37004, 읍부,'075,70~74세,2019,25092,11691,13401,87.2,24998,11651,13347,87.3
'37004, 읍부,'075001, 70세,2019,6184,2946,3238,91,6160,2937,3223,91.1
'37004, 읍부,'075002, 71세,2019,5788,2772,3016,91.9,5762,2759,3003,91.9
'37004, 읍부,'075003, 72세,2019,5561,2613,2948,88.6,5546,2606,2940,88.6
'37004, 읍부,'075004, 73세,2019,3655,1703,1952,87.2,3636,1695,1941,87.3
'37004, 읍부,'075005, 74세,2019,3904,1657,2247,73.7,3894,1654,2240,73.8
'37004, 읍부,'080,75~79세,2019,23769,9392,14377,65.3,23721,9373,14348,65.3
'37004, 읍부,'080001, 75세,2019,4544,1883,2661,70.8,4532,1876,2656,70.6
'37004, 읍부,'080002, 76세,2019,4950,1988,2962,67.1,4939,1984,2955,67.1
'37004, 읍부,'080003, 77세,2019,5623,2237,3386,66.1,5614,2235,3379,66.1
'37004, 읍부,'080004, 78세,2019,4429,1662,2767,60.1,4421,1657,2764,59.9
'37004, 읍부,'080005, 79세,2019,4223,1622,2601,62.4,4215,1621,2594,62.5
'37004, 읍부,'085,80~84세,2019,17855,6105,11750,52,17840,6099,11741,51.9
'37004, 읍부,'085001, 80세,2019,4525,1601,2924,54.8,4521,1600,2921,54.8
'37004, 읍부,'085002, 81세,2019,3745,1316,2429,54.2,3741,1313,2428,54.1
'37004, 읍부,'085003, 82세,2019,3394,1163,2231,52.1,3389,1161,2228,52.1
'37004, 읍부,'085004, 83세,2019,3239,1093,2146,50.9,3239,1093,2146,50.9
'37004, 읍부,'085005, 84세,2019,2952,932,2020,46.1,2950,932,2018,46.2
'37004, 읍부,'086,85세이상,2019,12248,3100,9148,33.9,12240,3097,9143,33.9
'37004, 읍부,'090,85~89세,2019,8578,2377,6201,38.3,8575,2376,6199,38.3
'37004, 읍부,'090001, 85세,2019,2382,732,1650,44.4,2382,732,1650,44.4
'37004, 읍부,'090002, 86세,2019,1965,550,1415,38.9,1963,550,1413,38.9
'37004, 읍부,'090003, 87세,2019,1835,495,1340,36.9,1835,495,1340,36.9
'37004, 읍부,'090004, 88세,2019,1322,342,980,34.9,1322,342,980,34.9
'37004, 읍부,'090005, 89세,2019,1074,258,816,31.6,1073,257,816,31.5
'37004, 읍부,'095,90~94세,2019,3000,597,2403,24.8,2998,597,2401,24.9
'37004, 읍부,'095001, 90세,2019,866,203,663,30.6,866,203,663,30.6
'37004, 읍부,'095002, 91세,2019,774,158,616,25.6,773,158,615,25.7
'37004, 읍부,'095003, 92세,2019,610,118,492,24,610,118,492,24
'37004, 읍부,'095004, 93세,2019,409,72,337,21.4,409,72,337,21.4
'37004, 읍부,'095005, 94세,2019,341,46,295,15.6,340,46,294,15.6
'37004, 읍부,'100,95~99세,2019,599,115,484,23.8,596,113,483,23.4
'37004, 읍부,'100001, 95세,2019,190,46,144,31.9,190,46,144,31.9
'37004, 읍부,'100002, 96세,2019,168,29,139,20.9,167,29,138,21
'37004, 읍부,'100003, 97세,2019,118,21,97,21.6,117,20,97,20.6
'37004, 읍부,'100004, 98세,2019,71,12,59,20.3,71,12,59,20.3
'37004, 읍부,'100005, 99세,2019,52,7,45,15.6,51,6,45,13.3
'37004, 읍부,'101,100세이상,2019,71,11,60,18.3,71,11,60,18.3
'37004, 읍부,'102,15세미만,2019,70894,36833,34061,108.1,70209,36462,33747,108
'37004, 읍부,'103,15~64세,2019,423669,227537,196132,116,399669,211939,187730,112.9
'37004, 읍부,'104,65세이상,2019,112019,46315,65704,70.5,111608,46113,65495,70.4
'37004, 읍부,'126,평균연령,2019,44,42.3,45.9,,44.5,42.7,46.2,
'37004, 읍부,'127,중위연령,2019,45.6,43.7,47.6,,46.5,44.9,48.3,
'37005, 면부,'000,합계,2019,651493,329594,321899,102.4,627307,312679,314628,99.4
'37005, 면부,'005,0~4세,2019,15584,7982,7602,105,15520,7956,7564,105.2
'37005, 면부,'005001, 0세,2019,2930,1545,1385,111.6,2918,1539,1379,111.6
'37005, 면부,'005002, 1세,2019,3022,1527,1495,102.1,3005,1520,1485,102.4
'37005, 면부,'005003, 2세,2019,2979,1525,1454,104.9,2970,1522,1448,105.1
'37005, 면부,'005004, 3세,2019,3368,1690,1678,100.7,3355,1686,1669,101
'37005, 면부,'005005, 4세,2019,3285,1695,1590,106.6,3272,1689,1583,106.7
'37005, 면부,'010,5~9세,2019,15700,8100,7600,106.6,15664,8087,7577,106.7
'37005, 면부,'010001, 5세,2019,3137,1606,1531,104.9,3131,1604,1527,105
'37005, 면부,'010002, 6세,2019,3156,1635,1521,107.5,3146,1633,1513,107.9
'37005, 면부,'010003, 7세,2019,3255,1685,1570,107.3,3247,1682,1565,107.5
'37005, 면부,'010004, 8세,2019,3195,1638,1557,105.2,3189,1636,1553,105.3
'37005, 면부,'010005, 9세,2019,2957,1536,1421,108.1,2951,1532,1419,108
'37005, 면부,'015,10~14세,2019,14716,7854,6862,114.5,14673,7834,6839,114.5
'37005, 면부,'015001, 10세,2019,2847,1493,1354,110.3,2837,1490,1347,110.6
'37005, 면부,'015002, 11세,2019,3132,1691,1441,117.3,3123,1686,1437,117.3
'37005, 면부,'015003, 12세,2019,2995,1543,1452,106.3,2987,1539,1448,106.3
'37005, 면부,'015004, 13세,2019,2873,1580,1293,122.2,2867,1578,1289,122.4
'37005, 면부,'015005, 14세,2019,2869,1547,1322,117,2859,1541,1318,116.9
'37005, 면부,'020,15~19세,2019,17775,9545,8230,116,17610,9462,8148,116.1
'37005, 면부,'020001, 15세,2019,2966,1569,1397,112.3,2957,1563,1394,112.1
'37005, 면부,'020002, 16세,2019,2817,1510,1307,115.5,2808,1506,1302,115.7
'37005, 면부,'020003, 17세,2019,3162,1681,1481,113.5,3145,1672,1473,113.5
'37005, 면부,'020004, 18세,2019,3876,2051,1825,112.4,3848,2033,1815,112
'37005, 면부,'020005, 19세,2019,4954,2734,2220,123.2,4852,2688,2164,124.2
'37005, 면부,'025,20~24세,2019,26676,16189,10487,154.4,23418,13906,9512,146.2
'37005, 면부,'025001, 20세,2019,4896,2890,2006,144.1,4652,2750,1902,144.6
'37005, 면부,'025002, 21세,2019,5313,3194,2119,150.7,4781,2842,1939,146.6
'37005, 면부,'025003, 22세,2019,5405,3155,2250,140.2,4742,2713,2029,133.7
'37005, 면부,'025004, 23세,2019,5406,3389,2017,168,4568,2765,1803,153.4
'37005, 면부,'025005, 24세,2019,5656,3561,2095,170,4675,2836,1839,154.2
'37005, 면부,'030,25~29세,2019,28845,17710,11135,159,23022,13396,9626,139.2
'37005, 면부,'030001, 25세,2019,5731,3597,2134,168.6,4635,2782,1853,150.1
'37005, 면부,'030002, 26세,2019,5682,3545,2137,165.9,4517,2680,1837,145.9
'37005, 면부,'030003, 27세,2019,5920,3587,2333,153.8,4666,2637,2029,130
'37005, 면부,'030004, 28세,2019,5772,3514,2258,155.6,4605,2626,1979,132.7
'37005, 면부,'030005, 29세,2019,5740,3467,2273,152.5,4599,2671,1928,138.5
'37005, 면부,'035,30~34세,2019,28588,17057,11531,147.9,23588,13441,10147,132.5
'37005, 면부,'035001, 30세,2019,5703,3513,2190,160.4,4606,2724,1882,144.7
'37005, 면부,'035002, 31세,2019,5688,3398,2290,148.4,4686,2689,1997,134.7
'37005, 면부,'035003, 32세,2019,5828,3414,2414,141.4,4775,2657,2118,125.4
'37005, 면부,'035004, 33세,2019,5713,3355,2358,142.3,4789,2679,2110,127
'37005, 면부,'035005, 34세,2019,5656,3377,2279,148.2,4732,2692,2040,132
'37005, 면부,'040,35~39세,2019,31518,18437,13081,140.9,27898,15752,12146,129.7
'37005, 면부,'040001, 35세,2019,5732,3369,2363,142.6,4897,2761,2136,129.3
'37005, 면부,'040002, 36세,2019,6285,3660,2625,139.4,5506,3069,2437,125.9
'37005, 면부,'040003, 37세,2019,6715,3876,2839,136.5,5956,3291,2665,123.5
'37005, 면부,'040004, 38세,2019,6360,3737,2623,142.5,5734,3284,2450,134
'37005, 면부,'040005, 39세,2019,6426,3795,2631,144.2,5805,3347,2458,136.2
'37005, 면부,'045,40~44세,2019,29368,17733,11635,152.4,27213,16186,11027,146.8
'37005, 면부,'045001, 40세,2019,6083,3693,2390,154.5,5547,3290,2257,145.8
'37005, 면부,'045002, 41세,2019,5554,3356,2198,152.7,5087,3017,2070,145.7
'37005, 면부,'045003, 42세,2019,5744,3431,2313,148.3,5334,3145,2189,143.7
'37005, 면부,'045004, 43세,2019,5776,3534,2242,157.6,5364,3245,2119,153.1
'37005, 면부,'045005, 44세,2019,6211,3719,2492,149.2,5881,3489,2392,145.9
'37005, 면부,'050,45~49세,2019,37465,21762,15703,138.6,36006,20820,15186,137.1
'37005, 면부,'050001, 45세,2019,6852,3998,2854,140.1,6537,3804,2733,139.2
'37005, 면부,'050002, 46세,2019,7131,4211,2920,144.2,6830,4006,2824,141.9
'37005, 면부,'050003, 47세,2019,7138,4174,2964,140.8,6872,4006,2866,139.8
'37005, 면부,'050004, 48세,2019,8180,4769,3411,139.8,7888,4576,3312,138.2
'37005, 면부,'050005, 49세,2019,8164,4610,3554,129.7,7879,4428,3451,128.3
'37005, 면부,'055,50~54세,2019,48900,26506,22394,118.4,47819,25892,21927,118.1
'37005, 면부,'055001, 50세,2019,9012,5042,3970,127,8749,4863,3886,125.1
'37005, 면부,'055002, 51세,2019,9682,5239,4443,117.9,9457,5114,4343,117.8
'37005, 면부,'055003, 52세,2019,9435,4998,4437,112.6,9229,4889,4340,112.6
'37005, 면부,'055004, 53세,2019,10084,5534,4550,121.6,9874,5431,4443,122.2
'37005, 면부,'055005, 54세,2019,10687,5693,4994,114,10510,5595,4915,113.8
'37005, 면부,'060,55~59세,2019,64430,33284,31146,106.9,63693,32904,30789,106.9
'37005, 면부,'060001, 55세,2019,10496,5516,4980,110.8,10299,5412,4887,110.7
'37005, 면부,'060002, 56세,2019,11406,6020,5386,111.8,11238,5919,5319,111.3
'37005, 면부,'060003, 57세,2019,12738,6727,6011,111.9,12603,6659,5944,112
'37005, 면부,'060004, 58세,2019,14663,7528,7135,105.5,14550,7479,7071,105.8
'37005, 면부,'060005, 59세,2019,15127,7493,7634,98.2,15003,7435,7568,98.2
'37005, 면부,'065,60~64세,2019,67885,34627,33258,104.1,67478,34402,33076,104
'37005, 면부,'065001, 60세,2019,14091,7018,7073,99.2,13985,6959,7026,99
'37005, 면부,'065002, 61세,2019,12972,6812,6160,110.6,12870,6756,6114,110.5
'37005, 면부,'065003, 62세,2019,13738,7200,6538,110.1,13661,7165,6496,110.3
'37005, 면부,'065004, 63세,2019,13507,6908,6599,104.7,13444,6868,6576,104.4
'37005, 면부,'065005, 64세,2019,13577,6689,6888,97.1,13518,6654,6864,96.9
'37005, 면부,'070,65~69세,2019,57537,28219,29318,96.3,57354,28127,29227,96.2
'37005, 면부,'070001, 65세,2019,12305,6139,6166,99.6,12256,6111,6145,99.4
'37005, 면부,'070002, 66세,2019,11858,5897,5961,98.9,11819,5882,5937,99.1
'37005, 면부,'070003, 67세,2019,12845,6190,6655,93,12806,6170,6636,93
'37005, 면부,'070004, 68세,2019,10052,4918,5134,95.8,10027,4905,5122,95.8
'37005, 면부,'070005, 69세,2019,10477,5075,5402,93.9,10446,5059,5387,93.9
'37005, 면부,'075,70~74세,2019,46752,22412,24340,92.1,46659,22366,24293,92.1
'37005, 면부,'075001, 70세,2019,11384,5659,5725,98.8,11356,5647,5709,98.9
'37005, 면부,'075002, 71세,2019,10806,5330,5476,97.3,10783,5316,5467,97.2
'37005, 면부,'075003, 72세,2019,10379,4962,5417,91.6,10360,4950,5410,91.5
'37005, 면부,'075004, 73세,2019,6639,3147,3492,90.1,6623,3142,3481,90.3
'37005, 면부,'075005, 74세,2019,7544,3314,4230,78.3,7537,3311,4226,78.3
'37005, 면부,'080,75~79세,2019,50877,20299,30578,66.4,50846,20283,30563,66.4
'37005, 면부,'080001, 75세,2019,8974,3670,5304,69.2,8965,3667,5298,69.2
'37005, 면부,'080002, 76세,2019,10431,4263,6168,69.1,10424,4258,6166,69.1
'37005, 면부,'080003, 77세,2019,12331,5011,7320,68.5,12326,5008,7318,68.4
'37005, 면부,'080004, 78세,2019,9698,3819,5879,65,9692,3816,5876,64.9
'37005, 면부,'080005, 79세,2019,9443,3536,5907,59.9,9439,3534,5905,59.8
'37005, 면부,'085,80~84세,2019,40940,14303,26637,53.7,40926,14298,26628,53.7
'37005, 면부,'085001, 80세,2019,9918,3697,6221,59.4,9911,3696,6215,59.5
'37005, 면부,'085002, 81세,2019,8616,3070,5546,55.4,8613,3069,5544,55.4
'37005, 면부,'085003, 82세,2019,7915,2742,5173,53,7913,2740,5173,53
'37005, 면부,'085004, 83세,2019,7359,2499,4860,51.4,7358,2499,4859,51.4
'37005, 면부,'085005, 84세,2019,7132,2295,4837,47.4,7131,2294,4837,47.4
'37005, 면부,'086,85세이상,2019,27937,7575,20362,37.2,27920,7567,20353,37.2
'37005, 면부,'090,85~89세,2019,20124,5885,14239,41.3,20111,5879,14232,41.3
'37005, 면부,'090001, 85세,2019,5836,1874,3962,47.3,5830,1872,3958,47.3
'37005, 면부,'090002, 86세,2019,4685,1419,3266,43.4,4683,1418,3265,43.4
'37005, 면부,'090003, 87세,2019,3929,1137,2792,40.7,3928,1136,2792,40.7
'37005, 면부,'090004, 88세,2019,3045,802,2243,35.8,3044,801,2243,35.7
'37005, 면부,'090005, 89세,2019,2629,653,1976,33,2626,652,1974,33
'37005, 면부,'095,90~94세,2019,6319,1434,4885,29.4,6316,1432,4884,29.3
'37005, 면부,'095001, 90세,2019,2020,487,1533,31.8,2019,486,1533,31.7
'37005, 면부,'095002, 91세,2019,1628,344,1284,26.8,1627,343,1284,26.7
'37005, 면부,'095003, 92세,2019,1227,291,936,31.1,1227,291,936,31.1
'37005, 면부,'095004, 93세,2019,774,164,610,26.9,774,164,610,26.9
'37005, 면부,'095005, 94세,2019,670,148,522,28.4,669,148,521,28.4
'37005, 면부,'100,95~99세,2019,1332,236,1096,21.5,1331,236,1095,21.6
'37005, 면부,'100001, 95세,2019,432,73,359,20.3,432,73,359,20.3
'37005, 면부,'100002, 96세,2019,361,72,289,24.9,361,72,289,24.9
'37005, 면부,'100003, 97세,2019,267,48,219,21.9,267,48,219,21.9
'37005, 면부,'100004, 98세,2019,150,26,124,21,149,26,123,21.1
'37005, 면부,'100005, 99세,2019,122,17,105,16.2,122,17,105,16.2
'37005, 면부,'101,100세이상,2019,162,20,142,14.1,162,20,142,14.1
'37005, 면부,'102,15세미만,2019,46000,23936,22064,108.5,45857,23877,21980,108.6
'37005, 면부,'103,15~64세,2019,381450,212850,168600,126.2,357745,196161,161584,121.4
'37005, 면부,'104,65세이상,2019,224043,92808,131235,70.7,223705,92641,131064,70.7
'37005, 면부,'126,평균연령,2019,53.4,50.5,56.3,,54.1,51.4,56.8,
'37005, 면부,'127,중위연령,2019,57.7,54.3,60.5,,58.5,55.7,61,
'37003, 동부,'000,합계,2019,1410079,712125,697954,102,1377521,694763,682758,101.8
'37003, 동부,'005,0~4세,2019,54770,28050,26720,105,54065,27697,26368,105
'37003, 동부,'005001, 0세,2019,8651,4417,4234,104.3,8530,4352,4178,104.2
'37003, 동부,'005002, 1세,2019,9631,5033,4598,109.5,9505,4966,4539,109.4
'37003, 동부,'005003, 2세,2019,10781,5511,5270,104.6,10605,5409,5196,104.1
'37003, 동부,'005004, 3세,2019,12490,6382,6108,104.5,12322,6314,6008,105.1
'37003, 동부,'005005, 4세,2019,13217,6707,6510,103,13103,6656,6447,103.2
'37003, 동부,'010,5~9세,2019,68078,35260,32818,107.4,67652,35042,32610,107.5
'37003, 동부,'010001, 5세,2019,12888,6723,6165,109.1,12786,6677,6109,109.3
'37003, 동부,'010002, 6세,2019,13257,6834,6423,106.4,13157,6782,6375,106.4
'37003, 동부,'010003, 7세,2019,14476,7468,7008,106.6,14381,7417,6964,106.5
'37003, 동부,'010004, 8세,2019,14109,7407,6702,110.5,14043,7371,6672,110.5
'37003, 동부,'010005, 9세,2019,13348,6828,6520,104.7,13285,6795,6490,104.7
'37003, 동부,'015,10~14세,2019,65834,34274,31560,108.6,65566,34144,31422,108.7
'37003, 동부,'015001, 10세,2019,12888,6739,6149,109.6,12844,6718,6126,109.7
'37003, 동부,'015002, 11세,2019,13602,7067,6535,108.1,13537,7033,6504,108.1
'37003, 동부,'015003, 12세,2019,13867,7209,6658,108.3,13814,7182,6632,108.3
'37003, 동부,'015004, 13세,2019,12745,6682,6063,110.2,12688,6655,6033,110.3
'37003, 동부,'015005, 14세,2019,12732,6577,6155,106.9,12683,6556,6127,107
'37003, 동부,'020,15~19세,2019,81681,44558,37123,120,80381,43935,36446,120.5
'37003, 동부,'020001, 15세,2019,13867,7383,6484,113.9,13837,7367,6470,113.9
'37003, 동부,'020002, 16세,2019,14912,8043,6869,117.1,14867,8020,6847,117.1
'37003, 동부,'020003, 17세,2019,15599,8522,7077,120.4,15544,8495,7049,120.5
'37003, 동부,'020004, 18세,2019,17920,9758,8162,119.6,17664,9646,8018,120.3
'37003, 동부,'020005, 19세,2019,19383,10852,8531,127.2,18469,10407,8062,129.1
'37003, 동부,'025,20~24세,2019,96631,55157,41474,133,90274,51670,38604,133.8
'37003, 동부,'025001, 20세,2019,18829,10629,8200,129.6,17577,9975,7602,131.2
'37003, 동부,'025002, 21세,2019,19113,10780,8333,129.4,17777,10062,7715,130.4
'37003, 동부,'025003, 22세,2019,19582,11047,8535,129.4,18247,10315,7932,130
'37003, 동부,'025004, 23세,2019,19551,11277,8274,136.3,18320,10602,7718,137.4
'37003, 동부,'025005, 24세,2019,19556,11424,8132,140.5,18353,10716,7637,140.3
'37003, 동부,'030,25~29세,2019,88132,49366,38766,127.3,82602,46341,36261,127.8
'37003, 동부,'030001, 25세,2019,18605,10602,8003,132.5,17481,9967,7514,132.6
'37003, 동부,'030002, 26세,2019,17971,10110,7861,128.6,16899,9537,7362,129.5
'37003, 동부,'030003, 27세,2019,18075,9998,8077,123.8,16961,9372,7589,123.5
'37003, 동부,'030004, 28세,2019,16979,9423,7556,124.7,15880,8832,7048,125.3
'37003, 동부,'030005, 29세,2019,16502,9233,7269,127,15381,8633,6748,127.9
'37003, 동부,'035,30~34세,2019,82695,44348,38347,115.6,77628,41588,36040,115.4
'37003, 동부,'035001, 30세,2019,15975,8887,7088,125.4,14901,8309,6592,126
'37003, 동부,'035002, 31세,2019,16028,8699,7329,118.7,14943,8120,6823,119
'37003, 동부,'035003, 32세,2019,16592,8777,7815,112.3,15529,8180,7349,111.3
'37003, 동부,'035004, 33세,2019,16961,9009,7952,113.3,16017,8501,7516,113.1
'37003, 동부,'035005, 34세,2019,17139,8976,8163,110,16238,8478,7760,109.3
'37003, 동부,'040,35~39세,2019,106932,54745,52187,104.9,103174,52698,50476,104.4
'37003, 동부,'040001, 35세,2019,18198,9373,8825,106.2,17384,8937,8447,105.8
'37003, 동부,'040002, 36세,2019,20425,10482,9943,105.4,19635,10041,9594,104.7
'37003, 동부,'040003, 37세,2019,22566,11515,11051,104.2,21774,11086,10688,103.7
'37003, 동부,'040004, 38세,2019,22580,11569,11011,105.1,21879,11183,10696,104.6
'37003, 동부,'040005, 39세,2019,23163,11806,11357,104,22502,11451,11051,103.6
'37003, 동부,'045,40~44세,2019,105633,52809,52824,100,102991,51409,51582,99.7
'37003, 동부,'045001, 40세,2019,21530,10951,10579,103.5,20917,10603,10314,102.8
'37003, 동부,'045002, 41세,2019,20045,10184,9861,103.3,19501,9905,9596,103.2
'37003, 동부,'045003, 42세,2019,20887,10402,10485,99.2,20392,10146,10246,99
'37003, 동부,'045004, 43세,2019,20773,10237,10536,97.2,20264,9977,10287,97
'37003, 동부,'045005, 44세,2019,22398,11035,11363,97.1,21917,10778,11139,96.8
'37003, 동부,'050,45~49세,2019,123047,61196,61851,98.9,120852,60003,60849,98.6
'37003, 동부,'050001, 45세,2019,24033,11840,12193,97.1,23571,11589,11982,96.7
'37003, 동부,'050002, 46세,2019,24148,11706,12442,94.1,23680,11456,12224,93.7
'37003, 동부,'050003, 47세,2019,24265,12273,11992,102.3,23803,12024,11779,102.1
'37003, 동부,'050004, 48세,2019,25160,12672,12488,101.5,24779,12460,12319,101.1
'37003, 동부,'050005, 49세,2019,25441,12705,12736,99.8,25019,12474,12545,99.4
'37003, 동부,'055,50~54세,2019,121074,60361,60713,99.4,119380,59502,59878,99.4
'37003, 동부,'055001, 50세,2019,25169,12534,12635,99.2,24813,12362,12451,99.3
'37003, 동부,'055002, 51세,2019,26216,13049,13167,99.1,25861,12875,12986,99.1
'37003, 동부,'055003, 52세,2019,23288,11506,11782,97.7,22960,11343,11617,97.6
'37003, 동부,'055004, 53세,2019,23147,11796,11351,103.9,22828,11621,11207,103.7
'37003, 동부,'055005, 54세,2019,23254,11476,11778,97.4,22918,11301,11617,97.3
'37003, 동부,'060,55~59세,2019,118794,59367,59427,99.9,117531,58716,58815,99.8
'37003, 동부,'060001, 55세,2019,21629,10970,10659,102.9,21321,10814,10507,102.9
'37003, 동부,'060002, 56세,2019,23274,11762,11512,102.2,22976,11608,11368,102.1
'37003, 동부,'060003, 57세,2019,23371,11690,11681,100.1,23119,11558,11561,100
'37003, 동부,'060004, 58세,2019,25464,12657,12807,98.8,25281,12559,12722,98.7
'37003, 동부,'060005, 59세,2019,25056,12288,12768,96.2,24834,12177,12657,96.2
'37003, 동부,'065,60~64세,2019,99262,48604,50658,95.9,98556,48263,50293,96
'37003, 동부,'065001, 60세,2019,22148,10850,11298,96,21987,10769,11218,96
'37003, 동부,'065002, 61세,2019,19872,9744,10128,96.2,19715,9665,10050,96.2
'37003, 동부,'065003, 62세,2019,20272,10063,10209,98.6,20114,9990,10124,98.7
'37003, 동부,'065004, 63세,2019,18810,9202,9608,95.8,18692,9148,9544,95.9
'37003, 동부,'065005, 64세,2019,18160,8745,9415,92.9,18048,8691,9357,92.9
'37003, 동부,'070,65~69세,2019,68506,32809,35697,91.9,68156,32649,35507,92
'37003, 동부,'070001, 65세,2019,15644,7677,7967,96.4,15554,7631,7923,96.3
'37003, 동부,'070002, 66세,2019,14588,6885,7703,89.4,14510,6853,7657,89.5
'37003, 동부,'070003, 67세,2019,15376,7236,8140,88.9,15305,7203,8102,88.9
'37003, 동부,'070004, 68세,2019,11445,5453,5992,91,11387,5430,5957,91.2
'37003, 동부,'070005, 69세,2019,11453,5558,5895,94.3,11400,5532,5868,94.3
'37003, 동부,'075,70~74세,2019,47214,22166,25048,88.5,47076,22106,24970,88.5
'37003, 동부,'075001, 70세,2019,11954,5798,6156,94.2,11917,5782,6135,94.2
'37003, 동부,'075002, 71세,2019,11233,5294,5939,89.1,11201,5281,5920,89.2
'37003, 동부,'075003, 72세,2019,10246,4766,5480,87,10220,4755,5465,87
'37003, 동부,'075004, 73세,2019,6790,3161,3629,87.1,6765,3151,3614,87.2
'37003, 동부,'075005, 74세,2019,6991,3147,3844,81.9,6973,3137,3836,81.8
'37003, 동부,'080,75~79세,2019,39077,16059,23018,69.8,39006,16032,22974,69.8
'37003, 동부,'080001, 75세,2019,7929,3414,4515,75.6,7909,3407,4502,75.7
'37003, 동부,'080002, 76세,2019,8491,3610,4881,74,8476,3603,4873,73.9
'37003, 동부,'080003, 77세,2019,9138,3770,5368,70.2,9124,3764,5360,70.2
'37003, 동부,'080004, 78세,2019,6985,2760,4225,65.3,6973,2757,4216,65.4
'37003, 동부,'080005, 79세,2019,6534,2505,4029,62.2,6524,2501,4023,62.2
'37003, 동부,'085,80~84세,2019,25422,8843,16579,53.3,25365,8824,16541,53.3
'37003, 동부,'085001, 80세,2019,6433,2424,4009,60.5,6426,2422,4004,60.5
'37003, 동부,'085002, 81세,2019,5576,1959,3617,54.2,5558,1952,3606,54.1
'37003, 동부,'085003, 82세,2019,4868,1688,3180,53.1,4854,1682,3172,53
'37003, 동부,'085004, 83세,2019,4544,1515,3029,50,4532,1512,3020,50.1
'37003, 동부,'085005, 84세,2019,4001,1257,2744,45.8,3995,1256,2739,45.9
'37003, 동부,'086,85세이상,2019,17297,4153,13144,31.6,17266,4144,13122,31.6
'37003, 동부,'090,85~89세,2019,12226,3239,8987,36,12215,3235,8980,36
'37003, 동부,'090001, 85세,2019,3453,1016,2437,41.7,3449,1014,2435,41.6
'37003, 동부,'090002, 86세,2019,2830,769,2061,37.3,2828,768,2060,37.3
'37003, 동부,'090003, 87세,2019,2507,670,1837,36.5,2506,670,1836,36.5
'37003, 동부,'090004, 88세,2019,1835,443,1392,31.8,1832,442,1390,31.8
'37003, 동부,'090005, 89세,2019,1601,341,1260,27.1,1600,341,1259,27.1
'37003, 동부,'095,90~94세,2019,4082,783,3299,23.7,4065,779,3286,23.7
'37003, 동부,'095001, 90세,2019,1284,256,1028,24.9,1279,254,1025,24.8
'37003, 동부,'095002, 91세,2019,1050,212,838,25.3,1047,211,836,25.2
'37003, 동부,'095003, 92세,2019,805,143,662,21.6,801,143,658,21.7
'37003, 동부,'095004, 93세,2019,510,95,415,22.9,507,94,413,22.8
'37003, 동부,'095005, 94세,2019,433,77,356,21.6,431,77,354,21.8
'37003, 동부,'100,95~99세,2019,881,121,760,15.9,878,120,758,15.8
'37003, 동부,'100001, 95세,2019,257,45,212,21.2,256,45,211,21.3
'37003, 동부,'100002, 96세,2019,257,34,223,15.2,257,34,223,15.2
'37003, 동부,'100003, 97세,2019,180,25,155,16.1,179,25,154,16.2
'37003, 동부,'100004, 98세,2019,119,11,108,10.2,118,10,108,9.3
'37003, 동부,'100005, 99세,2019,68,6,62,9.7,68,6,62,9.7
'37003, 동부,'101,100세이상,2019,108,10,98,10.2,108,10,98,10.2
'37003, 동부,'102,15세미만,2019,188682,97584,91098,107.1,187283,96883,90400,107.2
'37003, 동부,'103,15~64세,2019,1023881,530511,493370,107.5,993369,514125,479244,107.3
'37003, 동부,'104,65세이상,2019,197516,84030,113486,74,196869,83755,113114,74
'37003, 동부,'126,평균연령,2019,41.6,40.1,43.1,,41.8,40.3,43.3,
'37003, 동부,'127,중위연령,2019,42.9,40.9,44.7,,43.3,41.4,45.1,
'37010, 포항시,'000,합계,2019,502064,254874,247190,103.1,493476,249770,243706,102.5
'37010, 포항시,'005,0~4세,2019,18347,9518,8829,107.8,18156,9419,8737,107.8
'37010, 포항시,'005001, 0세,2019,2853,1423,1430,99.5,2822,1410,1412,99.9
'37010, 포항시,'005002, 1세,2019,3140,1663,1477,112.6,3109,1645,1464,112.4
'37010, 포항시,'005003, 2세,2019,3535,1846,1689,109.3,3495,1825,1670,109.3
'37010, 포항시,'005004, 3세,2019,4251,2222,2029,109.5,4202,2195,2007,109.4
'37010, 포항시,'005005, 4세,2019,4568,2364,2204,107.3,4528,2344,2184,107.3
'37010, 포항시,'010,5~9세,2019,23455,12172,11283,107.9,23341,12115,11226,107.9
'37010, 포항시,'010001, 5세,2019,4433,2272,2161,105.1,4407,2262,2145,105.5
'37010, 포항시,'010002, 6세,2019,4593,2334,2259,103.3,4556,2317,2239,103.5
'37010, 포항시,'010003, 7세,2019,4938,2637,2301,114.6,4916,2625,2291,114.6
'37010, 포항시,'010004, 8세,2019,4875,2540,2335,108.8,4860,2534,2326,108.9
'37010, 포항시,'010005, 9세,2019,4616,2389,2227,107.3,4602,2377,2225,106.8
'37010, 포항시,'015,10~14세,2019,22176,11585,10591,109.4,22127,11555,10572,109.3
'37010, 포항시,'015001, 10세,2019,4416,2305,2111,109.2,4397,2292,2105,108.9
'37010, 포항시,'015002, 11세,2019,4538,2332,2206,105.7,4533,2331,2202,105.9
'37010, 포항시,'015003, 12세,2019,4597,2365,2232,106,4587,2358,2229,105.8
'37010, 포항시,'015004, 13세,2019,4336,2276,2060,110.5,4327,2271,2056,110.5
'37010, 포항시,'015005, 14세,2019,4289,2307,1982,116.4,4283,2303,1980,116.3
'37010, 포항시,'020,15~19세,2019,24519,13389,11130,120.3,24238,13261,10977,120.8
'37010, 포항시,'020001, 15세,2019,4617,2413,2204,109.5,4610,2410,2200,109.5
'37010, 포항시,'020002, 16세,2019,4615,2459,2156,114.1,4608,2456,2152,114.1
'37010, 포항시,'020003, 17세,2019,4837,2632,2205,119.4,4831,2628,2203,119.3
'37010, 포항시,'020004, 18세,2019,5461,2986,2475,120.6,5399,2952,2447,120.6
'37010, 포항시,'020005, 19세,2019,4989,2899,2090,138.7,4790,2815,1975,142.5
'37010, 포항시,'025,20~24세,2019,28224,16335,11889,137.4,26857,15590,11267,138.4
'37010, 포항시,'025001, 20세,2019,5357,3251,2106,154.4,5138,3151,1987,158.6
'37010, 포항시,'025002, 21세,2019,5533,3287,2246,146.3,5271,3145,2126,147.9
'37010, 포항시,'025003, 22세,2019,5560,3117,2443,127.6,5271,2970,2301,129.1
'37010, 포항시,'025004, 23세,2019,5949,3336,2613,127.7,5648,3165,2483,127.5
'37010, 포항시,'025005, 24세,2019,5825,3344,2481,134.8,5529,3159,2370,133.3
'37010, 포항시,'030,25~29세,2019,28478,16599,11879,139.7,26919,15598,11321,137.8
'37010, 포항시,'030001, 25세,2019,5803,3408,2395,142.3,5510,3223,2287,140.9
'37010, 포항시,'030002, 26세,2019,5784,3381,2403,140.7,5460,3169,2291,138.3
'37010, 포항시,'030003, 27세,2019,5877,3480,2397,145.2,5566,3271,2295,142.5
'37010, 포항시,'030004, 28세,2019,5528,3225,2303,140,5211,3014,2197,137.2
'37010, 포항시,'030005, 29세,2019,5486,3105,2381,130.4,5172,2921,2251,129.8
'37010, 포항시,'035,30~34세,2019,26866,14595,12271,118.9,25339,13633,11706,116.5
'37010, 포항시,'035001, 30세,2019,5302,3026,2276,133,4950,2797,2153,129.9
'37010, 포항시,'035002, 31세,2019,5147,2842,2305,123.3,4808,2635,2173,121.3
'37010, 포항시,'035003, 32세,2019,5251,2798,2453,114.1,4965,2606,2359,110.5
'37010, 포항시,'035004, 33세,2019,5539,2997,2542,117.9,5257,2829,2428,116.5
'37010, 포항시,'035005, 34세,2019,5627,2932,2695,108.8,5359,2766,2593,106.7
'37010, 포항시,'040,35~39세,2019,36539,18927,17612,107.5,35421,18224,17197,106
'37010, 포항시,'040001, 35세,2019,6275,3241,3034,106.8,6000,3077,2923,105.3
'37010, 포항시,'040002, 36세,2019,6953,3706,3247,114.1,6727,3558,3169,112.3
'37010, 포항시,'040003, 37세,2019,7699,3939,3760,104.8,7488,3809,3679,103.5
'37010, 포항시,'040004, 38세,2019,7869,4095,3774,108.5,7652,3959,3693,107.2
'37010, 포항시,'040005, 39세,2019,7743,3946,3797,103.9,7554,3821,3733,102.4
'37010, 포항시,'045,40~44세,2019,35426,18044,17382,103.8,34664,17558,17106,102.6
'37010, 포항시,'045001, 40세,2019,7388,3734,3654,102.2,7214,3616,3598,100.5
'37010, 포항시,'045002, 41세,2019,6763,3512,3251,108,6598,3404,3194,106.6
'37010, 포항시,'045003, 42세,2019,7148,3640,3508,103.8,7012,3552,3460,102.7
'37010, 포항시,'045004, 43세,2019,6660,3357,3303,101.6,6512,3269,3243,100.8
'37010, 포항시,'045005, 44세,2019,7467,3801,3666,103.7,7328,3717,3611,102.9
'37010, 포항시,'050,45~49세,2019,42727,21360,21367,100,42140,20993,21147,99.3
'37010, 포항시,'050001, 45세,2019,8213,4115,4098,100.4,8088,4036,4052,99.6
'37010, 포항시,'050002, 46세,2019,8370,4156,4214,98.6,8233,4063,4170,97.4
'37010, 포항시,'050003, 47세,2019,8288,4170,4118,101.3,8184,4105,4079,100.6
'37010, 포항시,'050004, 48세,2019,8850,4428,4422,100.1,8741,4369,4372,99.9
'37010, 포항시,'050005, 49세,2019,9006,4491,4515,99.5,8894,4420,4474,98.8
'37010, 포항시,'055,50~54세,2019,44386,22343,22043,101.4,44001,22123,21878,101.1
'37010, 포항시,'055001, 50세,2019,8954,4581,4373,104.8,8853,4518,4335,104.2
'37010, 포항시,'055002, 51세,2019,9501,4843,4658,104,9416,4797,4619,103.9
'37010, 포항시,'055003, 52세,2019,8397,4190,4207,99.6,8330,4154,4176,99.5
'37010, 포항시,'055004, 53세,2019,8595,4388,4207,104.3,8536,4361,4175,104.5
'37010, 포항시,'055005, 54세,2019,8939,4341,4598,94.4,8866,4293,4573,93.9
'37010, 포항시,'060,55~59세,2019,46723,23144,23579,98.2,46413,22993,23420,98.2
'37010, 포항시,'060001, 55세,2019,8098,3992,4106,97.2,8020,3955,4065,97.3
'37010, 포항시,'060002, 56세,2019,9044,4489,4555,98.6,8961,4446,4515,98.5
'37010, 포항시,'060003, 57세,2019,9236,4702,4534,103.7,9177,4671,4506,103.7
'37010, 포항시,'060004, 58세,2019,10182,5049,5133,98.4,10145,5035,5110,98.5
'37010, 포항시,'060005, 59세,2019,10163,4912,5251,93.5,10110,4886,5224,93.5
'37010, 포항시,'065,60~64세,2019,42951,20920,22031,95,42789,20842,21947,95
'37010, 포항시,'065001, 60세,2019,9467,4531,4936,91.8,9426,4515,4911,91.9
'37010, 포항시,'065002, 61세,2019,8484,4058,4426,91.7,8450,4039,4411,91.6
'37010, 포항시,'065003, 62세,2019,8738,4386,4352,100.8,8705,4369,4336,100.8
'37010, 포항시,'065004, 63세,2019,8040,3922,4118,95.2,8013,3907,4106,95.2
'37010, 포항시,'065005, 64세,2019,8222,4023,4199,95.8,8195,4012,4183,95.9
'37010, 포항시,'070,65~69세,2019,29551,14902,14649,101.7,29454,14856,14598,101.8
'37010, 포항시,'070001, 65세,2019,6997,3593,3404,105.6,6973,3579,3394,105.5
'37010, 포항시,'070002, 66세,2019,6262,3139,3123,100.5,6242,3129,3113,100.5
'37010, 포항시,'070003, 67세,2019,6577,3274,3303,99.1,6560,3269,3291,99.3
'37010, 포항시,'070004, 68세,2019,4931,2462,2469,99.7,4911,2455,2456,100
'37010, 포항시,'070005, 69세,2019,4784,2434,2350,103.6,4768,2424,2344,103.4
'37010, 포항시,'075,70~74세,2019,19629,9585,10044,95.4,19588,9569,10019,95.5
'37010, 포항시,'075001, 70세,2019,4965,2453,2512,97.7,4956,2449,2507,97.7
'37010, 포항시,'075002, 71세,2019,4600,2292,2308,99.3,4591,2288,2303,99.3
'37010, 포항시,'075003, 72세,2019,4307,2113,2194,96.3,4298,2110,2188,96.4
'37010, 포항시,'075004, 73세,2019,2833,1378,1455,94.7,2829,1377,1452,94.8
'37010, 포항시,'075005, 74세,2019,2924,1349,1575,85.7,2914,1345,1569,85.7
'37010, 포항시,'080,75~79세,2019,15475,6552,8923,73.4,15459,6545,8914,73.4
'37010, 포항시,'080001, 75세,2019,3232,1451,1781,81.5,3228,1449,1779,81.5
'37010, 포항시,'080002, 76세,2019,3291,1425,1866,76.4,3286,1423,1863,76.4
'37010, 포항시,'080003, 77세,2019,3561,1499,2062,72.7,3560,1499,2061,72.7
'37010, 포항시,'080004, 78세,2019,2835,1169,1666,70.2,2833,1167,1666,70
'37010, 포항시,'080005, 79세,2019,2556,1008,1548,65.1,2552,1007,1545,65.2
'37010, 포항시,'085,80~84세,2019,9716,3323,6393,52,9698,3318,6380,52
'37010, 포항시,'085001, 80세,2019,2516,982,1534,64,2512,981,1531,64.1
'37010, 포항시,'085002, 81세,2019,2094,714,1380,51.7,2088,713,1375,51.9
'37010, 포항시,'085003, 82세,2019,1882,670,1212,55.3,1877,669,1208,55.4
'37010, 포항시,'085004, 83세,2019,1737,544,1193,45.6,1735,543,1192,45.6
'37010, 포항시,'085005, 84세,2019,1487,413,1074,38.5,1486,412,1074,38.4
'37010, 포항시,'086,85세이상,2019,6876,1581,5295,29.9,6872,1578,5294,29.8
'37010, 포항시,'090,85~89세,2019,4796,1228,3568,34.4,4794,1227,3567,34.4
'37010, 포항시,'090001, 85세,2019,1335,400,935,42.8,1334,399,935,42.7
'37010, 포항시,'090002, 86세,2019,1094,282,812,34.7,1093,282,811,34.8
'37010, 포항시,'090003, 87세,2019,974,236,738,32,974,236,738,32
'37010, 포항시,'090004, 88세,2019,766,173,593,29.2,766,173,593,29.2
'37010, 포항시,'090005, 89세,2019,627,137,490,28,627,137,490,28
'37010, 포항시,'095,90~94세,2019,1680,282,1398,20.2,1679,281,1398,20.1
'37010, 포항시,'095001, 90세,2019,513,100,413,24.2,512,99,413,24
'37010, 포항시,'095002, 91세,2019,441,69,372,18.5,441,69,372,18.5
'37010, 포항시,'095003, 92세,2019,352,56,296,18.9,352,56,296,18.9
'37010, 포항시,'095004, 93세,2019,198,29,169,17.2,198,29,169,17.2
'37010, 포항시,'095005, 94세,2019,176,28,148,18.9,176,28,148,18.9
'37010, 포항시,'100,95~99세,2019,361,66,295,22.4,360,65,295,22
'37010, 포항시,'100001, 95세,2019,117,22,95,23.2,117,22,95,23.2
'37010, 포항시,'100002, 96세,2019,102,24,78,30.8,102,24,78,30.8
'37010, 포항시,'100003, 97세,2019,69,11,58,19,69,11,58,19
'37010, 포항시,'100004, 98세,2019,39,5,34,14.7,39,5,34,14.7
'37010, 포항시,'100005, 99세,2019,34,X,30,13.3,33,X,30,10
'37010, 포항시,'101,100세이상,2019,39,5,34,14.7,39,5,34,14.7
'37010, 포항시,'102,15세미만,2019,63978,33275,30703,108.4,63624,33089,30535,108.4
'37010, 포항시,'103,15~64세,2019,356839,185656,171183,108.5,348781,180815,167966,107.6
'37010, 포항시,'104,65세이상,2019,81247,35943,45304,79.3,81071,35866,45205,79.3
'37010, 포항시,'126,평균연령,2019,43.5,42,45.1,,43.7,42.2,45.2,
'37010, 포항시,'127,중위연령,2019,45.9,44,47.6,,46.2,44.4,47.9,
'37011, 남구,'000,합계,2019,233172,121579,111593,108.9,228741,118681,110060,107.8
'37011, 남구,'005,0~4세,2019,8227,4295,3932,109.2,8163,4263,3900,109.3
'37011, 남구,'005001, 0세,2019,1289,653,636,102.7,1278,647,631,102.5
'37011, 남구,'005002, 1세,2019,1357,733,624,117.5,1346,727,619,117.4
'37011, 남구,'005003, 2세,2019,1586,840,746,112.6,1574,834,740,112.7
'37011, 남구,'005004, 3세,2019,1941,1023,918,111.4,1924,1013,911,111.2
'37011, 남구,'005005, 4세,2019,2054,1046,1008,103.8,2041,1042,999,104.3
'37011, 남구,'010,5~9세,2019,10776,5568,5208,106.9,10731,5544,5187,106.9
'37011, 남구,'010001, 5세,2019,2018,1051,967,108.7,2009,1047,962,108.8
'37011, 남구,'010002, 6세,2019,2057,1032,1025,100.7,2044,1024,1020,100.4
'37011, 남구,'010003, 7세,2019,2303,1222,1081,113,2296,1219,1077,113.2
'37011, 남구,'010004, 8세,2019,2250,1158,1092,106,2241,1155,1086,106.4
'37011, 남구,'010005, 9세,2019,2148,1105,1043,105.9,2141,1099,1042,105.5
'37011, 남구,'015,10~14세,2019,10298,5397,4901,110.1,10284,5388,4896,110
'37011, 남구,'015001, 10세,2019,2050,1080,970,111.3,2043,1075,968,111.1
'37011, 남구,'015002, 11세,2019,2129,1088,1041,104.5,2127,1088,1039,104.7
'37011, 남구,'015003, 12세,2019,2128,1098,1030,106.6,2126,1096,1030,106.4
'37011, 남구,'015004, 13세,2019,1969,1031,938,109.9,1967,1030,937,109.9
'37011, 남구,'015005, 14세,2019,2022,1100,922,119.3,2021,1099,922,119.2
'37011, 남구,'020,15~19세,2019,10976,6246,4730,132.1,10941,6225,4716,132
'37011, 남구,'020001, 15세,2019,2131,1109,1022,108.5,2128,1107,1021,108.4
'37011, 남구,'020002, 16세,2019,2141,1207,934,129.2,2141,1207,934,129.2
'37011, 남구,'020003, 17세,2019,2224,1260,964,130.7,2222,1258,964,130.5
'37011, 남구,'020004, 18세,2019,2495,1408,1087,129.5,2487,1402,1085,129.2
'37011, 남구,'020005, 19세,2019,1985,1262,723,174.6,1963,1251,712,175.7
'37011, 남구,'025,20~24세,2019,12173,7444,4729,157.4,11726,7169,4557,157.3
'37011, 남구,'025001, 20세,2019,2210,1467,743,197.4,2164,1443,721,200.1
'37011, 남구,'025002, 21세,2019,2267,1477,790,187,2198,1434,764,187.7
'37011, 남구,'025003, 22세,2019,2384,1437,947,151.7,2302,1389,913,152.1
'37011, 남구,'025004, 23세,2019,2644,1517,1127,134.6,2520,1437,1083,132.7
'37011, 남구,'025005, 24세,2019,2668,1546,1122,137.8,2542,1466,1076,136.2
'37011, 남구,'030,25~29세,2019,14402,8701,5701,152.6,13503,8092,5411,149.5
'37011, 남구,'030001, 25세,2019,2832,1716,1116,153.8,2676,1612,1064,151.5
'37011, 남구,'030002, 26세,2019,2945,1777,1168,152.1,2764,1650,1114,148.1
'37011, 남구,'030003, 27세,2019,3018,1842,1176,156.6,2841,1718,1123,153
'37011, 남구,'030004, 28세,2019,2838,1739,1099,158.2,2637,1593,1044,152.6
'37011, 남구,'030005, 29세,2019,2769,1627,1142,142.5,2585,1519,1066,142.5
'37011, 남구,'035,30~34세,2019,13032,7392,5640,131.1,12080,6745,5335,126.4
'37011, 남구,'035001, 30세,2019,2569,1534,1035,148.2,2364,1394,970,143.7
'37011, 남구,'035002, 31세,2019,2499,1454,1045,139.1,2289,1306,983,132.9
'37011, 남구,'035003, 32세,2019,2588,1437,1151,124.8,2400,1300,1100,118.2
'37011, 남구,'035004, 33세,2019,2659,1483,1176,126.1,2484,1376,1108,124.2
'37011, 남구,'035005, 34세,2019,2717,1484,1233,120.4,2543,1369,1174,116.6
'37011, 남구,'040,35~39세,2019,17120,9088,8032,113.1,16463,8626,7837,110.1
'37011, 남구,'040001, 35세,2019,2897,1580,1317,120,2733,1467,1266,115.9
'37011, 남구,'040002, 36세,2019,3271,1776,1495,118.8,3136,1678,1458,115.1
'37011, 남구,'040003, 37세,2019,3584,1872,1712,109.3,3463,1787,1676,106.6
'37011, 남구,'040004, 38세,2019,3719,1985,1734,114.5,3588,1897,1691,112.2
'37011, 남구,'040005, 39세,2019,3649,1875,1774,105.7,3543,1797,1746,102.9
'37011, 남구,'045,40~44세,2019,16665,8746,7919,110.4,16219,8439,7780,108.5
'37011, 남구,'045001, 40세,2019,3497,1837,1660,110.7,3395,1762,1633,107.9
'37011, 남구,'045002, 41세,2019,3195,1710,1485,115.2,3091,1632,1459,111.9
'37011, 남구,'045003, 42세,2019,3380,1800,1580,113.9,3309,1750,1559,112.3
'37011, 남구,'045004, 43세,2019,3072,1602,1470,109,2981,1549,1432,108.2
'37011, 남구,'045005, 44세,2019,3521,1797,1724,104.2,3443,1746,1697,102.9
'37011, 남구,'050,45~49세,2019,19993,10331,9662,106.9,19667,10109,9558,105.8
'37011, 남구,'050001, 45세,2019,3897,1996,1901,105,3828,1953,1875,104.2
'37011, 남구,'050002, 46세,2019,3935,2051,1884,108.9,3855,1990,1865,106.7
'37011, 남구,'050003, 47세,2019,3821,1957,1864,105,3770,1922,1848,104
'37011, 남구,'050004, 48세,2019,4110,2114,1996,105.9,4049,2078,1971,105.4
'37011, 남구,'050005, 49세,2019,4230,2213,2017,109.7,4165,2166,1999,108.4
'37011, 남구,'055,50~54세,2019,20933,10915,10018,109,20728,10792,9936,108.6
'37011, 남구,'055001, 50세,2019,4207,2212,1995,110.9,4156,2177,1979,110
'37011, 남구,'055002, 51세,2019,4525,2400,2125,112.9,4479,2372,2107,112.6
'37011, 남구,'055003, 52세,2019,4074,2117,1957,108.2,4033,2095,1938,108.1
'37011, 남구,'055004, 53세,2019,3996,2125,1871,113.6,3962,2108,1854,113.7
'37011, 남구,'055005, 54세,2019,4131,2061,2070,99.6,4098,2040,2058,99.1
'37011, 남구,'060,55~59세,2019,21405,10855,10550,102.9,21247,10774,10473,102.9
'37011, 남구,'060001, 55세,2019,3687,1862,1825,102,3650,1847,1803,102.4
'37011, 남구,'060002, 56세,2019,4103,2096,2007,104.4,4066,2077,1989,104.4
'37011, 남구,'060003, 57세,2019,4235,2183,2052,106.4,4202,2164,2038,106.2
'37011, 남구,'060004, 58세,2019,4661,2361,2300,102.7,4642,2353,2289,102.8
'37011, 남구,'060005, 59세,2019,4719,2353,2366,99.5,4687,2333,2354,99.1
'37011, 남구,'065,60~64세,2019,20160,9848,10312,95.5,20074,9805,10269,95.5
'37011, 남구,'065001, 60세,2019,4394,2126,2268,93.7,4372,2116,2256,93.8
'37011, 남구,'065002, 61세,2019,3938,1832,2106,87,3921,1823,2098,86.9
'37011, 남구,'065003, 62세,2019,4133,2071,2062,100.4,4114,2061,2053,100.4
'37011, 남구,'065004, 63세,2019,3808,1863,1945,95.8,3795,1856,1939,95.7
'37011, 남구,'065005, 64세,2019,3887,1956,1931,101.3,3872,1949,1923,101.4
'37011, 남구,'070,65~69세,2019,14044,7142,6902,103.5,13986,7113,6873,103.5
'37011, 남구,'070001, 65세,2019,3296,1703,1593,106.9,3281,1695,1586,106.9
'37011, 남구,'070002, 66세,2019,2966,1495,1471,101.6,2951,1488,1463,101.7
'37011, 남구,'070003, 67세,2019,3191,1590,1601,99.3,3180,1587,1593,99.6
'37011, 남구,'070004, 68세,2019,2336,1170,1166,100.3,2326,1165,1161,100.3
'37011, 남구,'070005, 69세,2019,2255,1184,1071,110.6,2248,1178,1070,110.1
'37011, 남구,'075,70~74세,2019,9185,4512,4673,96.6,9163,4506,4657,96.8
'37011, 남구,'075001, 70세,2019,2365,1153,1212,95.1,2358,1151,1207,95.4
'37011, 남구,'075002, 71세,2019,2152,1108,1044,106.1,2146,1106,1040,106.3
'37011, 남구,'075003, 72세,2019,2015,987,1028,96,2012,986,1026,96.1
'37011, 남구,'075004, 73세,2019,1292,625,667,93.7,1290,625,665,94
'37011, 남구,'075005, 74세,2019,1361,639,722,88.5,1357,638,719,88.7
'37011, 남구,'080,75~79세,2019,6975,3056,3919,78,6968,3053,3915,78
'37011, 남구,'080001, 75세,2019,1471,677,794,85.3,1469,676,793,85.2
'37011, 남구,'080002, 76세,2019,1519,710,809,87.8,1517,709,808,87.7
'37011, 남구,'080003, 77세,2019,1609,708,901,78.6,1609,708,901,78.6
'37011, 남구,'080004, 78세,2019,1259,522,737,70.8,1258,521,737,70.7
'37011, 남구,'080005, 79세,2019,1117,439,678,64.7,1115,439,676,64.9
'37011, 남구,'085,80~84세,2019,4164,1431,2733,52.4,4157,1428,2729,52.3
'37011, 남구,'085001, 80세,2019,1064,417,647,64.5,1062,416,646,64.4
'37011, 남구,'085002, 81세,2019,879,316,563,56.1,877,315,562,56
'37011, 남구,'085003, 82세,2019,832,296,536,55.2,830,295,535,55.1
'37011, 남구,'085004, 83세,2019,763,233,530,44,762,233,529,44
'37011, 남구,'085005, 84세,2019,626,169,457,37,626,169,457,37
'37011, 남구,'086,85세이상,2019,2644,612,2032,30.1,2641,610,2031,30
'37011, 남구,'090,85~89세,2019,1888,484,1404,34.5,1886,483,1403,34.4
'37011, 남구,'090001, 85세,2019,549,171,378,45.2,548,170,378,45
'37011, 남구,'090002, 86세,2019,443,113,330,34.2,442,113,329,34.3
'37011, 남구,'090003, 87세,2019,381,84,297,28.3,381,84,297,28.3
'37011, 남구,'090004, 88세,2019,286,71,215,33,286,71,215,33
'37011, 남구,'090005, 89세,2019,229,45,184,24.5,229,45,184,24.5
'37011, 남구,'095,90~94세,2019,615,102,513,19.9,615,102,513,19.9
'37011, 남구,'095001, 90세,2019,177,31,146,21.2,177,31,146,21.2
'37011, 남구,'095002, 91세,2019,164,30,134,22.4,164,30,134,22.4
'37011, 남구,'095003, 92세,2019,124,18,106,17,124,18,106,17
'37011, 남구,'095004, 93세,2019,80,11,69,15.9,80,11,69,15.9
'37011, 남구,'095005, 94세,2019,70,12,58,20.7,70,12,58,20.7
'37011, 남구,'100,95~99세,2019,130,24,106,22.6,129,23,106,21.7
'37011, 남구,'100001, 95세,2019,46,7,39,17.9,46,7,39,17.9
'37011, 남구,'100002, 96세,2019,37,7,30,23.3,37,7,30,23.3
'37011, 남구,'100003, 97세,2019,21,5,16,31.3,21,5,16,31.3
'37011, 남구,'100004, 98세,2019,13,X,12,8.3,13,X,12,8.3
'37011, 남구,'100005, 99세,2019,13,X,9,44.4,12,X,9,33.3
'37011, 남구,'101,100세이상,2019,11,X,9,22.2,11,X,9,22.2
'37011, 남구,'102,15세미만,2019,29301,15260,14041,108.7,29178,15195,13983,108.7
'37011, 남구,'103,15~64세,2019,166859,89566,77293,115.9,162648,86776,75872,114.4
'37011, 남구,'104,65세이상,2019,37012,16753,20259,82.7,36915,16710,20205,82.7
'37011, 남구,'126,평균연령,2019,43.5,42,45.1,,43.6,42.2,45.2,
'37011, 남구,'127,중위연령,2019,45.7,43.8,47.7,,46.1,44.3,47.9,
'37012, 북구,'000,합계,2019,268892,133295,135597,98.3,264735,131089,133646,98.1
'37012, 북구,'005,0~4세,2019,10120,5223,4897,106.7,9993,5156,4837,106.6
'37012, 북구,'005001, 0세,2019,1564,770,794,97,1544,763,781,97.7
'37012, 북구,'005002, 1세,2019,1783,930,853,109,1763,918,845,108.6
'37012, 북구,'005003, 2세,2019,1949,1006,943,106.7,1921,991,930,106.6
'37012, 북구,'005004, 3세,2019,2310,1199,1111,107.9,2278,1182,1096,107.8
'37012, 북구,'005005, 4세,2019,2514,1318,1196,110.2,2487,1302,1185,109.9
'37012, 북구,'010,5~9세,2019,12679,6604,6075,108.7,12610,6571,6039,108.8
'37012, 북구,'010001, 5세,2019,2415,1221,1194,102.3,2398,1215,1183,102.7
'37012, 북구,'010002, 6세,2019,2536,1302,1234,105.5,2512,1293,1219,106.1
'37012, 북구,'010003, 7세,2019,2635,1415,1220,116,2620,1406,1214,115.8
'37012, 북구,'010004, 8세,2019,2625,1382,1243,111.2,2619,1379,1240,111.2
'37012, 북구,'010005, 9세,2019,2468,1284,1184,108.4,2461,1278,1183,108
'37012, 북구,'015,10~14세,2019,11878,6188,5690,108.8,11843,6167,5676,108.7
'37012, 북구,'015001, 10세,2019,2366,1225,1141,107.4,2354,1217,1137,107
'37012, 북구,'015002, 11세,2019,2409,1244,1165,106.8,2406,1243,1163,106.9
'37012, 북구,'015003, 12세,2019,2469,1267,1202,105.4,2461,1262,1199,105.3
'37012, 북구,'015004, 13세,2019,2367,1245,1122,111,2360,1241,1119,110.9
'37012, 북구,'015005, 14세,2019,2267,1207,1060,113.9,2262,1204,1058,113.8
'37012, 북구,'020,15~19세,2019,13543,7143,6400,111.6,13297,7036,6261,112.4
'37012, 북구,'020001, 15세,2019,2486,1304,1182,110.3,2482,1303,1179,110.5
'37012, 북구,'020002, 16세,2019,2474,1252,1222,102.5,2467,1249,1218,102.5
'37012, 북구,'020003, 17세,2019,2613,1372,1241,110.6,2609,1370,1239,110.6
'37012, 북구,'020004, 18세,2019,2966,1578,1388,113.7,2912,1550,1362,113.8
'37012, 북구,'020005, 19세,2019,3004,1637,1367,119.8,2827,1564,1263,123.8
'37012, 북구,'025,20~24세,2019,16051,8891,7160,124.2,15131,8421,6710,125.5
'37012, 북구,'025001, 20세,2019,3147,1784,1363,130.9,2974,1708,1266,134.9
'37012, 북구,'025002, 21세,2019,3266,1810,1456,124.3,3073,1711,1362,125.6
'37012, 북구,'025003, 22세,2019,3176,1680,1496,112.3,2969,1581,1388,113.9
'37012, 북구,'025004, 23세,2019,3305,1819,1486,122.4,3128,1728,1400,123.4
'37012, 북구,'025005, 24세,2019,3157,1798,1359,132.3,2987,1693,1294,130.8
'37012, 북구,'030,25~29세,2019,14076,7898,6178,127.8,13416,7506,5910,127
'37012, 북구,'030001, 25세,2019,2971,1692,1279,132.3,2834,1611,1223,131.7
'37012, 북구,'030002, 26세,2019,2839,1604,1235,129.9,2696,1519,1177,129.1
'37012, 북구,'030003, 27세,2019,2859,1638,1221,134.2,2725,1553,1172,132.5
'37012, 북구,'030004, 28세,2019,2690,1486,1204,123.4,2574,1421,1153,123.2
'37012, 북구,'030005, 29세,2019,2717,1478,1239,119.3,2587,1402,1185,118.3
'37012, 북구,'035,30~34세,2019,13834,7203,6631,108.6,13259,6888,6371,108.1
'37012, 북구,'035001, 30세,2019,2733,1492,1241,120.2,2586,1403,1183,118.6
'37012, 북구,'035002, 31세,2019,2648,1388,1260,110.2,2519,1329,1190,111.7
'37012, 북구,'035003, 32세,2019,2663,1361,1302,104.5,2565,1306,1259,103.7
'37012, 북구,'035004, 33세,2019,2880,1514,1366,110.8,2773,1453,1320,110.1
'37012, 북구,'035005, 34세,2019,2910,1448,1462,99,2816,1397,1419,98.4
'37012, 북구,'040,35~39세,2019,19419,9839,9580,102.7,18958,9598,9360,102.5
'37012, 북구,'040001, 35세,2019,3378,1661,1717,96.7,3267,1610,1657,97.2
'37012, 북구,'040002, 36세,2019,3682,1930,1752,110.2,3591,1880,1711,109.9
'37012, 북구,'040003, 37세,2019,4115,2067,2048,100.9,4025,2022,2003,100.9
'37012, 북구,'040004, 38세,2019,4150,2110,2040,103.4,4064,2062,2002,103
'37012, 북구,'040005, 39세,2019,4094,2071,2023,102.4,4011,2024,1987,101.9
'37012, 북구,'045,40~44세,2019,18761,9298,9463,98.3,18445,9119,9326,97.8
'37012, 북구,'045001, 40세,2019,3891,1897,1994,95.1,3819,1854,1965,94.4
'37012, 북구,'045002, 41세,2019,3568,1802,1766,102,3507,1772,1735,102.1
'37012, 북구,'045003, 42세,2019,3768,1840,1928,95.4,3703,1802,1901,94.8
'37012, 북구,'045004, 43세,2019,3588,1755,1833,95.7,3531,1720,1811,95
'37012, 북구,'045005, 44세,2019,3946,2004,1942,103.2,3885,1971,1914,103
'37012, 북구,'050,45~49세,2019,22734,11029,11705,94.2,22473,10884,11589,93.9
'37012, 북구,'050001, 45세,2019,4316,2119,2197,96.4,4260,2083,2177,95.7
'37012, 북구,'050002, 46세,2019,4435,2105,2330,90.3,4378,2073,2305,89.9
'37012, 북구,'050003, 47세,2019,4467,2213,2254,98.2,4414,2183,2231,97.8
'37012, 북구,'050004, 48세,2019,4740,2314,2426,95.4,4692,2291,2401,95.4
'37012, 북구,'050005, 49세,2019,4776,2278,2498,91.2,4729,2254,2475,91.1
'37012, 북구,'055,50~54세,2019,23453,11428,12025,95,23273,11331,11942,94.9
'37012, 북구,'055001, 50세,2019,4747,2369,2378,99.6,4697,2341,2356,99.4
'37012, 북구,'055002, 51세,2019,4976,2443,2533,96.4,4937,2425,2512,96.5
'37012, 북구,'055003, 52세,2019,4323,2073,2250,92.1,4297,2059,2238,92
'37012, 북구,'055004, 53세,2019,4599,2263,2336,96.9,4574,2253,2321,97.1
'37012, 북구,'055005, 54세,2019,4808,2280,2528,90.2,4768,2253,2515,89.6
'37012, 북구,'060,55~59세,2019,25318,12289,13029,94.3,25166,12219,12947,94.4
'37012, 북구,'060001, 55세,2019,4411,2130,2281,93.4,4370,2108,2262,93.2
'37012, 북구,'060002, 56세,2019,4941,2393,2548,93.9,4895,2369,2526,93.8
'37012, 북구,'060003, 57세,2019,5001,2519,2482,101.5,4975,2507,2468,101.6
'37012, 북구,'060004, 58세,2019,5521,2688,2833,94.9,5503,2682,2821,95.1
'37012, 북구,'060005, 59세,2019,5444,2559,2885,88.7,5423,2553,2870,89
'37012, 북구,'065,60~64세,2019,22791,11072,11719,94.5,22715,11037,11678,94.5
'37012, 북구,'065001, 60세,2019,5073,2405,2668,90.1,5054,2399,2655,90.4
'37012, 북구,'065002, 61세,2019,4546,2226,2320,95.9,4529,2216,2313,95.8
'37012, 북구,'065003, 62세,2019,4605,2315,2290,101.1,4591,2308,2283,101.1
'37012, 북구,'065004, 63세,2019,4232,2059,2173,94.8,4218,2051,2167,94.6
'37012, 북구,'065005, 64세,2019,4335,2067,2268,91.1,4323,2063,2260,91.3
'37012, 북구,'070,65~69세,2019,15507,7760,7747,100.2,15468,7743,7725,100.2
'37012, 북구,'070001, 65세,2019,3701,1890,1811,104.4,3692,1884,1808,104.2
'37012, 북구,'070002, 66세,2019,3296,1644,1652,99.5,3291,1641,1650,99.5
'37012, 북구,'070003, 67세,2019,3386,1684,1702,98.9,3380,1682,1698,99.1
'37012, 북구,'070004, 68세,2019,2595,1292,1303,99.2,2585,1290,1295,99.6
'37012, 북구,'070005, 69세,2019,2529,1250,1279,97.7,2520,1246,1274,97.8
'37012, 북구,'075,70~74세,2019,10444,5073,5371,94.5,10425,5063,5362,94.4
'37012, 북구,'075001, 70세,2019,2600,1300,1300,100,2598,1298,1300,99.8
'37012, 북구,'075002, 71세,2019,2448,1184,1264,93.7,2445,1182,1263,93.6
'37012, 북구,'075003, 72세,2019,2292,1126,1166,96.6,2286,1124,1162,96.7
'37012, 북구,'075004, 73세,2019,1541,753,788,95.6,1539,752,787,95.6
'37012, 북구,'075005, 74세,2019,1563,710,853,83.2,1557,707,850,83.2
'37012, 북구,'080,75~79세,2019,8500,3496,5004,69.9,8491,3492,4999,69.9
'37012, 북구,'080001, 75세,2019,1761,774,987,78.4,1759,773,986,78.4
'37012, 북구,'080002, 76세,2019,1772,715,1057,67.6,1769,714,1055,67.7
'37012, 북구,'080003, 77세,2019,1952,791,1161,68.1,1951,791,1160,68.2
'37012, 북구,'080004, 78세,2019,1576,647,929,69.6,1575,646,929,69.5
'37012, 북구,'080005, 79세,2019,1439,569,870,65.4,1437,568,869,65.4
'37012, 북구,'085,80~84세,2019,5552,1892,3660,51.7,5541,1890,3651,51.8
'37012, 북구,'085001, 80세,2019,1452,565,887,63.7,1450,565,885,63.8
'37012, 북구,'085002, 81세,2019,1215,398,817,48.7,1211,398,813,49
'37012, 북구,'085003, 82세,2019,1050,374,676,55.3,1047,374,673,55.6
'37012, 북구,'085004, 83세,2019,974,311,663,46.9,973,310,663,46.8
'37012, 북구,'085005, 84세,2019,861,244,617,39.5,860,243,617,39.4
'37012, 북구,'086,85세이상,2019,4232,969,3263,29.7,4231,968,3263,29.7
'37012, 북구,'090,85~89세,2019,2908,744,2164,34.4,2908,744,2164,34.4
'37012, 북구,'090001, 85세,2019,786,229,557,41.1,786,229,557,41.1
'37012, 북구,'090002, 86세,2019,651,169,482,35.1,651,169,482,35.1
'37012, 북구,'090003, 87세,2019,593,152,441,34.5,593,152,441,34.5
'37012, 북구,'090004, 88세,2019,480,102,378,27,480,102,378,27
'37012, 북구,'090005, 89세,2019,398,92,306,30.1,398,92,306,30.1
'37012, 북구,'095,90~94세,2019,1065,180,885,20.3,1064,179,885,20.2
'37012, 북구,'095001, 90세,2019,336,69,267,25.8,335,68,267,25.5
'37012, 북구,'095002, 91세,2019,277,39,238,16.4,277,39,238,16.4
'37012, 북구,'095003, 92세,2019,228,38,190,20,228,38,190,20
'37012, 북구,'095004, 93세,2019,118,18,100,18,118,18,100,18
'37012, 북구,'095005, 94세,2019,106,16,90,17.8,106,16,90,17.8
'37012, 북구,'100,95~99세,2019,231,42,189,22.2,231,42,189,22.2
'37012, 북구,'100001, 95세,2019,71,15,56,26.8,71,15,56,26.8
'37012, 북구,'100002, 96세,2019,65,17,48,35.4,65,17,48,35.4
'37012, 북구,'100003, 97세,2019,48,6,42,14.3,48,6,42,14.3
'37012, 북구,'100004, 98세,2019,26,X,22,18.2,26,X,22,18.2
'37012, 북구,'100005, 99세,2019,21,X,21,0,21,X,21,0
'37012, 북구,'101,100세이상,2019,28,X,25,12,28,X,25,12
'37012, 북구,'102,15세미만,2019,34677,18015,16662,108.1,34446,17894,16552,108.1
'37012, 북구,'103,15~64세,2019,189980,96090,93890,102.3,186133,94039,92094,102.1
'37012, 북구,'104,65세이상,2019,44235,19190,25045,76.6,44156,19156,25000,76.6
'37012, 북구,'126,평균연령,2019,43.6,42.1,45.1,,43.8,42.2,45.3,
'37012, 북구,'127,중위연령,2019,45.9,44.2,47.5,,46.3,44.5,47.8,
'37020, 경주시,'000,합계,2019,264314,134636,129678,103.8,246801,123616,123185,100.3
'37020, 경주시,'005,0~4세,2019,7657,3886,3771,103,7307,3697,3610,102.4
'37020, 경주시,'005001, 0세,2019,1171,594,577,102.9,1120,563,557,101.1
'37020, 경주시,'005002, 1세,2019,1347,702,645,108.8,1288,669,619,108.1
'37020, 경주시,'005003, 2세,2019,1572,840,732,114.8,1474,780,694,112.4
'37020, 경주시,'005004, 3세,2019,1776,867,909,95.4,1687,829,858,96.6
'37020, 경주시,'005005, 4세,2019,1791,883,908,97.2,1738,856,882,97.1
'37020, 경주시,'010,5~9세,2019,9549,4939,4610,107.1,9285,4803,4482,107.2
'37020, 경주시,'010001, 5세,2019,1805,942,863,109.2,1744,914,830,110.1
'37020, 경주시,'010002, 6세,2019,1814,955,859,111.2,1757,923,834,110.7
'37020, 경주시,'010003, 7세,2019,2022,1022,1000,102.2,1972,993,979,101.4
'37020, 경주시,'010004, 8세,2019,2019,1046,973,107.5,1971,1023,948,107.9
'37020, 경주시,'010005, 9세,2019,1889,974,915,106.4,1841,950,891,106.6
'37020, 경주시,'015,10~14세,2019,9789,5067,4722,107.3,9574,4964,4610,107.7
'37020, 경주시,'015001, 10세,2019,1869,971,898,108.1,1843,957,886,108
'37020, 경주시,'015002, 11세,2019,2018,1036,982,105.5,1960,1009,951,106.1
'37020, 경주시,'015003, 12세,2019,2009,1029,980,105,1967,1005,962,104.5
'37020, 경주시,'015004, 13세,2019,1992,1026,966,106.2,1945,1005,940,106.9
'37020, 경주시,'015005, 14세,2019,1901,1005,896,112.2,1859,988,871,113.4
'37020, 경주시,'020,15~19세,2019,12440,6614,5826,113.5,12074,6435,5639,114.1
'37020, 경주시,'020001, 15세,2019,2011,1084,927,116.9,1990,1073,917,117
'37020, 경주시,'020002, 16세,2019,2061,1038,1023,101.5,2036,1024,1012,101.2
'37020, 경주시,'020003, 17세,2019,2270,1204,1066,112.9,2233,1182,1051,112.5
'37020, 경주시,'020004, 18세,2019,2715,1458,1257,116,2635,1424,1211,117.6
'37020, 경주시,'020005, 19세,2019,3383,1830,1553,117.8,3180,1732,1448,119.6
'37020, 경주시,'025,20~24세,2019,18080,10347,7733,133.8,15407,8818,6589,133.8
'37020, 경주시,'025001, 20세,2019,3557,2005,1552,129.2,3092,1794,1298,138.2
'37020, 경주시,'025002, 21세,2019,3753,2080,1673,124.3,3200,1773,1427,124.2
'37020, 경주시,'025003, 22세,2019,3654,2015,1639,122.9,3075,1671,1404,119
'37020, 경주시,'025004, 23세,2019,3589,2099,1490,140.9,3049,1770,1279,138.4
'37020, 경주시,'025005, 24세,2019,3527,2148,1379,155.8,2991,1810,1181,153.3
'37020, 경주시,'030,25~29세,2019,15771,9504,6267,151.7,12677,7370,5307,138.9
'37020, 경주시,'030001, 25세,2019,3352,2069,1283,161.3,2754,1668,1086,153.6
'37020, 경주시,'030002, 26세,2019,3180,1920,1260,152.4,2562,1504,1058,142.2
'37020, 경주시,'030003, 27세,2019,3097,1833,1264,145,2495,1397,1098,127.2
'37020, 경주시,'030004, 28세,2019,3097,1846,1251,147.6,2471,1405,1066,131.8
'37020, 경주시,'030005, 29세,2019,3045,1836,1209,151.9,2395,1396,999,139.7
'37020, 경주시,'035,30~34세,2019,13994,8011,5983,133.9,10884,5883,5001,117.6
'37020, 경주시,'035001, 30세,2019,2908,1730,1178,146.9,2284,1297,987,131.4
'37020, 경주시,'035002, 31세,2019,2750,1577,1173,134.4,2105,1143,962,118.8
'37020, 경주시,'035003, 32세,2019,2871,1628,1243,131,2214,1194,1020,117.1
'37020, 경주시,'035004, 33세,2019,2671,1508,1163,129.7,2087,1111,976,113.8
'37020, 경주시,'035005, 34세,2019,2794,1568,1226,127.9,2194,1138,1056,107.8
'37020, 경주시,'040,35~39세,2019,17098,9337,7761,120.3,14708,7691,7017,109.6
'37020, 경주시,'040001, 35세,2019,2934,1619,1315,123.1,2365,1222,1143,106.9
'37020, 경주시,'040002, 36세,2019,3324,1817,1507,120.6,2833,1471,1362,108
'37020, 경주시,'040003, 37세,2019,3559,1970,1589,124,3051,1624,1427,113.8
'37020, 경주시,'040004, 38세,2019,3635,1979,1656,119.5,3228,1702,1526,111.5
'37020, 경주시,'040005, 39세,2019,3646,1952,1694,115.2,3231,1672,1559,107.2
'37020, 경주시,'045,40~44세,2019,17068,9141,7927,115.3,15424,8106,7318,110.8
'37020, 경주시,'045001, 40세,2019,3446,1889,1557,121.3,3073,1641,1432,114.6
'37020, 경주시,'045002, 41세,2019,3290,1751,1539,113.8,2908,1512,1396,108.3
'37020, 경주시,'045003, 42세,2019,3323,1787,1536,116.3,3002,1584,1418,111.7
'37020, 경주시,'045004, 43세,2019,3358,1760,1598,110.1,3038,1566,1472,106.4
'37020, 경주시,'045005, 44세,2019,3651,1954,1697,115.1,3403,1803,1600,112.7
'37020, 경주시,'050,45~49세,2019,21888,11389,10499,108.5,20587,10589,9998,105.9
'37020, 경주시,'050001, 45세,2019,4219,2171,2048,106,3935,2000,1935,103.4
'37020, 경주시,'050002, 46세,2019,4241,2156,2085,103.4,3982,1990,1992,99.9
'37020, 경주시,'050003, 47세,2019,4389,2335,2054,113.7,4113,2169,1944,111.6
'37020, 경주시,'050004, 48세,2019,4538,2361,2177,108.5,4300,2218,2082,106.5
'37020, 경주시,'050005, 49세,2019,4501,2366,2135,110.8,4257,2212,2045,108.2
'37020, 경주시,'055,50~54세,2019,22776,11752,11024,106.6,21841,11226,10615,105.8
'37020, 경주시,'055001, 50세,2019,4535,2350,2185,107.6,4329,2237,2092,106.9
'37020, 경주시,'055002, 51세,2019,4835,2483,2352,105.6,4634,2378,2256,105.4
'37020, 경주시,'055003, 52세,2019,4403,2222,2181,101.9,4228,2115,2113,100.1
'37020, 경주시,'055004, 53세,2019,4522,2377,2145,110.8,4336,2270,2066,109.9
'37020, 경주시,'055005, 54세,2019,4481,2320,2161,107.4,4314,2226,2088,106.6
'37020, 경주시,'060,55~59세,2019,23640,12093,11547,104.7,23040,11756,11284,104.2
'37020, 경주시,'060001, 55세,2019,4278,2169,2109,102.8,4125,2084,2041,102.1
'37020, 경주시,'060002, 56세,2019,4716,2448,2268,107.9,4584,2375,2209,107.5
'37020, 경주시,'060003, 57세,2019,4722,2420,2302,105.1,4594,2352,2242,104.9
'37020, 경주시,'060004, 58세,2019,5002,2547,2455,103.7,4914,2491,2423,102.8
'37020, 경주시,'060005, 59세,2019,4922,2509,2413,104,4823,2454,2369,103.6
'37020, 경주시,'065,60~64세,2019,21509,10644,10865,98,21185,10478,10707,97.9
'37020, 경주시,'065001, 60세,2019,4709,2389,2320,103,4629,2352,2277,103.3
'37020, 경주시,'065002, 61세,2019,4303,2166,2137,101.4,4217,2116,2101,100.7
'37020, 경주시,'065003, 62세,2019,4291,2113,2178,97,4220,2081,2139,97.3
'37020, 경주시,'065004, 63세,2019,4183,2050,2133,96.1,4140,2024,2116,95.7
'37020, 경주시,'065005, 64세,2019,4023,1926,2097,91.8,3979,1905,2074,91.9
'37020, 경주시,'070,65~69세,2019,16074,7580,8494,89.2,15935,7512,8423,89.2
'37020, 경주시,'070001, 65세,2019,3503,1686,1817,92.8,3465,1667,1798,92.7
'37020, 경주시,'070002, 66세,2019,3358,1632,1726,94.6,3327,1617,1710,94.6
'37020, 경주시,'070003, 67세,2019,3435,1578,1857,85,3405,1561,1844,84.7
'37020, 경주시,'070004, 68세,2019,2898,1364,1534,88.9,2882,1357,1525,89
'37020, 경주시,'070005, 69세,2019,2880,1320,1560,84.6,2856,1310,1546,84.7
'37020, 경주시,'075,70~74세,2019,12247,5750,6497,88.5,12192,5726,6466,88.6
'37020, 경주시,'075001, 70세,2019,3062,1468,1594,92.1,3044,1461,1583,92.3
'37020, 경주시,'075002, 71세,2019,2779,1328,1451,91.5,2770,1322,1448,91.3
'37020, 경주시,'075003, 72세,2019,2642,1228,1414,86.8,2632,1223,1409,86.8
'37020, 경주시,'075004, 73세,2019,1762,839,923,90.9,1750,835,915,91.3
'37020, 경주시,'075005, 74세,2019,2002,887,1115,79.6,1996,885,1111,79.7
'37020, 경주시,'080,75~79세,2019,11159,4504,6655,67.7,11134,4493,6641,67.7
'37020, 경주시,'080001, 75세,2019,2115,906,1209,74.9,2105,902,1203,75
'37020, 경주시,'080002, 76세,2019,2333,982,1351,72.7,2331,981,1350,72.7
'37020, 경주시,'080003, 77세,2019,2796,1154,1642,70.3,2791,1150,1641,70.1
'37020, 경주시,'080004, 78세,2019,1991,755,1236,61.1,1986,753,1233,61.1
'37020, 경주시,'080005, 79세,2019,1924,707,1217,58.1,1921,707,1214,58.2
'37020, 경주시,'085,80~84세,2019,8047,2678,5369,49.9,8033,2672,5361,49.8
'37020, 경주시,'085001, 80세,2019,2021,710,1311,54.2,2017,709,1308,54.2
'37020, 경주시,'085002, 81세,2019,1715,576,1139,50.6,1711,572,1139,50.2
'37020, 경주시,'085003, 82세,2019,1614,558,1056,52.8,1613,557,1056,52.7
'37020, 경주시,'085004, 83세,2019,1433,455,978,46.5,1431,455,976,46.6
'37020, 경주시,'085005, 84세,2019,1264,379,885,42.8,1261,379,882,43
'37020, 경주시,'086,85세이상,2019,5528,1400,4128,33.9,5514,1397,4117,33.9
'37020, 경주시,'090,85~89세,2019,4021,1095,2926,37.4,4018,1095,2923,37.5
'37020, 경주시,'090001, 85세,2019,1123,336,787,42.7,1121,336,785,42.8
'37020, 경주시,'090002, 86세,2019,1012,273,739,36.9,1012,273,739,36.9
'37020, 경주시,'090003, 87세,2019,812,245,567,43.2,811,245,566,43.3
'37020, 경주시,'090004, 88세,2019,576,131,445,29.4,576,131,445,29.4
'37020, 경주시,'090005, 89세,2019,498,110,388,28.4,498,110,388,28.4
'37020, 경주시,'095,90~94세,2019,1195,247,948,26.1,1186,245,941,26
'37020, 경주시,'095001, 90세,2019,415,93,322,28.9,414,93,321,29
'37020, 경주시,'095002, 91세,2019,303,62,241,25.7,299,61,238,25.6
'37020, 경주시,'095003, 92세,2019,235,43,192,22.4,235,43,192,22.4
'37020, 경주시,'095004, 93세,2019,117,23,94,24.5,116,22,94,23.4
'37020, 경주시,'095005, 94세,2019,125,26,99,26.3,122,26,96,27.1
'37020, 경주시,'100,95~99세,2019,275,53,222,23.9,273,52,221,23.5
'37020, 경주시,'100001, 95세,2019,76,21,55,38.2,76,21,55,38.2
'37020, 경주시,'100002, 96세,2019,97,13,84,15.5,97,13,84,15.5
'37020, 경주시,'100003, 97세,2019,54,11,43,25.6,53,10,43,23.3
'37020, 경주시,'100004, 98세,2019,33,6,27,22.2,32,6,26,23.1
'37020, 경주시,'100005, 99세,2019,15,X,13,15.4,15,X,13,15.4
'37020, 경주시,'101,100세이상,2019,37,5,32,15.6,37,5,32,15.6
'37020, 경주시,'102,15세미만,2019,26995,13892,13103,106,26166,13464,12702,106
'37020, 경주시,'103,15~64세,2019,184264,98832,85432,115.7,167827,88352,79475,111.2
'37020, 경주시,'104,65세이상,2019,53055,21912,31143,70.4,52808,21800,31008,70.3
'37020, 경주시,'126,평균연령,2019,45.5,43.5,47.5,,46.3,44.3,48.2,
'37020, 경주시,'127,중위연령,2019,47.5,45.2,49.9,,48.9,47,51,
'37030, 김천시,'000,합계,2019,139902,70085,69817,100.4,136572,68190,68382,99.7
'37030, 김천시,'005,0~4세,2019,5138,2600,2538,102.4,5108,2592,2516,103
'37030, 김천시,'005001, 0세,2019,913,463,450,102.9,905,461,444,103.8
'37030, 김천시,'005002, 1세,2019,963,505,458,110.3,957,503,454,110.8
'37030, 김천시,'005003, 2세,2019,1007,511,496,103,1003,510,493,103.4
'37030, 김천시,'005004, 3세,2019,1142,582,560,103.9,1135,580,555,104.5
'37030, 김천시,'005005, 4세,2019,1113,539,574,93.9,1108,538,570,94.4
'37030, 김천시,'010,5~9세,2019,5701,2956,2745,107.7,5692,2951,2741,107.7
'37030, 김천시,'010001, 5세,2019,1107,570,537,106.1,1106,569,537,106
'37030, 김천시,'010002, 6세,2019,1148,620,528,117.4,1145,618,527,117.3
'37030, 김천시,'010003, 7세,2019,1195,616,579,106.4,1192,615,577,106.6
'37030, 김천시,'010004, 8세,2019,1149,599,550,108.9,1147,598,549,108.9
'37030, 김천시,'010005, 9세,2019,1102,551,551,100,1102,551,551,100
'37030, 김천시,'015,10~14세,2019,5327,2787,2540,109.7,5320,2784,2536,109.8
'37030, 김천시,'015001, 10세,2019,1063,551,512,107.6,1061,551,510,108
'37030, 김천시,'015002, 11세,2019,1141,624,517,120.7,1140,623,517,120.5
'37030, 김천시,'015003, 12세,2019,1088,560,528,106.1,1087,560,527,106.3
'37030, 김천시,'015004, 13세,2019,1018,566,452,125.2,1017,566,451,125.5
'37030, 김천시,'015005, 14세,2019,1017,486,531,91.5,1015,484,531,91.1
'37030, 김천시,'020,15~19세,2019,6781,3674,3107,118.2,6658,3639,3019,120.5
'37030, 김천시,'020001, 15세,2019,1171,614,557,110.2,1168,612,556,110.1
'37030, 김천시,'020002, 16세,2019,1249,721,528,136.6,1246,720,526,136.9
'37030, 김천시,'020003, 17세,2019,1337,765,572,133.7,1329,760,569,133.6
'37030, 김천시,'020004, 18세,2019,1490,798,692,115.3,1464,790,674,117.2
'37030, 김천시,'020005, 19세,2019,1534,776,758,102.4,1451,757,694,109.1
'37030, 김천시,'025,20~24세,2019,8222,4448,3774,117.9,7598,4122,3476,118.6
'37030, 김천시,'025001, 20세,2019,1671,867,804,107.8,1545,811,734,110.5
'37030, 김천시,'025002, 21세,2019,1617,836,781,107,1511,777,734,105.9
'37030, 김천시,'025003, 22세,2019,1730,893,837,106.7,1605,818,787,103.9
'37030, 김천시,'025004, 23세,2019,1624,930,694,134,1487,867,620,139.8
'37030, 김천시,'025005, 24세,2019,1580,922,658,140.1,1450,849,601,141.3
'37030, 김천시,'030,25~29세,2019,7636,4316,3320,130,6932,3871,3061,126.5
'37030, 김천시,'030001, 25세,2019,1542,922,620,148.7,1394,832,562,148
'37030, 김천시,'030002, 26세,2019,1520,864,656,131.7,1382,773,609,126.9
'37030, 김천시,'030003, 27세,2019,1566,845,721,117.2,1420,753,667,112.9
'37030, 김천시,'030004, 28세,2019,1530,868,662,131.1,1398,782,616,126.9
'37030, 김천시,'030005, 29세,2019,1478,817,661,123.6,1338,731,607,120.4
'37030, 김천시,'035,30~34세,2019,7240,4012,3228,124.3,6658,3629,3029,119.8
'37030, 김천시,'035001, 30세,2019,1405,813,592,137.3,1273,732,541,135.3
'37030, 김천시,'035002, 31세,2019,1423,798,625,127.7,1312,720,592,121.6
'37030, 김천시,'035003, 32세,2019,1423,799,624,128,1308,725,583,124.4
'37030, 김천시,'035004, 33세,2019,1485,808,677,119.4,1360,729,631,115.5
'37030, 김천시,'035005, 34세,2019,1504,794,710,111.8,1405,723,682,106
'37030, 김천시,'040,35~39세,2019,9218,4865,4353,111.8,8847,4647,4200,110.6
'37030, 김천시,'040001, 35세,2019,1560,819,741,110.5,1467,774,693,111.7
'37030, 김천시,'040002, 36세,2019,1780,916,864,106,1694,864,830,104.1
'37030, 김천시,'040003, 37세,2019,1971,1030,941,109.5,1905,985,920,107.1
'37030, 김천시,'040004, 38세,2019,1950,1060,890,119.1,1876,1010,866,116.6
'37030, 김천시,'040005, 39세,2019,1957,1040,917,113.4,1905,1014,891,113.8
'37030, 김천시,'045,40~44세,2019,8828,4712,4116,114.5,8587,4566,4021,113.6
'37030, 김천시,'045001, 40세,2019,1738,945,793,119.2,1689,914,775,117.9
'37030, 김천시,'045002, 41세,2019,1699,904,795,113.7,1642,872,770,113.2
'37030, 김천시,'045003, 42세,2019,1837,984,853,115.4,1794,955,839,113.8
'37030, 김천시,'045004, 43세,2019,1688,893,795,112.3,1648,869,779,111.6
'37030, 김천시,'045005, 44세,2019,1866,986,880,112,1814,956,858,111.4
'37030, 김천시,'050,45~49세,2019,10490,5486,5004,109.6,10286,5376,4910,109.5
'37030, 김천시,'050001, 45세,2019,1976,1026,950,108,1944,1006,938,107.2
'37030, 김천시,'050002, 46세,2019,2053,1042,1011,103.1,2008,1021,987,103.4
'37030, 김천시,'050003, 47세,2019,2085,1119,966,115.8,2038,1096,942,116.3
'37030, 김천시,'050004, 48세,2019,2168,1127,1041,108.3,2128,1105,1023,108
'37030, 김천시,'050005, 49세,2019,2208,1172,1036,113.1,2168,1148,1020,112.5
'37030, 김천시,'055,50~54세,2019,11287,5863,5424,108.1,11103,5767,5336,108.1
'37030, 김천시,'055001, 50세,2019,2306,1184,1122,105.5,2263,1162,1101,105.5
'37030, 김천시,'055002, 51세,2019,2372,1226,1146,107,2338,1213,1125,107.8
'37030, 김천시,'055003, 52세,2019,2219,1160,1059,109.5,2188,1142,1046,109.2
'37030, 김천시,'055004, 53세,2019,2240,1180,1060,111.3,2203,1155,1048,110.2
'37030, 김천시,'055005, 54세,2019,2150,1113,1037,107.3,2111,1095,1016,107.8
'37030, 김천시,'060,55~59세,2019,12269,6284,5985,105,12160,6230,5930,105.1
'37030, 김천시,'060001, 55세,2019,2079,1117,962,116.1,2051,1104,947,116.6
'37030, 김천시,'060002, 56세,2019,2363,1241,1122,110.6,2340,1229,1111,110.6
'37030, 김천시,'060003, 57세,2019,2419,1206,1213,99.4,2403,1200,1203,99.8
'37030, 김천시,'060004, 58세,2019,2728,1391,1337,104,2708,1385,1323,104.7
'37030, 김천시,'060005, 59세,2019,2680,1329,1351,98.4,2658,1312,1346,97.5
'37030, 김천시,'065,60~64세,2019,11270,5605,5665,98.9,11211,5575,5636,98.9
'37030, 김천시,'065001, 60세,2019,2401,1210,1191,101.6,2380,1198,1182,101.4
'37030, 김천시,'065002, 61세,2019,2185,1104,1081,102.1,2175,1101,1074,102.5
'37030, 김천시,'065003, 62세,2019,2324,1178,1146,102.8,2311,1168,1143,102.2
'37030, 김천시,'065004, 63세,2019,2206,1081,1125,96.1,2195,1078,1117,96.5
'37030, 김천시,'065005, 64세,2019,2154,1032,1122,92,2150,1030,1120,92
'37030, 김천시,'070,65~69세,2019,8802,4192,4610,90.9,8762,4178,4584,91.1
'37030, 김천시,'070001, 65세,2019,1946,928,1018,91.2,1939,924,1015,91
'37030, 김천시,'070002, 66세,2019,1878,884,994,88.9,1869,882,987,89.4
'37030, 김천시,'070003, 67세,2019,2055,973,1082,89.9,2046,971,1075,90.3
'37030, 김천시,'070004, 68세,2019,1421,676,745,90.7,1411,671,740,90.7
'37030, 김천시,'070005, 69세,2019,1502,731,771,94.8,1497,730,767,95.2
'37030, 김천시,'075,70~74세,2019,6659,3091,3568,86.6,6634,3078,3556,86.6
'37030, 김천시,'075001, 70세,2019,1636,769,867,88.7,1632,768,864,88.9
'37030, 김천시,'075002, 71세,2019,1565,738,827,89.2,1558,736,822,89.5
'37030, 김천시,'075003, 72세,2019,1491,691,800,86.4,1485,687,798,86.1
'37030, 김천시,'075004, 73세,2019,992,442,550,80.4,988,440,548,80.3
'37030, 김천시,'075005, 74세,2019,975,451,524,86.1,971,447,524,85.3
'37030, 김천시,'080,75~79세,2019,6429,2484,3945,63,6419,2478,3941,62.9
'37030, 김천시,'080001, 75세,2019,1216,504,712,70.8,1213,502,711,70.6
'37030, 김천시,'080002, 76세,2019,1330,524,806,65,1327,521,806,64.6
'37030, 김천시,'080003, 77세,2019,1429,550,879,62.6,1429,550,879,62.6
'37030, 김천시,'080004, 78세,2019,1232,457,775,59,1229,457,772,59.2
'37030, 김천시,'080005, 79세,2019,1222,449,773,58.1,1221,448,773,58
'37030, 김천시,'085,80~84세,2019,5090,1784,3306,54,5086,1782,3304,53.9
'37030, 김천시,'085001, 80세,2019,1206,426,780,54.6,1206,426,780,54.6
'37030, 김천시,'085002, 81세,2019,1096,394,702,56.1,1093,393,700,56.1
'37030, 김천시,'085003, 82세,2019,990,346,644,53.7,990,346,644,53.7
'37030, 김천시,'085004, 83세,2019,934,319,615,51.9,933,318,615,51.7
'37030, 김천시,'085005, 84세,2019,864,299,565,52.9,864,299,565,52.9
'37030, 김천시,'086,85세이상,2019,3515,926,2589,35.8,3511,925,2586,35.8
'37030, 김천시,'090,85~89세,2019,2482,724,1758,41.2,2481,723,1758,41.1
'37030, 김천시,'090001, 85세,2019,682,214,468,45.7,682,214,468,45.7
'37030, 김천시,'090002, 86세,2019,587,178,409,43.5,587,178,409,43.5
'37030, 김천시,'090003, 87세,2019,482,134,348,38.5,482,134,348,38.5
'37030, 김천시,'090004, 88세,2019,379,106,273,38.8,378,105,273,38.5
'37030, 김천시,'090005, 89세,2019,352,92,260,35.4,352,92,260,35.4
'37030, 김천시,'095,90~94세,2019,827,180,647,27.8,825,180,645,27.9
'37030, 김천시,'095001, 90세,2019,259,61,198,30.8,259,61,198,30.8
'37030, 김천시,'095002, 91세,2019,216,48,168,28.6,216,48,168,28.6
'37030, 김천시,'095003, 92세,2019,176,40,136,29.4,176,40,136,29.4
'37030, 김천시,'095004, 93세,2019,96,17,79,21.5,95,17,78,21.8
'37030, 김천시,'095005, 94세,2019,80,14,66,21.2,79,14,65,21.5
'37030, 김천시,'100,95~99세,2019,186,21,165,12.7,185,21,164,12.8
'37030, 김천시,'100001, 95세,2019,43,X,39,10.3,43,X,39,10.3
'37030, 김천시,'100002, 96세,2019,57,9,48,18.8,57,9,48,18.8
'37030, 김천시,'100003, 97세,2019,43,6,37,16.2,42,6,36,16.7
'37030, 김천시,'100004, 98세,2019,26,X,24,8.3,26,X,24,8.3
'37030, 김천시,'100005, 99세,2019,17,X,17,0,17,X,17,0
'37030, 김천시,'101,100세이상,2019,20,X,19,5.3,20,X,19,5.3
'37030, 김천시,'102,15세미만,2019,16166,8343,7823,106.6,16120,8327,7793,106.9
'37030, 김천시,'103,15~64세,2019,93241,49265,43976,112,90040,47422,42618,111.3
'37030, 김천시,'104,65세이상,2019,30495,12477,18018,69.2,30412,12441,17971,69.2
'37030, 김천시,'126,평균연령,2019,45.7,43.8,47.7,,46,44,48,
'37030, 김천시,'127,중위연령,2019,47.9,45.7,50.2,,48.4,46.3,50.6,
'37040, 안동시,'000,합계,2019,160344,79503,80841,98.3,158260,78505,79755,98.4
'37040, 안동시,'005,0~4세,2019,5085,2662,2423,109.9,5072,2656,2416,109.9
'37040, 안동시,'005001, 0세,2019,877,451,426,105.9,875,450,425,105.9
'37040, 안동시,'005002, 1세,2019,957,507,450,112.7,957,507,450,112.7
'37040, 안동시,'005003, 2세,2019,1028,536,492,108.9,1024,534,490,109
'37040, 안동시,'005004, 3세,2019,1070,562,508,110.6,1066,561,505,111.1
'37040, 안동시,'005005, 4세,2019,1153,606,547,110.8,1150,604,546,110.6
'37040, 안동시,'010,5~9세,2019,6055,3197,2858,111.9,6040,3189,2851,111.9
'37040, 안동시,'010001, 5세,2019,1091,562,529,106.2,1084,558,526,106.1
'37040, 안동시,'010002, 6세,2019,1214,642,572,112.2,1210,640,570,112.3
'37040, 안동시,'010003, 7세,2019,1300,689,611,112.8,1299,689,610,113
'37040, 안동시,'010004, 8세,2019,1238,668,570,117.2,1237,667,570,117
'37040, 안동시,'010005, 9세,2019,1212,636,576,110.4,1210,635,575,110.4
'37040, 안동시,'015,10~14세,2019,6263,3275,2988,109.6,6255,3272,2983,109.7
'37040, 안동시,'015001, 10세,2019,1173,601,572,105.1,1172,600,572,104.9
'37040, 안동시,'015002, 11세,2019,1266,658,608,108.2,1265,657,608,108.1
'37040, 안동시,'015003, 12세,2019,1314,675,639,105.6,1312,675,637,106
'37040, 안동시,'015004, 13세,2019,1268,686,582,117.9,1267,685,582,117.7
'37040, 안동시,'015005, 14세,2019,1242,655,587,111.6,1239,655,584,112.2
'37040, 안동시,'020,15~19세,2019,9023,4727,4296,110,8984,4711,4273,110.3
'37040, 안동시,'020001, 15세,2019,1425,776,649,119.6,1422,774,648,119.4
'37040, 안동시,'020002, 16세,2019,1502,796,706,112.7,1502,796,706,112.7
'37040, 안동시,'020003, 17세,2019,1585,848,737,115.1,1582,848,734,115.5
'37040, 안동시,'020004, 18세,2019,1978,1007,971,103.7,1972,1006,966,104.1
'37040, 안동시,'020005, 19세,2019,2533,1300,1233,105.4,2506,1287,1219,105.6
'37040, 안동시,'025,20~24세,2019,10661,5662,4999,113.3,10396,5535,4861,113.9
'37040, 안동시,'025001, 20세,2019,2251,1048,1203,87.1,2212,1036,1176,88.1
'37040, 안동시,'025002, 21세,2019,2200,1037,1163,89.2,2149,1018,1131,90
'37040, 안동시,'025003, 22세,2019,2153,1165,988,117.9,2109,1138,971,117.2
'37040, 안동시,'025004, 23세,2019,2053,1222,831,147.1,1990,1187,803,147.8
'37040, 안동시,'025005, 24세,2019,2004,1190,814,146.2,1936,1156,780,148.2
'37040, 안동시,'030,25~29세,2019,7785,4360,3425,127.3,7400,4170,3230,129.1
'37040, 안동시,'030001, 25세,2019,1696,974,722,134.9,1623,938,685,136.9
'37040, 안동시,'030002, 26세,2019,1610,923,687,134.4,1543,887,656,135.2
'37040, 안동시,'030003, 27세,2019,1555,854,701,121.8,1463,801,662,121
'37040, 안동시,'030004, 28세,2019,1500,810,690,117.4,1421,780,641,121.7
'37040, 안동시,'030005, 29세,2019,1424,799,625,127.8,1350,764,586,130.4
'37040, 안동시,'035,30~34세,2019,7119,3753,3366,111.5,6733,3564,3169,112.5
'37040, 안동시,'035001, 30세,2019,1368,740,628,117.8,1300,711,589,120.7
'37040, 안동시,'035002, 31세,2019,1410,755,655,115.3,1325,712,613,116.2
'37040, 안동시,'035003, 32세,2019,1480,758,722,105,1387,716,671,106.7
'37040, 안동시,'035004, 33세,2019,1462,766,696,110.1,1383,722,661,109.2
'37040, 안동시,'035005, 34세,2019,1399,734,665,110.4,1338,703,635,110.7
'37040, 안동시,'040,35~39세,2019,9254,4644,4610,100.7,8994,4516,4478,100.8
'37040, 안동시,'040001, 35세,2019,1588,847,741,114.3,1531,817,714,114.4
'37040, 안동시,'040002, 36세,2019,1726,854,872,97.9,1670,825,845,97.6
'37040, 안동시,'040003, 37세,2019,1966,955,1011,94.5,1910,929,981,94.7
'37040, 안동시,'040004, 38세,2019,1865,919,946,97.1,1820,898,922,97.4
'37040, 안동시,'040005, 39세,2019,2109,1069,1040,102.8,2063,1047,1016,103.1
'37040, 안동시,'045,40~44세,2019,10090,5131,4959,103.5,9933,5059,4874,103.8
'37040, 안동시,'045001, 40세,2019,1875,976,899,108.6,1836,957,879,108.9
'37040, 안동시,'045002, 41세,2019,1876,962,914,105.3,1847,949,898,105.7
'37040, 안동시,'045003, 42세,2019,2044,1020,1024,99.6,2010,1006,1004,100.2
'37040, 안동시,'045004, 43세,2019,2023,1048,975,107.5,1989,1032,957,107.8
'37040, 안동시,'045005, 44세,2019,2272,1125,1147,98.1,2251,1115,1136,98.2
'37040, 안동시,'050,45~49세,2019,12239,6499,5740,113.2,12082,6427,5655,113.7
'37040, 안동시,'050001, 45세,2019,2374,1303,1071,121.7,2347,1289,1058,121.8
'37040, 안동시,'050002, 46세,2019,2422,1273,1149,110.8,2388,1254,1134,110.6
'37040, 안동시,'050003, 47세,2019,2315,1222,1093,111.8,2285,1213,1072,113.2
'37040, 안동시,'050004, 48세,2019,2530,1350,1180,114.4,2506,1338,1168,114.6
'37040, 안동시,'050005, 49세,2019,2598,1351,1247,108.3,2556,1333,1223,109
'37040, 안동시,'055,50~54세,2019,12671,6542,6129,106.7,12532,6487,6045,107.3
'37040, 안동시,'055001, 50세,2019,2631,1391,1240,112.2,2600,1377,1223,112.6
'37040, 안동시,'055002, 51세,2019,2705,1394,1311,106.3,2681,1383,1298,106.5
'37040, 안동시,'055003, 52세,2019,2447,1269,1178,107.7,2417,1257,1160,108.4
'37040, 안동시,'055004, 53세,2019,2485,1280,1205,106.2,2459,1269,1190,106.6
'37040, 안동시,'055005, 54세,2019,2403,1208,1195,101.1,2375,1201,1174,102.3
'37040, 안동시,'060,55~59세,2019,14107,7026,7081,99.2,13990,6969,7021,99.3
'37040, 안동시,'060001, 55세,2019,2394,1240,1154,107.5,2373,1230,1143,107.6
'37040, 안동시,'060002, 56세,2019,2561,1292,1269,101.8,2538,1284,1254,102.4
'37040, 안동시,'060003, 57세,2019,2609,1294,1315,98.4,2581,1278,1303,98.1
'37040, 안동시,'060004, 58세,2019,3260,1614,1646,98.1,3242,1603,1639,97.8
'37040, 안동시,'060005, 59세,2019,3283,1586,1697,93.5,3256,1574,1682,93.6
'37040, 안동시,'065,60~64세,2019,13062,6532,6530,100,12976,6488,6488,100
'37040, 안동시,'065001, 60세,2019,2675,1314,1361,96.5,2662,1305,1357,96.2
'37040, 안동시,'065002, 61세,2019,2652,1334,1318,101.2,2636,1327,1309,101.4
'37040, 안동시,'065003, 62세,2019,2650,1363,1287,105.9,2627,1355,1272,106.5
'37040, 안동시,'065004, 63세,2019,2582,1318,1264,104.3,2567,1310,1257,104.2
'37040, 안동시,'065005, 64세,2019,2503,1203,1300,92.5,2484,1191,1293,92.1
'37040, 안동시,'070,65~69세,2019,10382,4879,5503,88.7,10353,4863,5490,88.6
'37040, 안동시,'070001, 65세,2019,2231,1081,1150,94,2224,1077,1147,93.9
'37040, 안동시,'070002, 66세,2019,2274,1005,1269,79.2,2265,1001,1264,79.2
'37040, 안동시,'070003, 67세,2019,2381,1103,1278,86.3,2376,1103,1273,86.6
'37040, 안동시,'070004, 68세,2019,1778,837,941,88.9,1774,833,941,88.5
'37040, 안동시,'070005, 69세,2019,1718,853,865,98.6,1714,849,865,98.2
'37040, 안동시,'075,70~74세,2019,8071,3867,4204,92,8058,3859,4199,91.9
'37040, 안동시,'075001, 70세,2019,1941,973,968,100.5,1936,971,965,100.6
'37040, 안동시,'075002, 71세,2019,1888,919,969,94.8,1886,917,969,94.6
'37040, 안동시,'075003, 72세,2019,1761,839,922,91,1760,838,922,90.9
'37040, 안동시,'075004, 73세,2019,1224,578,646,89.5,1220,576,644,89.4
'37040, 안동시,'075005, 74세,2019,1257,558,699,79.8,1256,557,699,79.7
'37040, 안동시,'080,75~79세,2019,8238,3386,4852,69.8,8232,3383,4849,69.8
'37040, 안동시,'080001, 75세,2019,1551,625,926,67.5,1551,625,926,67.5
'37040, 안동시,'080002, 76세,2019,1765,749,1016,73.7,1762,748,1014,73.8
'37040, 안동시,'080003, 77세,2019,1973,840,1133,74.1,1970,838,1132,74
'37040, 안동시,'080004, 78세,2019,1494,607,887,68.4,1494,607,887,68.4
'37040, 안동시,'080005, 79세,2019,1455,565,890,63.5,1455,565,890,63.5
'37040, 안동시,'085,80~84세,2019,5941,2211,3730,59.3,5935,2208,3727,59.2
'37040, 안동시,'085001, 80세,2019,1511,585,926,63.2,1510,584,926,63.1
'37040, 안동시,'085002, 81세,2019,1249,465,784,59.3,1248,464,784,59.2
'37040, 안동시,'085003, 82세,2019,1086,396,690,57.4,1084,395,689,57.3
'37040, 안동시,'085004, 83세,2019,1055,390,665,58.6,1053,390,663,58.8
'37040, 안동시,'085005, 84세,2019,1040,375,665,56.4,1040,375,665,56.4
'37040, 안동시,'086,85세이상,2019,4298,1150,3148,36.5,4295,1149,3146,36.5
'37040, 안동시,'090,85~89세,2019,2986,852,2134,39.9,2984,851,2133,39.9
'37040, 안동시,'090001, 85세,2019,829,272,557,48.8,829,272,557,48.8
'37040, 안동시,'090002, 86세,2019,690,210,480,43.8,690,210,480,43.8
'37040, 안동시,'090003, 87세,2019,633,180,453,39.7,633,180,453,39.7
'37040, 안동시,'090004, 88세,2019,447,115,332,34.6,446,114,332,34.3
'37040, 안동시,'090005, 89세,2019,387,75,312,24,386,75,311,24.1
'37040, 안동시,'095,90~94세,2019,1087,252,835,30.2,1086,252,834,30.2
'37040, 안동시,'095001, 90세,2019,341,97,244,39.8,341,97,244,39.8
'37040, 안동시,'095002, 91세,2019,268,50,218,22.9,268,50,218,22.9
'37040, 안동시,'095003, 92세,2019,189,38,151,25.2,188,38,150,25.3
'37040, 안동시,'095004, 93세,2019,168,42,126,33.3,168,42,126,33.3
'37040, 안동시,'095005, 94세,2019,121,25,96,26,121,25,96,26
'37040, 안동시,'100,95~99세,2019,195,40,155,25.8,195,40,155,25.8
'37040, 안동시,'100001, 95세,2019,58,15,43,34.9,58,15,43,34.9
'37040, 안동시,'100002, 96세,2019,64,10,54,18.5,64,10,54,18.5
'37040, 안동시,'100003, 97세,2019,31,7,24,29.2,31,7,24,29.2
'37040, 안동시,'100004, 98세,2019,25,X,22,13.6,25,X,22,13.6
'37040, 안동시,'100005, 99세,2019,17,5,12,41.7,17,5,12,41.7
'37040, 안동시,'101,100세이상,2019,30,6,24,25,30,6,24,25
'37040, 안동시,'102,15세미만,2019,17403,9134,8269,110.5,17367,9117,8250,110.5
'37040, 안동시,'103,15~64세,2019,106011,54876,51135,107.3,104020,53926,50094,107.6
'37040, 안동시,'104,65세이상,2019,36930,15493,21437,72.3,36873,15462,21411,72.2
'37040, 안동시,'126,평균연령,2019,46.3,44.5,48.1,,46.4,44.6,48.3,
'37040, 안동시,'127,중위연령,2019,48.7,46.8,50.6,,48.9,47,50.9,
'37050, 구미시,'000,합계,2019,420319,217387,202932,107.1,413284,213409,199875,106.8
'37050, 구미시,'005,0~4세,2019,19769,10118,9651,104.8,19671,10068,9603,104.8
'37050, 구미시,'005001, 0세,2019,3050,1584,1466,108,3029,1571,1458,107.8
'37050, 구미시,'005002, 1세,2019,3493,1809,1684,107.4,3473,1795,1678,107
'37050, 구미시,'005003, 2세,2019,3897,1971,1926,102.3,3874,1959,1915,102.3
'37050, 구미시,'005004, 3세,2019,4523,2300,2223,103.5,4502,2293,2209,103.8
'37050, 구미시,'005005, 4세,2019,4806,2454,2352,104.3,4793,2450,2343,104.6
'37050, 구미시,'010,5~9세,2019,23849,12392,11457,108.2,23806,12370,11436,108.2
'37050, 구미시,'010001, 5세,2019,4682,2466,2216,111.3,4669,2462,2207,111.6
'37050, 구미시,'010002, 6세,2019,4700,2414,2286,105.6,4689,2407,2282,105.5
'37050, 구미시,'010003, 7세,2019,5065,2612,2453,106.5,5055,2606,2449,106.4
'37050, 구미시,'010004, 8세,2019,4898,2600,2298,113.1,4894,2597,2297,113.1
'37050, 구미시,'010005, 9세,2019,4504,2300,2204,104.4,4499,2298,2201,104.4
'37050, 구미시,'015,10~14세,2019,21815,11347,10468,108.4,21791,11336,10455,108.4
'37050, 구미시,'015001, 10세,2019,4279,2262,2017,112.1,4273,2260,2013,112.3
'37050, 구미시,'015002, 11세,2019,4560,2356,2204,106.9,4555,2352,2203,106.8
'37050, 구미시,'015003, 12세,2019,4662,2421,2241,108,4657,2419,2238,108.1
'37050, 구미시,'015004, 13세,2019,4151,2173,1978,109.9,4147,2171,1976,109.9
'37050, 구미시,'015005, 14세,2019,4163,2135,2028,105.3,4159,2134,2025,105.4
'37050, 구미시,'020,15~19세,2019,25460,14048,11412,123.1,25368,14011,11357,123.4
'37050, 구미시,'020001, 15세,2019,4387,2332,2055,113.5,4382,2330,2052,113.5
'37050, 구미시,'020002, 16세,2019,4836,2569,2267,113.3,4830,2565,2265,113.2
'37050, 구미시,'020003, 17세,2019,4844,2569,2275,112.9,4836,2567,2269,113.1
'37050, 구미시,'020004, 18세,2019,5577,3046,2531,120.3,5558,3041,2517,120.8
'37050, 구미시,'020005, 19세,2019,5816,3532,2284,154.6,5762,3508,2254,155.6
'37050, 구미시,'025,20~24세,2019,28766,17106,11660,146.7,28071,16689,11382,146.6
'37050, 구미시,'025001, 20세,2019,5478,3326,2152,154.6,5428,3301,2127,155.2
'37050, 구미시,'025002, 21세,2019,5450,3229,2221,145.4,5333,3168,2165,146.3
'37050, 구미시,'025003, 22세,2019,5838,3424,2414,141.8,5707,3344,2363,141.5
'37050, 구미시,'025004, 23세,2019,5789,3480,2309,150.7,5591,3361,2230,150.7
'37050, 구미시,'025005, 24세,2019,6211,3647,2564,142.2,6012,3515,2497,140.8
'37050, 구미시,'030,25~29세,2019,30159,16433,13726,119.7,28835,15644,13191,118.6
'37050, 구미시,'030001, 25세,2019,6225,3446,2779,124,5997,3306,2691,122.9
'37050, 구미시,'030002, 26세,2019,6037,3327,2710,122.8,5793,3180,2613,121.7
'37050, 구미시,'030003, 27세,2019,6285,3292,2993,110,5993,3124,2869,108.9
'37050, 구미시,'030004, 28세,2019,5816,3162,2654,119.1,5557,3012,2545,118.3
'37050, 구미시,'030005, 29세,2019,5796,3206,2590,123.8,5495,3022,2473,122.2
'37050, 구미시,'035,30~34세,2019,31753,17202,14551,118.2,30302,16369,13933,117.5
'37050, 구미시,'035001, 30세,2019,5780,3222,2558,126,5467,3045,2422,125.7
'37050, 구미시,'035002, 31세,2019,6162,3386,2776,122,5838,3203,2635,121.6
'37050, 구미시,'035003, 32세,2019,6470,3428,3042,112.7,6166,3244,2922,111
'37050, 구미시,'035004, 33세,2019,6724,3598,3126,115.1,6458,3447,3011,114.5
'37050, 구미시,'035005, 34세,2019,6617,3568,3049,117,6373,3430,2943,116.5
'37050, 구미시,'040,35~39세,2019,38708,20281,18427,110.1,37637,19655,17982,109.3
'37050, 구미시,'040001, 35세,2019,6693,3494,3199,109.2,6481,3364,3117,107.9
'37050, 구미시,'040002, 36세,2019,7514,3946,3568,110.6,7291,3817,3474,109.9
'37050, 구미시,'040003, 37세,2019,8156,4297,3859,111.4,7928,4169,3759,110.9
'37050, 구미시,'040004, 38세,2019,8041,4197,3844,109.2,7818,4071,3747,108.6
'37050, 구미시,'040005, 39세,2019,8304,4347,3957,109.9,8119,4234,3885,109
'37050, 구미시,'045,40~44세,2019,35143,17741,17402,101.9,34467,17364,17103,101.5
'37050, 구미시,'045001, 40세,2019,7411,3867,3544,109.1,7259,3774,3485,108.3
'37050, 구미시,'045002, 41세,2019,6802,3523,3279,107.4,6663,3455,3208,107.7
'37050, 구미시,'045003, 42세,2019,7021,3525,3496,100.8,6885,3451,3434,100.5
'37050, 구미시,'045004, 43세,2019,6923,3447,3476,99.2,6794,3374,3420,98.7
'37050, 구미시,'045005, 44세,2019,6986,3379,3607,93.7,6866,3310,3556,93.1
'37050, 구미시,'050,45~49세,2019,37733,18829,18904,99.6,37198,18526,18672,99.2
'37050, 구미시,'050001, 45세,2019,7439,3643,3796,96,7320,3576,3744,95.5
'37050, 구미시,'050002, 46세,2019,7412,3573,3839,93.1,7293,3508,3785,92.7
'37050, 구미시,'050003, 47세,2019,7409,3783,3626,104.3,7291,3716,3575,103.9
'37050, 구미시,'050004, 48세,2019,7648,3944,3704,106.5,7570,3898,3672,106.2
'37050, 구미시,'050005, 49세,2019,7825,3886,3939,98.7,7724,3828,3896,98.3
'37050, 구미시,'055,50~54세,2019,36123,18039,18084,99.8,35739,17842,17897,99.7
'37050, 구미시,'055001, 50세,2019,7842,3889,3953,98.4,7752,3842,3910,98.3
'37050, 구미시,'055002, 51세,2019,7795,3818,3977,96,7716,3780,3936,96
'37050, 구미시,'055003, 52세,2019,7014,3358,3656,91.8,6938,3321,3617,91.8
'37050, 구미시,'055004, 53세,2019,6635,3448,3187,108.2,6567,3410,3157,108
'37050, 구미시,'055005, 54세,2019,6837,3526,3311,106.5,6766,3489,3277,106.5
'37050, 구미시,'060,55~59세,2019,32062,16888,15174,111.3,31757,16724,15033,111.2
'37050, 구미시,'060001, 55세,2019,6276,3339,2937,113.7,6200,3299,2901,113.7
'37050, 구미시,'060002, 56세,2019,6411,3405,3006,113.3,6340,3364,2976,113
'37050, 구미시,'060003, 57세,2019,6349,3331,3018,110.4,6284,3293,2991,110.1
'37050, 구미시,'060004, 58세,2019,6653,3479,3174,109.6,6612,3454,3158,109.4
'37050, 구미시,'060005, 59세,2019,6373,3334,3039,109.7,6321,3314,3007,110.2
'37050, 구미시,'065,60~64세,2019,21785,11365,10420,109.1,21590,11266,10324,109.1
'37050, 구미시,'065001, 60세,2019,5314,2753,2561,107.5,5268,2730,2538,107.6
'37050, 구미시,'065002, 61세,2019,4490,2362,2128,111,4438,2335,2103,111
'37050, 구미시,'065003, 62세,2019,4393,2283,2110,108.2,4358,2266,2092,108.3
'37050, 구미시,'065004, 63세,2019,3939,2107,1832,115,3907,2089,1818,114.9
'37050, 구미시,'065005, 64세,2019,3649,1860,1789,104,3619,1846,1773,104.1
'37050, 구미시,'070,65~69세,2019,13032,6435,6597,97.5,12955,6403,6552,97.7
'37050, 구미시,'070001, 65세,2019,3136,1586,1550,102.3,3115,1573,1542,102
'37050, 구미시,'070002, 66세,2019,2879,1444,1435,100.6,2865,1441,1424,101.2
'37050, 구미시,'070003, 67세,2019,2950,1450,1500,96.7,2932,1440,1492,96.5
'37050, 구미시,'070004, 68세,2019,1995,949,1046,90.7,1985,948,1037,91.4
'37050, 구미시,'070005, 69세,2019,2072,1006,1066,94.4,2058,1001,1057,94.7
'37050, 구미시,'075,70~74세,2019,8267,3913,4354,89.9,8239,3901,4338,89.9
'37050, 구미시,'075001, 70세,2019,2076,1054,1022,103.1,2069,1051,1018,103.2
'37050, 구미시,'075002, 71세,2019,1992,927,1065,87,1982,922,1060,87
'37050, 구미시,'075003, 72세,2019,1831,882,949,92.9,1828,880,948,92.8
'37050, 구미시,'075004, 73세,2019,1205,563,642,87.7,1200,562,638,88.1
'37050, 구미시,'075005, 74세,2019,1163,487,676,72,1160,486,674,72.1
'37050, 구미시,'080,75~79세,2019,7132,2742,4390,62.5,7115,2739,4376,62.6
'37050, 구미시,'080001, 75세,2019,1394,577,817,70.6,1388,576,812,70.9
'37050, 구미시,'080002, 76세,2019,1565,601,964,62.3,1561,600,961,62.4
'37050, 구미시,'080003, 77세,2019,1700,661,1039,63.6,1696,661,1035,63.9
'37050, 구미시,'080004, 78세,2019,1274,449,825,54.4,1273,449,824,54.5
'37050, 구미시,'080005, 79세,2019,1199,454,745,60.9,1197,453,744,60.9
'37050, 구미시,'085,80~84세,2019,5180,1682,3498,48.1,5167,1677,3490,48.1
'37050, 구미시,'085001, 80세,2019,1281,419,862,48.6,1278,418,860,48.6
'37050, 구미시,'085002, 81세,2019,1084,374,710,52.7,1081,373,708,52.7
'37050, 구미시,'085003, 82세,2019,987,314,673,46.7,983,312,671,46.5
'37050, 구미시,'085004, 83세,2019,900,288,612,47.1,897,287,610,47
'37050, 구미시,'085005, 84세,2019,928,287,641,44.8,928,287,641,44.8
'37050, 구미시,'086,85세이상,2019,3583,826,2757,30,3576,825,2751,30
'37050, 구미시,'090,85~89세,2019,2503,640,1863,34.4,2501,640,1861,34.4
'37050, 구미시,'090001, 85세,2019,736,209,527,39.7,736,209,527,39.7
'37050, 구미시,'090002, 86세,2019,544,137,407,33.7,544,137,407,33.7
'37050, 구미시,'090003, 87세,2019,518,132,386,34.2,518,132,386,34.2
'37050, 구미시,'090004, 88세,2019,381,96,285,33.7,379,96,283,33.9
'37050, 구미시,'090005, 89세,2019,324,66,258,25.6,324,66,258,25.6
'37050, 구미시,'095,90~94세,2019,867,163,704,23.2,863,162,701,23.1
'37050, 구미시,'095001, 90세,2019,267,49,218,22.5,267,49,218,22.5
'37050, 구미시,'095002, 91세,2019,219,44,175,25.1,218,43,175,24.6
'37050, 구미시,'095003, 92세,2019,177,34,143,23.8,174,34,140,24.3
'37050, 구미시,'095004, 93세,2019,122,23,99,23.2,122,23,99,23.2
'37050, 구미시,'095005, 94세,2019,82,13,69,18.8,82,13,69,18.8
'37050, 구미시,'100,95~99세,2019,194,22,172,12.8,193,22,171,12.9
'37050, 구미시,'100001, 95세,2019,56,9,47,19.1,56,9,47,19.1
'37050, 구미시,'100002, 96세,2019,50,5,45,11.1,49,5,44,11.4
'37050, 구미시,'100003, 97세,2019,48,X,44,9.1,48,X,44,9.1
'37050, 구미시,'100004, 98세,2019,18,X,15,20,18,X,15,20
'37050, 구미시,'100005, 99세,2019,22,X,21,4.8,22,X,21,4.8
'37050, 구미시,'101,100세이상,2019,19,X,18,5.6,19,X,18,5.6
'37050, 구미시,'102,15세미만,2019,65433,33857,31576,107.2,65268,33774,31494,107.2
'37050, 구미시,'103,15~64세,2019,317692,167932,149760,112.1,310964,164090,146874,111.7
'37050, 구미시,'104,65세이상,2019,37194,15598,21596,72.2,37052,15545,21507,72.3
'37050, 구미시,'126,평균연령,2019,38.2,37.2,39.4,,38.3,37.2,39.4,
'37050, 구미시,'127,중위연령,2019,38.8,37.6,40,,38.9,37.7,40.2,
'37060, 영주시,'000,합계,2019,105235,52678,52557,100.2,103667,51897,51770,100.2
'37060, 영주시,'005,0~4세,2019,2715,1397,1318,106,2698,1388,1310,106
'37060, 영주시,'005001, 0세,2019,414,215,199,108,412,214,198,108.1
'37060, 영주시,'005002, 1세,2019,515,274,241,113.7,511,272,239,113.8
'37060, 영주시,'005003, 2세,2019,520,253,267,94.8,516,252,264,95.5
'37060, 영주시,'005004, 3세,2019,623,328,295,111.2,619,325,294,110.5
'37060, 영주시,'005005, 4세,2019,643,327,316,103.5,640,325,315,103.2
'37060, 영주시,'010,5~9세,2019,3832,2001,1831,109.3,3821,1993,1828,109
'37060, 영주시,'010001, 5세,2019,679,378,301,125.6,677,376,301,124.9
'37060, 영주시,'010002, 6세,2019,674,350,324,108,671,350,321,109
'37060, 영주시,'010003, 7세,2019,856,442,414,106.8,854,440,414,106.3
'37060, 영주시,'010004, 8세,2019,798,401,397,101,796,399,397,100.5
'37060, 영주시,'010005, 9세,2019,825,430,395,108.9,823,428,395,108.4
'37060, 영주시,'015,10~14세,2019,4125,2127,1998,106.5,4120,2125,1995,106.5
'37060, 영주시,'015001, 10세,2019,796,402,394,102,795,402,393,102.3
'37060, 영주시,'015002, 11세,2019,842,404,438,92.2,841,404,437,92.4
'37060, 영주시,'015003, 12세,2019,830,408,422,96.7,829,407,422,96.4
'37060, 영주시,'015004, 13세,2019,820,454,366,124,818,453,365,124.1
'37060, 영주시,'015005, 14세,2019,837,459,378,121.4,837,459,378,121.4
'37060, 영주시,'020,15~19세,2019,6087,3496,2591,134.9,6057,3478,2579,134.9
'37060, 영주시,'020001, 15세,2019,922,507,415,122.2,921,506,415,121.9
'37060, 영주시,'020002, 16세,2019,996,565,431,131.1,995,565,430,131.4
'37060, 영주시,'020003, 17세,2019,1104,646,458,141,1103,646,457,141.4
'37060, 영주시,'020004, 18세,2019,1426,811,615,131.9,1419,806,613,131.5
'37060, 영주시,'020005, 19세,2019,1639,967,672,143.9,1619,955,664,143.8
'37060, 영주시,'025,20~24세,2019,6540,3922,2618,149.8,6282,3783,2499,151.4
'37060, 영주시,'025001, 20세,2019,1359,739,620,119.2,1329,729,600,121.5
'37060, 영주시,'025002, 21세,2019,1363,785,578,135.8,1323,764,559,136.7
'37060, 영주시,'025003, 22세,2019,1404,837,567,147.6,1341,801,540,148.3
'37060, 영주시,'025004, 23세,2019,1227,797,430,185.3,1166,762,404,188.6
'37060, 영주시,'025005, 24세,2019,1187,764,423,180.6,1123,727,396,183.6
'37060, 영주시,'030,25~29세,2019,4417,2610,1807,144.4,4135,2459,1676,146.7
'37060, 영주시,'030001, 25세,2019,976,606,370,163.8,933,578,355,162.8
'37060, 영주시,'030002, 26세,2019,919,526,393,133.8,861,495,366,135.2
'37060, 영주시,'030003, 27세,2019,895,521,374,139.3,837,491,346,141.9
'37060, 영주시,'030004, 28세,2019,780,477,303,157.4,718,446,272,164
'37060, 영주시,'030005, 29세,2019,847,480,367,130.8,786,449,337,133.2
'37060, 영주시,'035,30~34세,2019,3917,2153,1764,122.1,3654,2036,1618,125.8
'37060, 영주시,'035001, 30세,2019,757,443,314,141.1,712,422,290,145.5
'37060, 영주시,'035002, 31세,2019,774,439,335,131,714,414,300,138
'37060, 영주시,'035003, 32세,2019,771,405,366,110.7,721,379,342,110.8
'37060, 영주시,'035004, 33세,2019,789,412,377,109.3,731,390,341,114.4
'37060, 영주시,'035005, 34세,2019,826,454,372,122,776,431,345,124.9
'37060, 영주시,'040,35~39세,2019,5314,2729,2585,105.6,5134,2636,2498,105.5
'37060, 영주시,'040001, 35세,2019,828,433,395,109.6,796,419,377,111.1
'37060, 영주시,'040002, 36세,2019,1052,542,510,106.3,1011,520,491,105.9
'37060, 영주시,'040003, 37세,2019,1100,576,524,109.9,1067,555,512,108.4
'37060, 영주시,'040004, 38세,2019,1126,564,562,100.4,1086,544,542,100.4
'37060, 영주시,'040005, 39세,2019,1208,614,594,103.4,1174,598,576,103.8
'37060, 영주시,'045,40~44세,2019,6256,3179,3077,103.3,6125,3126,2999,104.2
'37060, 영주시,'045001, 40세,2019,1221,636,585,108.7,1191,624,567,110.1
'37060, 영주시,'045002, 41세,2019,1139,590,549,107.5,1118,582,536,108.6
'37060, 영주시,'045003, 42세,2019,1234,628,606,103.6,1203,619,584,106
'37060, 영주시,'045004, 43세,2019,1294,639,655,97.6,1265,626,639,98
'37060, 영주시,'045005, 44세,2019,1368,686,682,100.6,1348,675,673,100.3
'37060, 영주시,'050,45~49세,2019,7843,4110,3733,110.1,7724,4057,3667,110.6
'37060, 영주시,'050001, 45세,2019,1485,747,738,101.2,1461,734,727,101
'37060, 영주시,'050002, 46세,2019,1590,819,771,106.2,1561,811,750,108.1
'37060, 영주시,'050003, 47세,2019,1539,838,701,119.5,1516,824,692,119.1
'37060, 영주시,'050004, 48세,2019,1598,863,735,117.4,1575,852,723,117.8
'37060, 영주시,'050005, 49세,2019,1631,843,788,107,1611,836,775,107.9
'37060, 영주시,'055,50~54세,2019,8546,4371,4175,104.7,8448,4319,4129,104.6
'37060, 영주시,'055001, 50세,2019,1762,941,821,114.6,1737,931,806,115.5
'37060, 영주시,'055002, 51세,2019,1840,966,874,110.5,1823,954,869,109.8
'37060, 영주시,'055003, 52세,2019,1616,766,850,90.1,1599,757,842,89.9
'37060, 영주시,'055004, 53세,2019,1695,867,828,104.7,1668,855,813,105.2
'37060, 영주시,'055005, 54세,2019,1633,831,802,103.6,1621,822,799,102.9
'37060, 영주시,'060,55~59세,2019,9703,4871,4832,100.8,9623,4830,4793,100.8
'37060, 영주시,'060001, 55세,2019,1602,814,788,103.3,1584,806,778,103.6
'37060, 영주시,'060002, 56세,2019,1704,858,846,101.4,1692,853,839,101.7
'37060, 영주시,'060003, 57세,2019,1859,967,892,108.4,1843,960,883,108.7
'37060, 영주시,'060004, 58세,2019,2261,1124,1137,98.9,2242,1114,1128,98.8
'37060, 영주시,'060005, 59세,2019,2277,1108,1169,94.8,2262,1097,1165,94.2
'37060, 영주시,'065,60~64세,2019,9236,4519,4717,95.8,9178,4494,4684,95.9
'37060, 영주시,'065001, 60세,2019,1830,887,943,94.1,1815,882,933,94.5
'37060, 영주시,'065002, 61세,2019,1779,877,902,97.2,1770,872,898,97.1
'37060, 영주시,'065003, 62세,2019,2005,996,1009,98.7,1991,993,998,99.5
'37060, 영주시,'065004, 63세,2019,1813,879,934,94.1,1804,873,931,93.8
'37060, 영주시,'065005, 64세,2019,1809,880,929,94.7,1798,874,924,94.6
'37060, 영주시,'070,65~69세,2019,7709,3625,4084,88.8,7680,3608,4072,88.6
'37060, 영주시,'070001, 65세,2019,1756,833,923,90.2,1746,828,918,90.2
'37060, 영주시,'070002, 66세,2019,1643,776,867,89.5,1636,772,864,89.4
'37060, 영주시,'070003, 67세,2019,1729,778,951,81.8,1723,775,948,81.8
'37060, 영주시,'070004, 68세,2019,1228,568,660,86.1,1224,565,659,85.7
'37060, 영주시,'070005, 69세,2019,1353,670,683,98.1,1351,668,683,97.8
'37060, 영주시,'075,70~74세,2019,5734,2711,3023,89.7,5731,2709,3022,89.6
'37060, 영주시,'075001, 70세,2019,1407,690,717,96.2,1405,689,716,96.2
'37060, 영주시,'075002, 71세,2019,1406,680,726,93.7,1406,680,726,93.7
'37060, 영주시,'075003, 72세,2019,1259,600,659,91,1258,599,659,90.9
'37060, 영주시,'075004, 73세,2019,753,344,409,84.1,753,344,409,84.1
'37060, 영주시,'075005, 74세,2019,909,397,512,77.5,909,397,512,77.5
'37060, 영주시,'080,75~79세,2019,5862,2421,3441,70.4,5860,2421,3439,70.4
'37060, 영주시,'080001, 75세,2019,1167,496,671,73.9,1166,496,670,74
'37060, 영주시,'080002, 76세,2019,1216,519,697,74.5,1215,519,696,74.6
'37060, 영주시,'080003, 77세,2019,1378,574,804,71.4,1378,574,804,71.4
'37060, 영주시,'080004, 78세,2019,1101,449,652,68.9,1101,449,652,68.9
'37060, 영주시,'080005, 79세,2019,1000,383,617,62.1,1000,383,617,62.1
'37060, 영주시,'085,80~84세,2019,4347,1649,2698,61.1,4345,1648,2697,61.1
'37060, 영주시,'085001, 80세,2019,1138,469,669,70.1,1138,469,669,70.1
'37060, 영주시,'085002, 81세,2019,965,370,595,62.2,964,369,595,62
'37060, 영주시,'085003, 82세,2019,774,290,484,59.9,774,290,484,59.9
'37060, 영주시,'085004, 83세,2019,766,293,473,61.9,766,293,473,61.9
'37060, 영주시,'085005, 84세,2019,704,227,477,47.6,703,227,476,47.7
'37060, 영주시,'086,85세이상,2019,3052,787,2265,34.7,3052,787,2265,34.7
'37060, 영주시,'090,85~89세,2019,2090,585,1505,38.9,2090,585,1505,38.9
'37060, 영주시,'090001, 85세,2019,591,185,406,45.6,591,185,406,45.6
'37060, 영주시,'090002, 86세,2019,465,134,331,40.5,465,134,331,40.5
'37060, 영주시,'090003, 87세,2019,426,114,312,36.5,426,114,312,36.5
'37060, 영주시,'090004, 88세,2019,347,92,255,36.1,347,92,255,36.1
'37060, 영주시,'090005, 89세,2019,261,60,201,29.9,261,60,201,29.9
'37060, 영주시,'095,90~94세,2019,756,166,590,28.1,756,166,590,28.1
'37060, 영주시,'095001, 90세,2019,238,53,185,28.6,238,53,185,28.6
'37060, 영주시,'095002, 91세,2019,200,45,155,29,200,45,155,29
'37060, 영주시,'095003, 92세,2019,130,32,98,32.7,130,32,98,32.7
'37060, 영주시,'095004, 93세,2019,96,18,78,23.1,96,18,78,23.1
'37060, 영주시,'095005, 94세,2019,92,18,74,24.3,92,18,74,24.3
'37060, 영주시,'100,95~99세,2019,186,32,154,20.8,186,32,154,20.8
'37060, 영주시,'100001, 95세,2019,57,9,48,18.8,57,9,48,18.8
'37060, 영주시,'100002, 96세,2019,47,8,39,20.5,47,8,39,20.5
'37060, 영주시,'100003, 97세,2019,29,7,22,31.8,29,7,22,31.8
'37060, 영주시,'100004, 98세,2019,27,X,25,8,27,X,25,8
'37060, 영주시,'100005, 99세,2019,26,6,20,30,26,6,20,30
'37060, 영주시,'101,100세이상,2019,20,X,16,25,20,X,16,25
'37060, 영주시,'102,15세미만,2019,10672,5525,5147,107.3,10639,5506,5133,107.3
'37060, 영주시,'103,15~64세,2019,67859,35960,31899,112.7,66360,35218,31142,113.1
'37060, 영주시,'104,65세이상,2019,26704,11193,15511,72.2,26668,11173,15495,72.1
'37060, 영주시,'126,평균연령,2019,47.8,45.5,50.2,,48,45.6,50.4,
'37060, 영주시,'127,중위연령,2019,50.9,48.4,53.5,,51.2,48.7,53.9,
'37070, 영천시,'000,합계,2019,100487,51762,48725,106.2,95795,48394,47401,102.1
'37070, 영천시,'005,0~4세,2019,2893,1482,1411,105,2859,1467,1392,105.4
'37070, 영천시,'005001, 0세,2019,620,324,296,109.5,614,321,293,109.6
'37070, 영천시,'005002, 1세,2019,518,273,245,111.4,514,270,244,110.7
'37070, 영천시,'005003, 2세,2019,541,273,268,101.9,531,269,262,102.7
'37070, 영천시,'005004, 3세,2019,575,291,284,102.5,567,290,277,104.7
'37070, 영천시,'005005, 4세,2019,639,321,318,100.9,633,317,316,100.3
'37070, 영천시,'010,5~9세,2019,2938,1488,1450,102.6,2918,1479,1439,102.8
'37070, 영천시,'010001, 5세,2019,563,301,262,114.9,558,299,259,115.4
'37070, 영천시,'010002, 6세,2019,570,284,286,99.3,567,283,284,99.6
'37070, 영천시,'010003, 7세,2019,621,289,332,87,614,285,329,86.6
'37070, 영천시,'010004, 8세,2019,585,300,285,105.3,583,299,284,105.3
'37070, 영천시,'010005, 9세,2019,599,314,285,110.2,596,313,283,110.6
'37070, 영천시,'015,10~14세,2019,3020,1590,1430,111.2,3012,1586,1426,111.2
'37070, 영천시,'015001, 10세,2019,603,337,266,126.7,600,335,265,126.4
'37070, 영천시,'015002, 11세,2019,610,331,279,118.6,610,331,279,118.6
'37070, 영천시,'015003, 12세,2019,647,346,301,115,646,345,301,114.6
'37070, 영천시,'015004, 13세,2019,580,290,290,100,578,290,288,100.7
'37070, 영천시,'015005, 14세,2019,580,286,294,97.3,578,285,293,97.3
'37070, 영천시,'020,15~19세,2019,3362,1870,1492,125.3,3337,1863,1474,126.4
'37070, 영천시,'020001, 15세,2019,649,346,303,114.2,648,346,302,114.6
'37070, 영천시,'020002, 16세,2019,642,345,297,116.2,639,343,296,115.9
'37070, 영천시,'020003, 17세,2019,699,375,324,115.7,694,373,321,116.2
'37070, 영천시,'020004, 18세,2019,756,418,338,123.7,750,416,334,124.6
'37070, 영천시,'020005, 19세,2019,616,386,230,167.8,606,385,221,174.2
'37070, 영천시,'025,20~24세,2019,5443,3513,1930,182,4756,3033,1723,176
'37070, 영천시,'025001, 20세,2019,818,536,282,190.1,778,510,268,190.3
'37070, 영천시,'025002, 21세,2019,1104,722,382,189,937,619,318,194.7
'37070, 영천시,'025003, 22세,2019,1180,785,395,198.7,1025,674,351,192
'37070, 영천시,'025004, 23세,2019,1133,707,426,166,1000,613,387,158.4
'37070, 영천시,'025005, 24세,2019,1208,763,445,171.5,1016,617,399,154.6
'37070, 영천시,'030,25~29세,2019,5585,3458,2127,162.6,4489,2597,1892,137.3
'37070, 영천시,'030001, 25세,2019,1140,721,419,172.1,941,564,377,149.6
'37070, 영천시,'030002, 26세,2019,1094,670,424,158,895,511,384,133.1
'37070, 영천시,'030003, 27세,2019,1159,715,444,161,909,526,383,137.3
'37070, 영천시,'030004, 28세,2019,1102,676,426,158.7,875,494,381,129.7
'37070, 영천시,'030005, 29세,2019,1090,676,414,163.3,869,502,367,136.8
'37070, 영천시,'035,30~34세,2019,5098,2995,2103,142.4,4180,2297,1883,122
'37070, 영천시,'035001, 30세,2019,1011,610,401,152.1,821,471,350,134.6
'37070, 영천시,'035002, 31세,2019,1045,623,422,147.6,848,475,373,127.3
'37070, 영천시,'035003, 32세,2019,1037,591,446,132.5,826,433,393,110.2
'37070, 영천시,'035004, 33세,2019,1006,588,418,140.7,847,460,387,118.9
'37070, 영천시,'035005, 34세,2019,999,583,416,140.1,838,458,380,120.5
'37070, 영천시,'040,35~39세,2019,5894,3353,2541,132,5189,2832,2357,120.2
'37070, 영천시,'040001, 35세,2019,1023,613,410,149.5,889,513,376,136.4
'37070, 영천시,'040002, 36세,2019,1148,639,509,125.5,1002,529,473,111.8
'37070, 영천시,'040003, 37세,2019,1230,706,524,134.7,1078,593,485,122.3
'37070, 영천시,'040004, 38세,2019,1243,697,546,127.7,1108,596,512,116.4
'37070, 영천시,'040005, 39세,2019,1250,698,552,126.4,1112,601,511,117.6
'37070, 영천시,'045,40~44세,2019,5665,3150,2515,125.2,5228,2841,2387,119
'37070, 영천시,'045001, 40세,2019,1150,649,501,129.5,1023,555,468,118.6
'37070, 영천시,'045002, 41세,2019,1051,588,463,127,960,522,438,119.2
'37070, 영천시,'045003, 42세,2019,1016,555,461,120.4,943,502,441,113.8
'37070, 영천시,'045004, 43세,2019,1174,657,517,127.1,1096,604,492,122.8
'37070, 영천시,'045005, 44세,2019,1274,701,573,122.3,1206,658,548,120.1
'37070, 영천시,'050,45~49세,2019,7257,3875,3382,114.6,6982,3689,3293,112
'37070, 영천시,'050001, 45세,2019,1406,758,648,117,1346,717,629,114
'37070, 영천시,'050002, 46세,2019,1351,715,636,112.4,1304,683,621,110
'37070, 영천시,'050003, 47세,2019,1438,775,663,116.9,1382,736,646,113.9
'37070, 영천시,'050004, 48세,2019,1551,830,721,115.1,1486,787,699,112.6
'37070, 영천시,'050005, 49세,2019,1511,797,714,111.6,1464,766,698,109.7
'37070, 영천시,'055,50~54세,2019,8340,4417,3923,112.6,8128,4295,3833,112.1
'37070, 영천시,'055001, 50세,2019,1599,846,753,112.4,1548,807,741,108.9
'37070, 영천시,'055002, 51세,2019,1771,953,818,116.5,1711,921,790,116.6
'37070, 영천시,'055003, 52세,2019,1667,889,778,114.3,1631,871,760,114.6
'37070, 영천시,'055004, 53세,2019,1709,909,800,113.6,1679,893,786,113.6
'37070, 영천시,'055005, 54세,2019,1594,820,774,105.9,1559,803,756,106.2
'37070, 영천시,'060,55~59세,2019,9367,4755,4612,103.1,9219,4672,4547,102.7
'37070, 영천시,'060001, 55세,2019,1693,888,805,110.3,1654,864,790,109.4
'37070, 영천시,'060002, 56세,2019,1736,920,816,112.7,1694,900,794,113.4
'37070, 영천시,'060003, 57세,2019,1805,917,888,103.3,1783,903,880,102.6
'37070, 영천시,'060004, 58세,2019,2113,1074,1039,103.4,2090,1061,1029,103.1
'37070, 영천시,'060005, 59세,2019,2020,956,1064,89.8,1998,944,1054,89.6
'37070, 영천시,'065,60~64세,2019,9187,4684,4503,104,9117,4634,4483,103.4
'37070, 영천시,'065001, 60세,2019,2027,1025,1002,102.3,2005,1010,995,101.5
'37070, 영천시,'065002, 61세,2019,1703,866,837,103.5,1690,858,832,103.1
'37070, 영천시,'065003, 62세,2019,1853,990,863,114.7,1840,979,861,113.7
'37070, 영천시,'065004, 63세,2019,1794,910,884,102.9,1785,903,882,102.4
'37070, 영천시,'065005, 64세,2019,1810,893,917,97.4,1797,884,913,96.8
'37070, 영천시,'070,65~69세,2019,7622,3687,3935,93.7,7587,3672,3915,93.8
'37070, 영천시,'070001, 65세,2019,1514,754,760,99.2,1505,750,755,99.3
'37070, 영천시,'070002, 66세,2019,1599,739,860,85.9,1592,738,854,86.4
'37070, 영천시,'070003, 67세,2019,1631,773,858,90.1,1623,768,855,89.8
'37070, 영천시,'070004, 68세,2019,1449,719,730,98.5,1443,715,728,98.2
'37070, 영천시,'070005, 69세,2019,1429,702,727,96.6,1424,701,723,97
'37070, 영천시,'075,70~74세,2019,5972,2828,3144,89.9,5962,2823,3139,89.9
'37070, 영천시,'075001, 70세,2019,1467,720,747,96.4,1463,717,746,96.1
'37070, 영천시,'075002, 71세,2019,1422,696,726,95.9,1420,695,725,95.9
'37070, 영천시,'075003, 72세,2019,1269,601,668,90,1267,601,666,90.2
'37070, 영천시,'075004, 73세,2019,839,386,453,85.2,838,386,452,85.4
'37070, 영천시,'075005, 74세,2019,975,425,550,77.3,974,424,550,77.1
'37070, 영천시,'080,75~79세,2019,5864,2366,3498,67.6,5857,2363,3494,67.6
'37070, 영천시,'080001, 75세,2019,1099,470,629,74.7,1098,469,629,74.6
'37070, 영천시,'080002, 76세,2019,1211,485,726,66.8,1210,485,725,66.9
'37070, 영천시,'080003, 77세,2019,1483,606,877,69.1,1479,604,875,69
'37070, 영천시,'080004, 78세,2019,1068,420,648,64.8,1067,420,647,64.9
'37070, 영천시,'080005, 79세,2019,1003,385,618,62.3,1003,385,618,62.3
'37070, 영천시,'085,80~84세,2019,4290,1490,2800,53.2,4285,1490,2795,53.3
'37070, 영천시,'085001, 80세,2019,1047,382,665,57.4,1047,382,665,57.4
'37070, 영천시,'085002, 81세,2019,911,326,585,55.7,909,326,583,55.9
'37070, 영천시,'085003, 82세,2019,842,287,555,51.7,840,287,553,51.9
'37070, 영천시,'085004, 83세,2019,786,266,520,51.2,785,266,519,51.3
'37070, 영천시,'085005, 84세,2019,704,229,475,48.2,704,229,475,48.2
'37070, 영천시,'086,85세이상,2019,2690,761,1929,39.5,2690,761,1929,39.5
'37070, 영천시,'090,85~89세,2019,2054,618,1436,43,2054,618,1436,43
'37070, 영천시,'090001, 85세,2019,608,200,408,49,608,200,408,49
'37070, 영천시,'090002, 86세,2019,490,143,347,41.2,490,143,347,41.2
'37070, 영천시,'090003, 87세,2019,410,122,288,42.4,410,122,288,42.4
'37070, 영천시,'090004, 88세,2019,292,74,218,33.9,292,74,218,33.9
'37070, 영천시,'090005, 89세,2019,254,79,175,45.1,254,79,175,45.1
'37070, 영천시,'095,90~94세,2019,536,127,409,31.1,536,127,409,31.1
'37070, 영천시,'095001, 90세,2019,183,36,147,24.5,183,36,147,24.5
'37070, 영천시,'095002, 91세,2019,144,35,109,32.1,144,35,109,32.1
'37070, 영천시,'095003, 92세,2019,94,25,69,36.2,94,25,69,36.2
'37070, 영천시,'095004, 93세,2019,68,17,51,33.3,68,17,51,33.3
'37070, 영천시,'095005, 94세,2019,47,14,33,42.4,47,14,33,42.4
'37070, 영천시,'100,95~99세,2019,90,13,77,16.9,90,13,77,16.9
'37070, 영천시,'100001, 95세,2019,25,X,22,13.6,25,X,22,13.6
'37070, 영천시,'100002, 96세,2019,18,X,16,12.5,18,X,16,12.5
'37070, 영천시,'100003, 97세,2019,25,X,21,19,25,X,21,19
'37070, 영천시,'100004, 98세,2019,19,X,15,26.7,19,X,15,26.7
'37070, 영천시,'100005, 99세,2019,X,X,X,0,X,X,X,0
'37070, 영천시,'101,100세이상,2019,10,X,7,42.9,10,X,7,42.9
'37070, 영천시,'102,15세미만,2019,8851,4560,4291,106.3,8789,4532,4257,106.5
'37070, 영천시,'103,15~64세,2019,65198,36070,29128,123.8,60625,32753,27872,117.5
'37070, 영천시,'104,65세이상,2019,26438,11132,15306,72.7,26381,11109,15272,72.7
'37070, 영천시,'126,평균연령,2019,48.9,46.5,51.5,,49.6,47.4,52,
'37070, 영천시,'127,중위연령,2019,51.8,48.9,55.1,,53,50.6,55.8,
'37080, 상주시,'000,합계,2019,96641,47669,48972,97.3,95188,47013,48175,97.6
'37080, 상주시,'005,0~4세,2019,2374,1218,1156,105.4,2359,1212,1147,105.7
'37080, 상주시,'005001, 0세,2019,440,215,225,95.6,439,214,225,95.1
'37080, 상주시,'005002, 1세,2019,448,231,217,106.5,444,230,214,107.5
'37080, 상주시,'005003, 2세,2019,443,233,210,111,439,231,208,111.1
'37080, 상주시,'005004, 3세,2019,495,242,253,95.7,491,241,250,96.4
'37080, 상주시,'005005, 4세,2019,548,297,251,118.3,546,296,250,118.4
'37080, 상주시,'010,5~9세,2019,2991,1552,1439,107.9,2983,1548,1435,107.9
'37080, 상주시,'010001, 5세,2019,521,277,244,113.5,518,276,242,114
'37080, 상주시,'010002, 6세,2019,573,292,281,103.9,571,291,280,103.9
'37080, 상주시,'010003, 7세,2019,626,338,288,117.4,624,337,287,117.4
'37080, 상주시,'010004, 8세,2019,634,322,312,103.2,634,322,312,103.2
'37080, 상주시,'010005, 9세,2019,637,323,314,102.9,636,322,314,102.5
'37080, 상주시,'015,10~14세,2019,3421,1781,1640,108.6,3413,1778,1635,108.7
'37080, 상주시,'015001, 10세,2019,649,328,321,102.2,647,327,320,102.2
'37080, 상주시,'015002, 11세,2019,715,384,331,116,711,382,329,116.1
'37080, 상주시,'015003, 12세,2019,719,385,334,115.3,719,385,334,115.3
'37080, 상주시,'015004, 13세,2019,662,338,324,104.3,661,338,323,104.6
'37080, 상주시,'015005, 14세,2019,676,346,330,104.8,675,346,329,105.2
'37080, 상주시,'020,15~19세,2019,4512,2554,1958,130.4,4492,2547,1945,131
'37080, 상주시,'020001, 15세,2019,673,362,311,116.4,672,362,310,116.8
'37080, 상주시,'020002, 16세,2019,902,485,417,116.3,901,485,416,116.6
'37080, 상주시,'020003, 17세,2019,913,503,410,122.7,912,502,410,122.4
'37080, 상주시,'020004, 18세,2019,1012,553,459,120.5,1008,553,455,121.5
'37080, 상주시,'020005, 19세,2019,1012,651,361,180.3,999,645,354,182.2
'37080, 상주시,'025,20~24세,2019,5169,3231,1938,166.7,5009,3148,1861,169.2
'37080, 상주시,'025001, 20세,2019,944,581,363,160.1,930,574,356,161.2
'37080, 상주시,'025002, 21세,2019,998,614,384,159.9,987,610,377,161.8
'37080, 상주시,'025003, 22세,2019,1090,659,431,152.9,1048,641,407,157.5
'37080, 상주시,'025004, 23세,2019,1119,706,413,170.9,1078,680,398,170.9
'37080, 상주시,'025005, 24세,2019,1018,671,347,193.4,966,643,323,199.1
'37080, 상주시,'030,25~29세,2019,3899,2273,1626,139.8,3588,2106,1482,142.1
'37080, 상주시,'030001, 25세,2019,897,556,341,163,825,515,310,166.1
'37080, 상주시,'030002, 26세,2019,797,480,317,151.4,733,442,291,151.9
'37080, 상주시,'030003, 27세,2019,734,433,301,143.9,681,408,273,149.5
'37080, 상주시,'030004, 28세,2019,746,403,343,117.5,681,373,308,121.1
'37080, 상주시,'030005, 29세,2019,725,401,324,123.8,668,368,300,122.7
'37080, 상주시,'035,30~34세,2019,3536,1936,1600,121,3303,1846,1457,126.7
'37080, 상주시,'035001, 30세,2019,673,392,281,139.5,625,371,254,146.1
'37080, 상주시,'035002, 31세,2019,673,351,322,109,640,337,303,111.2
'37080, 상주시,'035003, 32세,2019,708,379,329,115.2,649,362,287,126.1
'37080, 상주시,'035004, 33세,2019,764,423,341,124,716,405,311,130.2
'37080, 상주시,'035005, 34세,2019,718,391,327,119.6,673,371,302,122.8
'37080, 상주시,'040,35~39세,2019,4450,2356,2094,112.5,4293,2301,1992,115.5
'37080, 상주시,'040001, 35세,2019,775,423,352,120.2,738,410,328,125
'37080, 상주시,'040002, 36세,2019,837,436,401,108.7,804,423,381,111
'37080, 상주시,'040003, 37세,2019,912,475,437,108.7,881,466,415,112.3
'37080, 상주시,'040004, 38세,2019,935,515,420,122.6,914,506,408,124
'37080, 상주시,'040005, 39세,2019,991,507,484,104.8,956,496,460,107.8
'37080, 상주시,'045,40~44세,2019,4866,2522,2344,107.6,4753,2485,2268,109.6
'37080, 상주시,'045001, 40세,2019,957,503,454,110.8,929,491,438,112.1
'37080, 상주시,'045002, 41세,2019,851,454,397,114.4,831,447,384,116.4
'37080, 상주시,'045003, 42세,2019,936,465,471,98.7,918,459,459,100
'37080, 상주시,'045004, 43세,2019,980,513,467,109.9,957,505,452,111.7
'37080, 상주시,'045005, 44세,2019,1142,587,555,105.8,1118,583,535,109
'37080, 상주시,'050,45~49세,2019,6627,3513,3114,112.8,6516,3469,3047,113.8
'37080, 상주시,'050001, 45세,2019,1288,675,613,110.1,1269,668,601,111.1
'37080, 상주시,'050002, 46세,2019,1248,657,591,111.2,1227,649,578,112.3
'37080, 상주시,'050003, 47세,2019,1275,656,619,106,1250,646,604,107
'37080, 상주시,'050004, 48세,2019,1439,788,651,121,1418,776,642,120.9
'37080, 상주시,'050005, 49세,2019,1377,737,640,115.2,1352,730,622,117.4
'37080, 상주시,'055,50~54세,2019,7486,3951,3535,111.8,7369,3894,3475,112.1
'37080, 상주시,'055001, 50세,2019,1372,754,618,122,1347,741,606,122.3
'37080, 상주시,'055002, 51세,2019,1582,843,739,114.1,1564,833,731,114
'37080, 상주시,'055003, 52세,2019,1473,764,709,107.8,1449,755,694,108.8
'37080, 상주시,'055004, 53세,2019,1507,818,689,118.7,1485,806,679,118.7
'37080, 상주시,'055005, 54세,2019,1552,772,780,99,1524,759,765,99.2
'37080, 상주시,'060,55~59세,2019,9326,4727,4599,102.8,9241,4681,4560,102.7
'37080, 상주시,'060001, 55세,2019,1632,820,812,101,1606,810,796,101.8
'37080, 상주시,'060002, 56세,2019,1729,913,816,111.9,1706,900,806,111.7
'37080, 상주시,'060003, 57세,2019,1765,899,866,103.8,1752,891,861,103.5
'37080, 상주시,'060004, 58세,2019,2012,1026,986,104.1,2001,1019,982,103.8
'37080, 상주시,'060005, 59세,2019,2188,1069,1119,95.5,2176,1061,1115,95.2
'37080, 상주시,'065,60~64세,2019,9344,4627,4717,98.1,9298,4604,4694,98.1
'37080, 상주시,'065001, 60세,2019,1962,970,992,97.8,1959,968,991,97.7
'37080, 상주시,'065002, 61세,2019,1872,934,938,99.6,1862,930,932,99.8
'37080, 상주시,'065003, 62세,2019,1880,969,911,106.4,1866,962,904,106.4
'37080, 상주시,'065004, 63세,2019,1826,887,939,94.5,1814,880,934,94.2
'37080, 상주시,'065005, 64세,2019,1804,867,937,92.5,1797,864,933,92.6
'37080, 상주시,'070,65~69세,2019,7404,3501,3903,89.7,7365,3482,3883,89.7
'37080, 상주시,'070001, 65세,2019,1616,769,847,90.8,1606,766,840,91.2
'37080, 상주시,'070002, 66세,2019,1503,720,783,92,1492,715,777,92
'37080, 상주시,'070003, 67세,2019,1725,804,921,87.3,1718,800,918,87.1
'37080, 상주시,'070004, 68세,2019,1193,562,631,89.1,1190,560,630,88.9
'37080, 상주시,'070005, 69세,2019,1367,646,721,89.6,1359,641,718,89.3
'37080, 상주시,'075,70~74세,2019,6099,2868,3231,88.8,6081,2860,3221,88.8
'37080, 상주시,'075001, 70세,2019,1562,777,785,99,1559,776,783,99.1
'37080, 상주시,'075002, 71세,2019,1392,655,737,88.9,1383,651,732,88.9
'37080, 상주시,'075003, 72세,2019,1387,639,748,85.4,1383,637,746,85.4
'37080, 상주시,'075004, 73세,2019,852,404,448,90.2,851,404,447,90.4
'37080, 상주시,'075005, 74세,2019,906,393,513,76.6,905,392,513,76.4
'37080, 상주시,'080,75~79세,2019,6331,2382,3949,60.3,6325,2378,3947,60.2
'37080, 상주시,'080001, 75세,2019,1064,395,669,59,1062,393,669,58.7
'37080, 상주시,'080002, 76세,2019,1243,519,724,71.7,1243,519,724,71.7
'37080, 상주시,'080003, 77세,2019,1584,589,995,59.2,1583,588,995,59.1
'37080, 상주시,'080004, 78세,2019,1213,448,765,58.6,1211,447,764,58.5
'37080, 상주시,'080005, 79세,2019,1227,431,796,54.1,1226,431,795,54.2
'37080, 상주시,'085,80~84세,2019,5205,1774,3431,51.7,5202,1772,3430,51.7
'37080, 상주시,'085001, 80세,2019,1256,434,822,52.8,1255,434,821,52.9
'37080, 상주시,'085002, 81세,2019,1107,396,711,55.7,1107,396,711,55.7
'37080, 상주시,'085003, 82세,2019,1032,352,680,51.8,1031,351,680,51.6
'37080, 상주시,'085004, 83세,2019,936,296,640,46.3,936,296,640,46.3
'37080, 상주시,'085005, 84세,2019,874,296,578,51.2,873,295,578,51
'37080, 상주시,'086,85세이상,2019,3601,903,2698,33.5,3598,902,2696,33.5
'37080, 상주시,'090,85~89세,2019,2507,690,1817,38,2505,689,1816,37.9
'37080, 상주시,'090001, 85세,2019,735,230,505,45.5,734,229,505,45.3
'37080, 상주시,'090002, 86세,2019,553,149,404,36.9,553,149,404,36.9
'37080, 상주시,'090003, 87세,2019,499,137,362,37.8,499,137,362,37.8
'37080, 상주시,'090004, 88세,2019,389,103,286,36,389,103,286,36
'37080, 상주시,'090005, 89세,2019,331,71,260,27.3,330,71,259,27.4
'37080, 상주시,'095,90~94세,2019,871,179,692,25.9,870,179,691,25.9
'37080, 상주시,'095001, 90세,2019,247,53,194,27.3,246,53,193,27.5
'37080, 상주시,'095002, 91세,2019,220,46,174,26.4,220,46,174,26.4
'37080, 상주시,'095003, 92세,2019,172,34,138,24.6,172,34,138,24.6
'37080, 상주시,'095004, 93세,2019,133,19,114,16.7,133,19,114,16.7
'37080, 상주시,'095005, 94세,2019,99,27,72,37.5,99,27,72,37.5
'37080, 상주시,'100,95~99세,2019,206,33,173,19.1,206,33,173,19.1
'37080, 상주시,'100001, 95세,2019,73,10,63,15.9,73,10,63,15.9
'37080, 상주시,'100002, 96세,2019,43,9,34,26.5,43,9,34,26.5
'37080, 상주시,'100003, 97세,2019,54,9,45,20,54,9,45,20
'37080, 상주시,'100004, 98세,2019,19,X,16,18.8,19,X,16,18.8
'37080, 상주시,'100005, 99세,2019,17,X,15,13.3,17,X,15,13.3
'37080, 상주시,'101,100세이상,2019,17,X,16,6.3,17,X,16,6.3
'37080, 상주시,'102,15세미만,2019,8786,4551,4235,107.5,8755,4538,4217,107.6
'37080, 상주시,'103,15~64세,2019,59215,31690,27525,115.1,57862,31081,26781,116.1
'37080, 상주시,'104,65세이상,2019,28640,11428,17212,66.4,28571,11394,17177,66.3
'37080, 상주시,'126,평균연령,2019,50.4,47.5,53.2,,50.6,47.7,53.5,
'37080, 상주시,'127,중위연령,2019,54.3,51.2,57.5,,54.7,51.4,57.9,
'37090, 문경시,'000,합계,2019,68542,33614,34928,96.2,67511,33128,34383,96.3
'37090, 문경시,'005,0~4세,2019,1765,905,860,105.2,1762,904,858,105.4
'37090, 문경시,'005001, 0세,2019,306,156,150,104,306,156,150,104
'37090, 문경시,'005002, 1세,2019,294,153,141,108.5,293,153,140,109.3
'37090, 문경시,'005003, 2세,2019,358,192,166,115.7,357,191,166,115.1
'37090, 문경시,'005004, 3세,2019,398,203,195,104.1,398,203,195,104.1
'37090, 문경시,'005005, 4세,2019,409,201,208,96.6,408,201,207,97.1
'37090, 문경시,'010,5~9세,2019,2280,1206,1074,112.3,2271,1203,1068,112.6
'37090, 문경시,'010001, 5세,2019,401,212,189,112.2,401,212,189,112.2
'37090, 문경시,'010002, 6세,2019,435,227,208,109.1,432,226,206,109.7
'37090, 문경시,'010003, 7세,2019,469,244,225,108.4,466,242,224,108
'37090, 문경시,'010004, 8세,2019,537,289,248,116.5,536,289,247,117
'37090, 문경시,'010005, 9세,2019,438,234,204,114.7,436,234,202,115.8
'37090, 문경시,'015,10~14세,2019,2446,1343,1103,121.8,2443,1343,1100,122.1
'37090, 문경시,'015001, 10세,2019,455,240,215,111.6,454,240,214,112.1
'37090, 문경시,'015002, 11세,2019,488,270,218,123.9,488,270,218,123.9
'37090, 문경시,'015003, 12세,2019,491,263,228,115.4,490,263,227,115.9
'37090, 문경시,'015004, 13세,2019,481,276,205,134.6,480,276,204,135.3
'37090, 문경시,'015005, 14세,2019,531,294,237,124.1,531,294,237,124.1
'37090, 문경시,'020,15~19세,2019,3305,1818,1487,122.3,3284,1805,1479,122
'37090, 문경시,'020001, 15세,2019,576,315,261,120.7,574,313,261,119.9
'37090, 문경시,'020002, 16세,2019,736,417,319,130.7,735,416,319,130.4
'37090, 문경시,'020003, 17세,2019,710,381,329,115.8,710,381,329,115.8
'37090, 문경시,'020004, 18세,2019,734,408,326,125.2,731,406,325,124.9
'37090, 문경시,'020005, 19세,2019,549,297,252,117.9,534,289,245,118
'37090, 문경시,'025,20~24세,2019,2825,1634,1191,137.2,2701,1571,1130,139
'37090, 문경시,'025001, 20세,2019,573,365,208,175.5,563,361,202,178.7
'37090, 문경시,'025002, 21세,2019,618,377,241,156.4,610,371,239,155.2
'37090, 문경시,'025003, 22세,2019,540,290,250,116,507,273,234,116.7
'37090, 문경시,'025004, 23세,2019,545,301,244,123.4,508,280,228,122.8
'37090, 문경시,'025005, 24세,2019,549,301,248,121.4,513,286,227,126
'37090, 문경시,'030,25~29세,2019,2520,1406,1114,126.2,2337,1310,1027,127.6
'37090, 문경시,'030001, 25세,2019,498,277,221,125.3,458,253,205,123.4
'37090, 문경시,'030002, 26세,2019,549,302,247,122.3,512,284,228,124.6
'37090, 문경시,'030003, 27세,2019,539,292,247,118.2,505,276,229,120.5
'37090, 문경시,'030004, 28세,2019,448,249,199,125.1,413,226,187,120.9
'37090, 문경시,'030005, 29세,2019,486,286,200,143,449,271,178,152.2
'37090, 문경시,'035,30~34세,2019,2579,1421,1158,122.7,2413,1342,1071,125.3
'37090, 문경시,'035001, 30세,2019,473,251,222,113.1,438,235,203,115.8
'37090, 문경시,'035002, 31세,2019,492,280,212,132.1,464,267,197,135.5
'37090, 문경시,'035003, 32세,2019,545,306,239,128,507,290,217,133.6
'37090, 문경시,'035004, 33세,2019,518,273,245,111.4,488,257,231,111.3
'37090, 문경시,'035005, 34세,2019,551,311,240,129.6,516,293,223,131.4
'37090, 문경시,'040,35~39세,2019,3472,1803,1669,108,3374,1764,1610,109.6
'37090, 문경시,'040001, 35세,2019,660,356,304,117.1,633,340,293,116
'37090, 문경시,'040002, 36세,2019,625,324,301,107.6,611,318,293,108.5
'37090, 문경시,'040003, 37세,2019,749,360,389,92.5,723,353,370,95.4
'37090, 문경시,'040004, 38세,2019,677,344,333,103.3,662,337,325,103.7
'37090, 문경시,'040005, 39세,2019,761,419,342,122.5,745,416,329,126.4
'37090, 문경시,'045,40~44세,2019,3846,2024,1822,111.1,3761,1984,1777,111.6
'37090, 문경시,'045001, 40세,2019,734,389,345,112.8,711,375,336,111.6
'37090, 문경시,'045002, 41세,2019,699,355,344,103.2,688,350,338,103.6
'37090, 문경시,'045003, 42세,2019,755,419,336,124.7,743,413,330,125.2
'37090, 문경시,'045004, 43세,2019,757,393,364,108,746,387,359,107.8
'37090, 문경시,'045005, 44세,2019,901,468,433,108.1,873,459,414,110.9
'37090, 문경시,'050,45~49세,2019,4733,2534,2199,115.2,4653,2498,2155,115.9
'37090, 문경시,'050001, 45세,2019,964,518,446,116.1,944,509,435,117
'37090, 문경시,'050002, 46세,2019,906,473,433,109.2,892,468,424,110.4
'37090, 문경시,'050003, 47세,2019,941,524,417,125.7,928,518,410,126.3
'37090, 문경시,'050004, 48세,2019,941,493,448,110,925,485,440,110.2
'37090, 문경시,'050005, 49세,2019,981,526,455,115.6,964,518,446,116.1
'37090, 문경시,'055,50~54세,2019,5365,2773,2592,107,5272,2730,2542,107.4
'37090, 문경시,'055001, 50세,2019,1051,549,502,109.4,1033,546,487,112.1
'37090, 문경시,'055002, 51세,2019,1103,601,502,119.7,1077,584,493,118.5
'37090, 문경시,'055003, 52세,2019,1056,544,512,106.3,1040,537,503,106.8
'37090, 문경시,'055004, 53세,2019,1067,543,524,103.6,1054,535,519,103.1
'37090, 문경시,'055005, 54세,2019,1088,536,552,97.1,1068,528,540,97.8
'37090, 문경시,'060,55~59세,2019,6577,3297,3280,100.5,6491,3260,3231,100.9
'37090, 문경시,'060001, 55세,2019,1134,584,550,106.2,1112,574,538,106.7
'37090, 문경시,'060002, 56세,2019,1254,639,615,103.9,1228,623,605,103
'37090, 문경시,'060003, 57세,2019,1229,624,605,103.1,1217,621,596,104.2
'37090, 문경시,'060004, 58세,2019,1430,705,725,97.2,1417,701,716,97.9
'37090, 문경시,'060005, 59세,2019,1530,745,785,94.9,1517,741,776,95.5
'37090, 문경시,'065,60~64세,2019,6785,3338,3447,96.8,6743,3321,3422,97
'37090, 문경시,'065001, 60세,2019,1345,658,687,95.8,1335,653,682,95.7
'37090, 문경시,'065002, 61세,2019,1338,670,668,100.3,1331,668,663,100.8
'37090, 문경시,'065003, 62세,2019,1427,700,727,96.3,1416,696,720,96.7
'37090, 문경시,'065004, 63세,2019,1368,668,700,95.4,1362,666,696,95.7
'37090, 문경시,'065005, 64세,2019,1307,642,665,96.5,1299,638,661,96.5
'37090, 문경시,'070,65~69세,2019,5447,2563,2884,88.9,5427,2552,2875,88.8
'37090, 문경시,'070001, 65세,2019,1151,553,598,92.5,1141,548,593,92.4
'37090, 문경시,'070002, 66세,2019,1141,528,613,86.1,1138,527,611,86.3
'37090, 문경시,'070003, 67세,2019,1204,568,636,89.3,1203,567,636,89.2
'37090, 문경시,'070004, 68세,2019,905,421,484,87,903,420,483,87
'37090, 문경시,'070005, 69세,2019,1046,493,553,89.2,1042,490,552,88.8
'37090, 문경시,'075,70~74세,2019,4427,2039,2388,85.4,4416,2034,2382,85.4
'37090, 문경시,'075001, 70세,2019,1087,516,571,90.4,1085,516,569,90.7
'37090, 문경시,'075002, 71세,2019,957,444,513,86.5,955,443,512,86.5
'37090, 문경시,'075003, 72세,2019,981,451,530,85.1,977,449,528,85
'37090, 문경시,'075004, 73세,2019,678,302,376,80.3,676,300,376,79.8
'37090, 문경시,'075005, 74세,2019,724,326,398,81.9,723,326,397,82.1
'37090, 문경시,'080,75~79세,2019,4510,1813,2697,67.2,4507,1811,2696,67.2
'37090, 문경시,'080001, 75세,2019,797,304,493,61.7,796,303,493,61.5
'37090, 문경시,'080002, 76세,2019,961,379,582,65.1,961,379,582,65.1
'37090, 문경시,'080003, 77세,2019,1028,430,598,71.9,1028,430,598,71.9
'37090, 문경시,'080004, 78세,2019,883,356,527,67.6,882,356,526,67.7
'37090, 문경시,'080005, 79세,2019,841,344,497,69.2,840,343,497,69
'37090, 문경시,'085,80~84세,2019,3394,1124,2270,49.5,3392,1124,2268,49.6
'37090, 문경시,'085001, 80세,2019,807,300,507,59.2,807,300,507,59.2
'37090, 문경시,'085002, 81세,2019,743,253,490,51.6,742,253,489,51.7
'37090, 문경시,'085003, 82세,2019,644,198,446,44.4,644,198,446,44.4
'37090, 문경시,'085004, 83세,2019,647,208,439,47.4,646,208,438,47.5
'37090, 문경시,'085005, 84세,2019,553,165,388,42.5,553,165,388,42.5
'37090, 문경시,'086,85세이상,2019,2266,573,1693,33.8,2264,572,1692,33.8
'37090, 문경시,'090,85~89세,2019,1565,431,1134,38,1565,431,1134,38
'37090, 문경시,'090001, 85세,2019,467,145,322,45,467,145,322,45
'37090, 문경시,'090002, 86세,2019,372,102,270,37.8,372,102,270,37.8
'37090, 문경시,'090003, 87세,2019,274,73,201,36.3,274,73,201,36.3
'37090, 문경시,'090004, 88세,2019,234,57,177,32.2,234,57,177,32.2
'37090, 문경시,'090005, 89세,2019,218,54,164,32.9,218,54,164,32.9
'37090, 문경시,'095,90~94세,2019,551,115,436,26.4,549,114,435,26.2
'37090, 문경시,'095001, 90세,2019,159,36,123,29.3,158,35,123,28.5
'37090, 문경시,'095002, 91세,2019,143,28,115,24.3,143,28,115,24.3
'37090, 문경시,'095003, 92세,2019,113,26,87,29.9,113,26,87,29.9
'37090, 문경시,'095004, 93세,2019,81,14,67,20.9,80,14,66,21.2
'37090, 문경시,'095005, 94세,2019,55,11,44,25,55,11,44,25
'37090, 문경시,'100,95~99세,2019,132,24,108,22.2,132,24,108,22.2
'37090, 문경시,'100001, 95세,2019,37,7,30,23.3,37,7,30,23.3
'37090, 문경시,'100002, 96세,2019,42,8,34,23.5,42,8,34,23.5
'37090, 문경시,'100003, 97세,2019,25,X,21,19,25,X,21,19
'37090, 문경시,'100004, 98세,2019,20,X,18,11.1,20,X,18,11.1
'37090, 문경시,'100005, 99세,2019,8,X,5,60,8,X,5,60
'37090, 문경시,'101,100세이상,2019,18,X,15,20,18,X,15,20
'37090, 문경시,'102,15세미만,2019,6491,3454,3037,113.7,6476,3450,3026,114
'37090, 문경시,'103,15~64세,2019,42007,22048,19959,110.5,41029,21585,19444,111
'37090, 문경시,'104,65세이상,2019,20044,8112,11932,68,20006,8093,11913,67.9
'37090, 문경시,'126,평균연령,2019,50.3,47.7,52.8,,50.5,47.9,53,
'37090, 문경시,'127,중위연령,2019,54.2,51.3,57,,54.5,51.5,57.4,
'37100, 경산시,'000,합계,2019,290088,146429,143659,101.9,274546,137109,137437,99.8
'37100, 경산시,'005,0~4세,2019,10202,5226,4976,105,9963,5095,4868,104.7
'37100, 경산시,'005001, 0세,2019,1714,900,814,110.6,1666,873,793,110.1
'37100, 경산시,'005002, 1세,2019,1837,932,905,103,1791,909,882,103.1
'37100, 경산시,'005003, 2세,2019,1977,1010,967,104.4,1923,977,946,103.3
'37100, 경산시,'005004, 3세,2019,2340,1202,1138,105.6,2296,1181,1115,105.9
'37100, 경산시,'005005, 4세,2019,2334,1182,1152,102.6,2287,1155,1132,102
'37100, 경산시,'010,5~9세,2019,11648,5940,5708,104.1,11528,5877,5651,104
'37100, 경산시,'010001, 5세,2019,2354,1177,1177,100,2322,1160,1162,99.8
'37100, 경산시,'010002, 6세,2019,2342,1184,1158,102.2,2306,1165,1141,102.1
'37100, 경산시,'010003, 7세,2019,2419,1230,1189,103.4,2395,1220,1175,103.8
'37100, 경산시,'010004, 8세,2019,2399,1280,1119,114.4,2384,1270,1114,114
'37100, 경산시,'010005, 9세,2019,2134,1069,1065,100.4,2121,1062,1059,100.3
'37100, 경산시,'015,10~14세,2019,10478,5404,5074,106.5,10429,5377,5052,106.4
'37100, 경산시,'015001, 10세,2019,2118,1086,1032,105.2,2107,1083,1024,105.8
'37100, 경산시,'015002, 11세,2019,2156,1130,1026,110.1,2143,1121,1022,109.7
'37100, 경산시,'015003, 12세,2019,2255,1167,1088,107.3,2244,1160,1084,107
'37100, 경산시,'015004, 13세,2019,2026,1057,969,109.1,2023,1055,968,109
'37100, 경산시,'015005, 14세,2019,1923,964,959,100.5,1912,958,954,100.4
'37100, 경산시,'020,15~19세,2019,20493,10241,10252,99.9,19221,9596,9625,99.7
'37100, 경산시,'020001, 15세,2019,2257,1188,1069,111.1,2252,1185,1067,111.1
'37100, 경산시,'020002, 16세,2019,2386,1297,1089,119.1,2368,1290,1078,119.7
'37100, 경산시,'020003, 17세,2019,2499,1338,1161,115.2,2473,1323,1150,115
'37100, 경산시,'020004, 18세,2019,4318,2185,2133,102.4,4050,2059,1991,103.4
'37100, 경산시,'020005, 19세,2019,9033,4233,4800,88.2,8078,3739,4339,86.2
'37100, 경산시,'025,20~24세,2019,30983,15883,15100,105.2,26579,13317,13262,100.4
'37100, 경산시,'025001, 20세,2019,6845,2830,4015,70.5,5791,2260,3531,64
'37100, 경산시,'025002, 21세,2019,6540,2896,3644,79.5,5516,2341,3175,73.7
'37100, 경산시,'025003, 22세,2019,6453,3409,3044,112,5597,2923,2674,109.3
'37100, 경산시,'025004, 23세,2019,5848,3458,2390,144.7,5088,2966,2122,139.8
'37100, 경산시,'025005, 24세,2019,5297,3290,2007,163.9,4587,2827,1760,160.6
'37100, 경산시,'030,25~29세,2019,20690,12155,8535,142.4,17731,10324,7407,139.4
'37100, 경산시,'030001, 25세,2019,4641,2828,1813,156,3986,2399,1587,151.2
'37100, 경산시,'030002, 26세,2019,4310,2608,1702,153.2,3692,2227,1465,152
'37100, 경산시,'030003, 27세,2019,4200,2390,1810,132,3561,1998,1563,127.8
'37100, 경산시,'030004, 28세,2019,3862,2206,1656,133.2,3354,1897,1457,130.2
'37100, 경산시,'030005, 29세,2019,3677,2123,1554,136.6,3138,1803,1335,135.1
'37100, 경산시,'035,30~34세,2019,17248,9646,7602,126.9,15091,8288,6803,121.8
'37100, 경산시,'035001, 30세,2019,3518,2000,1518,131.8,3018,1698,1320,128.6
'37100, 경산시,'035002, 31세,2019,3368,1939,1429,135.7,2911,1650,1261,130.8
'37100, 경산시,'035003, 32세,2019,3455,1860,1595,116.6,3020,1603,1417,113.1
'37100, 경산시,'035004, 33세,2019,3353,1864,1489,125.2,2981,1609,1372,117.3
'37100, 경산시,'035005, 34세,2019,3554,1983,1571,126.2,3161,1728,1433,120.6
'37100, 경산시,'040,35~39세,2019,20478,10843,9635,112.5,18958,9840,9118,107.9
'37100, 경산시,'040001, 35세,2019,3545,1935,1610,120.2,3179,1701,1478,115.1
'37100, 경산시,'040002, 36세,2019,3955,2046,1909,107.2,3653,1837,1816,101.2
'37100, 경산시,'040003, 37세,2019,4286,2249,2037,110.4,3952,2021,1931,104.7
'37100, 경산시,'040004, 38세,2019,4331,2317,2014,115,4062,2141,1921,111.5
'37100, 경산시,'040005, 39세,2019,4361,2296,2065,111.2,4112,2140,1972,108.5
'37100, 경산시,'045,40~44세,2019,19566,10249,9317,110,18576,9599,8977,106.9
'37100, 경산시,'045001, 40세,2019,4160,2162,1998,108.2,3885,1979,1906,103.8
'37100, 경산시,'045002, 41세,2019,3700,1967,1733,113.5,3517,1849,1668,110.9
'37100, 경산시,'045003, 42세,2019,3746,1948,1798,108.3,3553,1822,1731,105.3
'37100, 경산시,'045004, 43세,2019,3899,2050,1849,110.9,3716,1933,1783,108.4
'37100, 경산시,'045005, 44세,2019,4061,2122,1939,109.4,3905,2016,1889,106.7
'37100, 경산시,'050,45~49세,2019,23059,11699,11360,103,22358,11252,11106,101.3
'37100, 경산시,'050001, 45세,2019,4447,2298,2149,106.9,4304,2214,2090,105.9
'37100, 경산시,'050002, 46세,2019,4557,2301,2256,102,4386,2185,2201,99.3
'37100, 경산시,'050003, 47세,2019,4539,2319,2220,104.5,4389,2231,2158,103.4
'37100, 경산시,'050004, 48세,2019,4930,2485,2445,101.6,4813,2406,2407,100
'37100, 경산시,'050005, 49세,2019,4586,2296,2290,100.3,4466,2216,2250,98.5
'37100, 경산시,'055,50~54세,2019,22557,11307,11250,100.5,22063,11041,11022,100.2
'37100, 경산시,'055001, 50세,2019,4570,2262,2308,98,4459,2197,2262,97.1
'37100, 경산시,'055002, 51세,2019,4885,2398,2487,96.4,4783,2343,2440,96
'37100, 경산시,'055003, 52세,2019,4344,2195,2149,102.1,4248,2144,2104,101.9
'37100, 경산시,'055004, 53세,2019,4379,2292,2087,109.8,4285,2240,2045,109.5
'37100, 경산시,'055005, 54세,2019,4379,2160,2219,97.3,4288,2117,2171,97.5
'37100, 경산시,'060,55~59세,2019,22064,11048,11016,100.3,21741,10871,10870,100
'37100, 경산시,'060001, 55세,2019,4058,2040,2018,101.1,3990,2005,1985,101
'37100, 경산시,'060002, 56세,2019,4258,2137,2121,100.8,4173,2084,2089,99.8
'37100, 경산시,'060003, 57세,2019,4491,2269,2222,102.1,4418,2228,2190,101.7
'37100, 경산시,'060004, 58세,2019,4720,2352,2368,99.3,4670,2329,2341,99.5
'37100, 경산시,'060005, 59세,2019,4537,2250,2287,98.4,4490,2225,2265,98.2
'37100, 경산시,'065,60~64세,2019,18651,9203,9448,97.4,18482,9110,9372,97.2
'37100, 경산시,'065001, 60세,2019,4277,2129,2148,99.1,4239,2112,2127,99.3
'37100, 경산시,'065002, 61세,2019,3657,1861,1796,103.6,3614,1833,1781,102.9
'37100, 경산시,'065003, 62세,2019,3818,1876,1942,96.6,3789,1859,1930,96.3
'37100, 경산시,'065004, 63세,2019,3456,1698,1758,96.6,3426,1684,1742,96.7
'37100, 경산시,'065005, 64세,2019,3443,1639,1804,90.9,3414,1622,1792,90.5
'37100, 경산시,'070,65~69세,2019,13388,6324,7064,89.5,13305,6282,7023,89.4
'37100, 경산시,'070001, 65세,2019,2946,1408,1538,91.5,2925,1399,1526,91.7
'37100, 경산시,'070002, 66세,2019,2778,1317,1461,90.1,2760,1307,1453,90
'37100, 경산시,'070003, 67세,2019,2976,1394,1582,88.1,2959,1382,1577,87.6
'37100, 경산시,'070004, 68세,2019,2358,1117,1241,90,2342,1112,1230,90.4
'37100, 경산시,'070005, 69세,2019,2330,1088,1242,87.6,2319,1082,1237,87.5
'37100, 경산시,'075,70~74세,2019,9980,4561,5419,84.2,9952,4550,5402,84.2
'37100, 경산시,'075001, 70세,2019,2535,1185,1350,87.8,2526,1179,1347,87.5
'37100, 경산시,'075002, 71세,2019,2376,1079,1297,83.2,2371,1078,1293,83.4
'37100, 경산시,'075003, 72세,2019,2217,988,1229,80.4,2213,985,1228,80.2
'37100, 경산시,'075004, 73세,2019,1378,660,718,91.9,1370,659,711,92.7
'37100, 경산시,'075005, 74세,2019,1474,649,825,78.7,1472,649,823,78.9
'37100, 경산시,'080,75~79세,2019,8742,3562,5180,68.8,8720,3556,5164,68.9
'37100, 경산시,'080001, 75세,2019,1747,731,1016,71.9,1741,729,1012,72
'37100, 경산시,'080002, 76세,2019,1853,796,1057,75.3,1849,794,1055,75.3
'37100, 경산시,'080003, 77세,2019,2023,852,1171,72.8,2018,852,1166,73.1
'37100, 경산시,'080004, 78세,2019,1590,623,967,64.4,1586,621,965,64.4
'37100, 경산시,'080005, 79세,2019,1529,560,969,57.8,1526,560,966,58
'37100, 경산시,'085,80~84세,2019,5934,2091,3843,54.4,5928,2090,3838,54.5
'37100, 경산시,'085001, 80세,2019,1495,571,924,61.8,1495,571,924,61.8
'37100, 경산시,'085002, 81세,2019,1262,448,814,55,1259,447,812,55
'37100, 경산시,'085003, 82세,2019,1135,377,758,49.7,1135,377,758,49.7
'37100, 경산시,'085004, 83세,2019,1086,383,703,54.5,1085,383,702,54.6
'37100, 경산시,'085005, 84세,2019,956,312,644,48.4,954,312,642,48.6
'37100, 경산시,'086,85세이상,2019,3927,1047,2880,36.4,3921,1044,2877,36.3
'37100, 경산시,'090,85~89세,2019,2882,827,2055,40.2,2879,825,2054,40.2
'37100, 경산시,'090001, 85세,2019,829,247,582,42.4,828,246,582,42.3
'37100, 경산시,'090002, 86세,2019,684,220,464,47.4,683,219,464,47.2
'37100, 경산시,'090003, 87세,2019,592,161,431,37.4,592,161,431,37.4
'37100, 경산시,'090004, 88세,2019,432,127,305,41.6,432,127,305,41.6
'37100, 경산시,'090005, 89세,2019,345,72,273,26.4,344,72,272,26.5
'37100, 경산시,'095,90~94세,2019,847,188,659,28.5,846,188,658,28.6
'37100, 경산시,'095001, 90세,2019,255,56,199,28.1,254,56,198,28.3
'37100, 경산시,'095002, 91세,2019,219,57,162,35.2,219,57,162,35.2
'37100, 경산시,'095003, 92세,2019,187,42,145,29,187,42,145,29
'37100, 경산시,'095004, 93세,2019,104,24,80,30,104,24,80,30
'37100, 경산시,'095005, 94세,2019,82,9,73,12.3,82,9,73,12.3
'37100, 경산시,'100,95~99세,2019,172,27,145,18.6,170,26,144,18.1
'37100, 경산시,'100001, 95세,2019,59,5,54,9.3,58,5,53,9.4
'37100, 경산시,'100002, 96세,2019,45,7,38,18.4,45,7,38,18.4
'37100, 경산시,'100003, 97세,2019,35,7,28,25,35,7,28,25
'37100, 경산시,'100004, 98세,2019,22,6,16,37.5,21,5,16,31.3
'37100, 경산시,'100005, 99세,2019,11,X,9,22.2,11,X,9,22.2
'37100, 경산시,'101,100세이상,2019,26,5,21,23.8,26,5,21,23.8
'37100, 경산시,'102,15세미만,2019,32328,16570,15758,105.2,31920,16349,15571,105
'37100, 경산시,'103,15~64세,2019,215789,112274,103515,108.5,200800,103238,97562,105.8
'37100, 경산시,'104,65세이상,2019,41971,17585,24386,72.1,41826,17522,24304,72.1
'37100, 경산시,'126,평균연령,2019,41,39.7,42.3,,41.6,40.3,42.8,
'37100, 경산시,'127,중위연령,2019,40.7,39.1,42.7,,42.1,40.4,43.9,
'37310, 군위군,'000,합계,2019,22206,11434,10772,106.1,21457,10888,10569,103
'37310, 군위군,'005,0~4세,2019,349,185,164,112.8,349,185,164,112.8
'37310, 군위군,'005001, 0세,2019,76,36,40,90,76,36,40,90
'37310, 군위군,'005002, 1세,2019,73,41,32,128.1,73,41,32,128.1
'37310, 군위군,'005003, 2세,2019,62,37,25,148,62,37,25,148
'37310, 군위군,'005004, 3세,2019,68,37,31,119.4,68,37,31,119.4
'37310, 군위군,'005005, 4세,2019,70,34,36,94.4,70,34,36,94.4
'37310, 군위군,'010,5~9세,2019,375,206,169,121.9,373,204,169,120.7
'37310, 군위군,'010001, 5세,2019,74,36,38,94.7,74,36,38,94.7
'37310, 군위군,'010002, 6세,2019,65,44,21,209.5,65,44,21,209.5
'37310, 군위군,'010003, 7세,2019,89,49,40,122.5,88,48,40,120
'37310, 군위군,'010004, 8세,2019,72,37,35,105.7,72,37,35,105.7
'37310, 군위군,'010005, 9세,2019,75,40,35,114.3,74,39,35,111.4
'37310, 군위군,'015,10~14세,2019,436,247,189,130.7,434,246,188,130.9
'37310, 군위군,'015001, 10세,2019,84,50,34,147.1,84,50,34,147.1
'37310, 군위군,'015002, 11세,2019,90,53,37,143.2,90,53,37,143.2
'37310, 군위군,'015003, 12세,2019,87,47,40,117.5,86,47,39,120.5
'37310, 군위군,'015004, 13세,2019,88,50,38,131.6,87,49,38,128.9
'37310, 군위군,'015005, 14세,2019,87,47,40,117.5,87,47,40,117.5
'37310, 군위군,'020,15~19세,2019,517,282,235,120,514,279,235,118.7
'37310, 군위군,'020001, 15세,2019,78,39,39,100,77,38,39,97.4
'37310, 군위군,'020002, 16세,2019,118,68,50,136,118,68,50,136
'37310, 군위군,'020003, 17세,2019,130,70,60,116.7,130,70,60,116.7
'37310, 군위군,'020004, 18세,2019,107,44,63,69.8,107,44,63,69.8
'37310, 군위군,'020005, 19세,2019,84,61,23,265.2,82,59,23,256.5
'37310, 군위군,'025,20~24세,2019,741,467,274,170.4,654,403,251,160.6
'37310, 군위군,'025001, 20세,2019,108,81,27,300,105,78,27,288.9
'37310, 군위군,'025002, 21세,2019,147,100,47,212.8,138,95,43,220.9
'37310, 군위군,'025003, 22세,2019,155,92,63,146,133,76,57,133.3
'37310, 군위군,'025004, 23세,2019,167,100,67,149.3,140,77,63,122.2
'37310, 군위군,'025005, 24세,2019,164,94,70,134.3,138,77,61,126.2
'37310, 군위군,'030,25~29세,2019,866,566,300,188.7,676,418,258,162
'37310, 군위군,'030001, 25세,2019,185,121,64,189.1,155,95,60,158.3
'37310, 군위군,'030002, 26세,2019,168,114,54,211.1,130,83,47,176.6
'37310, 군위군,'030003, 27세,2019,178,120,58,206.9,141,91,50,182
'37310, 군위군,'030004, 28세,2019,159,99,60,165,115,67,48,139.6
'37310, 군위군,'030005, 29세,2019,176,112,64,175,135,82,53,154.7
'37310, 군위군,'035,30~34세,2019,832,526,306,171.9,652,389,263,147.9
'37310, 군위군,'035001, 30세,2019,162,107,55,194.5,119,73,46,158.7
'37310, 군위군,'035002, 31세,2019,176,116,60,193.3,134,81,53,152.8
'37310, 군위군,'035003, 32세,2019,179,116,63,184.1,137,86,51,168.6
'37310, 군위군,'035004, 33세,2019,158,94,64,146.9,133,75,58,129.3
'37310, 군위군,'035005, 34세,2019,157,93,64,145.3,129,74,55,134.5
'37310, 군위군,'040,35~39세,2019,837,482,355,135.8,719,390,329,118.5
'37310, 군위군,'040001, 35세,2019,145,88,57,154.4,116,62,54,114.8
'37310, 군위군,'040002, 36세,2019,166,89,77,115.6,139,69,70,98.6
'37310, 군위군,'040003, 37세,2019,148,88,60,146.7,132,72,60,120
'37310, 군위군,'040004, 38세,2019,183,105,78,134.6,164,93,71,131
'37310, 군위군,'040005, 39세,2019,195,112,83,134.9,168,94,74,127
'37310, 군위군,'045,40~44세,2019,902,544,358,152,852,510,342,149.1
'37310, 군위군,'045001, 40세,2019,175,110,65,169.2,166,104,62,167.7
'37310, 군위군,'045002, 41세,2019,170,107,63,169.8,158,100,58,172.4
'37310, 군위군,'045003, 42세,2019,161,101,60,168.3,152,95,57,166.7
'37310, 군위군,'045004, 43세,2019,200,111,89,124.7,191,104,87,119.5
'37310, 군위군,'045005, 44세,2019,196,115,81,142,185,107,78,137.2
'37310, 군위군,'050,45~49세,2019,1193,695,498,139.6,1145,666,479,139
'37310, 군위군,'050001, 45세,2019,210,128,82,156.1,196,121,75,161.3
'37310, 군위군,'050002, 46세,2019,230,143,87,164.4,223,139,84,165.5
'37310, 군위군,'050003, 47세,2019,239,134,105,127.6,232,128,104,123.1
'37310, 군위군,'050004, 48세,2019,260,145,115,126.1,248,138,110,125.5
'37310, 군위군,'050005, 49세,2019,254,145,109,133,246,140,106,132.1
'37310, 군위군,'055,50~54세,2019,1748,987,761,129.7,1722,972,750,129.6
'37310, 군위군,'055001, 50세,2019,304,169,135,125.2,300,168,132,127.3
'37310, 군위군,'055002, 51세,2019,318,176,142,123.9,313,172,141,122
'37310, 군위군,'055003, 52세,2019,343,199,144,138.2,336,195,141,138.3
'37310, 군위군,'055004, 53세,2019,367,212,155,136.8,358,207,151,137.1
'37310, 군위군,'055005, 54세,2019,416,231,185,124.9,415,230,185,124.3
'37310, 군위군,'060,55~59세,2019,2338,1239,1099,112.7,2312,1228,1084,113.3
'37310, 군위군,'060001, 55세,2019,397,220,177,124.3,388,217,171,126.9
'37310, 군위군,'060002, 56세,2019,403,208,195,106.7,398,205,193,106.2
'37310, 군위군,'060003, 57세,2019,482,267,215,124.2,473,264,209,126.3
'37310, 군위군,'060004, 58세,2019,520,270,250,108,517,268,249,107.6
'37310, 군위군,'060005, 59세,2019,536,274,262,104.6,536,274,262,104.6
'37310, 군위군,'065,60~64세,2019,2527,1335,1192,112,2519,1331,1188,112
'37310, 군위군,'065001, 60세,2019,532,271,261,103.8,532,271,261,103.8
'37310, 군위군,'065002, 61세,2019,448,241,207,116.4,446,241,205,117.6
'37310, 군위군,'065003, 62세,2019,506,272,234,116.2,505,271,234,115.8
'37310, 군위군,'065004, 63세,2019,526,281,245,114.7,524,279,245,113.9
'37310, 군위군,'065005, 64세,2019,515,270,245,110.2,512,269,243,110.7
'37310, 군위군,'070,65~69세,2019,2165,1065,1100,96.8,2160,1063,1097,96.9
'37310, 군위군,'070001, 65세,2019,425,220,205,107.3,425,220,205,107.3
'37310, 군위군,'070002, 66세,2019,422,223,199,112.1,419,222,197,112.7
'37310, 군위군,'070003, 67세,2019,526,250,276,90.6,526,250,276,90.6
'37310, 군위군,'070004, 68세,2019,393,190,203,93.6,392,190,202,94.1
'37310, 군위군,'070005, 69세,2019,399,182,217,83.9,398,181,217,83.4
'37310, 군위군,'075,70~74세,2019,1857,919,938,98,1856,918,938,97.9
'37310, 군위군,'075001, 70세,2019,431,236,195,121,430,235,195,120.5
'37310, 군위군,'075002, 71세,2019,413,200,213,93.9,413,200,213,93.9
'37310, 군위군,'075003, 72세,2019,434,218,216,100.9,434,218,216,100.9
'37310, 군위군,'075004, 73세,2019,260,126,134,94,260,126,134,94
'37310, 군위군,'075005, 74세,2019,319,139,180,77.2,319,139,180,77.2
'37310, 군위군,'080,75~79세,2019,1985,822,1163,70.7,1982,819,1163,70.4
'37310, 군위군,'080001, 75세,2019,336,145,191,75.9,336,145,191,75.9
'37310, 군위군,'080002, 76세,2019,404,169,235,71.9,401,166,235,70.6
'37310, 군위군,'080003, 77세,2019,497,208,289,72,497,208,289,72
'37310, 군위군,'080004, 78세,2019,378,155,223,69.5,378,155,223,69.5
'37310, 군위군,'080005, 79세,2019,370,145,225,64.4,370,145,225,64.4
'37310, 군위군,'085,80~84세,2019,1581,577,1004,57.5,1581,577,1004,57.5
'37310, 군위군,'085001, 80세,2019,355,135,220,61.4,355,135,220,61.4
'37310, 군위군,'085002, 81세,2019,354,130,224,58,354,130,224,58
'37310, 군위군,'085003, 82세,2019,287,111,176,63.1,287,111,176,63.1
'37310, 군위군,'085004, 83세,2019,285,104,181,57.5,285,104,181,57.5
'37310, 군위군,'085005, 84세,2019,300,97,203,47.8,300,97,203,47.8
'37310, 군위군,'086,85세이상,2019,957,290,667,43.5,957,290,667,43.5
'37310, 군위군,'090,85~89세,2019,731,244,487,50.1,731,244,487,50.1
'37310, 군위군,'090001, 85세,2019,224,76,148,51.4,224,76,148,51.4
'37310, 군위군,'090002, 86세,2019,160,60,100,60,160,60,100,60
'37310, 군위군,'090003, 87세,2019,145,51,94,54.3,145,51,94,54.3
'37310, 군위군,'090004, 88세,2019,103,28,75,37.3,103,28,75,37.3
'37310, 군위군,'090005, 89세,2019,99,29,70,41.4,99,29,70,41.4
'37310, 군위군,'095,90~94세,2019,192,44,148,29.7,192,44,148,29.7
'37310, 군위군,'095001, 90세,2019,66,15,51,29.4,66,15,51,29.4
'37310, 군위군,'095002, 91세,2019,51,11,40,27.5,51,11,40,27.5
'37310, 군위군,'095003, 92세,2019,42,10,32,31.3,42,10,32,31.3
'37310, 군위군,'095004, 93세,2019,15,X,13,15.4,15,X,13,15.4
'37310, 군위군,'095005, 94세,2019,18,6,12,50,18,6,12,50
'37310, 군위군,'100,95~99세,2019,28,X,26,7.7,28,X,26,7.7
'37310, 군위군,'100001, 95세,2019,12,X,11,9.1,12,X,11,9.1
'37310, 군위군,'100002, 96세,2019,X,X,X,0,X,X,X,0
'37310, 군위군,'100003, 97세,2019,8,X,7,14.3,8,X,7,14.3
'37310, 군위군,'100004, 98세,2019,X,X,X,0,X,X,X,0
'37310, 군위군,'100005, 99세,2019,X,X,X,0,X,X,X,0
'37310, 군위군,'101,100세이상,2019,6,X,6,0,6,X,6,0
'37310, 군위군,'102,15세미만,2019,1160,638,522,122.2,1156,635,521,121.9
'37310, 군위군,'103,15~64세,2019,12501,7123,5378,132.4,11765,6586,5179,127.2
'37310, 군위군,'104,65세이상,2019,8545,3673,4872,75.4,8536,3667,4869,75.3
'37310, 군위군,'126,평균연령,2019,56.1,53.3,59.2,,56.9,54.2,59.6,
'37310, 군위군,'127,중위연령,2019,59.9,57.4,62.9,,60.6,58.4,63.3,
'37320, 의성군,'000,합계,2019,49477,24114,25363,95.1,48566,23601,24965,94.5
'37320, 의성군,'005,0~4세,2019,1050,551,499,110.4,1047,550,497,110.7
'37320, 의성군,'005001, 0세,2019,236,135,101,133.7,235,135,100,135
'37320, 의성군,'005002, 1세,2019,233,115,118,97.5,233,115,118,97.5
'37320, 의성군,'005003, 2세,2019,197,107,90,118.9,196,106,90,117.8
'37320, 의성군,'005004, 3세,2019,209,108,101,106.9,208,108,100,108
'37320, 의성군,'005005, 4세,2019,175,86,89,96.6,175,86,89,96.6
'37320, 의성군,'010,5~9세,2019,898,461,437,105.5,897,461,436,105.7
'37320, 의성군,'010001, 5세,2019,183,95,88,108,183,95,88,108
'37320, 의성군,'010002, 6세,2019,179,97,82,118.3,179,97,82,118.3
'37320, 의성군,'010003, 7세,2019,190,95,95,100,190,95,95,100
'37320, 의성군,'010004, 8세,2019,176,83,93,89.2,175,83,92,90.2
'37320, 의성군,'010005, 9세,2019,170,91,79,115.2,170,91,79,115.2
'37320, 의성군,'015,10~14세,2019,1050,555,495,112.1,1047,553,494,111.9
'37320, 의성군,'015001, 10세,2019,186,98,88,111.4,185,98,87,112.6
'37320, 의성군,'015002, 11세,2019,235,129,106,121.7,234,128,106,120.8
'37320, 의성군,'015003, 12세,2019,211,100,111,90.1,211,100,111,90.1
'37320, 의성군,'015004, 13세,2019,215,117,98,119.4,214,116,98,118.4
'37320, 의성군,'015005, 14세,2019,203,111,92,120.7,203,111,92,120.7
'37320, 의성군,'020,15~19세,2019,1042,550,492,111.8,1036,547,489,111.9
'37320, 의성군,'020001, 15세,2019,245,134,111,120.7,243,133,110,120.9
'37320, 의성군,'020002, 16세,2019,194,94,100,94,194,94,100,94
'37320, 의성군,'020003, 17세,2019,220,115,105,109.5,220,115,105,109.5
'37320, 의성군,'020004, 18세,2019,221,118,103,114.6,219,116,103,112.6
'37320, 의성군,'020005, 19세,2019,162,89,73,121.9,160,89,71,125.4
'37320, 의성군,'025,20~24세,2019,1357,838,519,161.5,1258,775,483,160.5
'37320, 의성군,'025001, 20세,2019,226,147,79,186.1,219,145,74,195.9
'37320, 의성군,'025002, 21세,2019,252,185,67,276.1,236,175,61,286.9
'37320, 의성군,'025003, 22세,2019,272,159,113,140.7,251,151,100,151
'37320, 의성군,'025004, 23세,2019,281,155,126,123,259,137,122,112.3
'37320, 의성군,'025005, 24세,2019,326,192,134,143.3,293,167,126,132.5
'37320, 의성군,'030,25~29세,2019,1712,1001,711,140.8,1522,890,632,140.8
'37320, 의성군,'030001, 25세,2019,334,190,144,131.9,295,171,124,137.9
'37320, 의성군,'030002, 26세,2019,349,205,144,142.4,311,182,129,141.1
'37320, 의성군,'030003, 27세,2019,368,218,150,145.3,333,195,138,141.3
'37320, 의성군,'030004, 28세,2019,344,197,147,134,303,172,131,131.3
'37320, 의성군,'030005, 29세,2019,317,191,126,151.6,280,170,110,154.5
'37320, 의성군,'035,30~34세,2019,1638,931,707,131.7,1487,850,637,133.4
'37320, 의성군,'035001, 30세,2019,347,205,142,144.4,312,185,127,145.7
'37320, 의성군,'035002, 31세,2019,324,196,128,153.1,298,183,115,159.1
'37320, 의성군,'035003, 32세,2019,321,179,142,126.1,294,163,131,124.4
'37320, 의성군,'035004, 33세,2019,301,149,152,98,268,134,134,100
'37320, 의성군,'035005, 34세,2019,345,202,143,141.3,315,185,130,142.3
'37320, 의성군,'040,35~39세,2019,1764,959,805,119.1,1656,892,764,116.8
'37320, 의성군,'040001, 35세,2019,317,169,148,114.2,284,148,136,108.8
'37320, 의성군,'040002, 36세,2019,349,197,152,129.6,323,182,141,129.1
'37320, 의성군,'040003, 37세,2019,392,202,190,106.3,372,188,184,102.2
'37320, 의성군,'040004, 38세,2019,361,199,162,122.8,347,191,156,122.4
'37320, 의성군,'040005, 39세,2019,345,192,153,125.5,330,183,147,124.5
'37320, 의성군,'045,40~44세,2019,1928,1143,785,145.6,1854,1103,751,146.9
'37320, 의성군,'045001, 40세,2019,392,222,170,130.6,375,215,160,134.4
'37320, 의성군,'045002, 41세,2019,367,222,145,153.1,348,211,137,154
'37320, 의성군,'045003, 42세,2019,372,213,159,134,358,207,151,137.1
'37320, 의성군,'045004, 43세,2019,359,221,138,160.1,350,216,134,161.2
'37320, 의성군,'045005, 44세,2019,438,265,173,153.2,423,254,169,150.3
'37320, 의성군,'050,45~49세,2019,2589,1476,1113,132.6,2509,1433,1076,133.2
'37320, 의성군,'050001, 45세,2019,458,277,181,153,440,267,173,154.3
'37320, 의성군,'050002, 46세,2019,492,276,216,127.8,481,270,211,128
'37320, 의성군,'050003, 47세,2019,535,312,223,139.9,522,306,216,141.7
'37320, 의성군,'050004, 48세,2019,562,306,256,119.5,538,292,246,118.7
'37320, 의성군,'050005, 49세,2019,542,305,237,128.7,528,298,230,129.6
'37320, 의성군,'055,50~54세,2019,3623,2015,1608,125.3,3555,1977,1578,125.3
'37320, 의성군,'055001, 50세,2019,657,364,293,124.2,644,355,289,122.8
'37320, 의성군,'055002, 51세,2019,683,378,305,123.9,666,369,297,124.2
'37320, 의성군,'055003, 52세,2019,712,409,303,135,700,404,296,136.5
'37320, 의성군,'055004, 53세,2019,740,433,307,141,725,424,301,140.9
'37320, 의성군,'055005, 54세,2019,831,431,400,107.8,820,425,395,107.6
'37320, 의성군,'060,55~59세,2019,5015,2518,2497,100.8,4966,2496,2470,101.1
'37320, 의성군,'060001, 55세,2019,749,356,393,90.6,740,351,389,90.2
'37320, 의성군,'060002, 56세,2019,859,448,411,109,847,442,405,109.1
'37320, 의성군,'060003, 57세,2019,1067,543,524,103.6,1054,538,516,104.3
'37320, 의성군,'060004, 58세,2019,1123,573,550,104.2,1119,572,547,104.6
'37320, 의성군,'060005, 59세,2019,1217,598,619,96.6,1206,593,613,96.7
'37320, 의성군,'065,60~64세,2019,5712,2890,2822,102.4,5668,2866,2802,102.3
'37320, 의성군,'065001, 60세,2019,1094,560,534,104.9,1085,557,528,105.5
'37320, 의성군,'065002, 61세,2019,1134,565,569,99.3,1124,557,567,98.2
'37320, 의성군,'065003, 62세,2019,1199,637,562,113.3,1187,631,556,113.5
'37320, 의성군,'065004, 63세,2019,1149,590,559,105.5,1140,585,555,105.4
'37320, 의성군,'065005, 64세,2019,1136,538,598,90,1132,536,596,89.9
'37320, 의성군,'070,65~69세,2019,5041,2443,2598,94,5024,2432,2592,93.8
'37320, 의성군,'070001, 65세,2019,1066,523,543,96.3,1063,521,542,96.1
'37320, 의성군,'070002, 66세,2019,1064,519,545,95.2,1061,517,544,95
'37320, 의성군,'070003, 67세,2019,1079,526,553,95.1,1077,524,553,94.8
'37320, 의성군,'070004, 68세,2019,913,445,468,95.1,909,442,467,94.6
'37320, 의성군,'070005, 69세,2019,919,430,489,87.9,914,428,486,88.1
'37320, 의성군,'075,70~74세,2019,4056,1864,2192,85,4043,1859,2184,85.1
'37320, 의성군,'075001, 70세,2019,964,456,508,89.8,960,453,507,89.3
'37320, 의성군,'075002, 71세,2019,959,450,509,88.4,955,449,506,88.7
'37320, 의성군,'075003, 72세,2019,902,407,495,82.2,902,407,495,82.2
'37320, 의성군,'075004, 73세,2019,568,267,301,88.7,564,266,298,89.3
'37320, 의성군,'075005, 74세,2019,663,284,379,74.9,662,284,378,75.1
'37320, 의성군,'080,75~79세,2019,4687,1911,2776,68.8,4685,1910,2775,68.8
'37320, 의성군,'080001, 75세,2019,809,333,476,70,808,333,475,70.1
'37320, 의성군,'080002, 76세,2019,1001,416,585,71.1,1001,416,585,71.1
'37320, 의성군,'080003, 77세,2019,1183,480,703,68.3,1183,480,703,68.3
'37320, 의성군,'080004, 78세,2019,890,354,536,66,890,354,536,66
'37320, 의성군,'080005, 79세,2019,804,328,476,68.9,803,327,476,68.7
'37320, 의성군,'085,80~84세,2019,3827,1330,2497,53.3,3826,1330,2496,53.3
'37320, 의성군,'085001, 80세,2019,968,374,594,63,967,374,593,63.1
'37320, 의성군,'085002, 81세,2019,790,259,531,48.8,790,259,531,48.8
'37320, 의성군,'085003, 82세,2019,755,245,510,48,755,245,510,48
'37320, 의성군,'085004, 83세,2019,652,237,415,57.1,652,237,415,57.1
'37320, 의성군,'085005, 84세,2019,662,215,447,48.1,662,215,447,48.1
'37320, 의성군,'086,85세이상,2019,2488,678,1810,37.5,2486,677,1809,37.4
'37320, 의성군,'090,85~89세,2019,1813,542,1271,42.6,1812,542,1270,42.7
'37320, 의성군,'090001, 85세,2019,545,169,376,44.9,544,169,375,45.1
'37320, 의성군,'090002, 86세,2019,416,118,298,39.6,416,118,298,39.6
'37320, 의성군,'090003, 87세,2019,371,113,258,43.8,371,113,258,43.8
'37320, 의성군,'090004, 88세,2019,256,72,184,39.1,256,72,184,39.1
'37320, 의성군,'090005, 89세,2019,225,70,155,45.2,225,70,155,45.2
'37320, 의성군,'095,90~94세,2019,559,121,438,27.6,558,120,438,27.4
'37320, 의성군,'095001, 90세,2019,173,31,142,21.8,172,30,142,21.1
'37320, 의성군,'095002, 91세,2019,146,31,115,27,146,31,115,27
'37320, 의성군,'095003, 92세,2019,118,36,82,43.9,118,36,82,43.9
'37320, 의성군,'095004, 93세,2019,69,16,53,30.2,69,16,53,30.2
'37320, 의성군,'095005, 94세,2019,53,7,46,15.2,53,7,46,15.2
'37320, 의성군,'100,95~99세,2019,104,14,90,15.6,104,14,90,15.6
'37320, 의성군,'100001, 95세,2019,35,6,29,20.7,35,6,29,20.7
'37320, 의성군,'100002, 96세,2019,26,X,22,18.2,26,X,22,18.2
'37320, 의성군,'100003, 97세,2019,24,X,20,20,24,X,20,20
'37320, 의성군,'100004, 98세,2019,8,X,8,0,8,X,8,0
'37320, 의성군,'100005, 99세,2019,11,X,11,0,11,X,11,0
'37320, 의성군,'101,100세이상,2019,12,X,11,9.1,12,X,11,9.1
'37320, 의성군,'102,15세미만,2019,2998,1567,1431,109.5,2991,1564,1427,109.6
'37320, 의성군,'103,15~64세,2019,26380,14321,12059,118.8,25511,13829,11682,118.4
'37320, 의성군,'104,65세이상,2019,20099,8226,11873,69.3,20064,8208,11856,69.2
'37320, 의성군,'126,평균연령,2019,56.8,54,59.6,,57.2,54.3,59.9,
'37320, 의성군,'127,중위연령,2019,61,58.4,63.6,,61.3,58.8,63.9,
'37330, 청송군,'000,합계,2019,23958,11929,12029,99.2,23634,11832,11802,100.3
'37330, 청송군,'005,0~4세,2019,494,270,224,120.5,494,270,224,120.5
'37330, 청송군,'005001, 0세,2019,113,69,44,156.8,113,69,44,156.8
'37330, 청송군,'005002, 1세,2019,76,37,39,94.9,76,37,39,94.9
'37330, 청송군,'005003, 2세,2019,98,52,46,113,98,52,46,113
'37330, 청송군,'005004, 3세,2019,90,52,38,136.8,90,52,38,136.8
'37330, 청송군,'005005, 4세,2019,117,60,57,105.3,117,60,57,105.3
'37330, 청송군,'010,5~9세,2019,550,272,278,97.8,550,272,278,97.8
'37330, 청송군,'010001, 5세,2019,110,52,58,89.7,110,52,58,89.7
'37330, 청송군,'010002, 6세,2019,108,48,60,80,108,48,60,80
'37330, 청송군,'010003, 7세,2019,123,60,63,95.2,123,60,63,95.2
'37330, 청송군,'010004, 8세,2019,114,65,49,132.7,114,65,49,132.7
'37330, 청송군,'010005, 9세,2019,95,47,48,97.9,95,47,48,97.9
'37330, 청송군,'015,10~14세,2019,546,298,248,120.2,546,298,248,120.2
'37330, 청송군,'015001, 10세,2019,101,51,50,102,101,51,50,102
'37330, 청송군,'015002, 11세,2019,107,64,43,148.8,107,64,43,148.8
'37330, 청송군,'015003, 12세,2019,104,51,53,96.2,104,51,53,96.2
'37330, 청송군,'015004, 13세,2019,112,61,51,119.6,112,61,51,119.6
'37330, 청송군,'015005, 14세,2019,122,71,51,139.2,122,71,51,139.2
'37330, 청송군,'020,15~19세,2019,599,317,282,112.4,594,316,278,113.7
'37330, 청송군,'020001, 15세,2019,122,67,55,121.8,121,67,54,124.1
'37330, 청송군,'020002, 16세,2019,121,58,63,92.1,121,58,63,92.1
'37330, 청송군,'020003, 17세,2019,143,71,72,98.6,143,71,72,98.6
'37330, 청송군,'020004, 18세,2019,124,72,52,138.5,123,72,51,141.2
'37330, 청송군,'020005, 19세,2019,89,49,40,122.5,86,48,38,126.3
'37330, 청송군,'025,20~24세,2019,719,427,292,146.2,691,424,267,158.8
'37330, 청송군,'025001, 20세,2019,113,76,37,205.4,111,76,35,217.1
'37330, 청송군,'025002, 21세,2019,151,90,61,147.5,143,90,53,169.8
'37330, 청송군,'025003, 22세,2019,138,78,60,130,133,78,55,141.8
'37330, 청송군,'025004, 23세,2019,161,94,67,140.3,155,92,63,146
'37330, 청송군,'025005, 24세,2019,156,89,67,132.8,149,88,61,144.3
'37330, 청송군,'030,25~29세,2019,844,498,346,143.9,782,481,301,159.8
'37330, 청송군,'030001, 25세,2019,168,88,80,110,159,87,72,120.8
'37330, 청송군,'030002, 26세,2019,178,112,66,169.7,160,105,55,190.9
'37330, 청송군,'030003, 27세,2019,183,115,68,169.1,176,113,63,179.4
'37330, 청송군,'030004, 28세,2019,155,95,60,158.3,146,93,53,175.5
'37330, 청송군,'030005, 29세,2019,160,88,72,122.2,141,83,58,143.1
'37330, 청송군,'035,30~34세,2019,829,519,310,167.4,778,507,271,187.1
'37330, 청송군,'035001, 30세,2019,172,117,55,212.7,164,116,48,241.7
'37330, 청송군,'035002, 31세,2019,166,112,54,207.4,155,106,49,216.3
'37330, 청송군,'035003, 32세,2019,170,102,68,150,162,101,61,165.6
'37330, 청송군,'035004, 33세,2019,156,89,67,132.8,144,88,56,157.1
'37330, 청송군,'035005, 34세,2019,165,99,66,150,153,96,57,168.4
'37330, 청송군,'040,35~39세,2019,972,518,454,114.1,928,502,426,117.8
'37330, 청송군,'040001, 35세,2019,152,73,79,92.4,141,70,71,98.6
'37330, 청송군,'040002, 36세,2019,201,105,96,109.4,191,103,88,117
'37330, 청송군,'040003, 37세,2019,187,95,92,103.3,178,88,90,97.8
'37330, 청송군,'040004, 38세,2019,220,123,97,126.8,214,121,93,130.1
'37330, 청송군,'040005, 39세,2019,212,122,90,135.6,204,120,84,142.9
'37330, 청송군,'045,40~44세,2019,997,558,439,127.1,976,555,421,131.8
'37330, 청송군,'045001, 40세,2019,190,105,85,123.5,186,105,81,129.6
'37330, 청송군,'045002, 41세,2019,183,105,78,134.6,181,104,77,135.1
'37330, 청송군,'045003, 42세,2019,199,109,90,121.1,194,109,85,128.2
'37330, 청송군,'045004, 43세,2019,213,122,91,134.1,207,121,86,140.7
'37330, 청송군,'045005, 44세,2019,212,117,95,123.2,208,116,92,126.1
'37330, 청송군,'050,45~49세,2019,1397,794,603,131.7,1370,784,586,133.8
'37330, 청송군,'050001, 45세,2019,264,147,117,125.6,255,144,111,129.7
'37330, 청송군,'050002, 46세,2019,248,139,109,127.5,247,138,109,126.6
'37330, 청송군,'050003, 47세,2019,253,148,105,141,250,147,103,142.7
'37330, 청송군,'050004, 48세,2019,287,171,116,147.4,279,167,112,149.1
'37330, 청송군,'050005, 49세,2019,345,189,156,121.2,339,188,151,124.5
'37330, 청송군,'055,50~54세,2019,2009,1080,929,116.3,1978,1068,910,117.4
'37330, 청송군,'055001, 50세,2019,379,223,156,142.9,373,221,152,145.4
'37330, 청송군,'055002, 51세,2019,393,197,196,100.5,387,195,192,101.6
'37330, 청송군,'055003, 52세,2019,392,209,183,114.2,383,204,179,114
'37330, 청송군,'055004, 53세,2019,412,224,188,119.1,407,222,185,120
'37330, 청송군,'055005, 54세,2019,433,227,206,110.2,428,226,202,111.9
'37330, 청송군,'060,55~59세,2019,2569,1304,1265,103.1,2544,1297,1247,104
'37330, 청송군,'060001, 55세,2019,420,216,204,105.9,413,213,200,106.5
'37330, 청송군,'060002, 56세,2019,463,233,230,101.3,461,232,229,101.3
'37330, 청송군,'060003, 57세,2019,529,276,253,109.1,522,273,249,109.6
'37330, 청송군,'060004, 58세,2019,560,284,276,102.9,556,284,272,104.4
'37330, 청송군,'060005, 59세,2019,597,295,302,97.7,592,295,297,99.3
'37330, 청송군,'065,60~64세,2019,2714,1356,1358,99.9,2697,1346,1351,99.6
'37330, 청송군,'065001, 60세,2019,561,281,280,100.4,558,279,279,100
'37330, 청송군,'065002, 61세,2019,539,282,257,109.7,534,279,255,109.4
'37330, 청송군,'065003, 62세,2019,554,276,278,99.3,552,276,276,100
'37330, 청송군,'065004, 63세,2019,545,270,275,98.2,542,267,275,97.1
'37330, 청송군,'065005, 64세,2019,515,247,268,92.2,511,245,266,92.1
'37330, 청송군,'070,65~69세,2019,2294,1144,1150,99.5,2290,1142,1148,99.5
'37330, 청송군,'070001, 65세,2019,475,243,232,104.7,472,241,231,104.3
'37330, 청송군,'070002, 66세,2019,473,236,237,99.6,472,236,236,100
'37330, 청송군,'070003, 67세,2019,503,231,272,84.9,503,231,272,84.9
'37330, 청송군,'070004, 68세,2019,427,222,205,108.3,427,222,205,108.3
'37330, 청송군,'070005, 69세,2019,416,212,204,103.9,416,212,204,103.9
'37330, 청송군,'075,70~74세,2019,1884,892,992,89.9,1877,890,987,90.2
'37330, 청송군,'075001, 70세,2019,426,211,215,98.1,426,211,215,98.1
'37330, 청송군,'075002, 71세,2019,447,221,226,97.8,447,221,226,97.8
'37330, 청송군,'075003, 72세,2019,431,202,229,88.2,429,202,227,89
'37330, 청송군,'075004, 73세,2019,266,112,154,72.7,262,110,152,72.4
'37330, 청송군,'075005, 74세,2019,314,146,168,86.9,313,146,167,87.4
'37330, 청송군,'080,75~79세,2019,2062,823,1239,66.4,2060,821,1239,66.3
'37330, 청송군,'080001, 75세,2019,397,165,232,71.1,397,165,232,71.1
'37330, 청송군,'080002, 76세,2019,422,179,243,73.7,422,179,243,73.7
'37330, 청송군,'080003, 77세,2019,484,185,299,61.9,483,184,299,61.5
'37330, 청송군,'080004, 78세,2019,392,150,242,62,391,149,242,61.6
'37330, 청송군,'080005, 79세,2019,367,144,223,64.6,367,144,223,64.6
'37330, 청송군,'085,80~84세,2019,1554,579,975,59.4,1554,579,975,59.4
'37330, 청송군,'085001, 80세,2019,416,153,263,58.2,416,153,263,58.2
'37330, 청송군,'085002, 81세,2019,312,126,186,67.7,312,126,186,67.7
'37330, 청송군,'085003, 82세,2019,279,98,181,54.1,279,98,181,54.1
'37330, 청송군,'085004, 83세,2019,280,109,171,63.7,280,109,171,63.7
'37330, 청송군,'085005, 84세,2019,267,93,174,53.4,267,93,174,53.4
'37330, 청송군,'086,85세이상,2019,925,280,645,43.4,925,280,645,43.4
'37330, 청송군,'090,85~89세,2019,670,223,447,49.9,670,223,447,49.9
'37330, 청송군,'090001, 85세,2019,201,65,136,47.8,201,65,136,47.8
'37330, 청송군,'090002, 86세,2019,138,53,85,62.4,138,53,85,62.4
'37330, 청송군,'090003, 87세,2019,146,55,91,60.4,146,55,91,60.4
'37330, 청송군,'090004, 88세,2019,112,30,82,36.6,112,30,82,36.6
'37330, 청송군,'090005, 89세,2019,73,20,53,37.7,73,20,53,37.7
'37330, 청송군,'095,90~94세,2019,218,52,166,31.3,218,52,166,31.3
'37330, 청송군,'095001, 90세,2019,66,18,48,37.5,66,18,48,37.5
'37330, 청송군,'095002, 91세,2019,56,16,40,40,56,16,40,40
'37330, 청송군,'095003, 92세,2019,38,8,30,26.7,38,8,30,26.7
'37330, 청송군,'095004, 93세,2019,39,8,31,25.8,39,8,31,25.8
'37330, 청송군,'095005, 94세,2019,19,X,17,11.8,19,X,17,11.8
'37330, 청송군,'100,95~99세,2019,31,5,26,19.2,31,5,26,19.2
'37330, 청송군,'100001, 95세,2019,8,X,7,14.3,8,X,7,14.3
'37330, 청송군,'100002, 96세,2019,7,X,6,16.7,7,X,6,16.7
'37330, 청송군,'100003, 97세,2019,X,X,X,0,X,X,X,0
'37330, 청송군,'100004, 98세,2019,8,X,7,14.3,8,X,7,14.3
'37330, 청송군,'100005, 99세,2019,X,X,X,100,X,X,X,100
'37330, 청송군,'101,100세이상,2019,6,X,6,0,6,X,6,0
'37330, 청송군,'102,15세미만,2019,1590,840,750,112,1590,840,750,112
'37330, 청송군,'103,15~64세,2019,13649,7371,6278,117.4,13338,7280,6058,120.2
'37330, 청송군,'104,65세이상,2019,8719,3718,5001,74.3,8706,3712,4994,74.3
'37330, 청송군,'126,평균연령,2019,55,52.6,57.4,,55.2,52.7,57.8,
'37330, 청송군,'127,중위연령,2019,59.1,56.8,61.2,,59.3,57,61.6,
'37340, 영양군,'000,합계,2019,16146,7832,8314,94.2,15839,7754,8085,95.9
'37340, 영양군,'005,0~4세,2019,387,201,186,108.1,387,201,186,108.1
'37340, 영양군,'005001, 0세,2019,74,36,38,94.7,74,36,38,94.7
'37340, 영양군,'005002, 1세,2019,69,42,27,155.6,69,42,27,155.6
'37340, 영양군,'005003, 2세,2019,94,48,46,104.3,94,48,46,104.3
'37340, 영양군,'005004, 3세,2019,69,38,31,122.6,69,38,31,122.6
'37340, 영양군,'005005, 4세,2019,81,37,44,84.1,81,37,44,84.1
'37340, 영양군,'010,5~9세,2019,407,216,191,113.1,407,216,191,113.1
'37340, 영양군,'010001, 5세,2019,78,34,44,77.3,78,34,44,77.3
'37340, 영양군,'010002, 6세,2019,79,44,35,125.7,79,44,35,125.7
'37340, 영양군,'010003, 7세,2019,70,44,26,169.2,70,44,26,169.2
'37340, 영양군,'010004, 8세,2019,80,49,31,158.1,80,49,31,158.1
'37340, 영양군,'010005, 9세,2019,100,45,55,81.8,100,45,55,81.8
'37340, 영양군,'015,10~14세,2019,436,230,206,111.7,436,230,206,111.7
'37340, 영양군,'015001, 10세,2019,71,42,29,144.8,71,42,29,144.8
'37340, 영양군,'015002, 11세,2019,99,51,48,106.3,99,51,48,106.3
'37340, 영양군,'015003, 12세,2019,103,51,52,98.1,103,51,52,98.1
'37340, 영양군,'015004, 13세,2019,76,44,32,137.5,76,44,32,137.5
'37340, 영양군,'015005, 14세,2019,87,42,45,93.3,87,42,45,93.3
'37340, 영양군,'020,15~19세,2019,607,220,387,56.8,606,219,387,56.6
'37340, 영양군,'020001, 15세,2019,88,43,45,95.6,88,43,45,95.6
'37340, 영양군,'020002, 16세,2019,139,40,99,40.4,138,39,99,39.4
'37340, 영양군,'020003, 17세,2019,177,51,126,40.5,177,51,126,40.5
'37340, 영양군,'020004, 18세,2019,138,40,98,40.8,138,40,98,40.8
'37340, 영양군,'020005, 19세,2019,65,46,19,242.1,65,46,19,242.1
'37340, 영양군,'025,20~24세,2019,425,259,166,156,399,256,143,179
'37340, 영양군,'025001, 20세,2019,71,53,18,294.4,65,52,13,400
'37340, 영양군,'025002, 21세,2019,97,74,23,321.7,95,74,21,352.4
'37340, 영양군,'025003, 22세,2019,76,46,30,153.3,72,45,27,166.7
'37340, 영양군,'025004, 23세,2019,80,34,46,73.9,76,34,42,81
'37340, 영양군,'025005, 24세,2019,101,52,49,106.1,91,51,40,127.5
'37340, 영양군,'030,25~29세,2019,543,293,250,117.2,486,280,206,135.9
'37340, 영양군,'030001, 25세,2019,117,72,45,160,104,69,35,197.1
'37340, 영양군,'030002, 26세,2019,101,55,46,119.6,92,52,40,130
'37340, 영양군,'030003, 27세,2019,109,50,59,84.7,99,48,51,94.1
'37340, 영양군,'030004, 28세,2019,117,67,50,134,104,64,40,160
'37340, 영양군,'030005, 29세,2019,99,49,50,98,87,47,40,117.5
'37340, 영양군,'035,30~34세,2019,504,253,251,100.8,459,247,212,116.5
'37340, 영양군,'035001, 30세,2019,95,54,41,131.7,91,53,38,139.5
'37340, 영양군,'035002, 31세,2019,102,51,51,100,91,49,42,116.7
'37340, 영양군,'035003, 32세,2019,105,49,56,87.5,95,48,47,102.1
'37340, 영양군,'035004, 33세,2019,119,58,61,95.1,108,58,50,116
'37340, 영양군,'035005, 34세,2019,83,41,42,97.6,74,39,35,111.4
'37340, 영양군,'040,35~39세,2019,622,313,309,101.3,587,308,279,110.4
'37340, 영양군,'040001, 35세,2019,96,52,44,118.2,93,51,42,121.4
'37340, 영양군,'040002, 36세,2019,135,63,72,87.5,122,61,61,100
'37340, 영양군,'040003, 37세,2019,129,61,68,89.7,119,60,59,101.7
'37340, 영양군,'040004, 38세,2019,117,69,48,143.8,111,68,43,158.1
'37340, 영양군,'040005, 39세,2019,145,68,77,88.3,142,68,74,91.9
'37340, 영양군,'045,40~44세,2019,688,387,301,128.6,658,381,277,137.5
'37340, 영양군,'045001, 40세,2019,126,74,52,142.3,121,73,48,152.1
'37340, 영양군,'045002, 41세,2019,133,79,54,146.3,128,79,49,161.2
'37340, 영양군,'045003, 42세,2019,135,75,60,125,126,74,52,142.3
'37340, 영양군,'045004, 43세,2019,140,78,62,125.8,133,77,56,137.5
'37340, 영양군,'045005, 44세,2019,154,81,73,111,150,78,72,108.3
'37340, 영양군,'050,45~49세,2019,1050,623,427,145.9,1018,613,405,151.4
'37340, 영양군,'050001, 45세,2019,174,98,76,128.9,166,97,69,140.6
'37340, 영양군,'050002, 46세,2019,193,119,74,160.8,185,116,69,168.1
'37340, 영양군,'050003, 47세,2019,198,117,81,144.4,192,114,78,146.2
'37340, 영양군,'050004, 48세,2019,236,147,89,165.2,231,145,86,168.6
'37340, 영양군,'050005, 49세,2019,249,142,107,132.7,244,141,103,136.9
'37340, 영양군,'055,50~54세,2019,1253,713,540,132,1224,701,523,134
'37340, 영양군,'055001, 50세,2019,245,153,92,166.3,242,151,91,165.9
'37340, 영양군,'055002, 51세,2019,252,146,106,137.7,241,142,99,143.4
'37340, 영양군,'055003, 52세,2019,210,121,89,136,203,119,84,141.7
'37340, 영양군,'055004, 53세,2019,285,154,131,117.6,280,153,127,120.5
'37340, 영양군,'055005, 54세,2019,261,139,122,113.9,258,136,122,111.5
'37340, 영양군,'060,55~59세,2019,1696,860,836,102.9,1670,852,818,104.2
'37340, 영양군,'060001, 55세,2019,241,133,108,123.1,235,130,105,123.8
'37340, 영양군,'060002, 56세,2019,321,156,165,94.5,313,154,159,96.9
'37340, 영양군,'060003, 57세,2019,312,159,153,103.9,309,158,151,104.6
'37340, 영양군,'060004, 58세,2019,424,223,201,110.9,419,221,198,111.6
'37340, 영양군,'060005, 59세,2019,398,189,209,90.4,394,189,205,92.2
'37340, 영양군,'065,60~64세,2019,1677,844,833,101.3,1663,835,828,100.8
'37340, 영양군,'065001, 60세,2019,297,156,141,110.6,292,152,140,108.6
'37340, 영양군,'065002, 61세,2019,339,167,172,97.1,334,165,169,97.6
'37340, 영양군,'065003, 62세,2019,328,150,178,84.3,326,149,177,84.2
'37340, 영양군,'065004, 63세,2019,357,174,183,95.1,356,173,183,94.5
'37340, 영양군,'065005, 64세,2019,356,197,159,123.9,355,196,159,123.3
'37340, 영양군,'070,65~69세,2019,1384,674,710,94.9,1376,670,706,94.9
'37340, 영양군,'070001, 65세,2019,294,145,149,97.3,290,143,147,97.3
'37340, 영양군,'070002, 66세,2019,294,156,138,113,294,156,138,113
'37340, 영양군,'070003, 67세,2019,307,149,158,94.3,306,149,157,94.9
'37340, 영양군,'070004, 68세,2019,245,114,131,87,244,113,131,86.3
'37340, 영양군,'070005, 69세,2019,244,110,134,82.1,242,109,133,82
'37340, 영양군,'075,70~74세,2019,1238,584,654,89.3,1236,584,652,89.6
'37340, 영양군,'075001, 70세,2019,321,165,156,105.8,319,165,154,107.1
'37340, 영양군,'075002, 71세,2019,284,137,147,93.2,284,137,147,93.2
'37340, 영양군,'075003, 72세,2019,228,108,120,90,228,108,120,90
'37340, 영양군,'075004, 73세,2019,185,82,103,79.6,185,82,103,79.6
'37340, 영양군,'075005, 74세,2019,220,92,128,71.9,220,92,128,71.9
'37340, 영양군,'080,75~79세,2019,1481,604,877,68.9,1481,604,877,68.9
'37340, 영양군,'080001, 75세,2019,255,99,156,63.5,255,99,156,63.5
'37340, 영양군,'080002, 76세,2019,300,123,177,69.5,300,123,177,69.5
'37340, 영양군,'080003, 77세,2019,353,149,204,73,353,149,204,73
'37340, 영양군,'080004, 78세,2019,292,116,176,65.9,292,116,176,65.9
'37340, 영양군,'080005, 79세,2019,281,117,164,71.3,281,117,164,71.3
'37340, 영양군,'085,80~84세,2019,1062,375,687,54.6,1062,375,687,54.6
'37340, 영양군,'085001, 80세,2019,275,112,163,68.7,275,112,163,68.7
'37340, 영양군,'085002, 81세,2019,219,76,143,53.1,219,76,143,53.1
'37340, 영양군,'085003, 82세,2019,214,67,147,45.6,214,67,147,45.6
'37340, 영양군,'085004, 83세,2019,175,58,117,49.6,175,58,117,49.6
'37340, 영양군,'085005, 84세,2019,179,62,117,53,179,62,117,53
'37340, 영양군,'086,85세이상,2019,686,183,503,36.4,684,182,502,36.3
'37340, 영양군,'090,85~89세,2019,480,129,351,36.8,478,128,350,36.6
'37340, 영양군,'090001, 85세,2019,140,38,102,37.3,139,38,101,37.6
'37340, 영양군,'090002, 86세,2019,97,25,72,34.7,97,25,72,34.7
'37340, 영양군,'090003, 87세,2019,100,31,69,44.9,100,31,69,44.9
'37340, 영양군,'090004, 88세,2019,85,16,69,23.2,85,16,69,23.2
'37340, 영양군,'090005, 89세,2019,58,19,39,48.7,57,18,39,46.2
'37340, 영양군,'095,90~94세,2019,163,41,122,33.6,163,41,122,33.6
'37340, 영양군,'095001, 90세,2019,50,17,33,51.5,50,17,33,51.5
'37340, 영양군,'095002, 91세,2019,49,11,38,28.9,49,11,38,28.9
'37340, 영양군,'095003, 92세,2019,27,5,22,22.7,27,5,22,22.7
'37340, 영양군,'095004, 93세,2019,20,5,15,33.3,20,5,15,33.3
'37340, 영양군,'095005, 94세,2019,17,X,14,21.4,17,X,14,21.4
'37340, 영양군,'100,95~99세,2019,36,12,24,50,36,12,24,50
'37340, 영양군,'100001, 95세,2019,12,5,7,71.4,12,5,7,71.4
'37340, 영양군,'100002, 96세,2019,15,X,11,36.4,15,X,11,36.4
'37340, 영양군,'100003, 97세,2019,X,X,X,0,X,X,X,0
'37340, 영양군,'100004, 98세,2019,5,X,X,150,5,X,X,150
'37340, 영양군,'100005, 99세,2019,X,X,X,0,X,X,X,0
'37340, 영양군,'101,100세이상,2019,7,X,6,16.7,7,X,6,16.7
'37340, 영양군,'102,15세미만,2019,1230,647,583,111,1230,647,583,111
'37340, 영양군,'103,15~64세,2019,9065,4765,4300,110.8,8770,4692,4078,115.1
'37340, 영양군,'104,65세이상,2019,5851,2420,3431,70.5,5839,2415,3424,70.5
'37340, 영양군,'126,평균연령,2019,54.4,52.4,56.3,,54.7,52.4,56.8,
'37340, 영양군,'127,중위연령,2019,58.7,56.5,60.8,,58.9,56.6,61.4,
'37350, 영덕군,'000,합계,2019,35672,17342,18330,94.6,34264,16282,17982,90.5
'37350, 영덕군,'005,0~4세,2019,884,437,447,97.8,883,436,447,97.5
'37350, 영덕군,'005001, 0세,2019,169,87,82,106.1,169,87,82,106.1
'37350, 영덕군,'005002, 1세,2019,157,72,85,84.7,157,72,85,84.7
'37350, 영덕군,'005003, 2세,2019,198,93,105,88.6,198,93,105,88.6
'37350, 영덕군,'005004, 3세,2019,167,81,86,94.2,167,81,86,94.2
'37350, 영덕군,'005005, 4세,2019,193,104,89,116.9,192,103,89,115.7
'37350, 영덕군,'010,5~9세,2019,951,493,458,107.6,951,493,458,107.6
'37350, 영덕군,'010001, 5세,2019,194,99,95,104.2,194,99,95,104.2
'37350, 영덕군,'010002, 6세,2019,193,107,86,124.4,193,107,86,124.4
'37350, 영덕군,'010003, 7세,2019,191,99,92,107.6,191,99,92,107.6
'37350, 영덕군,'010004, 8세,2019,163,84,79,106.3,163,84,79,106.3
'37350, 영덕군,'010005, 9세,2019,210,104,106,98.1,210,104,106,98.1
'37350, 영덕군,'015,10~14세,2019,949,492,457,107.7,946,491,455,107.9
'37350, 영덕군,'015001, 10세,2019,174,96,78,123.1,174,96,78,123.1
'37350, 영덕군,'015002, 11세,2019,156,74,82,90.2,156,74,82,90.2
'37350, 영덕군,'015003, 12세,2019,220,118,102,115.7,220,118,102,115.7
'37350, 영덕군,'015004, 13세,2019,201,100,101,99,200,100,100,100
'37350, 영덕군,'015005, 14세,2019,198,104,94,110.6,196,103,93,110.8
'37350, 영덕군,'020,15~19세,2019,931,486,445,109.2,923,481,442,108.8
'37350, 영덕군,'020001, 15세,2019,221,114,107,106.5,221,114,107,106.5
'37350, 영덕군,'020002, 16세,2019,189,93,96,96.9,189,93,96,96.9
'37350, 영덕군,'020003, 17세,2019,209,106,103,102.9,208,105,103,101.9
'37350, 영덕군,'020004, 18세,2019,197,99,98,101,197,99,98,101
'37350, 영덕군,'020005, 19세,2019,115,74,41,180.5,108,70,38,184.2
'37350, 영덕군,'025,20~24세,2019,1049,690,359,192.2,887,564,323,174.6
'37350, 영덕군,'025001, 20세,2019,166,129,37,348.6,157,123,34,361.8
'37350, 영덕군,'025002, 21세,2019,206,150,56,267.9,184,133,51,260.8
'37350, 영덕군,'025003, 22세,2019,208,137,71,193,181,116,65,178.5
'37350, 영덕군,'025004, 23세,2019,240,143,97,147.4,191,102,89,114.6
'37350, 영덕군,'025005, 24세,2019,229,131,98,133.7,174,90,84,107.1
'37350, 영덕군,'030,25~29세,2019,1451,922,529,174.3,1130,660,470,140.4
'37350, 영덕군,'030001, 25세,2019,289,176,113,155.8,220,122,98,124.5
'37350, 영덕군,'030002, 26세,2019,290,177,113,156.6,235,130,105,123.8
'37350, 영덕군,'030003, 27세,2019,315,201,114,176.3,243,145,98,148
'37350, 영덕군,'030004, 28세,2019,278,192,86,223.3,210,131,79,165.8
'37350, 영덕군,'030005, 29세,2019,279,176,103,170.9,222,132,90,146.7
'37350, 영덕군,'035,30~34세,2019,1308,749,559,134,1039,547,492,111.2
'37350, 영덕군,'035001, 30세,2019,244,146,98,149,192,105,87,120.7
'37350, 영덕군,'035002, 31세,2019,240,140,100,140,203,112,91,123.1
'37350, 영덕군,'035003, 32세,2019,261,156,105,148.6,195,106,89,119.1
'37350, 영덕군,'035004, 33세,2019,269,146,123,118.7,203,95,108,88
'37350, 영덕군,'035005, 34세,2019,294,161,133,121.1,246,129,117,110.3
'37350, 영덕군,'040,35~39세,2019,1733,966,767,125.9,1487,766,721,106.2
'37350, 영덕군,'040001, 35세,2019,327,177,150,118,273,133,140,95
'37350, 영덕군,'040002, 36세,2019,335,183,152,120.4,290,147,143,102.8
'37350, 영덕군,'040003, 37세,2019,378,219,159,137.7,317,170,147,115.6
'37350, 영덕군,'040004, 38세,2019,343,186,157,118.5,298,151,147,102.7
'37350, 영덕군,'040005, 39세,2019,350,201,149,134.9,309,165,144,114.6
'37350, 영덕군,'045,40~44세,2019,1720,984,736,133.7,1553,852,701,121.5
'37350, 영덕군,'045001, 40세,2019,354,199,155,128.4,309,163,146,111.6
'37350, 영덕군,'045002, 41세,2019,328,197,131,150.4,291,166,125,132.8
'37350, 영덕군,'045003, 42세,2019,359,193,166,116.3,334,172,162,106.2
'37350, 영덕군,'045004, 43세,2019,356,203,153,132.7,320,180,140,128.6
'37350, 영덕군,'045005, 44세,2019,323,192,131,146.6,299,171,128,133.6
'37350, 영덕군,'050,45~49세,2019,2325,1350,975,138.5,2233,1284,949,135.3
'37350, 영덕군,'050001, 45세,2019,423,240,183,131.1,405,228,177,128.8
'37350, 영덕군,'050002, 46세,2019,457,279,178,156.7,430,257,173,148.6
'37350, 영덕군,'050003, 47세,2019,458,274,184,148.9,442,261,181,144.2
'37350, 영덕군,'050004, 48세,2019,498,273,225,121.3,481,264,217,121.7
'37350, 영덕군,'050005, 49세,2019,489,284,205,138.5,475,274,201,136.3
'37350, 영덕군,'055,50~54세,2019,2676,1450,1226,118.3,2613,1420,1193,119
'37350, 영덕군,'055001, 50세,2019,500,286,214,133.6,489,277,212,130.7
'37350, 영덕군,'055002, 51세,2019,537,295,242,121.9,523,288,235,122.6
'37350, 영덕군,'055003, 52세,2019,495,273,222,123,482,269,213,126.3
'37350, 영덕군,'055004, 53세,2019,569,290,279,103.9,555,282,273,103.3
'37350, 영덕군,'055005, 54세,2019,575,306,269,113.8,564,304,260,116.9
'37350, 영덕군,'060,55~59세,2019,3362,1692,1670,101.3,3319,1670,1649,101.3
'37350, 영덕군,'060001, 55세,2019,544,262,282,92.9,532,252,280,90
'37350, 영덕군,'060002, 56세,2019,677,358,319,112.2,667,355,312,113.8
'37350, 영덕군,'060003, 57세,2019,612,322,290,111,608,320,288,111.1
'37350, 영덕군,'060004, 58세,2019,740,372,368,101.1,733,370,363,101.9
'37350, 영덕군,'060005, 59세,2019,789,378,411,92,779,373,406,91.9
'37350, 영덕군,'065,60~64세,2019,3551,1683,1868,90.1,3532,1677,1855,90.4
'37350, 영덕군,'065001, 60세,2019,710,328,382,85.9,708,326,382,85.3
'37350, 영덕군,'065002, 61세,2019,701,351,350,100.3,696,351,345,101.7
'37350, 영덕군,'065003, 62세,2019,732,334,398,83.9,725,332,393,84.5
'37350, 영덕군,'065004, 63세,2019,686,337,349,96.6,682,336,346,97.1
'37350, 영덕군,'065005, 64세,2019,722,333,389,85.6,721,332,389,85.3
'37350, 영덕군,'070,65~69세,2019,3132,1447,1685,85.9,3125,1442,1683,85.7
'37350, 영덕군,'070001, 65세,2019,681,312,369,84.6,680,311,369,84.3
'37350, 영덕군,'070002, 66세,2019,660,313,347,90.2,660,313,347,90.2
'37350, 영덕군,'070003, 67세,2019,682,311,371,83.8,680,309,371,83.3
'37350, 영덕군,'070004, 68세,2019,565,275,290,94.8,562,274,288,95.1
'37350, 영덕군,'070005, 69세,2019,544,236,308,76.6,543,235,308,76.3
'37350, 영덕군,'075,70~74세,2019,2703,1182,1521,77.7,2701,1181,1520,77.7
'37350, 영덕군,'075001, 70세,2019,665,319,346,92.2,664,319,345,92.5
'37350, 영덕군,'075002, 71세,2019,646,271,375,72.3,645,270,375,72
'37350, 영덕군,'075003, 72세,2019,575,265,310,85.5,575,265,310,85.5
'37350, 영덕군,'075004, 73세,2019,372,161,211,76.3,372,161,211,76.3
'37350, 영덕군,'075005, 74세,2019,445,166,279,59.5,445,166,279,59.5
'37350, 영덕군,'080,75~79세,2019,3179,1165,2014,57.8,3176,1165,2011,57.9
'37350, 영덕군,'080001, 75세,2019,540,180,360,50,540,180,360,50
'37350, 영덕군,'080002, 76세,2019,740,300,440,68.2,738,300,438,68.5
'37350, 영덕군,'080003, 77세,2019,747,286,461,62,747,286,461,62
'37350, 영덕군,'080004, 78세,2019,592,204,388,52.6,592,204,388,52.6
'37350, 영덕군,'080005, 79세,2019,560,195,365,53.4,559,195,364,53.6
'37350, 영덕군,'085,80~84세,2019,2338,786,1552,50.6,2337,785,1552,50.6
'37350, 영덕군,'085001, 80세,2019,601,204,397,51.4,601,204,397,51.4
'37350, 영덕군,'085002, 81세,2019,515,176,339,51.9,514,175,339,51.6
'37350, 영덕군,'085003, 82세,2019,423,144,279,51.6,423,144,279,51.6
'37350, 영덕군,'085004, 83세,2019,427,154,273,56.4,427,154,273,56.4
'37350, 영덕군,'085005, 84세,2019,372,108,264,40.9,372,108,264,40.9
'37350, 영덕군,'086,85세이상,2019,1430,368,1062,34.7,1429,368,1061,34.7
'37350, 영덕군,'090,85~89세,2019,1022,281,741,37.9,1021,281,740,38
'37350, 영덕군,'090001, 85세,2019,295,83,212,39.2,295,83,212,39.2
'37350, 영덕군,'090002, 86세,2019,239,65,174,37.4,238,65,173,37.6
'37350, 영덕군,'090003, 87세,2019,204,68,136,50,204,68,136,50
'37350, 영덕군,'090004, 88세,2019,153,35,118,29.7,153,35,118,29.7
'37350, 영덕군,'090005, 89세,2019,131,30,101,29.7,131,30,101,29.7
'37350, 영덕군,'095,90~94세,2019,345,75,270,27.8,345,75,270,27.8
'37350, 영덕군,'095001, 90세,2019,117,32,85,37.6,117,32,85,37.6
'37350, 영덕군,'095002, 91세,2019,83,17,66,25.8,83,17,66,25.8
'37350, 영덕군,'095003, 92세,2019,56,7,49,14.3,56,7,49,14.3
'37350, 영덕군,'095004, 93세,2019,34,7,27,25.9,34,7,27,25.9
'37350, 영덕군,'095005, 94세,2019,55,12,43,27.9,55,12,43,27.9
'37350, 영덕군,'100,95~99세,2019,58,11,47,23.4,58,11,47,23.4
'37350, 영덕군,'100001, 95세,2019,16,X,14,14.3,16,X,14,14.3
'37350, 영덕군,'100002, 96세,2019,19,X,15,26.7,19,X,15,26.7
'37350, 영덕군,'100003, 97세,2019,12,5,7,71.4,12,5,7,71.4
'37350, 영덕군,'100004, 98세,2019,7,X,7,0,7,X,7,0
'37350, 영덕군,'100005, 99세,2019,X,X,X,0,X,X,X,0
'37350, 영덕군,'101,100세이상,2019,5,X,X,25,5,X,X,25
'37350, 영덕군,'102,15세미만,2019,2784,1422,1362,104.4,2780,1420,1360,104.4
'37350, 영덕군,'103,15~64세,2019,20106,10972,9134,120.1,18716,9921,8795,112.8
'37350, 영덕군,'104,65세이상,2019,12782,4948,7834,63.2,12768,4941,7827,63.1
'37350, 영덕군,'126,평균연령,2019,53.8,50.5,57,,54.6,51.5,57.3,
'37350, 영덕군,'127,중위연령,2019,58,53.9,61.4,,58.9,55.6,61.9,
'37360, 청도군,'000,합계,2019,41054,19891,21163,94,39491,19169,20322,94.3
'37360, 청도군,'005,0~4세,2019,681,355,326,108.9,680,355,325,109.2
'37360, 청도군,'005001, 0세,2019,115,54,61,88.5,115,54,61,88.5
'37360, 청도군,'005002, 1세,2019,135,74,61,121.3,134,74,60,123.3
'37360, 청도군,'005003, 2세,2019,132,70,62,112.9,132,70,62,112.9
'37360, 청도군,'005004, 3세,2019,147,81,66,122.7,147,81,66,122.7
'37360, 청도군,'005005, 4세,2019,152,76,76,100,152,76,76,100
'37360, 청도군,'010,5~9세,2019,838,428,410,104.4,837,428,409,104.6
'37360, 청도군,'010001, 5세,2019,149,78,71,109.9,149,78,71,109.9
'37360, 청도군,'010002, 6세,2019,156,80,76,105.3,156,80,76,105.3
'37360, 청도군,'010003, 7세,2019,175,94,81,116,175,94,81,116
'37360, 청도군,'010004, 8세,2019,196,89,107,83.2,195,89,106,84
'37360, 청도군,'010005, 9세,2019,162,87,75,116,162,87,75,116
'37360, 청도군,'015,10~14세,2019,988,495,493,100.4,986,494,492,100.4
'37360, 청도군,'015001, 10세,2019,192,95,97,97.9,192,95,97,97.9
'37360, 청도군,'015002, 11세,2019,204,111,93,119.4,203,110,93,118.3
'37360, 청도군,'015003, 12세,2019,211,99,112,88.4,211,99,112,88.4
'37360, 청도군,'015004, 13세,2019,189,98,91,107.7,189,98,91,107.7
'37360, 청도군,'015005, 14세,2019,192,92,100,92,191,92,99,92.9
'37360, 청도군,'020,15~19세,2019,1257,662,595,111.3,1248,660,588,112.2
'37360, 청도군,'020001, 15세,2019,222,124,98,126.5,221,124,97,127.8
'37360, 청도군,'020002, 16세,2019,259,134,125,107.2,259,134,125,107.2
'37360, 청도군,'020003, 17세,2019,297,143,154,92.9,293,142,151,94
'37360, 청도군,'020004, 18세,2019,271,139,132,105.3,269,139,130,106.9
'37360, 청도군,'020005, 19세,2019,208,122,86,141.9,206,121,85,142.4
'37360, 청도군,'025,20~24세,2019,1466,870,596,146,1243,779,464,167.9
'37360, 청도군,'025001, 20세,2019,255,184,71,259.2,242,179,63,284.1
'37360, 청도군,'025002, 21세,2019,286,177,109,162.4,267,169,98,172.4
'37360, 청도군,'025003, 22세,2019,286,144,142,101.4,239,128,111,115.3
'37360, 청도군,'025004, 23세,2019,301,169,132,128,242,146,96,152.1
'37360, 청도군,'025005, 24세,2019,338,196,142,138,253,157,96,163.5
'37360, 청도군,'030,25~29세,2019,1734,949,785,120.9,1285,749,536,139.7
'37360, 청도군,'030001, 25세,2019,401,214,187,114.4,308,173,135,128.1
'37360, 청도군,'030002, 26세,2019,339,195,144,135.4,252,159,93,171
'37360, 청도군,'030003, 27세,2019,333,167,166,100.6,236,127,109,116.5
'37360, 청도군,'030004, 28세,2019,316,188,128,146.9,236,143,93,153.8
'37360, 청도군,'030005, 29세,2019,345,185,160,115.6,253,147,106,138.7
'37360, 청도군,'035,30~34세,2019,1463,801,662,121,1124,621,503,123.5
'37360, 청도군,'035001, 30세,2019,323,175,148,118.2,239,133,106,125.5
'37360, 청도군,'035002, 31세,2019,289,159,130,122.3,214,123,91,135.2
'37360, 청도군,'035003, 32세,2019,311,169,142,119,232,126,106,118.9
'37360, 청도군,'035004, 33세,2019,274,150,124,121,219,118,101,116.8
'37360, 청도군,'035005, 34세,2019,266,148,118,125.4,220,121,99,122.2
'37360, 청도군,'040,35~39세,2019,1796,915,881,103.9,1602,831,771,107.8
'37360, 청도군,'040001, 35세,2019,307,151,156,96.8,255,124,131,94.7
'37360, 청도군,'040002, 36세,2019,323,184,139,132.4,284,166,118,140.7
'37360, 청도군,'040003, 37세,2019,395,198,197,100.5,359,186,173,107.5
'37360, 청도군,'040004, 38세,2019,385,182,203,89.7,356,170,186,91.4
'37360, 청도군,'040005, 39세,2019,386,200,186,107.5,348,185,163,113.5
'37360, 청도군,'045,40~44세,2019,1828,1001,827,121,1712,946,766,123.5
'37360, 청도군,'045001, 40세,2019,362,187,175,106.9,339,175,164,106.7
'37360, 청도군,'045002, 41세,2019,335,182,153,119,308,172,136,126.5
'37360, 청도군,'045003, 42세,2019,352,192,160,120,325,181,144,125.7
'37360, 청도군,'045004, 43세,2019,394,223,171,130.4,373,211,162,130.2
'37360, 청도군,'045005, 44세,2019,385,217,168,129.2,367,207,160,129.4
'37360, 청도군,'050,45~49세,2019,2485,1348,1137,118.6,2407,1309,1098,119.2
'37360, 청도군,'050001, 45세,2019,447,267,180,148.3,429,258,171,150.9
'37360, 청도군,'050002, 46세,2019,471,243,228,106.6,458,239,219,109.1
'37360, 청도군,'050003, 47세,2019,503,263,240,109.6,488,255,233,109.4
'37360, 청도군,'050004, 48세,2019,522,289,233,124,506,281,225,124.9
'37360, 청도군,'050005, 49세,2019,542,286,256,111.7,526,276,250,110.4
'37360, 청도군,'055,50~54세,2019,3004,1555,1449,107.3,2951,1532,1419,108
'37360, 청도군,'055001, 50세,2019,559,281,278,101.1,547,275,272,101.1
'37360, 청도군,'055002, 51세,2019,614,330,284,116.2,603,328,275,119.3
'37360, 청도군,'055003, 52세,2019,569,280,289,96.9,561,275,286,96.2
'37360, 청도군,'055004, 53세,2019,587,306,281,108.9,575,302,273,110.6
'37360, 청도군,'055005, 54세,2019,675,358,317,112.9,665,352,313,112.5
'37360, 청도군,'060,55~59세,2019,4202,2108,2094,100.7,4160,2092,2068,101.2
'37360, 청도군,'060001, 55세,2019,707,367,340,107.9,699,366,333,109.9
'37360, 청도군,'060002, 56세,2019,710,366,344,106.4,705,362,343,105.5
'37360, 청도군,'060003, 57세,2019,854,454,400,113.5,841,449,392,114.5
'37360, 청도군,'060004, 58세,2019,887,444,443,100.2,879,441,438,100.7
'37360, 청도군,'060005, 59세,2019,1044,477,567,84.1,1036,474,562,84.3
'37360, 청도군,'065,60~64세,2019,4585,2293,2292,100,4556,2277,2279,99.9
'37360, 청도군,'065001, 60세,2019,1052,534,518,103.1,1042,527,515,102.3
'37360, 청도군,'065002, 61세,2019,833,406,427,95.1,828,402,426,94.4
'37360, 청도군,'065003, 62세,2019,891,483,408,118.4,886,479,407,117.7
'37360, 청도군,'065004, 63세,2019,870,435,435,100,864,434,430,100.9
'37360, 청도군,'065005, 64세,2019,939,435,504,86.3,936,435,501,86.8
'37360, 청도군,'070,65~69세,2019,4150,2006,2144,93.6,4137,1998,2139,93.4
'37360, 청도군,'070001, 65세,2019,824,400,424,94.3,821,397,424,93.6
'37360, 청도군,'070002, 66세,2019,827,428,399,107.3,824,427,397,107.6
'37360, 청도군,'070003, 67세,2019,919,448,471,95.1,918,448,470,95.3
'37360, 청도군,'070004, 68세,2019,781,351,430,81.6,777,348,429,81.1
'37360, 청도군,'070005, 69세,2019,799,379,420,90.2,797,378,419,90.2
'37360, 청도군,'075,70~74세,2019,3097,1535,1562,98.3,3089,1532,1557,98.4
'37360, 청도군,'075001, 70세,2019,832,415,417,99.5,830,414,416,99.5
'37360, 청도군,'075002, 71세,2019,710,380,330,115.2,708,380,328,115.9
'37360, 청도군,'075003, 72세,2019,705,344,361,95.3,702,343,359,95.5
'37360, 청도군,'075004, 73세,2019,434,199,235,84.7,433,198,235,84.3
'37360, 청도군,'075005, 74세,2019,416,197,219,90,416,197,219,90
'37360, 청도군,'080,75~79세,2019,3096,1240,1856,66.8,3093,1237,1856,66.6
'37360, 청도군,'080001, 75세,2019,553,230,323,71.2,553,230,323,71.2
'37360, 청도군,'080002, 76세,2019,665,280,385,72.7,664,279,385,72.5
'37360, 청도군,'080003, 77세,2019,712,282,430,65.6,712,282,430,65.6
'37360, 청도군,'080004, 78세,2019,600,243,357,68.1,598,241,357,67.5
'37360, 청도군,'080005, 79세,2019,566,205,361,56.8,566,205,361,56.8
'37360, 청도군,'085,80~84세,2019,2559,849,1710,49.6,2556,848,1708,49.6
'37360, 청도군,'085001, 80세,2019,550,204,346,59,549,204,345,59.1
'37360, 청도군,'085002, 81세,2019,577,196,381,51.4,577,196,381,51.4
'37360, 청도군,'085003, 82세,2019,535,186,349,53.3,533,185,348,53.2
'37360, 청도군,'085004, 83세,2019,486,145,341,42.5,486,145,341,42.5
'37360, 청도군,'085005, 84세,2019,411,118,293,40.3,411,118,293,40.3
'37360, 청도군,'086,85세이상,2019,1825,481,1344,35.8,1825,481,1344,35.8
'37360, 청도군,'090,85~89세,2019,1335,370,965,38.3,1335,370,965,38.3
'37360, 청도군,'090001, 85세,2019,352,116,236,49.2,352,116,236,49.2
'37360, 청도군,'090002, 86세,2019,348,107,241,44.4,348,107,241,44.4
'37360, 청도군,'090003, 87세,2019,272,58,214,27.1,272,58,214,27.1
'37360, 청도군,'090004, 88세,2019,197,47,150,31.3,197,47,150,31.3
'37360, 청도군,'090005, 89세,2019,166,42,124,33.9,166,42,124,33.9
'37360, 청도군,'095,90~94세,2019,404,93,311,29.9,404,93,311,29.9
'37360, 청도군,'095001, 90세,2019,126,29,97,29.9,126,29,97,29.9
'37360, 청도군,'095002, 91세,2019,98,23,75,30.7,98,23,75,30.7
'37360, 청도군,'095003, 92세,2019,82,20,62,32.3,82,20,62,32.3
'37360, 청도군,'095004, 93세,2019,56,13,43,30.2,56,13,43,30.2
'37360, 청도군,'095005, 94세,2019,42,8,34,23.5,42,8,34,23.5
'37360, 청도군,'100,95~99세,2019,80,18,62,29,80,18,62,29
'37360, 청도군,'100001, 95세,2019,30,10,20,50,30,10,20,50
'37360, 청도군,'100002, 96세,2019,26,X,22,18.2,26,X,22,18.2
'37360, 청도군,'100003, 97세,2019,13,X,11,18.2,13,X,11,18.2
'37360, 청도군,'100004, 98세,2019,6,X,5,20,6,X,5,20
'37360, 청도군,'100005, 99세,2019,5,X,X,25,5,X,X,25
'37360, 청도군,'101,100세이상,2019,6,X,6,0,6,X,6,0
'37360, 청도군,'102,15세미만,2019,2507,1278,1229,104,2503,1277,1226,104.2
'37360, 청도군,'103,15~64세,2019,23820,12502,11318,110.5,22288,11796,10492,112.4
'37360, 청도군,'104,65세이상,2019,14727,6111,8616,70.9,14700,6096,8604,70.9
'37360, 청도군,'126,평균연령,2019,54.5,52,56.8,,55.3,52.7,57.7,
'37360, 청도군,'127,중위연령,2019,58.8,56.5,60.6,,59.5,57.3,61.5,
'37370, 고령군,'000,합계,2019,32191,16961,15230,111.4,29754,15038,14716,102.2
'37370, 고령군,'005,0~4세,2019,744,374,370,101.1,733,367,366,100.3
'37370, 고령군,'005001, 0세,2019,124,70,54,129.6,120,67,53,126.4
'37370, 고령군,'005002, 1세,2019,133,64,69,92.8,131,64,67,95.5
'37370, 고령군,'005003, 2세,2019,147,66,81,81.5,146,66,80,82.5
'37370, 고령군,'005004, 3세,2019,169,86,83,103.6,166,83,83,100
'37370, 고령군,'005005, 4세,2019,171,88,83,106,170,87,83,104.8
'37370, 고령군,'010,5~9세,2019,870,446,424,105.2,865,443,422,105
'37370, 고령군,'010001, 5세,2019,182,98,84,116.7,181,97,84,115.5
'37370, 고령군,'010002, 6세,2019,170,81,89,91,168,79,89,88.8
'37370, 고령군,'010003, 7세,2019,171,89,82,108.5,171,89,82,108.5
'37370, 고령군,'010004, 8세,2019,157,74,83,89.2,155,74,81,91.4
'37370, 고령군,'010005, 9세,2019,190,104,86,120.9,190,104,86,120.9
'37370, 고령군,'015,10~14세,2019,962,514,448,114.7,953,512,441,116.1
'37370, 고령군,'015001, 10세,2019,181,90,91,98.9,179,90,89,101.1
'37370, 고령군,'015002, 11세,2019,198,107,91,117.6,196,106,90,117.8
'37370, 고령군,'015003, 12세,2019,207,114,93,122.6,206,113,93,121.5
'37370, 고령군,'015004, 13세,2019,188,93,95,97.9,186,93,93,100
'37370, 고령군,'015005, 14세,2019,188,110,78,141,186,110,76,144.7
'37370, 고령군,'020,15~19세,2019,1016,556,460,120.9,988,540,448,120.5
'37370, 고령군,'020001, 15세,2019,182,104,78,133.3,182,104,78,133.3
'37370, 고령군,'020002, 16세,2019,196,105,91,115.4,195,104,91,114.3
'37370, 고령군,'020003, 17세,2019,193,96,97,99,193,96,97,99
'37370, 고령군,'020004, 18세,2019,238,125,113,110.6,232,120,112,107.1
'37370, 고령군,'020005, 19세,2019,207,126,81,155.6,186,116,70,165.7
'37370, 고령군,'025,20~24세,2019,1439,928,511,181.6,1155,689,466,147.9
'37370, 고령군,'025001, 20세,2019,267,180,87,206.9,233,152,81,187.7
'37370, 고령군,'025002, 21세,2019,281,190,91,208.8,238,158,80,197.5
'37370, 고령군,'025003, 22세,2019,284,161,123,130.9,230,114,116,98.3
'37370, 고령군,'025004, 23세,2019,299,188,111,169.4,225,126,99,127.3
'37370, 고령군,'025005, 24세,2019,308,209,99,211.1,229,139,90,154.4
'37370, 고령군,'030,25~29세,2019,1622,1054,568,185.6,1116,630,486,129.6
'37370, 고령군,'030001, 25세,2019,293,197,96,205.2,206,126,80,157.5
'37370, 고령군,'030002, 26세,2019,366,240,126,190.5,263,150,113,132.7
'37370, 고령군,'030003, 27세,2019,332,220,112,196.4,232,130,102,127.5
'37370, 고령군,'030004, 28세,2019,323,210,113,185.8,218,120,98,122.4
'37370, 고령군,'030005, 29세,2019,308,187,121,154.5,197,104,93,111.8
'37370, 고령군,'035,30~34세,2019,1578,1039,539,192.8,1026,575,451,127.5
'37370, 고령군,'035001, 30세,2019,338,230,108,213,210,120,90,133.3
'37370, 고령군,'035002, 31세,2019,318,217,101,214.9,198,116,82,141.5
'37370, 고령군,'035003, 32세,2019,310,197,113,174.3,191,102,89,114.6
'37370, 고령군,'035004, 33세,2019,304,193,111,173.9,221,119,102,116.7
'37370, 고령군,'035005, 34세,2019,308,202,106,190.6,206,118,88,134.1
'37370, 고령군,'040,35~39세,2019,1768,1077,691,155.9,1356,738,618,119.4
'37370, 고령군,'040001, 35세,2019,301,194,107,181.3,204,115,89,129.2
'37370, 고령군,'040002, 36세,2019,343,217,126,172.2,249,142,107,132.7
'37370, 고령군,'040003, 37세,2019,391,224,167,134.1,293,143,150,95.3
'37370, 고령군,'040004, 38세,2019,389,237,152,155.9,324,179,145,123.4
'37370, 고령군,'040005, 39세,2019,344,205,139,147.5,286,159,127,125.2
'37370, 고령군,'045,40~44세,2019,1771,1008,763,132.1,1533,822,711,115.6
'37370, 고령군,'045001, 40세,2019,351,195,156,125,289,147,142,103.5
'37370, 고령군,'045002, 41세,2019,347,204,143,142.7,294,162,132,122.7
'37370, 고령군,'045003, 42세,2019,333,193,140,137.9,291,158,133,118.8
'37370, 고령군,'045004, 43세,2019,355,211,144,146.5,306,171,135,126.7
'37370, 고령군,'045005, 44세,2019,385,205,180,113.9,353,184,169,108.9
'37370, 고령군,'050,45~49세,2019,2390,1370,1020,134.3,2243,1270,973,130.5
'37370, 고령군,'050001, 45세,2019,441,241,200,120.5,410,221,189,116.9
'37370, 고령군,'050002, 46세,2019,461,262,199,131.7,435,241,194,124.2
'37370, 고령군,'050003, 47세,2019,458,262,196,133.7,432,245,187,131
'37370, 고령군,'050004, 48세,2019,551,320,231,138.5,520,301,219,137.4
'37370, 고령군,'050005, 49세,2019,479,285,194,146.9,446,262,184,142.4
'37370, 고령군,'055,50~54세,2019,2604,1435,1169,122.8,2497,1369,1128,121.4
'37370, 고령군,'055001, 50세,2019,513,293,220,133.2,488,276,212,130.2
'37370, 고령군,'055002, 51세,2019,512,278,234,118.8,484,261,223,117
'37370, 고령군,'055003, 52세,2019,494,265,229,115.7,478,255,223,114.3
'37370, 고령군,'055004, 53세,2019,535,304,231,131.6,512,292,220,132.7
'37370, 고령군,'055005, 54세,2019,550,295,255,115.7,535,285,250,114
'37370, 고령군,'060,55~59세,2019,3214,1693,1521,111.3,3142,1652,1490,110.9
'37370, 고령군,'060001, 55세,2019,569,306,263,116.3,549,292,257,113.6
'37370, 고령군,'060002, 56세,2019,569,303,266,113.9,551,291,260,111.9
'37370, 고령군,'060003, 57세,2019,667,357,310,115.2,653,351,302,116.2
'37370, 고령군,'060004, 58세,2019,691,379,312,121.5,685,376,309,121.7
'37370, 고령군,'060005, 59세,2019,718,348,370,94.1,704,342,362,94.5
'37370, 고령군,'065,60~64세,2019,3003,1587,1416,112.1,2975,1571,1404,111.9
'37370, 고령군,'065001, 60세,2019,686,364,322,113,678,359,319,112.5
'37370, 고령군,'065002, 61세,2019,549,298,251,118.7,546,296,250,118.4
'37370, 고령군,'065003, 62세,2019,612,342,270,126.7,606,339,267,127
'37370, 고령군,'065004, 63세,2019,575,285,290,98.3,570,283,287,98.6
'37370, 고령군,'065005, 64세,2019,581,298,283,105.3,575,294,281,104.6
'37370, 고령군,'070,65~69세,2019,2566,1281,1285,99.7,2544,1271,1273,99.8
'37370, 고령군,'070001, 65세,2019,547,285,262,108.8,543,282,261,108
'37370, 고령군,'070002, 66세,2019,493,256,237,108,491,256,235,108.9
'37370, 고령군,'070003, 67세,2019,579,289,290,99.7,571,286,285,100.4
'37370, 고령군,'070004, 68세,2019,478,222,256,86.7,473,219,254,86.2
'37370, 고령군,'070005, 69세,2019,469,229,240,95.4,466,228,238,95.8
'37370, 고령군,'075,70~74세,2019,1977,940,1037,90.6,1968,933,1035,90.1
'37370, 고령군,'075001, 70세,2019,483,242,241,100.4,482,242,240,100.8
'37370, 고령군,'075002, 71세,2019,431,209,222,94.1,428,206,222,92.8
'37370, 고령군,'075003, 72세,2019,451,215,236,91.1,448,213,235,90.6
'37370, 고령군,'075004, 73세,2019,313,140,173,80.9,312,139,173,80.3
'37370, 고령군,'075005, 74세,2019,299,134,165,81.2,298,133,165,80.6
'37370, 고령군,'080,75~79세,2019,1991,786,1205,65.2,1986,784,1202,65.2
'37370, 고령군,'080001, 75세,2019,377,174,203,85.7,375,174,201,86.6
'37370, 고령군,'080002, 76세,2019,382,151,231,65.4,381,151,230,65.7
'37370, 고령군,'080003, 77세,2019,464,178,286,62.2,464,178,286,62.2
'37370, 고령군,'080004, 78세,2019,387,141,246,57.3,387,141,246,57.3
'37370, 고령군,'080005, 79세,2019,381,142,239,59.4,379,140,239,58.6
'37370, 고령군,'085,80~84세,2019,1632,594,1038,57.2,1631,593,1038,57.1
'37370, 고령군,'085001, 80세,2019,409,148,261,56.7,409,148,261,56.7
'37370, 고령군,'085002, 81세,2019,336,111,225,49.3,336,111,225,49.3
'37370, 고령군,'085003, 82세,2019,316,125,191,65.4,315,124,191,64.9
'37370, 고령군,'085004, 83세,2019,298,114,184,62,298,114,184,62
'37370, 고령군,'085005, 84세,2019,273,96,177,54.2,273,96,177,54.2
'37370, 고령군,'086,85세이상,2019,1044,279,765,36.5,1043,279,764,36.5
'37370, 고령군,'090,85~89세,2019,790,217,573,37.9,789,217,572,37.9
'37370, 고령군,'090001, 85세,2019,241,67,174,38.5,241,67,174,38.5
'37370, 고령군,'090002, 86세,2019,183,51,132,38.6,182,51,131,38.9
'37370, 고령군,'090003, 87세,2019,154,47,107,43.9,154,47,107,43.9
'37370, 고령군,'090004, 88세,2019,130,37,93,39.8,130,37,93,39.8
'37370, 고령군,'090005, 89세,2019,82,15,67,22.4,82,15,67,22.4
'37370, 고령군,'095,90~94세,2019,216,54,162,33.3,216,54,162,33.3
'37370, 고령군,'095001, 90세,2019,64,18,46,39.1,64,18,46,39.1
'37370, 고령군,'095002, 91세,2019,61,17,44,38.6,61,17,44,38.6
'37370, 고령군,'095003, 92세,2019,43,9,34,26.5,43,9,34,26.5
'37370, 고령군,'095004, 93세,2019,19,X,15,26.7,19,X,15,26.7
'37370, 고령군,'095005, 94세,2019,29,6,23,26.1,29,6,23,26.1
'37370, 고령군,'100,95~99세,2019,38,8,30,26.7,38,8,30,26.7
'37370, 고령군,'100001, 95세,2019,16,5,11,45.5,16,5,11,45.5
'37370, 고령군,'100002, 96세,2019,6,X,5,20,6,X,5,20
'37370, 고령군,'100003, 97세,2019,6,X,6,0,6,X,6,0
'37370, 고령군,'100004, 98세,2019,X,X,X,33.3,X,X,X,33.3
'37370, 고령군,'100005, 99세,2019,6,X,5,20,6,X,5,20
'37370, 고령군,'101,100세이상,2019,X,X,X,,X,X,X,
'37370, 고령군,'102,15세미만,2019,2576,1334,1242,107.4,2551,1322,1229,107.6
'37370, 고령군,'103,15~64세,2019,20405,11747,8658,135.7,18031,9856,8175,120.6
'37370, 고령군,'104,65세이상,2019,9210,3880,5330,72.8,9172,3860,5312,72.7
'37370, 고령군,'126,평균연령,2019,50.6,47.9,53.5,,51.9,49.7,54.1,
'37370, 고령군,'127,중위연령,2019,53.8,50.4,57.4,,55.7,53.5,58.1,
'37380, 성주군,'000,합계,2019,41314,21570,19744,109.2,39005,19857,19148,103.7
'37380, 성주군,'005,0~4세,2019,995,509,486,104.7,990,506,484,104.5
'37380, 성주군,'005001, 0세,2019,191,105,86,122.1,191,105,86,122.1
'37380, 성주군,'005002, 1세,2019,211,100,111,90.1,208,98,110,89.1
'37380, 성주군,'005003, 2세,2019,202,99,103,96.1,202,99,103,96.1
'37380, 성주군,'005004, 3세,2019,196,106,90,117.8,195,106,89,119.1
'37380, 성주군,'005005, 4세,2019,195,99,96,103.1,194,98,96,102.1
'37380, 성주군,'010,5~9세,2019,936,455,481,94.6,932,452,480,94.2
'37380, 성주군,'010001, 5세,2019,177,91,86,105.8,174,89,85,104.7
'37380, 성주군,'010002, 6세,2019,185,86,99,86.9,185,86,99,86.9
'37380, 성주군,'010003, 7세,2019,183,83,100,83,182,82,100,82
'37380, 성주군,'010004, 8세,2019,220,113,107,105.6,220,113,107,105.6
'37380, 성주군,'010005, 9세,2019,171,82,89,92.1,171,82,89,92.1
'37380, 성주군,'015,10~14세,2019,958,546,412,132.5,957,546,411,132.8
'37380, 성주군,'015001, 10세,2019,189,98,91,107.7,188,98,90,108.9
'37380, 성주군,'015002, 11세,2019,213,129,84,153.6,213,129,84,153.6
'37380, 성주군,'015003, 12세,2019,178,100,78,128.2,178,100,78,128.2
'37380, 성주군,'015004, 13세,2019,198,121,77,157.1,198,121,77,157.1
'37380, 성주군,'015005, 14세,2019,180,98,82,119.5,180,98,82,119.5
'37380, 성주군,'020,15~19세,2019,1022,570,452,126.1,1013,566,447,126.6
'37380, 성주군,'020001, 15세,2019,189,117,72,162.5,187,116,71,163.4
'37380, 성주군,'020002, 16세,2019,211,113,98,115.3,210,113,97,116.5
'37380, 성주군,'020003, 17세,2019,202,103,99,104,202,103,99,104
'37380, 성주군,'020004, 18세,2019,243,127,116,109.5,242,127,115,110.4
'37380, 성주군,'020005, 19세,2019,177,110,67,164.2,172,107,65,164.6
'37380, 성주군,'025,20~24세,2019,1625,1076,549,196,1366,881,485,181.6
'37380, 성주군,'025001, 20세,2019,258,186,72,258.3,237,169,68,248.5
'37380, 성주군,'025002, 21세,2019,308,211,97,217.5,265,181,84,215.5
'37380, 성주군,'025003, 22세,2019,349,215,134,160.4,299,182,117,155.6
'37380, 성주군,'025004, 23세,2019,340,221,119,185.7,278,173,105,164.8
'37380, 성주군,'025005, 24세,2019,370,243,127,191.3,287,176,111,158.6
'37380, 성주군,'030,25~29세,2019,2305,1457,848,171.8,1699,971,728,133.4
'37380, 성주군,'030001, 25세,2019,459,305,154,198.1,368,227,141,161
'37380, 성주군,'030002, 26세,2019,459,283,176,160.8,328,177,151,117.2
'37380, 성주군,'030003, 27세,2019,479,312,167,186.8,354,206,148,139.2
'37380, 성주군,'030004, 28세,2019,445,264,181,145.9,314,163,151,107.9
'37380, 성주군,'030005, 29세,2019,463,293,170,172.4,335,198,137,144.5
'37380, 성주군,'035,30~34세,2019,1955,1176,779,151,1451,802,649,123.6
'37380, 성주군,'035001, 30세,2019,376,240,136,176.5,261,156,105,148.6
'37380, 성주군,'035002, 31세,2019,443,271,172,157.6,330,188,142,132.4
'37380, 성주군,'035003, 32세,2019,365,220,145,151.7,283,154,129,119.4
'37380, 성주군,'035004, 33세,2019,389,233,156,149.4,283,154,129,119.4
'37380, 성주군,'035005, 34세,2019,382,212,170,124.7,294,150,144,104.2
'37380, 성주군,'040,35~39세,2019,2001,1202,799,150.4,1650,920,730,126
'37380, 성주군,'040001, 35세,2019,383,242,141,171.6,309,179,130,137.7
'37380, 성주군,'040002, 36세,2019,401,234,167,140.1,313,165,148,111.5
'37380, 성주군,'040003, 37세,2019,420,239,181,132,355,185,170,108.8
'37380, 성주군,'040004, 38세,2019,354,211,143,147.6,296,163,133,122.6
'37380, 성주군,'040005, 39세,2019,443,276,167,165.3,377,228,149,153
'37380, 성주군,'045,40~44세,2019,2055,1262,793,159.1,1837,1102,735,149.9
'37380, 성주군,'045001, 40세,2019,423,258,165,156.4,369,217,152,142.8
'37380, 성주군,'045002, 41세,2019,381,227,154,147.4,338,195,143,136.4
'37380, 성주군,'045003, 42세,2019,420,275,145,189.7,366,237,129,183.7
'37380, 성주군,'045004, 43세,2019,397,258,139,185.6,361,231,130,177.7
'37380, 성주군,'045005, 44세,2019,434,244,190,128.4,403,222,181,122.7
'37380, 성주군,'050,45~49세,2019,2629,1507,1122,134.3,2486,1411,1075,131.3
'37380, 성주군,'050001, 45세,2019,499,287,212,135.4,466,264,202,130.7
'37380, 성주군,'050002, 46세,2019,493,299,194,154.1,459,273,186,146.8
'37380, 성주군,'050003, 47세,2019,518,295,223,132.3,498,280,218,128.4
'37380, 성주군,'050004, 48세,2019,537,307,230,133.5,512,292,220,132.7
'37380, 성주군,'050005, 49세,2019,582,319,263,121.3,551,302,249,121.3
'37380, 성주군,'055,50~54세,2019,3495,1897,1598,118.7,3412,1851,1561,118.6
'37380, 성주군,'055001, 50세,2019,626,365,261,139.8,605,351,254,138.2
'37380, 성주군,'055002, 51세,2019,700,378,322,117.4,692,375,317,118.3
'37380, 성주군,'055003, 52세,2019,678,344,334,103,661,334,327,102.1
'37380, 성주군,'055004, 53세,2019,687,368,319,115.4,673,360,313,115
'37380, 성주군,'055005, 54세,2019,804,442,362,122.1,781,431,350,123.1
'37380, 성주군,'060,55~59세,2019,4534,2325,2209,105.3,4463,2287,2176,105.1
'37380, 성주군,'060001, 55세,2019,757,383,374,102.4,743,376,367,102.5
'37380, 성주군,'060002, 56세,2019,778,419,359,116.7,760,405,355,114.1
'37380, 성주군,'060003, 57세,2019,919,483,436,110.8,906,476,430,110.7
'37380, 성주군,'060004, 58세,2019,1042,534,508,105.1,1031,530,501,105.8
'37380, 성주군,'060005, 59세,2019,1038,506,532,95.1,1023,500,523,95.6
'37380, 성주군,'065,60~64세,2019,4291,2260,2031,111.3,4263,2244,2019,111.1
'37380, 성주군,'065001, 60세,2019,1001,504,497,101.4,994,500,494,101.2
'37380, 성주군,'065002, 61세,2019,804,446,358,124.6,797,443,354,125.1
'37380, 성주군,'065003, 62세,2019,815,445,370,120.3,811,442,369,119.8
'37380, 성주군,'065004, 63세,2019,805,451,354,127.4,800,448,352,127.3
'37380, 성주군,'065005, 64세,2019,866,414,452,91.6,861,411,450,91.3
'37380, 성주군,'070,65~69세,2019,3616,1777,1839,96.6,3600,1773,1827,97
'37380, 성주군,'070001, 65세,2019,710,360,350,102.9,707,360,347,103.7
'37380, 성주군,'070002, 66세,2019,710,373,337,110.7,707,372,335,111
'37380, 성주군,'070003, 67세,2019,844,383,461,83.1,839,383,456,84
'37380, 성주군,'070004, 68세,2019,645,324,321,100.9,642,323,319,101.3
'37380, 성주군,'070005, 69세,2019,707,337,370,91.1,705,335,370,90.5
'37380, 성주군,'075,70~74세,2019,2746,1334,1412,94.5,2738,1329,1409,94.3
'37380, 성주군,'075001, 70세,2019,700,349,351,99.4,696,347,349,99.4
'37380, 성주군,'075002, 71세,2019,645,313,332,94.3,645,313,332,94.3
'37380, 성주군,'075003, 72세,2019,617,297,320,92.8,616,296,320,92.5
'37380, 성주군,'075004, 73세,2019,397,189,208,90.9,394,187,207,90.3
'37380, 성주군,'075005, 74세,2019,387,186,201,92.5,387,186,201,92.5
'37380, 성주군,'080,75~79세,2019,2558,1091,1467,74.4,2555,1090,1465,74.4
'37380, 성주군,'080001, 75세,2019,466,205,261,78.5,466,205,261,78.5
'37380, 성주군,'080002, 76세,2019,547,235,312,75.3,546,234,312,75
'37380, 성주군,'080003, 77세,2019,589,251,338,74.3,588,251,337,74.5
'37380, 성주군,'080004, 78세,2019,489,215,274,78.5,489,215,274,78.5
'37380, 성주군,'080005, 79세,2019,467,185,282,65.6,466,185,281,65.8
'37380, 성주군,'085,80~84세,2019,2050,723,1327,54.5,2050,723,1327,54.5
'37380, 성주군,'085001, 80세,2019,508,212,296,71.6,508,212,296,71.6
'37380, 성주군,'085002, 81세,2019,422,162,260,62.3,422,162,260,62.3
'37380, 성주군,'085003, 82세,2019,345,132,213,62,345,132,213,62
'37380, 성주군,'085004, 83세,2019,407,114,293,38.9,407,114,293,38.9
'37380, 성주군,'085005, 84세,2019,368,103,265,38.9,368,103,265,38.9
'37380, 성주군,'086,85세이상,2019,1543,403,1140,35.4,1543,403,1140,35.4
'37380, 성주군,'090,85~89세,2019,1111,307,804,38.2,1111,307,804,38.2
'37380, 성주군,'090001, 85세,2019,307,91,216,42.1,307,91,216,42.1
'37380, 성주군,'090002, 86세,2019,258,71,187,38,258,71,187,38
'37380, 성주군,'090003, 87세,2019,232,67,165,40.6,232,67,165,40.6
'37380, 성주군,'090004, 88세,2019,158,43,115,37.4,158,43,115,37.4
'37380, 성주군,'090005, 89세,2019,156,35,121,28.9,156,35,121,28.9
'37380, 성주군,'095,90~94세,2019,351,83,268,31,351,83,268,31
'37380, 성주군,'095001, 90세,2019,102,29,73,39.7,102,29,73,39.7
'37380, 성주군,'095002, 91세,2019,99,21,78,26.9,99,21,78,26.9
'37380, 성주군,'095003, 92세,2019,65,17,48,35.4,65,17,48,35.4
'37380, 성주군,'095004, 93세,2019,42,7,35,20,42,7,35,20
'37380, 성주군,'095005, 94세,2019,43,9,34,26.5,43,9,34,26.5
'37380, 성주군,'100,95~99세,2019,74,12,62,19.4,74,12,62,19.4
'37380, 성주군,'100001, 95세,2019,23,X,20,15,23,X,20,15
'37380, 성주군,'100002, 96세,2019,22,X,19,15.8,22,X,19,15.8
'37380, 성주군,'100003, 97세,2019,14,X,10,40,14,X,10,40
'37380, 성주군,'100004, 98세,2019,9,X,7,28.6,9,X,7,28.6
'37380, 성주군,'100005, 99세,2019,6,X,6,0,6,X,6,0
'37380, 성주군,'101,100세이상,2019,7,X,6,16.7,7,X,6,16.7
'37380, 성주군,'102,15세미만,2019,2889,1510,1379,109.5,2879,1504,1375,109.4
'37380, 성주군,'103,15~64세,2019,25912,14732,11180,131.8,23640,13035,10605,122.9
'37380, 성주군,'104,65세이상,2019,12513,5328,7185,74.2,12486,5318,7168,74.2
'37380, 성주군,'126,평균연령,2019,52,49.4,55,,53.1,50.7,55.5,
'37380, 성주군,'127,중위연령,2019,55.9,52.8,58.8,,57.2,54.8,59.3,
'37390, 칠곡군,'000,합계,2019,118517,62074,56443,110,113115,58378,54737,106.7
'37390, 칠곡군,'005,0~4세,2019,4760,2462,2298,107.1,4678,2425,2253,107.6
'37390, 칠곡군,'005001, 0세,2019,691,335,356,94.1,678,328,350,93.7
'37390, 칠곡군,'005002, 1세,2019,839,445,394,112.9,825,439,386,113.7
'37390, 칠곡군,'005003, 2세,2019,919,487,432,112.7,901,478,423,113
'37390, 칠곡군,'005004, 3세,2019,1123,561,562,99.8,1102,554,548,101.1
'37390, 칠곡군,'005005, 4세,2019,1188,634,554,114.4,1172,626,546,114.7
'37390, 칠곡군,'010,5~9세,2019,5891,3058,2833,107.9,5848,3036,2812,108
'37390, 칠곡군,'010001, 5세,2019,1068,576,492,117.1,1056,566,490,115.5
'37390, 칠곡군,'010002, 6세,2019,1189,621,568,109.3,1178,616,562,109.6
'37390, 칠곡군,'010003, 7세,2019,1243,654,589,111,1235,652,583,111.8
'37390, 칠곡군,'010004, 8세,2019,1214,602,612,98.4,1209,601,608,98.8
'37390, 칠곡군,'010005, 9세,2019,1177,605,572,105.8,1170,601,569,105.6
'37390, 칠곡군,'015,10~14세,2019,5630,2972,2658,111.8,5589,2949,2640,111.7
'37390, 칠곡군,'015001, 10세,2019,1090,577,513,112.5,1080,570,510,111.8
'37390, 칠곡군,'015002, 11세,2019,1166,609,557,109.3,1159,607,552,110
'37390, 칠곡군,'015003, 12세,2019,1219,617,602,102.5,1209,613,596,102.9
'37390, 칠곡군,'015004, 13세,2019,1065,575,490,117.3,1058,570,488,116.8
'37390, 칠곡군,'015005, 14세,2019,1090,594,496,119.8,1083,589,494,119.2
'37390, 칠곡군,'020,15~19세,2019,5806,3092,2714,113.9,5767,3072,2695,114
'37390, 칠곡군,'020001, 15세,2019,1099,571,528,108.1,1097,570,527,108.2
'37390, 칠곡군,'020002, 16세,2019,1057,536,521,102.9,1053,536,517,103.7
'37390, 칠곡군,'020003, 17세,2019,1221,657,564,116.5,1218,655,563,116.3
'37390, 칠곡군,'020004, 18세,2019,1219,651,568,114.6,1212,646,566,114.1
'37390, 칠곡군,'020005, 19세,2019,1210,677,533,127,1187,665,522,127.4
'37390, 칠곡군,'025,20~24세,2019,6539,3848,2691,143,5964,3419,2545,134.3
'37390, 칠곡군,'025001, 20세,2019,1302,801,501,159.9,1256,772,484,159.5
'37390, 칠곡군,'025002, 21세,2019,1310,754,556,135.6,1237,703,534,131.6
'37390, 칠곡군,'025003, 22세,2019,1312,777,535,145.2,1189,683,506,135
'37390, 칠곡군,'025004, 23세,2019,1295,765,530,144.3,1152,655,497,131.8
'37390, 칠곡군,'025005, 24세,2019,1320,751,569,132,1130,606,524,115.6
'37390, 칠곡군,'030,25~29세,2019,7447,4078,3369,121,6315,3255,3060,106.4
'37390, 칠곡군,'030001, 25세,2019,1421,772,649,119,1219,621,598,103.8
'37390, 칠곡군,'030002, 26세,2019,1518,828,690,120,1286,670,616,108.8
'37390, 칠곡군,'030003, 27세,2019,1579,844,735,114.8,1352,673,679,99.1
'37390, 칠곡군,'030004, 28세,2019,1444,811,633,128.1,1211,639,572,111.7
'37390, 칠곡군,'030005, 29세,2019,1485,823,662,124.3,1247,652,595,109.6
'37390, 칠곡군,'035,30~34세,2019,8378,4974,3404,146.1,7243,4181,3062,136.5
'37390, 칠곡군,'035001, 30세,2019,1518,952,566,168.2,1290,789,501,157.5
'37390, 칠곡군,'035002, 31세,2019,1655,978,677,144.5,1416,817,599,136.4
'37390, 칠곡군,'035003, 32세,2019,1764,1043,721,144.7,1527,854,673,126.9
'37390, 칠곡군,'035004, 33세,2019,1737,1014,723,140.2,1537,880,657,133.9
'37390, 칠곡군,'035005, 34세,2019,1704,987,717,137.7,1473,841,632,133.1
'37390, 칠곡군,'040,35~39세,2019,10282,5695,4587,124.2,9379,5059,4320,117.1
'37390, 칠곡군,'040001, 35세,2019,1735,947,788,120.2,1541,820,721,113.7
'37390, 칠곡군,'040002, 36세,2019,1904,1059,845,125.3,1717,923,794,116.2
'37390, 칠곡군,'040003, 37세,2019,2258,1237,1021,121.2,2039,1084,955,113.5
'37390, 칠곡군,'040004, 38세,2019,2130,1176,954,123.3,1981,1068,913,117
'37390, 칠곡군,'040005, 39세,2019,2255,1276,979,130.3,2101,1164,937,124.2
'37390, 칠곡군,'045,40~44세,2019,9962,5335,4627,115.3,9438,4974,4464,111.4
'37390, 칠곡군,'045001, 40세,2019,2038,1107,931,118.9,1914,1009,905,111.5
'37390, 칠곡군,'045002, 41세,2019,1940,1041,899,115.8,1814,949,865,109.7
'37390, 칠곡군,'045003, 42세,2019,2017,1070,947,113,1909,1003,906,110.7
'37390, 칠곡군,'045004, 43세,2019,1848,1002,846,118.4,1769,945,824,114.7
'37390, 칠곡군,'045005, 44세,2019,2119,1115,1004,111.1,2032,1068,964,110.8
'37390, 칠곡군,'050,45~49세,2019,10886,5911,4975,118.8,10531,5689,4842,117.5
'37390, 칠곡군,'050001, 45세,2019,2269,1231,1038,118.6,2178,1174,1004,116.9
'37390, 칠곡군,'050002, 46세,2019,2116,1142,974,117.2,2058,1103,955,115.5
'37390, 칠곡군,'050003, 47세,2019,2164,1180,984,119.9,2097,1133,964,117.5
'37390, 칠곡군,'050004, 48세,2019,2178,1197,981,122,2098,1154,944,122.2
'37390, 칠곡군,'050005, 49세,2019,2159,1161,998,116.3,2100,1125,975,115.4
'37390, 칠곡군,'055,50~54세,2019,9862,5210,4652,112,9640,5077,4563,111.3
'37390, 칠곡군,'055001, 50세,2019,2101,1107,994,111.4,2052,1078,974,110.7
'37390, 칠곡군,'055002, 51세,2019,2092,1093,999,109.4,2048,1068,980,109
'37390, 칠곡군,'055003, 52세,2019,1888,966,922,104.8,1839,937,902,103.9
'37390, 칠곡군,'055004, 53세,2019,1913,1040,873,119.1,1870,1017,853,119.2
'37390, 칠곡군,'055005, 54세,2019,1868,1004,864,116.2,1831,977,854,114.4
'37390, 칠곡군,'060,55~59세,2019,8996,4868,4128,117.9,8838,4778,4060,117.7
'37390, 칠곡군,'060001, 55세,2019,1697,946,751,126,1652,923,729,126.6
'37390, 칠곡군,'060002, 56세,2019,1726,933,793,117.7,1694,913,781,116.9
'37390, 칠곡군,'060003, 57세,2019,1823,979,844,116,1791,961,830,115.8
'37390, 칠곡군,'060004, 58세,2019,1896,1021,875,116.7,1873,1004,869,115.5
'37390, 칠곡군,'060005, 59세,2019,1854,989,865,114.3,1828,977,851,114.8
'37390, 칠곡군,'065,60~64세,2019,7126,3644,3482,104.7,7025,3587,3438,104.3
'37390, 칠곡군,'065001, 60세,2019,1574,798,776,102.8,1546,781,765,102.1
'37390, 칠곡군,'065002, 61세,2019,1438,791,647,122.3,1412,778,634,122.7
'37390, 칠곡군,'065003, 62세,2019,1493,774,719,107.6,1481,768,713,107.7
'37390, 칠곡군,'065004, 63세,2019,1353,680,673,101,1329,664,665,99.8
'37390, 칠곡군,'065005, 64세,2019,1268,601,667,90.1,1257,596,661,90.2
'37390, 칠곡군,'070,65~69세,2019,4910,2432,2478,98.1,4858,2400,2458,97.6
'37390, 칠곡군,'070001, 65세,2019,1155,555,600,92.5,1138,545,593,91.9
'37390, 칠곡군,'070002, 66세,2019,970,472,498,94.8,965,469,496,94.6
'37390, 칠곡군,'070003, 67세,2019,1146,577,569,101.4,1136,572,564,101.4
'37390, 칠곡군,'070004, 68세,2019,801,395,406,97.3,790,385,405,95.1
'37390, 칠곡군,'070005, 69세,2019,838,433,405,106.9,829,429,400,107.3
'37390, 칠곡군,'075,70~74세,2019,3791,1721,2070,83.1,3767,1710,2057,83.1
'37390, 칠곡군,'075001, 70세,2019,936,425,511,83.2,929,424,505,84
'37390, 칠곡군,'075002, 71세,2019,888,442,446,99.1,880,436,444,98.2
'37390, 칠곡군,'075003, 72세,2019,803,371,432,85.9,799,369,430,85.8
'37390, 칠곡군,'075004, 73세,2019,558,238,320,74.4,555,237,318,74.5
'37390, 칠곡군,'075005, 74세,2019,606,245,361,67.9,604,244,360,67.8
'37390, 칠곡군,'080,75~79세,2019,3575,1339,2236,59.9,3566,1336,2230,59.9
'37390, 칠곡군,'080001, 75세,2019,636,261,375,69.6,634,260,374,69.5
'37390, 칠곡군,'080002, 76세,2019,738,273,465,58.7,737,273,464,58.8
'37390, 칠곡군,'080003, 77세,2019,873,326,547,59.6,871,325,546,59.5
'37390, 칠곡군,'080004, 78세,2019,662,241,421,57.2,659,240,419,57.3
'37390, 칠곡군,'080005, 79세,2019,666,238,428,55.6,665,238,427,55.7
'37390, 칠곡군,'085,80~84세,2019,2739,909,1830,49.7,2734,907,1827,49.6
'37390, 칠곡군,'085001, 80세,2019,696,227,469,48.4,695,227,468,48.5
'37390, 칠곡군,'085002, 81세,2019,562,195,367,53.1,562,195,367,53.1
'37390, 칠곡군,'085003, 82세,2019,548,189,359,52.6,545,187,358,52.2
'37390, 칠곡군,'085004, 83세,2019,478,153,325,47.1,478,153,325,47.1
'37390, 칠곡군,'085005, 84세,2019,455,145,310,46.8,454,145,309,46.9
'37390, 칠곡군,'086,85세이상,2019,1937,526,1411,37.3,1935,524,1411,37.1
'37390, 칠곡군,'090,85~89세,2019,1366,411,955,43,1364,409,955,42.8
'37390, 칠곡군,'090001, 85세,2019,379,134,245,54.7,379,134,245,54.7
'37390, 칠곡군,'090002, 86세,2019,326,92,234,39.3,325,91,234,38.9
'37390, 칠곡군,'090003, 87세,2019,282,72,210,34.3,282,72,210,34.3
'37390, 칠곡군,'090004, 88세,2019,210,71,139,51.1,210,71,139,51.1
'37390, 칠곡군,'090005, 89세,2019,169,42,127,33.1,168,41,127,32.3
'37390, 칠곡군,'095,90~94세,2019,451,102,349,29.2,451,102,349,29.2
'37390, 칠곡군,'095001, 90세,2019,142,39,103,37.9,142,39,103,37.9
'37390, 칠곡군,'095002, 91세,2019,115,24,91,26.4,115,24,91,26.4
'37390, 칠곡군,'095003, 92세,2019,94,19,75,25.3,94,19,75,25.3
'37390, 칠곡군,'095004, 93세,2019,54,12,42,28.6,54,12,42,28.6
'37390, 칠곡군,'095005, 94세,2019,46,8,38,21.1,46,8,38,21.1
'37390, 칠곡군,'100,95~99세,2019,103,13,90,14.4,103,13,90,14.4
'37390, 칠곡군,'100001, 95세,2019,34,8,26,30.8,34,8,26,30.8
'37390, 칠곡군,'100002, 96세,2019,27,X,24,12.5,27,X,24,12.5
'37390, 칠곡군,'100003, 97세,2019,22,X,21,4.8,22,X,21,4.8
'37390, 칠곡군,'100004, 98세,2019,11,X,11,0,11,X,11,0
'37390, 칠곡군,'100005, 99세,2019,9,X,8,12.5,9,X,8,12.5
'37390, 칠곡군,'101,100세이상,2019,17,X,17,0,17,X,17,0
'37390, 칠곡군,'102,15세미만,2019,16281,8492,7789,109,16115,8410,7705,109.1
'37390, 칠곡군,'103,15~64세,2019,85284,46655,38629,120.8,80140,43091,37049,116.3
'37390, 칠곡군,'104,65세이상,2019,16952,6927,10025,69.1,16860,6877,9983,68.9
'37390, 칠곡군,'126,평균연령,2019,41.7,40.2,43.3,,42,40.6,43.5,
'37390, 칠곡군,'127,중위연령,2019,42.3,40.8,44,,43.1,41.8,44.5,
'37400, 예천군,'000,합계,2019,53020,25971,27049,96,52264,25659,26605,96.4
'37400, 예천군,'005,0~4세,2019,2135,1047,1088,96.2,2130,1045,1085,96.3
'37400, 예천군,'005001, 0세,2019,342,171,171,100,341,171,170,100.6
'37400, 예천군,'005002, 1세,2019,394,184,210,87.6,393,183,210,87.1
'37400, 예천군,'005003, 2세,2019,398,188,210,89.5,396,187,209,89.5
'37400, 예천군,'005004, 3세,2019,501,232,269,86.2,501,232,269,86.2
'37400, 예천군,'005005, 4세,2019,500,272,228,119.3,499,272,227,119.8
'37400, 예천군,'010,5~9세,2019,2435,1257,1178,106.7,2432,1257,1175,107
'37400, 예천군,'010001, 5세,2019,433,221,212,104.2,433,221,212,104.2
'37400, 예천군,'010002, 6세,2019,512,259,253,102.4,511,259,252,102.8
'37400, 예천군,'010003, 7세,2019,531,297,234,126.9,530,297,233,127.5
'37400, 예천군,'010004, 8세,2019,516,252,264,95.5,516,252,264,95.5
'37400, 예천군,'010005, 9세,2019,443,228,215,106,442,228,214,106.5
'37400, 예천군,'015,10~14세,2019,2177,1152,1025,112.4,2174,1150,1024,112.3
'37400, 예천군,'015001, 10세,2019,485,257,228,112.7,484,257,227,113.2
'37400, 예천군,'015002, 11세,2019,459,240,219,109.6,458,239,219,109.1
'37400, 예천군,'015003, 12세,2019,430,229,201,113.9,430,229,201,113.9
'37400, 예천군,'015004, 13세,2019,405,219,186,117.7,405,219,186,117.7
'37400, 예천군,'015005, 14세,2019,398,207,191,108.4,397,206,191,107.9
'37400, 예천군,'020,15~19세,2019,1824,969,855,113.3,1812,966,846,114.2
'37400, 예천군,'020001, 15세,2019,388,188,200,94,388,188,200,94
'37400, 예천군,'020002, 16세,2019,345,176,169,104.1,343,176,167,105.4
'37400, 예천군,'020003, 17세,2019,358,199,159,125.2,355,198,157,126.1
'37400, 예천군,'020004, 18세,2019,363,185,178,103.9,363,185,178,103.9
'37400, 예천군,'020005, 19세,2019,370,221,149,148.3,363,219,144,152.1
'37400, 예천군,'025,20~24세,2019,1735,1078,657,164.1,1670,1054,616,171.1
'37400, 예천군,'025001, 20세,2019,356,234,122,191.8,349,233,116,200.9
'37400, 예천군,'025002, 21세,2019,355,247,108,228.7,344,240,104,230.8
'37400, 예천군,'025003, 22세,2019,317,199,118,168.6,310,196,114,171.9
'37400, 예천군,'025004, 23세,2019,358,199,159,125.2,341,193,148,130.4
'37400, 예천군,'025005, 24세,2019,349,199,150,132.7,326,192,134,143.3
'37400, 예천군,'030,25~29세,2019,1981,1064,917,116,1805,981,824,119.1
'37400, 예천군,'030001, 25세,2019,407,222,185,120,377,205,172,119.2
'37400, 예천군,'030002, 26세,2019,403,209,194,107.7,367,193,174,110.9
'37400, 예천군,'030003, 27세,2019,369,197,172,114.5,338,183,155,118.1
'37400, 예천군,'030004, 28세,2019,408,215,193,111.4,366,197,169,116.6
'37400, 예천군,'030005, 29세,2019,394,221,173,127.7,357,203,154,131.8
'37400, 예천군,'035,30~34세,2019,2387,1239,1148,107.9,2257,1176,1081,108.8
'37400, 예천군,'035001, 30세,2019,467,242,225,107.6,434,225,209,107.7
'37400, 예천군,'035002, 31세,2019,438,214,224,95.5,407,202,205,98.5
'37400, 예천군,'035003, 32세,2019,496,262,234,112,471,248,223,111.2
'37400, 예천군,'035004, 33세,2019,497,264,233,113.3,474,255,219,116.4
'37400, 예천군,'035005, 34세,2019,489,257,232,110.8,471,246,225,109.3
'37400, 예천군,'040,35~39세,2019,3281,1584,1697,93.3,3182,1551,1631,95.1
'37400, 예천군,'040001, 35세,2019,564,277,287,96.5,544,271,273,99.3
'37400, 예천군,'040002, 36세,2019,593,290,303,95.7,577,285,292,97.6
'37400, 예천군,'040003, 37세,2019,713,326,387,84.2,697,319,378,84.4
'37400, 예천군,'040004, 38세,2019,670,321,349,92,650,317,333,95.2
'37400, 예천군,'040005, 39세,2019,741,370,371,99.7,714,359,355,101.1
'37400, 예천군,'045,40~44세,2019,3348,1799,1549,116.1,3290,1778,1512,117.6
'37400, 예천군,'045001, 40세,2019,713,379,334,113.5,704,376,328,114.6
'37400, 예천군,'045002, 41세,2019,659,361,298,121.1,644,355,289,122.8
'37400, 예천군,'045003, 42세,2019,658,337,321,105,647,333,314,106.1
'37400, 예천군,'045004, 43세,2019,662,361,301,119.9,649,358,291,123
'37400, 예천군,'045005, 44세,2019,656,361,295,122.4,646,356,290,122.8
'37400, 예천군,'050,45~49세,2019,3348,1904,1444,131.9,3297,1891,1406,134.5
'37400, 예천군,'050001, 45세,2019,679,369,310,119,670,366,304,120.4
'37400, 예천군,'050002, 46세,2019,663,391,272,143.8,653,390,263,148.3
'37400, 예천군,'050003, 47세,2019,639,382,257,148.6,627,380,247,153.8
'37400, 예천군,'050004, 48세,2019,686,397,289,137.4,681,394,287,137.3
'37400, 예천군,'050005, 49세,2019,681,365,316,115.5,666,361,305,118.4
'37400, 예천군,'055,50~54세,2019,3549,1874,1675,111.9,3481,1843,1638,112.5
'37400, 예천군,'055001, 50세,2019,690,374,316,118.4,678,367,311,118
'37400, 예천군,'055002, 51세,2019,705,371,334,111.1,692,365,327,111.6
'37400, 예천군,'055003, 52세,2019,687,384,303,126.7,667,374,293,127.6
'37400, 예천군,'055004, 53세,2019,715,377,338,111.5,702,373,329,113.4
'37400, 예천군,'055005, 54세,2019,752,368,384,95.8,742,364,378,96.3
'37400, 예천군,'060,55~59세,2019,4360,2214,2146,103.2,4315,2191,2124,103.2
'37400, 예천군,'060001, 55세,2019,765,403,362,111.3,752,399,353,113
'37400, 예천군,'060002, 56세,2019,766,389,377,103.2,759,384,375,102.4
'37400, 예천군,'060003, 57세,2019,822,399,423,94.3,812,395,417,94.7
'37400, 예천군,'060004, 58세,2019,980,506,474,106.8,974,501,473,105.9
'37400, 예천군,'060005, 59세,2019,1027,517,510,101.4,1018,512,506,101.2
'37400, 예천군,'065,60~64세,2019,4579,2251,2328,96.7,4556,2244,2312,97.1
'37400, 예천군,'065001, 60세,2019,835,410,425,96.5,831,408,423,96.5
'37400, 예천군,'065002, 61세,2019,936,489,447,109.4,932,489,443,110.4
'37400, 예천군,'065003, 62세,2019,966,474,492,96.3,959,471,488,96.5
'37400, 예천군,'065004, 63세,2019,922,468,454,103.1,916,466,450,103.6
'37400, 예천군,'065005, 64세,2019,920,410,510,80.4,918,410,508,80.7
'37400, 예천군,'070,65~69세,2019,3933,1879,2054,91.5,3923,1874,2049,91.5
'37400, 예천군,'070001, 65세,2019,850,416,434,95.9,847,414,433,95.6
'37400, 예천군,'070002, 66세,2019,828,410,418,98.1,826,408,418,97.6
'37400, 예천군,'070003, 67세,2019,873,433,440,98.4,870,432,438,98.6
'37400, 예천군,'070004, 68세,2019,652,299,353,84.7,651,299,352,84.9
'37400, 예천군,'070005, 69세,2019,730,321,409,78.5,729,321,408,78.7
'37400, 예천군,'075,70~74세,2019,3150,1502,1648,91.1,3145,1501,1644,91.3
'37400, 예천군,'075001, 70세,2019,766,365,401,91,765,365,400,91.3
'37400, 예천군,'075002, 71세,2019,735,364,371,98.1,732,363,369,98.4
'37400, 예천군,'075003, 72세,2019,745,359,386,93,744,359,385,93.2
'37400, 예천군,'075004, 73세,2019,407,193,214,90.2,407,193,214,90.2
'37400, 예천군,'075005, 74세,2019,497,221,276,80.1,497,221,276,80.1
'37400, 예천군,'080,75~79세,2019,3640,1491,2149,69.4,3639,1491,2148,69.4
'37400, 예천군,'080001, 75세,2019,638,274,364,75.3,638,274,364,75.3
'37400, 예천군,'080002, 76세,2019,720,296,424,69.8,720,296,424,69.8
'37400, 예천군,'080003, 77세,2019,933,390,543,71.8,933,390,543,71.8
'37400, 예천군,'080004, 78세,2019,671,265,406,65.3,671,265,406,65.3
'37400, 예천군,'080005, 79세,2019,678,266,412,64.6,677,266,411,64.7
'37400, 예천군,'085,80~84세,2019,3140,1132,2008,56.4,3139,1132,2007,56.4
'37400, 예천군,'085001, 80세,2019,735,267,468,57.1,734,267,467,57.2
'37400, 예천군,'085002, 81세,2019,662,258,404,63.9,662,258,404,63.9
'37400, 예천군,'085003, 82세,2019,598,220,378,58.2,598,220,378,58.2
'37400, 예천군,'085004, 83세,2019,546,179,367,48.8,546,179,367,48.8
'37400, 예천군,'085005, 84세,2019,599,208,391,53.2,599,208,391,53.2
'37400, 예천군,'086,85세이상,2019,2018,535,1483,36.1,2017,534,1483,36
'37400, 예천군,'090,85~89세,2019,1432,421,1011,41.6,1431,420,1011,41.5
'37400, 예천군,'090001, 85세,2019,450,136,314,43.3,449,135,314,43
'37400, 예천군,'090002, 86세,2019,318,105,213,49.3,318,105,213,49.3
'37400, 예천군,'090003, 87세,2019,288,93,195,47.7,288,93,195,47.7
'37400, 예천군,'090004, 88세,2019,180,49,131,37.4,180,49,131,37.4
'37400, 예천군,'090005, 89세,2019,196,38,158,24.1,196,38,158,24.1
'37400, 예천군,'095,90~94세,2019,474,98,376,26.1,474,98,376,26.1
'37400, 예천군,'095001, 90세,2019,146,25,121,20.7,146,25,121,20.7
'37400, 예천군,'095002, 91세,2019,106,21,85,24.7,106,21,85,24.7
'37400, 예천군,'095003, 92세,2019,109,23,86,26.7,109,23,86,26.7
'37400, 예천군,'095004, 93세,2019,59,12,47,25.5,59,12,47,25.5
'37400, 예천군,'095005, 94세,2019,54,17,37,45.9,54,17,37,45.9
'37400, 예천군,'100,95~99세,2019,92,15,77,19.5,92,15,77,19.5
'37400, 예천군,'100001, 95세,2019,36,5,31,16.1,36,5,31,16.1
'37400, 예천군,'100002, 96세,2019,21,6,15,40,21,6,15,40
'37400, 예천군,'100003, 97세,2019,16,X,14,14.3,16,X,14,14.3
'37400, 예천군,'100004, 98세,2019,8,X,6,33.3,8,X,6,33.3
'37400, 예천군,'100005, 99세,2019,11,X,11,0,11,X,11,0
'37400, 예천군,'101,100세이상,2019,20,X,19,5.3,20,X,19,5.3
'37400, 예천군,'102,15세미만,2019,6747,3456,3291,105,6736,3452,3284,105.1
'37400, 예천군,'103,15~64세,2019,30392,15976,14416,110.8,29665,15675,13990,112
'37400, 예천군,'104,65세이상,2019,15881,6539,9342,70,15863,6532,9331,70
'37400, 예천군,'126,평균연령,2019,49.3,47,51.5,,49.5,47.1,51.8,
'37400, 예천군,'127,중위연령,2019,52.7,49.7,55.8,,53.1,49.9,56.3,
'37410, 봉화군,'000,합계,2019,30308,15056,15252,98.7,29830,14890,14940,99.7
'37410, 봉화군,'005,0~4세,2019,708,389,319,121.9,708,389,319,121.9
'37410, 봉화군,'005001, 0세,2019,130,77,53,145.3,130,77,53,145.3
'37410, 봉화군,'005002, 1세,2019,120,63,57,110.5,120,63,57,110.5
'37410, 봉화군,'005003, 2세,2019,148,74,74,100,148,74,74,100
'37410, 봉화군,'005004, 3세,2019,151,78,73,106.8,151,78,73,106.8
'37410, 봉화군,'005005, 4세,2019,159,97,62,156.5,159,97,62,156.5
'37410, 봉화군,'010,5~9세,2019,795,413,382,108.1,795,413,382,108.1
'37410, 봉화군,'010001, 5세,2019,160,82,78,105.1,160,82,78,105.1
'37410, 봉화군,'010002, 6세,2019,144,75,69,108.7,144,75,69,108.7
'37410, 봉화군,'010003, 7세,2019,156,86,70,122.9,156,86,70,122.9
'37410, 봉화군,'010004, 8세,2019,182,91,91,100,182,91,91,100
'37410, 봉화군,'010005, 9세,2019,153,79,74,106.8,153,79,74,106.8
'37410, 봉화군,'015,10~14세,2019,819,422,397,106.3,818,422,396,106.6
'37410, 봉화군,'015001, 10세,2019,157,94,63,149.2,157,94,63,149.2
'37410, 봉화군,'015002, 11세,2019,168,92,76,121.1,168,92,76,121.1
'37410, 봉화군,'015003, 12세,2019,177,75,102,73.5,177,75,102,73.5
'37410, 봉화군,'015004, 13세,2019,169,84,85,98.8,168,84,84,100
'37410, 봉화군,'015005, 14세,2019,148,77,71,108.5,148,77,71,108.5
'37410, 봉화군,'020,15~19세,2019,934,530,404,131.2,928,529,399,132.6
'37410, 봉화군,'020001, 15세,2019,186,101,85,118.8,186,101,85,118.8
'37410, 봉화군,'020002, 16세,2019,195,102,93,109.7,195,102,93,109.7
'37410, 봉화군,'020003, 17세,2019,218,125,93,134.4,217,125,92,135.9
'37410, 봉화군,'020004, 18세,2019,191,108,83,130.1,191,108,83,130.1
'37410, 봉화군,'020005, 19세,2019,144,94,50,188,139,93,46,202.2
'37410, 봉화군,'025,20~24세,2019,823,499,324,154,783,486,297,163.6
'37410, 봉화군,'025001, 20세,2019,155,105,50,210,153,105,48,218.8
'37410, 봉화군,'025002, 21세,2019,168,112,56,200,165,111,54,205.6
'37410, 봉화군,'025003, 22세,2019,157,91,66,137.9,148,89,59,150.8
'37410, 봉화군,'025004, 23세,2019,169,89,80,111.3,155,84,71,118.3
'37410, 봉화군,'025005, 24세,2019,174,102,72,141.7,162,97,65,149.2
'37410, 봉화군,'030,25~29세,2019,945,512,433,118.2,855,479,376,127.4
'37410, 봉화군,'030001, 25세,2019,205,109,96,113.5,187,103,84,122.6
'37410, 봉화군,'030002, 26세,2019,186,102,84,121.4,166,96,70,137.1
'37410, 봉화군,'030003, 27세,2019,192,101,91,111,174,92,82,112.2
'37410, 봉화군,'030004, 28세,2019,186,93,93,100,168,87,81,107.4
'37410, 봉화군,'030005, 29세,2019,176,107,69,155.1,160,101,59,171.2
'37410, 봉화군,'035,30~34세,2019,895,464,431,107.7,813,442,371,119.1
'37410, 봉화군,'035001, 30세,2019,169,86,83,103.6,151,81,70,115.7
'37410, 봉화군,'035002, 31세,2019,184,100,84,119,169,96,73,131.5
'37410, 봉화군,'035003, 32세,2019,173,94,79,119,154,89,65,136.9
'37410, 봉화군,'035004, 33세,2019,184,91,93,97.8,173,89,84,106
'37410, 봉화군,'035005, 34세,2019,185,93,92,101.1,166,87,79,110.1
'37410, 봉화군,'040,35~39세,2019,1236,645,591,109.1,1177,625,552,113.2
'37410, 봉화군,'040001, 35세,2019,216,113,103,109.7,200,106,94,112.8
'37410, 봉화군,'040002, 36세,2019,239,113,126,89.7,232,110,122,90.2
'37410, 봉화군,'040003, 37세,2019,245,119,126,94.4,233,117,116,100.9
'37410, 봉화군,'040004, 38세,2019,249,139,110,126.4,235,136,99,137.4
'37410, 봉화군,'040005, 39세,2019,287,161,126,127.8,277,156,121,128.9
'37410, 봉화군,'045,40~44세,2019,1372,799,573,139.4,1334,786,548,143.4
'37410, 봉화군,'045001, 40세,2019,286,172,114,150.9,273,168,105,160
'37410, 봉화군,'045002, 41세,2019,233,140,93,150.5,228,139,89,156.2
'37410, 봉화군,'045003, 42세,2019,262,144,118,122,257,142,115,123.5
'37410, 봉화군,'045004, 43세,2019,270,160,110,145.5,262,157,105,149.5
'37410, 봉화군,'045005, 44세,2019,321,183,138,132.6,314,180,134,134.3
'37410, 봉화군,'050,45~49세,2019,1812,1042,770,135.3,1781,1030,751,137.2
'37410, 봉화군,'050001, 45세,2019,358,206,152,135.5,350,203,147,138.1
'37410, 봉화군,'050002, 46세,2019,333,180,153,117.6,330,179,151,118.5
'37410, 봉화군,'050003, 47세,2019,339,208,131,158.8,333,203,130,156.2
'37410, 봉화군,'050004, 48세,2019,394,236,158,149.4,385,234,151,155
'37410, 봉화군,'050005, 49세,2019,388,212,176,120.5,383,211,172,122.7
'37410, 봉화군,'055,50~54세,2019,2487,1326,1161,114.2,2432,1308,1124,116.4
'37410, 봉화군,'055001, 50세,2019,460,250,210,119,448,247,201,122.9
'37410, 봉화군,'055002, 51세,2019,493,255,238,107.1,480,249,231,107.8
'37410, 봉화군,'055003, 52세,2019,472,260,212,122.6,463,258,205,125.9
'37410, 봉화군,'055004, 53세,2019,503,276,227,121.6,494,274,220,124.5
'37410, 봉화군,'055005, 54세,2019,559,285,274,104,547,280,267,104.9
'37410, 봉화군,'060,55~59세,2019,3316,1712,1604,106.7,3277,1695,1582,107.1
'37410, 봉화군,'060001, 55세,2019,507,271,236,114.8,497,265,232,114.2
'37410, 봉화군,'060002, 56세,2019,594,293,301,97.3,586,291,295,98.6
'37410, 봉화군,'060003, 57세,2019,687,378,309,122.3,679,374,305,122.6
'37410, 봉화군,'060004, 58세,2019,728,391,337,116,721,390,331,117.8
'37410, 봉화군,'060005, 59세,2019,800,379,421,90,794,375,419,89.5
'37410, 봉화군,'065,60~64세,2019,3362,1749,1613,108.4,3345,1744,1601,108.9
'37410, 봉화군,'065001, 60세,2019,657,318,339,93.8,652,316,336,94
'37410, 봉화군,'065002, 61세,2019,679,357,322,110.9,677,356,321,110.9
'37410, 봉화군,'065003, 62세,2019,692,360,332,108.4,687,360,327,110.1
'37410, 봉화군,'065004, 63세,2019,630,345,285,121.1,627,344,283,121.6
'37410, 봉화군,'065005, 64세,2019,704,369,335,110.1,702,368,334,110.2
'37410, 봉화군,'070,65~69세,2019,2713,1374,1339,102.6,2700,1366,1334,102.4
'37410, 봉화군,'070001, 65세,2019,615,323,292,110.6,612,321,291,110.3
'37410, 봉화군,'070002, 66세,2019,534,276,258,107,531,274,257,106.6
'37410, 봉화군,'070003, 67세,2019,591,293,298,98.3,588,291,297,98
'37410, 봉화군,'070004, 68세,2019,494,252,242,104.1,491,250,241,103.7
'37410, 봉화군,'070005, 69세,2019,479,230,249,92.4,478,230,248,92.7
'37410, 봉화군,'075,70~74세,2019,2217,1053,1164,90.5,2211,1050,1161,90.4
'37410, 봉화군,'075001, 70세,2019,515,260,255,102,515,260,255,102
'37410, 봉화군,'075002, 71세,2019,538,263,275,95.6,533,261,272,96
'37410, 봉화군,'075003, 72세,2019,520,236,284,83.1,519,235,284,82.7
'37410, 봉화군,'075004, 73세,2019,270,140,130,107.7,270,140,130,107.7
'37410, 봉화군,'075005, 74세,2019,374,154,220,70,374,154,220,70
'37410, 봉화군,'080,75~79세,2019,2494,1004,1490,67.4,2494,1004,1490,67.4
'37410, 봉화군,'080001, 75세,2019,458,198,260,76.2,458,198,260,76.2
'37410, 봉화군,'080002, 76세,2019,511,193,318,60.7,511,193,318,60.7
'37410, 봉화군,'080003, 77세,2019,534,219,315,69.5,534,219,315,69.5
'37410, 봉화군,'080004, 78세,2019,479,190,289,65.7,479,190,289,65.7
'37410, 봉화군,'080005, 79세,2019,512,204,308,66.2,512,204,308,66.2
'37410, 봉화군,'085,80~84세,2019,1968,703,1265,55.6,1968,703,1265,55.6
'37410, 봉화군,'085001, 80세,2019,447,187,260,71.9,447,187,260,71.9
'37410, 봉화군,'085002, 81세,2019,427,144,283,50.9,427,144,283,50.9
'37410, 봉화군,'085003, 82세,2019,365,117,248,47.2,365,117,248,47.2
'37410, 봉화군,'085004, 83세,2019,352,136,216,63,352,136,216,63
'37410, 봉화군,'085005, 84세,2019,377,119,258,46.1,377,119,258,46.1
'37410, 봉화군,'086,85세이상,2019,1412,420,992,42.3,1411,419,992,42.2
'37410, 봉화군,'090,85~89세,2019,969,326,643,50.7,968,325,643,50.5
'37410, 봉화군,'090001, 85세,2019,273,105,168,62.5,273,105,168,62.5
'37410, 봉화군,'090002, 86세,2019,214,75,139,54,214,75,139,54
'37410, 봉화군,'090003, 87세,2019,190,63,127,49.6,189,62,127,48.8
'37410, 봉화군,'090004, 88세,2019,143,35,108,32.4,143,35,108,32.4
'37410, 봉화군,'090005, 89세,2019,149,48,101,47.5,149,48,101,47.5
'37410, 봉화군,'095,90~94세,2019,357,78,279,28,357,78,279,28
'37410, 봉화군,'095001, 90세,2019,108,35,73,47.9,108,35,73,47.9
'37410, 봉화군,'095002, 91세,2019,91,21,70,30,91,21,70,30
'37410, 봉화군,'095003, 92세,2019,59,11,48,22.9,59,11,48,22.9
'37410, 봉화군,'095004, 93세,2019,47,7,40,17.5,47,7,40,17.5
'37410, 봉화군,'095005, 94세,2019,52,X,48,8.3,52,X,48,8.3
'37410, 봉화군,'100,95~99세,2019,75,14,61,23,75,14,61,23
'37410, 봉화군,'100001, 95세,2019,20,5,15,33.3,20,5,15,33.3
'37410, 봉화군,'100002, 96세,2019,23,X,19,21.1,23,X,19,21.1
'37410, 봉화군,'100003, 97세,2019,12,X,9,33.3,12,X,9,33.3
'37410, 봉화군,'100004, 98세,2019,14,X,12,16.7,14,X,12,16.7
'37410, 봉화군,'100005, 99세,2019,6,X,6,0,6,X,6,0
'37410, 봉화군,'101,100세이상,2019,11,X,9,22.2,11,X,9,22.2
'37410, 봉화군,'102,15세미만,2019,2322,1224,1098,111.5,2321,1224,1097,111.6
'37410, 봉화군,'103,15~64세,2019,17182,9278,7904,117.4,16725,9124,7601,120
'37410, 봉화군,'104,65세이상,2019,10804,4554,6250,72.9,10784,4542,6242,72.8
'37410, 봉화군,'126,평균연령,2019,54.6,52.2,57,,54.9,52.3,57.4,
'37410, 봉화군,'127,중위연령,2019,58.7,56.7,60.7,,59,56.9,61.1,
'37420, 울진군,'000,합계,2019,47651,24745,22906,108,45565,22951,22614,101.5
'37420, 울진군,'005,0~4세,2019,1398,711,687,103.5,1391,711,680,104.6
'37420, 울진군,'005001, 0세,2019,253,128,125,102.4,253,128,125,102.4
'37420, 울진군,'005002, 1세,2019,251,143,108,132.4,248,143,105,136.2
'37420, 울진군,'005003, 2세,2019,254,121,133,91,253,121,132,91.7
'37420, 울진군,'005004, 3세,2019,315,142,173,82.1,313,142,171,83
'37420, 울진군,'005005, 4세,2019,325,177,148,119.6,324,177,147,120.4
'37420, 울진군,'010,5~9세,2019,1607,823,784,105,1604,821,783,104.9
'37420, 울진군,'010001, 5세,2019,337,159,178,89.3,335,158,177,89.3
'37420, 울진군,'010002, 6세,2019,313,147,166,88.6,313,147,166,88.6
'37420, 울진군,'010003, 7세,2019,327,187,140,133.6,327,187,140,133.6
'37420, 울진군,'010004, 8세,2019,319,159,160,99.4,319,159,160,99.4
'37420, 울진군,'010005, 9세,2019,311,171,140,122.1,310,170,140,121.4
'37420, 울진군,'015,10~14세,2019,1679,898,781,115,1677,898,779,115.3
'37420, 울진군,'015001, 10세,2019,296,149,147,101.4,295,149,146,102.1
'37420, 울진군,'015002, 11세,2019,351,192,159,120.8,351,192,159,120.8
'37420, 울진군,'015003, 12세,2019,362,206,156,132.1,361,206,155,132.9
'37420, 울진군,'015004, 13세,2019,329,185,144,128.5,329,185,144,128.5
'37420, 울진군,'015005, 14세,2019,341,166,175,94.9,341,166,175,94.9
'37420, 울진군,'020,15~19세,2019,1951,1168,783,149.2,1941,1160,781,148.5
'37420, 울진군,'020001, 15세,2019,395,224,171,131,395,224,171,131
'37420, 울진군,'020002, 16세,2019,424,243,181,134.3,424,243,181,134.3
'37420, 울진군,'020003, 17세,2019,506,299,207,144.4,505,298,207,144
'37420, 울진군,'020004, 18세,2019,417,251,166,151.2,414,249,165,150.9
'37420, 울진군,'020005, 19세,2019,209,151,58,260.3,203,146,57,256.1
'37420, 울진군,'025,20~24세,2019,1684,1174,510,230.2,1482,998,484,206.2
'37420, 울진군,'025001, 20세,2019,280,219,61,359,269,210,59,355.9
'37420, 울진군,'025002, 21세,2019,332,245,87,281.6,307,223,84,265.5
'37420, 울진군,'025003, 22세,2019,329,223,106,210.4,290,194,96,202.1
'37420, 울진군,'025004, 23세,2019,348,227,121,187.6,295,178,117,152.1
'37420, 울진군,'025005, 24세,2019,395,260,135,192.6,321,193,128,150.8
'37420, 울진군,'030,25~29세,2019,2378,1530,848,180.4,1885,1090,795,137.1
'37420, 울진군,'030001, 25세,2019,437,265,172,154.1,363,201,162,124.1
'37420, 울진군,'030002, 26세,2019,467,294,173,169.9,377,214,163,131.3
'37420, 울진군,'030003, 27세,2019,485,319,166,192.2,362,209,153,136.6
'37420, 울진군,'030004, 28세,2019,510,330,180,183.3,404,236,168,140.5
'37420, 울진군,'030005, 29세,2019,479,322,157,205.1,379,230,149,154.4
'37420, 울진군,'035,30~34세,2019,2415,1532,883,173.5,1955,1113,842,132.2
'37420, 울진군,'035001, 30세,2019,498,335,163,205.5,390,235,155,151.6
'37420, 울진군,'035002, 31세,2019,478,293,185,158.4,397,218,179,121.8
'37420, 울진군,'035003, 32세,2019,519,327,192,170.3,420,237,183,129.5
'37420, 울진군,'035004, 33세,2019,463,290,173,167.6,379,214,165,129.7
'37420, 울진군,'035005, 34세,2019,457,287,170,168.8,369,209,160,130.6
'37420, 울진군,'040,35~39세,2019,2802,1616,1186,136.3,2438,1286,1152,111.6
'37420, 울진군,'040001, 35세,2019,464,282,182,154.9,384,213,171,124.6
'37420, 울진군,'040002, 36세,2019,544,318,226,140.7,468,247,221,111.8
'37420, 울진군,'040003, 37세,2019,613,352,261,134.9,539,283,256,110.5
'37420, 울진군,'040004, 38세,2019,569,329,240,137.1,507,272,235,115.7
'37420, 울진군,'040005, 39세,2019,612,335,277,120.9,540,271,269,100.7
'37420, 울진군,'045,40~44세,2019,2939,1695,1244,136.3,2722,1496,1226,122
'37420, 울진군,'045001, 40세,2019,590,339,251,135.1,542,296,246,120.3
'37420, 울진군,'045002, 41세,2019,573,340,233,145.9,524,295,229,128.8
'37420, 울진군,'045003, 42세,2019,592,315,277,113.7,556,284,272,104.4
'37420, 울진군,'045004, 43세,2019,556,337,219,153.9,513,295,218,135.3
'37420, 울진군,'045005, 44세,2019,628,364,264,137.9,587,326,261,124.9
'37420, 울진군,'050,45~49세,2019,3561,2035,1526,133.4,3422,1921,1501,128
'37420, 울진군,'050001, 45세,2019,626,341,285,119.6,598,316,282,112.1
'37420, 울진군,'050002, 46세,2019,733,425,308,138,707,401,306,131
'37420, 울진군,'050003, 47세,2019,637,361,276,130.8,610,342,268,127.6
'37420, 울진군,'050004, 48세,2019,797,464,333,139.3,765,439,326,134.7
'37420, 울진군,'050005, 49세,2019,768,444,324,137,742,423,319,132.6
'37420, 울진군,'055,50~54세,2019,3819,2091,1728,121,3730,2032,1698,119.7
'37420, 울진군,'055001, 50세,2019,745,405,340,119.1,724,386,338,114.2
'37420, 울진군,'055002, 51세,2019,763,409,354,115.5,736,392,344,114
'37420, 울진군,'055003, 52세,2019,741,408,333,122.5,723,400,323,123.8
'37420, 울진군,'055004, 53세,2019,771,434,337,128.8,759,426,333,127.9
'37420, 울진군,'055005, 54세,2019,799,435,364,119.5,788,428,360,118.9
'37420, 울진군,'060,55~59세,2019,4544,2390,2154,111,4494,2365,2129,111.1
'37420, 울진군,'060001, 55세,2019,754,423,331,127.8,740,417,323,129.1
'37420, 울진군,'060002, 56세,2019,844,454,390,116.4,838,449,389,115.4
'37420, 울진군,'060003, 57세,2019,827,416,411,101.2,821,413,408,101.2
'37420, 울진군,'060004, 58세,2019,1109,592,517,114.5,1098,586,512,114.5
'37420, 울진군,'060005, 59세,2019,1010,505,505,100,997,500,497,100.6
'37420, 울진군,'065,60~64세,2019,4139,2062,2077,99.3,4114,2050,2064,99.3
'37420, 울진군,'065001, 60세,2019,851,419,432,97,846,416,430,96.7
'37420, 울진군,'065002, 61세,2019,804,412,392,105.1,798,409,389,105.1
'37420, 울진군,'065003, 62세,2019,864,447,417,107.2,858,444,414,107.2
'37420, 울진군,'065004, 63세,2019,866,403,463,87,861,401,460,87.2
'37420, 울진군,'065005, 64세,2019,754,381,373,102.1,751,380,371,102.4
'37420, 울진군,'070,65~69세,2019,3124,1519,1605,94.6,3113,1513,1600,94.6
'37420, 울진군,'070001, 65세,2019,739,357,382,93.5,735,355,380,93.4
'37420, 울진군,'070002, 66세,2019,667,328,339,96.8,666,327,339,96.5
'37420, 울진군,'070003, 67세,2019,656,309,347,89,652,307,345,89
'37420, 울진군,'070004, 68세,2019,478,234,244,95.9,477,233,244,95.5
'37420, 울진군,'070005, 69세,2019,584,291,293,99.3,583,291,292,99.7
'37420, 울진군,'075,70~74세,2019,2729,1273,1456,87.4,2722,1271,1451,87.6
'37420, 울진군,'075001, 70세,2019,642,308,334,92.2,639,307,332,92.5
'37420, 울진군,'075002, 71세,2019,641,325,316,102.8,641,325,316,102.8
'37420, 울진군,'075003, 72세,2019,507,222,285,77.9,506,222,284,78.2
'37420, 울진군,'075004, 73세,2019,443,225,218,103.2,441,224,217,103.2
'37420, 울진군,'075005, 74세,2019,496,193,303,63.7,495,193,302,63.9
'37420, 울진군,'080,75~79세,2019,2841,1079,1762,61.2,2838,1077,1761,61.2
'37420, 울진군,'080001, 75세,2019,506,199,307,64.8,504,198,306,64.7
'37420, 울진군,'080002, 76세,2019,601,236,365,64.7,600,235,365,64.4
'37420, 울진군,'080003, 77세,2019,677,263,414,63.5,677,263,414,63.5
'37420, 울진군,'080004, 78세,2019,527,200,327,61.2,527,200,327,61.2
'37420, 울진군,'080005, 79세,2019,530,181,349,51.9,530,181,349,51.9
'37420, 울진군,'085,80~84세,2019,2349,766,1583,48.4,2348,766,1582,48.4
'37420, 울진군,'085001, 80세,2019,569,188,381,49.3,568,188,380,49.5
'37420, 울진군,'085002, 81세,2019,481,176,305,57.7,481,176,305,57.7
'37420, 울진군,'085003, 82세,2019,474,152,322,47.2,474,152,322,47.2
'37420, 울진군,'085004, 83세,2019,421,132,289,45.7,421,132,289,45.7
'37420, 울진군,'085005, 84세,2019,404,118,286,41.3,404,118,286,41.3
'37420, 울진군,'086,85세이상,2019,1692,383,1309,29.3,1689,383,1306,29.3
'37420, 울진군,'090,85~89세,2019,1184,305,879,34.7,1181,305,876,34.8
'37420, 울진군,'090001, 85세,2019,291,94,197,47.7,289,94,195,48.2
'37420, 울진군,'090002, 86세,2019,269,84,185,45.4,268,84,184,45.7
'37420, 울진군,'090003, 87세,2019,236,40,196,20.4,236,40,196,20.4
'37420, 울진군,'090004, 88세,2019,205,45,160,28.1,205,45,160,28.1
'37420, 울진군,'090005, 89세,2019,183,42,141,29.8,183,42,141,29.8
'37420, 울진군,'095,90~94세,2019,413,63,350,18,413,63,350,18
'37420, 울진군,'095001, 90세,2019,120,20,100,20,120,20,100,20
'37420, 울진군,'095002, 91세,2019,112,16,96,16.7,112,16,96,16.7
'37420, 울진군,'095003, 92세,2019,77,15,62,24.2,77,15,62,24.2
'37420, 울진군,'095004, 93세,2019,51,8,43,18.6,51,8,43,18.6
'37420, 울진군,'095005, 94세,2019,53,X,49,8.2,53,X,49,8.2
'37420, 울진군,'100,95~99세,2019,87,15,72,20.8,87,15,72,20.8
'37420, 울진군,'100001, 95세,2019,34,6,28,21.4,34,6,28,21.4
'37420, 울진군,'100002, 96세,2019,23,6,17,35.3,23,6,17,35.3
'37420, 울진군,'100003, 97세,2019,18,X,16,12.5,18,X,16,12.5
'37420, 울진군,'100004, 98세,2019,8,X,7,14.3,8,X,7,14.3
'37420, 울진군,'100005, 99세,2019,X,X,X,0,X,X,X,0
'37420, 울진군,'101,100세이상,2019,8,X,8,0,8,X,8,0
'37420, 울진군,'102,15세미만,2019,4684,2432,2252,108,4672,2430,2242,108.4
'37420, 울진군,'103,15~64세,2019,30232,17293,12939,133.7,28183,15511,12672,122.4
'37420, 울진군,'104,65세이상,2019,12735,5020,7715,65.1,12710,5010,7700,65.1
'37420, 울진군,'126,평균연령,2019,49.2,46,52.7,,49.9,46.9,52.8,
'37420, 울진군,'127,중위연령,2019,51.9,48.2,56.4,,53.1,50,56.7,
'37430, 울릉군,'000,합계,2019,8704,4848,3856,125.7,8430,4626,3804,121.6
'37430, 울릉군,'005,0~4세,2019,203,107,96,111.5,202,107,95,112.6
'37430, 울릉군,'005001, 0세,2019,38,21,17,123.5,38,21,17,123.5
'37430, 울릉군,'005002, 1세,2019,37,20,17,117.6,37,20,17,117.6
'37430, 울릉군,'005003, 2세,2019,30,14,16,87.5,30,14,16,87.5
'37430, 울릉군,'005004, 3세,2019,47,24,23,104.3,46,24,22,109.1
'37430, 울릉군,'005005, 4세,2019,51,28,23,121.7,51,28,23,121.7
'37430, 울릉군,'010,5~9세,2019,267,132,135,97.8,264,131,133,98.5
'37430, 울릉군,'010001, 5세,2019,57,26,31,83.9,55,26,29,89.7
'37430, 울릉군,'010002, 6세,2019,55,23,32,71.9,55,23,32,71.9
'37430, 울릉군,'010003, 7세,2019,54,21,33,63.6,54,21,33,63.6
'37430, 울릉군,'010004, 8세,2019,51,33,18,183.3,50,32,18,177.8
'37430, 울릉군,'010005, 9세,2019,50,29,21,138.1,50,29,21,138.1
'37430, 울릉군,'015,10~14세,2019,235,113,122,92.6,235,113,122,92.6
'37430, 울릉군,'015001, 10세,2019,47,24,23,104.3,47,24,23,104.3
'37430, 울릉군,'015002, 11세,2019,53,29,24,120.8,53,29,24,120.8
'37430, 울릉군,'015003, 12세,2019,50,18,32,56.3,50,18,32,56.3
'37430, 울릉군,'015004, 13세,2019,40,21,19,110.5,40,21,19,110.5
'37430, 울릉군,'015005, 14세,2019,45,21,24,87.5,45,21,24,87.5
'37430, 울릉군,'020,15~19세,2019,162,93,69,134.8,162,93,69,134.8
'37430, 울릉군,'020001, 15세,2019,35,17,18,94.4,35,17,18,94.4
'37430, 울릉군,'020002, 16세,2019,32,22,10,220,32,22,10,220
'37430, 울릉군,'020003, 17세,2019,34,17,17,100,34,17,17,100
'37430, 울릉군,'020004, 18세,2019,38,21,17,123.5,38,21,17,123.5
'37430, 울릉군,'020005, 19세,2019,23,16,7,228.6,23,16,7,228.6
'37430, 울릉군,'025,20~24세,2019,281,195,86,226.7,263,181,82,220.7
'37430, 울릉군,'025001, 20세,2019,43,35,8,437.5,39,32,7,457.1
'37430, 울릉군,'025002, 21세,2019,45,33,12,275,43,32,11,290.9
'37430, 울릉군,'025003, 22세,2019,55,41,14,292.9,54,40,14,285.7
'37430, 울릉군,'025004, 23세,2019,53,29,24,120.8,50,27,23,117.4
'37430, 울릉군,'025005, 24세,2019,85,57,28,203.6,77,50,27,185.2
'37430, 울릉군,'030,25~29세,2019,491,311,180,172.8,434,258,176,146.6
'37430, 울릉군,'030001, 25세,2019,95,60,35,171.4,90,56,34,164.7
'37430, 울릉군,'030002, 26세,2019,96,57,39,146.2,81,43,38,113.2
'37430, 울릉군,'030003, 27세,2019,101,69,32,215.6,91,59,32,184.4
'37430, 울릉군,'030004, 28세,2019,104,65,39,166.7,90,51,39,130.8
'37430, 울릉군,'030005, 29세,2019,95,60,35,171.4,82,49,33,148.5
'37430, 울릉군,'035,30~34세,2019,422,271,151,179.5,369,225,144,156.3
'37430, 울릉군,'035001, 30세,2019,114,72,42,171.4,98,58,40,145
'37430, 울릉군,'035002, 31세,2019,75,50,25,200,67,45,22,204.5
'37430, 울릉군,'035003, 32세,2019,67,42,25,168,56,32,24,133.3
'37430, 울릉군,'035004, 33세,2019,85,52,33,157.6,77,45,32,140.6
'37430, 울릉군,'035005, 34세,2019,81,55,26,211.5,71,45,26,173.1
'37430, 울릉군,'040,35~39세,2019,577,346,231,149.8,533,303,230,131.7
'37430, 울릉군,'040001, 35세,2019,109,57,52,109.6,101,49,52,94.2
'37430, 울릉군,'040002, 36세,2019,100,51,49,104.1,90,42,48,87.5
'37430, 울릉군,'040003, 37세,2019,125,82,43,190.7,114,71,43,165.1
'37430, 울릉군,'040004, 38세,2019,126,80,46,173.9,117,71,46,154.3
'37430, 울릉군,'040005, 39세,2019,117,76,41,185.4,111,70,41,170.7
'37430, 울릉군,'045,40~44세,2019,587,355,232,153,568,338,230,147
'37430, 울릉군,'045001, 40세,2019,105,66,39,169.2,100,61,39,156.4
'37430, 울릉군,'045002, 41세,2019,119,64,55,116.4,116,62,54,114.8
'37430, 울릉군,'045003, 42세,2019,118,73,45,162.2,114,70,44,159.1
'37430, 울릉군,'045004, 43세,2019,125,70,55,127.3,122,67,55,121.8
'37430, 울릉군,'045005, 44세,2019,120,82,38,215.8,116,78,38,205.3
'37430, 울릉군,'050,45~49세,2019,728,447,281,159.1,717,440,277,158.8
'37430, 울릉군,'050001, 45세,2019,133,82,51,160.8,131,80,51,156.9
'37430, 울릉군,'050002, 46세,2019,148,88,60,146.7,145,86,59,145.8
'37430, 울릉군,'050003, 47세,2019,131,81,50,162,129,79,50,158
'37430, 울릉군,'050004, 48세,2019,165,103,62,166.1,163,103,60,171.7
'37430, 울릉군,'050005, 49세,2019,151,93,58,160.3,149,92,57,161.4
'37430, 울릉군,'055,50~54세,2019,874,534,340,157.1,857,522,335,155.8
'37430, 울릉군,'055001, 50세,2019,162,104,58,179.3,158,101,57,177.2
'37430, 울릉군,'055002, 51세,2019,179,106,73,145.2,177,104,73,142.5
'37430, 울릉군,'055003, 52세,2019,161,96,65,147.7,159,96,63,152.4
'37430, 울릉군,'055004, 53세,2019,185,106,79,134.2,181,103,78,132.1
'37430, 울릉군,'055005, 54세,2019,187,122,65,187.7,182,118,64,184.4
'37430, 울릉군,'060,55~59세,2019,927,510,417,122.3,914,503,411,122.4
'37430, 울릉군,'060001, 55세,2019,136,78,58,134.5,136,78,58,134.5
'37430, 울릉군,'060002, 56세,2019,193,107,86,124.4,191,105,86,122.1
'37430, 울릉군,'060003, 57세,2019,174,104,70,148.6,171,103,68,151.5
'37430, 울릉군,'060004, 58세,2019,228,113,115,98.3,225,111,114,97.4
'37430, 울릉군,'060005, 59세,2019,196,108,88,122.7,191,106,85,124.7
'37430, 울릉군,'065,60~64세,2019,908,498,410,121.5,886,486,400,121.5
'37430, 울릉군,'065001, 60세,2019,221,112,109,102.8,218,111,107,103.7
'37430, 울릉군,'065002, 61세,2019,178,101,77,131.2,173,98,75,130.7
'37430, 울릉군,'065003, 62세,2019,195,109,86,126.7,189,105,84,125
'37430, 울릉군,'065004, 63세,2019,157,87,70,124.3,153,85,68,125
'37430, 울릉군,'065005, 64세,2019,157,89,68,130.9,153,87,66,131.8
'37430, 울릉군,'070,65~69세,2019,659,326,333,97.9,646,317,329,96.4
'37430, 울릉군,'070001, 65세,2019,128,69,59,116.9,124,67,57,117.5
'37430, 울릉군,'070002, 66세,2019,141,70,71,98.6,139,68,71,95.8
'37430, 울릉군,'070003, 67세,2019,145,69,76,90.8,142,67,75,89.3
'37430, 울릉군,'070004, 68세,2019,134,73,61,119.7,131,71,60,118.3
'37430, 울릉군,'070005, 69세,2019,111,45,66,68.2,110,44,66,66.7
'37430, 울릉군,'075,70~74세,2019,528,257,271,94.8,527,256,271,94.5
'37430, 울릉군,'075001, 70세,2019,103,47,56,83.9,103,47,56,83.9
'37430, 울릉군,'075002, 71세,2019,113,63,50,126,113,63,50,126
'37430, 울릉군,'075003, 72세,2019,123,65,58,112.1,123,65,58,112.1
'37430, 울릉군,'075004, 73세,2019,95,43,52,82.7,94,42,52,80.8
'37430, 울릉군,'075005, 74세,2019,94,39,55,70.9,94,39,55,70.9
'37430, 울릉군,'080,75~79세,2019,392,183,209,87.6,390,183,207,88.4
'37430, 울릉군,'080001, 75세,2019,94,45,49,91.8,94,45,49,91.8
'37430, 울릉군,'080002, 76세,2019,73,31,42,73.8,73,31,42,73.8
'37430, 울릉군,'080003, 77세,2019,91,46,45,102.2,90,46,44,104.5
'37430, 울릉군,'080004, 78세,2019,72,34,38,89.5,71,34,37,91.9
'37430, 울릉군,'080005, 79세,2019,62,27,35,77.1,62,27,35,77.1
'37430, 울릉군,'085,80~84세,2019,274,122,152,80.3,274,122,152,80.3
'37430, 울릉군,'085001, 80세,2019,69,33,36,91.7,69,33,36,91.7
'37430, 울릉군,'085002, 81세,2019,54,20,34,58.8,54,20,34,58.8
'37430, 울릉군,'085003, 82세,2019,52,19,33,57.6,52,19,33,57.6
'37430, 울릉군,'085004, 83세,2019,55,30,25,120,55,30,25,120
'37430, 울릉군,'085005, 84세,2019,44,20,24,83.3,44,20,24,83.3
'37430, 울릉군,'086,85세이상,2019,189,48,141,34,189,48,141,34
'37430, 울릉군,'090,85~89세,2019,139,35,104,33.7,139,35,104,33.7
'37430, 울릉군,'090001, 85세,2019,38,10,28,35.7,38,10,28,35.7
'37430, 울릉군,'090002, 86세,2019,23,X,19,21.1,23,X,19,21.1
'37430, 울릉군,'090003, 87세,2019,31,10,21,47.6,31,10,21,47.6
'37430, 울릉군,'090004, 88세,2019,27,5,22,22.7,27,5,22,22.7
'37430, 울릉군,'090005, 89세,2019,20,6,14,42.9,20,6,14,42.9
'37430, 울릉군,'095,90~94세,2019,41,11,30,36.7,41,11,30,36.7
'37430, 울릉군,'095001, 90세,2019,13,X,9,44.4,13,X,9,44.4
'37430, 울릉군,'095002, 91세,2019,12,X,11,9.1,12,X,11,9.1
'37430, 울릉군,'095003, 92세,2019,7,X,5,40,7,X,5,40
'37430, 울릉군,'095004, 93세,2019,5,X,X,400,5,X,X,400
'37430, 울릉군,'095005, 94세,2019,X,X,X,0,X,X,X,0
'37430, 울릉군,'100,95~99세,2019,9,X,7,28.6,9,X,7,28.6
'37430, 울릉군,'100001, 95세,2019,X,X,X,,X,X,X,
'37430, 울릉군,'100002, 96세,2019,X,X,X,0,X,X,X,0
'37430, 울릉군,'100003, 97세,2019,X,X,X,0,X,X,X,0
'37430, 울릉군,'100004, 98세,2019,X,X,X,0,X,X,X,0
'37430, 울릉군,'100005, 99세,2019,X,X,X,0,X,X,X,0
'37430, 울릉군,'101,100세이상,2019,X,X,X,,X,X,X,
'37430, 울릉군,'102,15세미만,2019,705,352,353,99.7,701,351,350,100.3
'37430, 울릉군,'103,15~64세,2019,5957,3560,2397,148.5,5703,3349,2354,142.3
'37430, 울릉군,'104,65세이상,2019,2042,936,1106,84.6,2026,926,1100,84.2
'37430, 울릉군,'126,평균연령,2019,49.6,48.1,51.4,,49.9,48.5,51.5,
'37430, 울릉군,'127,중위연령,2019,52.4,50.5,55.1,,52.8,51.2,55.1,
'38,경상남도,'000,합계,2019,3347209,1703892,1643317,103.7,3241301,1632680,1608621,101.5
'38,경상남도,'005,0~4세,2019,125576,64363,61213,105.1,124060,63584,60476,105.1
'38,경상남도,'005001, 0세,2019,19730,10059,9671,104,19497,9939,9558,104
'38,경상남도,'005002, 1세,2019,22020,11298,10722,105.4,21718,11149,10569,105.5
'38,경상남도,'005003, 2세,2019,24898,12815,12083,106.1,24596,12658,11938,106
'38,경상남도,'005004, 3세,2019,28527,14582,13945,104.6,28185,14412,13773,104.6
'38,경상남도,'005005, 4세,2019,30401,15609,14792,105.5,30064,15426,14638,105.4
'38,경상남도,'010,5~9세,2019,160353,82720,77633,106.6,159267,82176,77091,106.6
'38,경상남도,'010001, 5세,2019,30756,15841,14915,106.2,30469,15704,14765,106.4
'38,경상남도,'010002, 6세,2019,30708,15790,14918,105.8,30465,15668,14797,105.9
'38,경상남도,'010003, 7세,2019,33759,17428,16331,106.7,33523,17315,16208,106.8
'38,경상남도,'010004, 8세,2019,33256,17143,16113,106.4,33095,17052,16043,106.3
'38,경상남도,'010005, 9세,2019,31874,16518,15356,107.6,31715,16437,15278,107.6
'38,경상남도,'015,10~14세,2019,154990,80325,74665,107.6,154340,79997,74343,107.6
'38,경상남도,'015001, 10세,2019,30795,15960,14835,107.6,30649,15892,14757,107.7
'38,경상남도,'015002, 11세,2019,32461,16625,15836,105,32323,16561,15762,105.1
'38,경상남도,'015003, 12세,2019,32873,17060,15813,107.9,32726,16977,15749,107.8
'38,경상남도,'015004, 13세,2019,29780,15528,14252,109,29669,15473,14196,109
'38,경상남도,'015005, 14세,2019,29081,15152,13929,108.8,28973,15094,13879,108.8
'38,경상남도,'020,15~19세,2019,167002,89778,77224,116.3,165435,88961,76474,116.3
'38,경상남도,'020001, 15세,2019,31487,16562,14925,111,31370,16506,14864,111
'38,경상남도,'020002, 16세,2019,31857,16828,15029,112,31745,16770,14975,112
'38,경상남도,'020003, 17세,2019,33450,17652,15798,111.7,33298,17569,15729,111.7
'38,경상남도,'020004, 18세,2019,36007,19270,16737,115.1,35667,19087,16580,115.1
'38,경상남도,'020005, 19세,2019,34201,19466,14735,132.1,33355,19029,14326,132.8
'38,경상남도,'025,20~24세,2019,192416,111647,80769,138.2,180758,104078,76680,135.7
'38,경상남도,'025001, 20세,2019,35420,20882,14538,143.6,34165,20146,14019,143.7
'38,경상남도,'025002, 21세,2019,37982,22277,15705,141.8,36177,21207,14970,141.7
'38,경상남도,'025003, 22세,2019,39121,22461,16660,134.8,36769,20940,15829,132.3
'38,경상남도,'025004, 23세,2019,39991,23130,16861,137.2,37121,21185,15936,132.9
'38,경상남도,'025005, 24세,2019,39902,22897,17005,134.6,36526,20600,15926,129.3
'38,경상남도,'030,25~29세,2019,196129,111070,85059,130.6,175434,96271,79163,121.6
'38,경상남도,'030001, 25세,2019,39696,22682,17014,133.3,36066,20166,15900,126.8
'38,경상남도,'030002, 26세,2019,39697,22587,17110,132,35713,19759,15954,123.8
'38,경상남도,'030003, 27세,2019,39839,22318,17521,127.4,35659,19316,16343,118.2
'38,경상남도,'030004, 28세,2019,38464,21624,16840,128.4,34224,18572,15652,118.7
'38,경상남도,'030005, 29세,2019,38433,21859,16574,131.9,33772,18458,15314,120.5
'38,경상남도,'035,30~34세,2019,194809,107879,86930,124.1,173220,91951,81269,113.1
'38,경상남도,'035001, 30세,2019,37712,21255,16457,129.2,33297,18008,15289,117.8
'38,경상남도,'035002, 31세,2019,37319,20848,16471,126.6,32858,17577,15281,115
'38,경상남도,'035003, 32세,2019,38685,21093,17592,119.9,34183,17791,16392,108.5
'38,경상남도,'035004, 33세,2019,39746,22108,17638,125.3,35525,18969,16556,114.6
'38,경상남도,'035005, 34세,2019,41347,22575,18772,120.3,37357,19606,17751,110.5
'38,경상남도,'040,35~39세,2019,257405,136227,121178,112.4,241872,124947,116925,106.9
'38,경상남도,'040001, 35세,2019,44072,23618,20454,115.5,40395,20925,19470,107.5
'38,경상남도,'040002, 36세,2019,49037,26059,22978,113.4,45659,23587,22072,106.9
'38,경상남도,'040003, 37세,2019,53566,28225,25341,111.4,50389,25944,24445,106.1
'38,경상남도,'040004, 38세,2019,54418,28906,25512,113.3,51605,26883,24722,108.7
'38,경상남도,'040005, 39세,2019,56312,29419,26893,109.4,53824,27608,26216,105.3
'38,경상남도,'045,40~44세,2019,250743,130884,119859,109.2,240852,124106,116746,106.3
'38,경상남도,'045001, 40세,2019,52751,27750,25001,111,50356,26075,24281,107.4
'38,경상남도,'045002, 41세,2019,48807,25701,23106,111.2,46653,24223,22430,108
'38,경상남도,'045003, 42세,2019,49151,25591,23560,108.6,47291,24334,22957,106
'38,경상남도,'045004, 43세,2019,48281,25242,23039,109.6,46466,23957,22509,106.4
'38,경상남도,'045005, 44세,2019,51753,26600,25153,105.8,50086,25517,24569,103.9
'38,경상남도,'050,45~49세,2019,291703,150515,141188,106.6,284105,145713,138392,105.3
'38,경상남도,'050001, 45세,2019,56131,28987,27144,106.8,54528,27937,26591,105.1
'38,경상남도,'050002, 46세,2019,57913,29638,28275,104.8,56434,28716,27718,103.6
'38,경상남도,'050003, 47세,2019,56421,29566,26855,110.1,54866,28568,26298,108.6
'38,경상남도,'050004, 48세,2019,61023,31463,29560,106.4,59493,30505,28988,105.2
'38,경상남도,'050005, 49세,2019,60215,30861,29354,105.1,58784,29987,28797,104.1
'38,경상남도,'055,50~54세,2019,289172,147229,141943,103.7,283369,143902,139467,103.2
'38,경상남도,'055001, 50세,2019,60694,31101,29593,105.1,59345,30326,29019,104.5
'38,경상남도,'055002, 51세,2019,60830,30628,30202,101.4,59591,29894,29697,100.7
'38,경상남도,'055003, 52세,2019,56343,28268,28075,100.7,55202,27627,27575,100.2
'38,경상남도,'055004, 53세,2019,55575,29058,26517,109.6,54516,28461,26055,109.2
'38,경상남도,'055005, 54세,2019,55730,28174,27556,102.2,54715,27594,27121,101.7
'38,경상남도,'060,55~59세,2019,286323,145052,141271,102.7,282191,142861,139330,102.5
'38,경상남도,'060001, 55세,2019,49216,25002,24214,103.3,48231,24498,23733,103.2
'38,경상남도,'060002, 56세,2019,54689,28467,26222,108.6,53651,27896,25755,108.3
'38,경상남도,'060003, 57세,2019,57802,29530,28272,104.4,56988,29083,27905,104.2
'38,경상남도,'060004, 58세,2019,63152,31472,31680,99.3,62546,31159,31387,99.3
'38,경상남도,'060005, 59세,2019,61464,30581,30883,99,60775,30225,30550,98.9
'38,경상남도,'065,60~64세,2019,248003,124073,123930,100.1,245727,122877,122850,100
'38,경상남도,'065001, 60세,2019,53831,27239,26592,102.4,53297,26961,26336,102.4
'38,경상남도,'065002, 61세,2019,50663,25640,25023,102.5,50115,25355,24760,102.4
'38,경상남도,'065003, 62세,2019,50244,25274,24970,101.2,49798,25030,24768,101.1
'38,경상남도,'065004, 63세,2019,46046,22885,23161,98.8,45638,22683,22955,98.8
'38,경상남도,'065005, 64세,2019,47219,23035,24184,95.2,46879,22848,24031,95.1
'38,경상남도,'070,65~69세,2019,169077,82596,86481,95.5,167991,82075,85916,95.5
'38,경상남도,'070001, 65세,2019,39034,19503,19531,99.9,38743,19375,19368,100
'38,경상남도,'070002, 66세,2019,34052,16647,17405,95.6,33789,16516,17273,95.6
'38,경상남도,'070003, 67세,2019,37373,18214,19159,95.1,37171,18109,19062,95
'38,경상남도,'070004, 68세,2019,29271,14055,15216,92.4,29105,13978,15127,92.4
'38,경상남도,'070005, 69세,2019,29347,14177,15170,93.5,29183,14097,15086,93.4
'38,경상남도,'075,70~74세,2019,125887,58619,67268,87.1,125455,58418,67037,87.1
'38,경상남도,'075001, 70세,2019,29699,14238,15461,92.1,29570,14174,15396,92.1
'38,경상남도,'075002, 71세,2019,29049,13823,15226,90.8,28960,13780,15180,90.8
'38,경상남도,'075003, 72세,2019,27182,12511,14671,85.3,27098,12476,14622,85.3
'38,경상남도,'075004, 73세,2019,19837,9166,10671,85.9,19769,9134,10635,85.9
'38,경상남도,'075005, 74세,2019,20120,8881,11239,79,20058,8854,11204,79
'38,경상남도,'080,75~79세,2019,108310,43045,65265,66,108114,42969,65145,66
'38,경상남도,'080001, 75세,2019,21297,9074,12223,74.2,21253,9059,12194,74.3
'38,경상남도,'080002, 76세,2019,21822,8906,12916,69,21786,8890,12896,68.9
'38,경상남도,'080003, 77세,2019,24612,9725,14887,65.3,24575,9709,14866,65.3
'38,경상남도,'080004, 78세,2019,21090,8168,12922,63.2,21052,8157,12895,63.3
'38,경상남도,'080005, 79세,2019,19489,7172,12317,58.2,19448,7154,12294,58.2
'38,경상남도,'085,80~84세,2019,76533,25451,51082,49.8,76411,25402,51009,49.8
'38,경상남도,'085001, 80세,2019,18880,6679,12201,54.7,18854,6671,12183,54.8
'38,경상남도,'085002, 81세,2019,16020,5501,10519,52.3,15977,5486,10491,52.3
'38,경상남도,'085003, 82세,2019,15375,5147,10228,50.3,15358,5139,10219,50.3
'38,경상남도,'085004, 83세,2019,13751,4371,9380,46.6,13733,4363,9370,46.6
'38,경상남도,'085005, 84세,2019,12507,3753,8754,42.9,12489,3743,8746,42.8
'38,경상남도,'086,85세이상,2019,52778,12419,40359,30.8,52700,12392,40308,30.7
'38,경상남도,'090,85~89세,2019,38103,9579,28524,33.6,38059,9569,28490,33.6
'38,경상남도,'090001, 85세,2019,10754,3022,7732,39.1,10740,3018,7722,39.1
'38,경상남도,'090002, 86세,2019,8664,2307,6357,36.3,8657,2306,6351,36.3
'38,경상남도,'090003, 87세,2019,7855,1910,5945,32.1,7845,1909,5936,32.2
'38,경상남도,'090004, 88세,2019,5869,1331,4538,29.3,5862,1329,4533,29.3
'38,경상남도,'090005, 89세,2019,4961,1009,3952,25.5,4955,1007,3948,25.5
'38,경상남도,'095,90~94세,2019,12181,2431,9750,24.9,12156,2420,9736,24.9
'38,경상남도,'095001, 90세,2019,4083,901,3182,28.3,4075,898,3177,28.3
'38,경상남도,'095002, 91세,2019,3019,607,2412,25.2,3015,605,2410,25.1
'38,경상남도,'095003, 92세,2019,2267,442,1825,24.2,2262,440,1822,24.1
'38,경상남도,'095004, 93세,2019,1567,286,1281,22.3,1562,283,1279,22.1
'38,경상남도,'095005, 94세,2019,1245,195,1050,18.6,1242,194,1048,18.5
'38,경상남도,'100,95~99세,2019,2272,377,1895,19.9,2264,372,1892,19.7
'38,경상남도,'100001, 95세,2019,746,134,612,21.9,743,132,611,21.6
'38,경상남도,'100002, 96세,2019,653,106,547,19.4,652,105,547,19.2
'38,경상남도,'100003, 97세,2019,446,72,374,19.3,445,72,373,19.3
'38,경상남도,'100004, 98세,2019,254,37,217,17.1,252,36,216,16.7
'38,경상남도,'100005, 99세,2019,173,28,145,19.3,172,27,145,18.6
'38,경상남도,'101,100세이상,2019,222,32,190,16.8,221,31,190,16.3
'38,경상남도,'102,15세미만,2019,440919,227408,213511,106.5,437667,225757,211910,106.5
'38,경상남도,'103,15~64세,2019,2373705,1254354,1119351,112.1,2272963,1185667,1087296,109
'38,경상남도,'104,65세이상,2019,532585,222130,310455,71.5,530671,221256,309415,71.5
'38,경상남도,'126,평균연령,2019,42.9,41.3,44.6,,43.2,41.6,44.8,
'38,경상남도,'127,중위연령,2019,44.5,42.6,46.4,,45.1,43.4,46.7,
'38004, 읍부,'000,합계,2019,509697,256954,252743,101.7,495865,248400,247465,100.4
'38004, 읍부,'005,0~4세,2019,22516,11513,11003,104.6,22276,11395,10881,104.7
'38004, 읍부,'005001, 0세,2019,3593,1827,1766,103.5,3554,1807,1747,103.4
'38004, 읍부,'005002, 1세,2019,3998,2009,1989,101,3949,1988,1961,101.4
'38004, 읍부,'005003, 2세,2019,4383,2260,2123,106.5,4340,2237,2103,106.4
'38004, 읍부,'005004, 3세,2019,5136,2631,2505,105,5082,2609,2473,105.5
'38004, 읍부,'005005, 4세,2019,5406,2786,2620,106.3,5351,2754,2597,106
'38004, 읍부,'010,5~9세,2019,28141,14460,13681,105.7,27940,14368,13572,105.9
'38004, 읍부,'010001, 5세,2019,5452,2768,2684,103.1,5408,2748,2660,103.3
'38004, 읍부,'010002, 6세,2019,5449,2787,2662,104.7,5401,2760,2641,104.5
'38004, 읍부,'010003, 7세,2019,5955,3089,2866,107.8,5912,3072,2840,108.2
'38004, 읍부,'010004, 8세,2019,5833,2993,2840,105.4,5798,2976,2822,105.5
'38004, 읍부,'010005, 9세,2019,5452,2823,2629,107.4,5421,2812,2609,107.8
'38004, 읍부,'015,10~14세,2019,26082,13487,12595,107.1,25939,13419,12520,107.2
'38004, 읍부,'015001, 10세,2019,5269,2702,2567,105.3,5240,2687,2553,105.2
'38004, 읍부,'015002, 11세,2019,5557,2878,2679,107.4,5521,2867,2654,108
'38004, 읍부,'015003, 12세,2019,5456,2879,2577,111.7,5427,2862,2565,111.6
'38004, 읍부,'015004, 13세,2019,4941,2537,2404,105.5,4922,2528,2394,105.6
'38004, 읍부,'015005, 14세,2019,4859,2491,2368,105.2,4829,2475,2354,105.1
'38004, 읍부,'020,15~19세,2019,27060,14613,12447,117.4,26732,14447,12285,117.6
'38004, 읍부,'020001, 15세,2019,5146,2666,2480,107.5,5121,2657,2464,107.8
'38004, 읍부,'020002, 16세,2019,5320,2896,2424,119.5,5293,2885,2408,119.8
'38004, 읍부,'020003, 17세,2019,5476,2951,2525,116.9,5462,2946,2516,117.1
'38004, 읍부,'020004, 18세,2019,5806,3125,2681,116.6,5740,3093,2647,116.8
'38004, 읍부,'020005, 19세,2019,5312,2975,2337,127.3,5116,2866,2250,127.4
'38004, 읍부,'025,20~24세,2019,27364,16114,11250,143.2,25950,15198,10752,141.4
'38004, 읍부,'025001, 20세,2019,5312,3203,2109,151.9,5129,3088,2041,151.3
'38004, 읍부,'025002, 21세,2019,5487,3305,2182,151.5,5271,3169,2102,150.8
'38004, 읍부,'025003, 22세,2019,5530,3281,2249,145.9,5274,3114,2160,144.2
'38004, 읍부,'025004, 23세,2019,5525,3211,2314,138.8,5180,2981,2199,135.6
'38004, 읍부,'025005, 24세,2019,5510,3114,2396,130,5096,2846,2250,126.5
'38004, 읍부,'030,25~29세,2019,27818,15027,12791,117.5,25354,13413,11941,112.3
'38004, 읍부,'030001, 25세,2019,5413,2947,2466,119.5,4978,2662,2316,114.9
'38004, 읍부,'030002, 26세,2019,5570,3005,2565,117.2,5089,2701,2388,113.1
'38004, 읍부,'030003, 27세,2019,5649,2997,2652,113,5142,2655,2487,106.8
'38004, 읍부,'030004, 28세,2019,5541,3021,2520,119.9,5012,2678,2334,114.7
'38004, 읍부,'030005, 29세,2019,5645,3057,2588,118.1,5133,2717,2416,112.5
'38004, 읍부,'035,30~34세,2019,29695,15635,14060,111.2,26989,13802,13187,104.7
'38004, 읍부,'035001, 30세,2019,5562,3013,2549,118.2,5022,2647,2375,111.5
'38004, 읍부,'035002, 31세,2019,5617,3012,2605,115.6,5034,2606,2428,107.3
'38004, 읍부,'035003, 32세,2019,5978,3070,2908,105.6,5418,2694,2724,98.9
'38004, 읍부,'035004, 33세,2019,6226,3246,2980,108.9,5665,2879,2786,103.3
'38004, 읍부,'035005, 34세,2019,6312,3294,3018,109.1,5850,2976,2874,103.5
'38004, 읍부,'040,35~39세,2019,41358,21077,20281,103.9,39386,19772,19614,100.8
'38004, 읍부,'040001, 35세,2019,6977,3522,3455,101.9,6518,3219,3299,97.6
'38004, 읍부,'040002, 36세,2019,7921,4007,3914,102.4,7473,3712,3761,98.7
'38004, 읍부,'040003, 37세,2019,8632,4422,4210,105,8234,4147,4087,101.5
'38004, 읍부,'040004, 38세,2019,8758,4470,4288,104.2,8407,4240,4167,101.8
'38004, 읍부,'040005, 39세,2019,9070,4656,4414,105.5,8754,4454,4300,103.6
'38004, 읍부,'045,40~44세,2019,40233,20570,19663,104.6,38916,19756,19160,103.1
'38004, 읍부,'045001, 40세,2019,8459,4286,4173,102.7,8169,4111,4058,101.3
'38004, 읍부,'045002, 41세,2019,7981,4077,3904,104.4,7686,3889,3797,102.4
'38004, 읍부,'045003, 42세,2019,7958,4064,3894,104.4,7701,3903,3798,102.8
'38004, 읍부,'045004, 43세,2019,7694,3964,3730,106.3,7440,3803,3637,104.6
'38004, 읍부,'045005, 44세,2019,8141,4179,3962,105.5,7920,4050,3870,104.7
'38004, 읍부,'050,45~49세,2019,44569,23063,21506,107.2,43540,22460,21080,106.5
'38004, 읍부,'050001, 45세,2019,8716,4519,4197,107.7,8484,4374,4110,106.4
'38004, 읍부,'050002, 46세,2019,8774,4472,4302,104,8568,4357,4211,103.5
'38004, 읍부,'050003, 47세,2019,8733,4578,4155,110.2,8541,4464,4077,109.5
'38004, 읍부,'050004, 48세,2019,9299,4816,4483,107.4,9097,4701,4396,106.9
'38004, 읍부,'050005, 49세,2019,9047,4678,4369,107.1,8850,4564,4286,106.5
'38004, 읍부,'055,50~54세,2019,42336,21755,20581,105.7,41506,21288,20218,105.3
'38004, 읍부,'055001, 50세,2019,9187,4813,4374,110,8988,4696,4292,109.4
'38004, 읍부,'055002, 51세,2019,9050,4590,4460,102.9,8863,4475,4388,102
'38004, 읍부,'055003, 52세,2019,8122,4101,4021,102,7954,4014,3940,101.9
'38004, 읍부,'055004, 53세,2019,8059,4227,3832,110.3,7910,4147,3763,110.2
'38004, 읍부,'055005, 54세,2019,7918,4024,3894,103.3,7791,3956,3835,103.2
'38004, 읍부,'060,55~59세,2019,40586,20709,19877,104.2,40013,20440,19573,104.4
'38004, 읍부,'060001, 55세,2019,7189,3704,3485,106.3,7040,3640,3400,107.1
'38004, 읍부,'060002, 56세,2019,7677,3979,3698,107.6,7549,3913,3636,107.6
'38004, 읍부,'060003, 57세,2019,8230,4270,3960,107.8,8126,4215,3911,107.8
'38004, 읍부,'060004, 58세,2019,8911,4454,4457,99.9,8817,4411,4406,100.1
'38004, 읍부,'060005, 59세,2019,8579,4302,4277,100.6,8481,4261,4220,101
'38004, 읍부,'065,60~64세,2019,34997,17439,17558,99.3,34645,17264,17381,99.3
'38004, 읍부,'065001, 60세,2019,7602,3815,3787,100.7,7520,3776,3744,100.9
'38004, 읍부,'065002, 61세,2019,7164,3645,3519,103.6,7076,3604,3472,103.8
'38004, 읍부,'065003, 62세,2019,7197,3589,3608,99.5,7122,3546,3576,99.2
'38004, 읍부,'065004, 63세,2019,6515,3196,3319,96.3,6459,3174,3285,96.6
'38004, 읍부,'065005, 64세,2019,6519,3194,3325,96.1,6468,3164,3304,95.8
'38004, 읍부,'070,65~69세,2019,23944,11548,12396,93.2,23789,11480,12309,93.3
'38004, 읍부,'070001, 65세,2019,5486,2700,2786,96.9,5443,2682,2761,97.1
'38004, 읍부,'070002, 66세,2019,4807,2329,2478,94,4774,2316,2458,94.2
'38004, 읍부,'070003, 67세,2019,5280,2522,2758,91.4,5250,2504,2746,91.2
'38004, 읍부,'070004, 68세,2019,4171,1989,2182,91.2,4147,1981,2166,91.5
'38004, 읍부,'070005, 69세,2019,4200,2008,2192,91.6,4175,1997,2178,91.7
'38004, 읍부,'075,70~74세,2019,17966,8386,9580,87.5,17903,8358,9545,87.6
'38004, 읍부,'075001, 70세,2019,4326,2065,2261,91.3,4310,2058,2252,91.4
'38004, 읍부,'075002, 71세,2019,4086,1941,2145,90.5,4070,1935,2135,90.6
'38004, 읍부,'075003, 72세,2019,3855,1793,2062,87,3844,1788,2056,87
'38004, 읍부,'075004, 73세,2019,2844,1353,1491,90.7,2832,1348,1484,90.8
'38004, 읍부,'075005, 74세,2019,2855,1234,1621,76.1,2847,1229,1618,76
'38004, 읍부,'080,75~79세,2019,15620,6051,9569,63.2,15594,6042,9552,63.3
'38004, 읍부,'080001, 75세,2019,3034,1269,1765,71.9,3031,1268,1763,71.9
'38004, 읍부,'080002, 76세,2019,3119,1255,1864,67.3,3111,1251,1860,67.3
'38004, 읍부,'080003, 77세,2019,3488,1299,2189,59.3,3484,1297,2187,59.3
'38004, 읍부,'080004, 78세,2019,3114,1176,1938,60.7,3110,1176,1934,60.8
'38004, 읍부,'080005, 79세,2019,2865,1052,1813,58,2858,1050,1808,58.1
'38004, 읍부,'085,80~84세,2019,11305,3645,7660,47.6,11295,3639,7656,47.5
'38004, 읍부,'085001, 80세,2019,2774,976,1798,54.3,2772,975,1797,54.3
'38004, 읍부,'085002, 81세,2019,2384,803,1581,50.8,2382,802,1580,50.8
'38004, 읍부,'085003, 82세,2019,2290,747,1543,48.4,2288,745,1543,48.3
'38004, 읍부,'085004, 83세,2019,2033,634,1399,45.3,2031,633,1398,45.3
'38004, 읍부,'085005, 84세,2019,1824,485,1339,36.2,1822,484,1338,36.2
'38004, 읍부,'086,85세이상,2019,8107,1862,6245,29.8,8098,1859,6239,29.8
'38004, 읍부,'090,85~89세,2019,5794,1438,4356,33,5791,1438,4353,33
'38004, 읍부,'090001, 85세,2019,1595,441,1154,38.2,1594,441,1153,38.2
'38004, 읍부,'090002, 86세,2019,1330,382,948,40.3,1330,382,948,40.3
'38004, 읍부,'090003, 87세,2019,1183,275,908,30.3,1181,275,906,30.4
'38004, 읍부,'090004, 88세,2019,887,187,700,26.7,887,187,700,26.7
'38004, 읍부,'090005, 89세,2019,799,153,646,23.7,799,153,646,23.7
'38004, 읍부,'095,90~94세,2019,1920,356,1564,22.8,1916,354,1562,22.7
'38004, 읍부,'095001, 90세,2019,648,136,512,26.6,645,134,511,26.2
'38004, 읍부,'095002, 91세,2019,481,87,394,22.1,480,87,393,22.1
'38004, 읍부,'095003, 92세,2019,378,69,309,22.3,378,69,309,22.3
'38004, 읍부,'095004, 93세,2019,244,35,209,16.7,244,35,209,16.7
'38004, 읍부,'095005, 94세,2019,169,29,140,20.7,169,29,140,20.7
'38004, 읍부,'100,95~99세,2019,356,60,296,20.3,354,59,295,20
'38004, 읍부,'100001, 95세,2019,129,26,103,25.2,128,25,103,24.3
'38004, 읍부,'100002, 96세,2019,90,16,74,21.6,90,16,74,21.6
'38004, 읍부,'100003, 97세,2019,67,10,57,17.5,67,10,57,17.5
'38004, 읍부,'100004, 98세,2019,39,7,32,21.9,38,7,31,22.6
'38004, 읍부,'100005, 99세,2019,31,X,30,3.3,31,X,30,3.3
'38004, 읍부,'101,100세이상,2019,37,8,29,27.6,37,8,29,27.6
'38004, 읍부,'102,15세미만,2019,76739,39460,37279,105.9,76155,39182,36973,106
'38004, 읍부,'103,15~64세,2019,356016,186002,170014,109.4,343031,177840,165191,107.7
'38004, 읍부,'104,65세이상,2019,76942,31492,45450,69.3,76679,31378,45301,69.3
'38004, 읍부,'126,평균연령,2019,41.8,40.3,43.4,,42,40.5,43.5,
'38004, 읍부,'127,중위연령,2019,43.1,41.6,44.6,,43.5,42.1,45,
'38005, 면부,'000,합계,2019,700689,358337,342352,104.7,663389,330065,333324,99
'38005, 면부,'005,0~4세,2019,21179,10822,10357,104.5,20933,10703,10230,104.6
'38005, 면부,'005001, 0세,2019,3393,1728,1665,103.8,3369,1719,1650,104.2
'38005, 면부,'005002, 1세,2019,3790,1932,1858,104,3742,1911,1831,104.4
'38005, 면부,'005003, 2세,2019,4255,2231,2024,110.2,4200,2202,1998,110.2
'38005, 면부,'005004, 3세,2019,4695,2364,2331,101.4,4641,2337,2304,101.4
'38005, 면부,'005005, 4세,2019,5046,2567,2479,103.5,4981,2534,2447,103.6
'38005, 면부,'010,5~9세,2019,24972,12980,11992,108.2,24798,12888,11910,108.2
'38005, 면부,'010001, 5세,2019,5047,2600,2447,106.3,4996,2575,2421,106.4
'38005, 면부,'010002, 6세,2019,4835,2554,2281,112,4789,2529,2260,111.9
'38005, 면부,'010003, 7세,2019,5125,2670,2455,108.8,5092,2651,2441,108.6
'38005, 면부,'010004, 8세,2019,5082,2647,2435,108.7,5058,2633,2425,108.6
'38005, 면부,'010005, 9세,2019,4883,2509,2374,105.7,4863,2500,2363,105.8
'38005, 면부,'015,10~14세,2019,22416,11597,10819,107.2,22332,11550,10782,107.1
'38005, 면부,'015001, 10세,2019,4672,2385,2287,104.3,4656,2375,2281,104.1
'38005, 면부,'015002, 11세,2019,4764,2436,2328,104.6,4749,2428,2321,104.6
'38005, 면부,'015003, 12세,2019,4727,2488,2239,111.1,4711,2479,2232,111.1
'38005, 면부,'015004, 13세,2019,4207,2206,2001,110.2,4186,2195,1991,110.2
'38005, 면부,'015005, 14세,2019,4046,2082,1964,106,4030,2073,1957,105.9
'38005, 면부,'020,15~19세,2019,23017,12569,10448,120.3,22757,12412,10345,120
'38005, 면부,'020001, 15세,2019,4350,2302,2048,112.4,4339,2297,2042,112.5
'38005, 면부,'020002, 16세,2019,4710,2426,2284,106.2,4697,2416,2281,105.9
'38005, 면부,'020003, 17세,2019,4997,2672,2325,114.9,4962,2650,2312,114.6
'38005, 면부,'020004, 18세,2019,5037,2698,2339,115.3,4988,2671,2317,115.3
'38005, 면부,'020005, 19세,2019,3923,2471,1452,170.2,3771,2378,1393,170.7
'38005, 면부,'025,20~24세,2019,27923,17585,10338,170.1,23480,14428,9052,159.4
'38005, 면부,'025001, 20세,2019,4571,3074,1497,205.3,4257,2847,1410,201.9
'38005, 면부,'025002, 21세,2019,5274,3410,1864,182.9,4706,3048,1658,183.8
'38005, 면부,'025003, 22세,2019,5711,3491,2220,157.3,4775,2838,1937,146.5
'38005, 면부,'025004, 23세,2019,6008,3659,2349,155.8,4834,2808,2026,138.6
'38005, 면부,'025005, 24세,2019,6359,3951,2408,164.1,4908,2887,2021,142.9
'38005, 면부,'030,25~29세,2019,34168,21267,12901,164.8,25420,14429,10991,131.3
'38005, 면부,'030001, 25세,2019,6647,4147,2500,165.9,5092,2961,2131,138.9
'38005, 면부,'030002, 26세,2019,6825,4271,2554,167.2,5049,2904,2145,135.4
'38005, 면부,'030003, 27세,2019,6862,4309,2553,168.8,5121,2918,2203,132.5
'38005, 면부,'030004, 28세,2019,6820,4207,2613,161,5093,2851,2242,127.2
'38005, 면부,'030005, 29세,2019,7014,4333,2681,161.6,5065,2795,2270,123.1
'38005, 면부,'035,30~34세,2019,36516,22029,14487,152.1,27886,14944,12942,115.5
'38005, 면부,'035001, 30세,2019,7068,4350,2718,160,5296,2893,2403,120.4
'38005, 면부,'035002, 31세,2019,7131,4324,2807,154,5317,2862,2455,116.6
'38005, 면부,'035003, 32세,2019,7237,4325,2912,148.5,5455,2864,2591,110.5
'38005, 면부,'035004, 33세,2019,7381,4486,2895,155,5729,3123,2606,119.8
'38005, 면부,'035005, 34세,2019,7699,4544,3155,144,6089,3202,2887,110.9
'38005, 면부,'040,35~39세,2019,45707,26078,19629,132.9,39876,21352,18524,115.3
'38005, 면부,'040001, 35세,2019,8214,4711,3503,134.5,6799,3549,3250,109.2
'38005, 면부,'040002, 36세,2019,8912,5090,3822,133.2,7644,4054,3590,112.9
'38005, 면부,'040003, 37세,2019,9459,5374,4085,131.6,8270,4434,3836,115.6
'38005, 면부,'040004, 38세,2019,9427,5353,4074,131.4,8379,4514,3865,116.8
'38005, 면부,'040005, 39세,2019,9695,5550,4145,133.9,8784,4801,3983,120.5
'38005, 면부,'045,40~44세,2019,41105,23784,17321,137.3,37781,21243,16538,128.4
'38005, 면부,'045001, 40세,2019,8847,5150,3697,139.3,7997,4475,3522,127.1
'38005, 면부,'045002, 41세,2019,8038,4629,3409,135.8,7314,4064,3250,125
'38005, 면부,'045003, 42세,2019,8021,4602,3419,134.6,7367,4117,3250,126.7
'38005, 면부,'045004, 43세,2019,7846,4633,3213,144.2,7269,4183,3086,135.5
'38005, 면부,'045005, 44세,2019,8353,4770,3583,133.1,7834,4404,3430,128.4
'38005, 면부,'050,45~49세,2019,47068,26620,20448,130.2,44881,25074,19807,126.6
'38005, 면부,'050001, 45세,2019,8756,5063,3693,137.1,8278,4709,3569,131.9
'38005, 면부,'050002, 46세,2019,9309,5255,4054,129.6,8834,4935,3899,126.6
'38005, 면부,'050003, 47세,2019,9029,5164,3865,133.6,8567,4833,3734,129.4
'38005, 면부,'050004, 48세,2019,9879,5553,4326,128.4,9480,5274,4206,125.4
'38005, 면부,'050005, 49세,2019,10095,5585,4510,123.8,9722,5323,4399,121
'38005, 면부,'055,50~54세,2019,54125,29041,25084,115.8,52623,28103,24520,114.6
'38005, 면부,'055001, 50세,2019,10523,5778,4745,121.8,10162,5564,4598,121
'38005, 면부,'055002, 51세,2019,10784,5753,5031,114.4,10482,5558,4924,112.9
'38005, 면부,'055003, 52세,2019,10683,5668,5015,113,10362,5465,4897,111.6
'38005, 면부,'055004, 53세,2019,10892,5936,4956,119.8,10633,5762,4871,118.3
'38005, 면부,'055005, 54세,2019,11243,5906,5337,110.7,10984,5754,5230,110
'38005, 면부,'060,55~59세,2019,64723,33128,31595,104.9,63774,32578,31196,104.4
'38005, 면부,'060001, 55세,2019,10153,5176,4977,104,9935,5060,4875,103.8
'38005, 면부,'060002, 56세,2019,11611,6159,5452,113,11359,6013,5346,112.5
'38005, 면부,'060003, 57세,2019,13051,6792,6259,108.5,12872,6681,6191,107.9
'38005, 면부,'060004, 58세,2019,14932,7524,7408,101.6,14799,7446,7353,101.3
'38005, 면부,'060005, 59세,2019,14976,7477,7499,99.7,14809,7378,7431,99.3
'38005, 면부,'065,60~64세,2019,65676,33458,32218,103.8,65133,33164,31969,103.7
'38005, 면부,'065001, 60세,2019,13320,6795,6525,104.1,13195,6734,6461,104.2
'38005, 면부,'065002, 61세,2019,12895,6638,6257,106.1,12763,6567,6196,106
'38005, 면부,'065003, 62세,2019,13544,6939,6605,105.1,13439,6879,6560,104.9
'38005, 면부,'065004, 63세,2019,12762,6568,6194,106,12660,6513,6147,106
'38005, 면부,'065005, 64세,2019,13155,6518,6637,98.2,13076,6471,6605,98
'38005, 면부,'070,65~69세,2019,50676,25056,25620,97.8,50452,24941,25511,97.8
'38005, 면부,'070001, 65세,2019,11043,5534,5509,100.5,10983,5505,5478,100.5
'38005, 면부,'070002, 66세,2019,10089,4973,5116,97.2,10029,4941,5088,97.1
'38005, 면부,'070003, 67세,2019,11251,5593,5658,98.9,11217,5571,5646,98.7
'38005, 면부,'070004, 68세,2019,9082,4424,4658,95,9053,4415,4638,95.2
'38005, 면부,'070005, 69세,2019,9211,4532,4679,96.9,9170,4509,4661,96.7
'38005, 면부,'075,70~74세,2019,41684,19558,22126,88.4,41604,19519,22085,88.4
'38005, 면부,'075001, 70세,2019,9569,4760,4809,99,9544,4745,4799,98.9
'38005, 면부,'075002, 71세,2019,9458,4565,4893,93.3,9439,4555,4884,93.3
'38005, 면부,'075003, 72세,2019,8996,4204,4792,87.7,8983,4198,4785,87.7
'38005, 면부,'075004, 73세,2019,6644,3004,3640,82.5,6636,3001,3635,82.6
'38005, 면부,'075005, 74세,2019,7017,3025,3992,75.8,7002,3020,3982,75.8
'38005, 면부,'080,75~79세,2019,42149,16216,25933,62.5,42113,16200,25913,62.5
'38005, 면부,'080001, 75세,2019,7689,3181,4508,70.6,7681,3176,4505,70.5
'38005, 면부,'080002, 76세,2019,8099,3194,4905,65.1,8093,3193,4900,65.2
'38005, 면부,'080003, 77세,2019,9766,3758,6008,62.5,9759,3755,6004,62.5
'38005, 면부,'080004, 78세,2019,8538,3216,5322,60.4,8530,3213,5317,60.4
'38005, 면부,'080005, 79세,2019,8057,2867,5190,55.2,8050,2863,5187,55.2
'38005, 면부,'085,80~84세,2019,33354,10841,22513,48.2,33334,10834,22500,48.2
'38005, 면부,'085001, 80세,2019,8074,2766,5308,52.1,8070,2765,5305,52.1
'38005, 면부,'085002, 81세,2019,6940,2329,4611,50.5,6930,2326,4604,50.5
'38005, 면부,'085003, 82세,2019,6704,2186,4518,48.4,6703,2186,4517,48.4
'38005, 면부,'085004, 83세,2019,6059,1901,4158,45.7,6057,1901,4156,45.7
'38005, 면부,'085005, 84세,2019,5577,1659,3918,42.3,5574,1656,3918,42.3
'38005, 면부,'086,85세이상,2019,24231,5708,18523,30.8,24212,5703,18509,30.8
'38005, 면부,'090,85~89세,2019,17585,4421,13164,33.6,17574,4420,13154,33.6
'38005, 면부,'090001, 85세,2019,4980,1384,3596,38.5,4977,1384,3593,38.5
'38005, 면부,'090002, 86세,2019,4031,1032,2999,34.4,4029,1032,2997,34.4
'38005, 면부,'090003, 87세,2019,3592,902,2690,33.5,3590,902,2688,33.6
'38005, 면부,'090004, 88세,2019,2722,631,2091,30.2,2719,630,2089,30.2
'38005, 면부,'090005, 89세,2019,2260,472,1788,26.4,2259,472,1787,26.4
'38005, 면부,'095,90~94세,2019,5514,1116,4398,25.4,5510,1115,4395,25.4
'38005, 면부,'095001, 90세,2019,1803,406,1397,29.1,1802,406,1396,29.1
'38005, 면부,'095002, 91세,2019,1375,281,1094,25.7,1375,281,1094,25.7
'38005, 면부,'095003, 92세,2019,1040,201,839,24,1039,201,838,24
'38005, 면부,'095004, 93세,2019,734,147,587,25,732,146,586,24.9
'38005, 면부,'095005, 94세,2019,562,81,481,16.8,562,81,481,16.8
'38005, 면부,'100,95~99세,2019,1040,162,878,18.5,1037,160,877,18.2
'38005, 면부,'100001, 95세,2019,317,56,261,21.5,316,55,261,21.1
'38005, 면부,'100002, 96세,2019,304,47,257,18.3,303,46,257,17.9
'38005, 면부,'100003, 97세,2019,221,31,190,16.3,220,31,189,16.4
'38005, 면부,'100004, 98세,2019,123,14,109,12.8,123,14,109,12.8
'38005, 면부,'100005, 99세,2019,75,14,61,23,75,14,61,23
'38005, 면부,'101,100세이상,2019,92,9,83,10.8,91,8,83,9.6
'38005, 면부,'102,15세미만,2019,68567,35399,33168,106.7,68063,35141,32922,106.7
'38005, 면부,'103,15~64세,2019,440028,245559,194469,126.3,403611,217727,185884,117.1
'38005, 면부,'104,65세이상,2019,192094,77379,114715,67.5,191715,77197,114518,67.4
'38005, 면부,'126,평균연령,2019,49.5,46.7,52.4,,50.3,47.8,52.8,
'38005, 면부,'127,중위연령,2019,52.5,48.9,56.4,,54,51.1,57.1,
'38003, 동부,'000,합계,2019,2136823,1088601,1048222,103.9,2082047,1054215,1027832,102.6
'38003, 동부,'005,0~4세,2019,81881,42028,39853,105.5,80851,41486,39365,105.4
'38003, 동부,'005001, 0세,2019,12744,6504,6240,104.2,12574,6413,6161,104.1
'38003, 동부,'005002, 1세,2019,14232,7357,6875,107,14027,7250,6777,107
'38003, 동부,'005003, 2세,2019,16260,8324,7936,104.9,16056,8219,7837,104.9
'38003, 동부,'005004, 3세,2019,18696,9587,9109,105.2,18462,9466,8996,105.2
'38003, 동부,'005005, 4세,2019,19949,10256,9693,105.8,19732,10138,9594,105.7
'38003, 동부,'010,5~9세,2019,107240,55280,51960,106.4,106529,54920,51609,106.4
'38003, 동부,'010001, 5세,2019,20257,10473,9784,107,20065,10381,9684,107.2
'38003, 동부,'010002, 6세,2019,20424,10449,9975,104.8,20275,10379,9896,104.9
'38003, 동부,'010003, 7세,2019,22679,11669,11010,106,22519,11592,10927,106.1
'38003, 동부,'010004, 8세,2019,22341,11503,10838,106.1,22239,11443,10796,106
'38003, 동부,'010005, 9세,2019,21539,11186,10353,108,21431,11125,10306,107.9
'38003, 동부,'015,10~14세,2019,106492,55241,51251,107.8,106069,55028,51041,107.8
'38003, 동부,'015001, 10세,2019,20854,10873,9981,108.9,20753,10830,9923,109.1
'38003, 동부,'015002, 11세,2019,22140,11311,10829,104.5,22053,11266,10787,104.4
'38003, 동부,'015003, 12세,2019,22690,11693,10997,106.3,22588,11636,10952,106.2
'38003, 동부,'015004, 13세,2019,20632,10785,9847,109.5,20561,10750,9811,109.6
'38003, 동부,'015005, 14세,2019,20176,10579,9597,110.2,20114,10546,9568,110.2
'38003, 동부,'020,15~19세,2019,116925,62596,54329,115.2,115946,62102,53844,115.3
'38003, 동부,'020001, 15세,2019,21991,11594,10397,111.5,21910,11552,10358,111.5
'38003, 동부,'020002, 16세,2019,21827,11506,10321,111.5,21755,11469,10286,111.5
'38003, 동부,'020003, 17세,2019,22977,12029,10948,109.9,22874,11973,10901,109.8
'38003, 동부,'020004, 18세,2019,25164,13447,11717,114.8,24939,13323,11616,114.7
'38003, 동부,'020005, 19세,2019,24966,14020,10946,128.1,24468,13785,10683,129
'38003, 동부,'025,20~24세,2019,137129,77948,59181,131.7,131328,74452,56876,130.9
'38003, 동부,'025001, 20세,2019,25537,14605,10932,133.6,24779,14211,10568,134.5
'38003, 동부,'025002, 21세,2019,27221,15562,11659,133.5,26200,14990,11210,133.7
'38003, 동부,'025003, 22세,2019,27880,15689,12191,128.7,26720,14988,11732,127.8
'38003, 동부,'025004, 23세,2019,28458,16260,12198,133.3,27107,15396,11711,131.5
'38003, 동부,'025005, 24세,2019,28033,15832,12201,129.8,26522,14867,11655,127.6
'38003, 동부,'030,25~29세,2019,134143,74776,59367,126,124660,68429,56231,121.7
'38003, 동부,'030001, 25세,2019,27636,15588,12048,129.4,25996,14543,11453,127
'38003, 동부,'030002, 26세,2019,27302,15311,11991,127.7,25575,14154,11421,123.9
'38003, 동부,'030003, 27세,2019,27328,15012,12316,121.9,25396,13743,11653,117.9
'38003, 동부,'030004, 28세,2019,26103,14396,11707,123,24119,13043,11076,117.8
'38003, 동부,'030005, 29세,2019,25774,14469,11305,128,23574,12946,10628,121.8
'38003, 동부,'035,30~34세,2019,128598,70215,58383,120.3,118345,63205,55140,114.6
'38003, 동부,'035001, 30세,2019,25082,13892,11190,124.1,22979,12468,10511,118.6
'38003, 동부,'035002, 31세,2019,24571,13512,11059,122.2,22507,12109,10398,116.5
'38003, 동부,'035003, 32세,2019,25470,13698,11772,116.4,23310,12233,11077,110.4
'38003, 동부,'035004, 33세,2019,26139,14376,11763,122.2,24131,12967,11164,116.2
'38003, 동부,'035005, 34세,2019,27336,14737,12599,117,25418,13428,11990,112
'38003, 동부,'040,35~39세,2019,170340,89072,81268,109.6,162610,83823,78787,106.4
'38003, 동부,'040001, 35세,2019,28881,15385,13496,114,27078,14157,12921,109.6
'38003, 동부,'040002, 36세,2019,32204,16962,15242,111.3,30542,15821,14721,107.5
'38003, 동부,'040003, 37세,2019,35475,18429,17046,108.1,33885,17363,16522,105.1
'38003, 동부,'040004, 38세,2019,36233,19083,17150,111.3,34819,18129,16690,108.6
'38003, 동부,'040005, 39세,2019,37547,19213,18334,104.8,36286,18353,17933,102.3
'38003, 동부,'045,40~44세,2019,169405,86530,82875,104.4,164155,83107,81048,102.5
'38003, 동부,'045001, 40세,2019,35445,18314,17131,106.9,34190,17489,16701,104.7
'38003, 동부,'045002, 41세,2019,32788,16995,15793,107.6,31653,16270,15383,105.8
'38003, 동부,'045003, 42세,2019,33172,16925,16247,104.2,32223,16314,15909,102.5
'38003, 동부,'045004, 43세,2019,32741,16645,16096,103.4,31757,15971,15786,101.2
'38003, 동부,'045005, 44세,2019,35259,17651,17608,100.2,34332,17063,17269,98.8
'38003, 동부,'050,45~49세,2019,200066,100832,99234,101.6,195684,98179,97505,100.7
'38003, 동부,'050001, 45세,2019,38659,19405,19254,100.8,37766,18854,18912,99.7
'38003, 동부,'050002, 46세,2019,39830,19911,19919,100,39032,19424,19608,99.1
'38003, 동부,'050003, 47세,2019,38659,19824,18835,105.3,37758,19271,18487,104.2
'38003, 동부,'050004, 48세,2019,41845,21094,20751,101.7,40916,20530,20386,100.7
'38003, 동부,'050005, 49세,2019,41073,20598,20475,100.6,40212,20100,20112,99.9
'38003, 동부,'055,50~54세,2019,192711,96433,96278,100.2,189240,94511,94729,99.8
'38003, 동부,'055001, 50세,2019,40984,20510,20474,100.2,40195,20066,20129,99.7
'38003, 동부,'055002, 51세,2019,40996,20285,20711,97.9,40246,19861,20385,97.4
'38003, 동부,'055003, 52세,2019,37538,18499,19039,97.2,36886,18148,18738,96.9
'38003, 동부,'055004, 53세,2019,36624,18895,17729,106.6,35973,18552,17421,106.5
'38003, 동부,'055005, 54세,2019,36569,18244,18325,99.6,35940,17884,18056,99
'38003, 동부,'060,55~59세,2019,181014,91215,89799,101.6,178404,89843,88561,101.4
'38003, 동부,'060001, 55세,2019,31874,16122,15752,102.3,31256,15798,15458,102.2
'38003, 동부,'060002, 56세,2019,35401,18329,17072,107.4,34743,17970,16773,107.1
'38003, 동부,'060003, 57세,2019,36521,18468,18053,102.3,35990,18187,17803,102.2
'38003, 동부,'060004, 58세,2019,39309,19494,19815,98.4,38930,19302,19628,98.3
'38003, 동부,'060005, 59세,2019,37909,18802,19107,98.4,37485,18586,18899,98.3
'38003, 동부,'065,60~64세,2019,147330,73176,74154,98.7,145949,72449,73500,98.6
'38003, 동부,'065001, 60세,2019,32909,16629,16280,102.1,32582,16451,16131,102
'38003, 동부,'065002, 61세,2019,30604,15357,15247,100.7,30276,15184,15092,100.6
'38003, 동부,'065003, 62세,2019,29503,14746,14757,99.9,29237,14605,14632,99.8
'38003, 동부,'065004, 63세,2019,26769,13121,13648,96.1,26519,12996,13523,96.1
'38003, 동부,'065005, 64세,2019,27545,13323,14222,93.7,27335,13213,14122,93.6
'38003, 동부,'070,65~69세,2019,94457,45992,48465,94.9,93750,45654,48096,94.9
'38003, 동부,'070001, 65세,2019,22505,11269,11236,100.3,22317,11188,11129,100.5
'38003, 동부,'070002, 66세,2019,19156,9345,9811,95.3,18986,9259,9727,95.2
'38003, 동부,'070003, 67세,2019,20842,10099,10743,94,20704,10034,10670,94
'38003, 동부,'070004, 68세,2019,16018,7642,8376,91.2,15905,7582,8323,91.1
'38003, 동부,'070005, 69세,2019,15936,7637,8299,92,15838,7591,8247,92
'38003, 동부,'075,70~74세,2019,66237,30675,35562,86.3,65948,30541,35407,86.3
'38003, 동부,'075001, 70세,2019,15804,7413,8391,88.3,15716,7371,8345,88.3
'38003, 동부,'075002, 71세,2019,15505,7317,8188,89.4,15451,7290,8161,89.3
'38003, 동부,'075003, 72세,2019,14331,6514,7817,83.3,14271,6490,7781,83.4
'38003, 동부,'075004, 73세,2019,10349,4809,5540,86.8,10301,4785,5516,86.7
'38003, 동부,'075005, 74세,2019,10248,4622,5626,82.2,10209,4605,5604,82.2
'38003, 동부,'080,75~79세,2019,50541,20778,29763,69.8,50407,20727,29680,69.8
'38003, 동부,'080001, 75세,2019,10574,4624,5950,77.7,10541,4615,5926,77.9
'38003, 동부,'080002, 76세,2019,10604,4457,6147,72.5,10582,4446,6136,72.5
'38003, 동부,'080003, 77세,2019,11358,4668,6690,69.8,11332,4657,6675,69.8
'38003, 동부,'080004, 78세,2019,9438,3776,5662,66.7,9412,3768,5644,66.8
'38003, 동부,'080005, 79세,2019,8567,3253,5314,61.2,8540,3241,5299,61.2
'38003, 동부,'085,80~84세,2019,31874,10965,20909,52.4,31782,10929,20853,52.4
'38003, 동부,'085001, 80세,2019,8032,2937,5095,57.6,8012,2931,5081,57.7
'38003, 동부,'085002, 81세,2019,6696,2369,4327,54.7,6665,2358,4307,54.7
'38003, 동부,'085003, 82세,2019,6381,2214,4167,53.1,6367,2208,4159,53.1
'38003, 동부,'085004, 83세,2019,5659,1836,3823,48,5645,1829,3816,47.9
'38003, 동부,'085005, 84세,2019,5106,1609,3497,46,5093,1603,3490,45.9
'38003, 동부,'086,85세이상,2019,20440,4849,15591,31.1,20390,4830,15560,31
'38003, 동부,'090,85~89세,2019,14724,3720,11004,33.8,14694,3711,10983,33.8
'38003, 동부,'090001, 85세,2019,4179,1197,2982,40.1,4169,1193,2976,40.1
'38003, 동부,'090002, 86세,2019,3303,893,2410,37.1,3298,892,2406,37.1
'38003, 동부,'090003, 87세,2019,3080,733,2347,31.2,3074,732,2342,31.3
'38003, 동부,'090004, 88세,2019,2260,513,1747,29.4,2256,512,1744,29.4
'38003, 동부,'090005, 89세,2019,1902,384,1518,25.3,1897,382,1515,25.2
'38003, 동부,'095,90~94세,2019,4747,959,3788,25.3,4730,951,3779,25.2
'38003, 동부,'095001, 90세,2019,1632,359,1273,28.2,1628,358,1270,28.2
'38003, 동부,'095002, 91세,2019,1163,239,924,25.9,1160,237,923,25.7
'38003, 동부,'095003, 92세,2019,849,172,677,25.4,845,170,675,25.2
'38003, 동부,'095004, 93세,2019,589,104,485,21.4,586,102,484,21.1
'38003, 동부,'095005, 94세,2019,514,85,429,19.8,511,84,427,19.7
'38003, 동부,'100,95~99세,2019,876,155,721,21.5,873,153,720,21.3
'38003, 동부,'100001, 95세,2019,300,52,248,21,299,52,247,21.1
'38003, 동부,'100002, 96세,2019,259,43,216,19.9,259,43,216,19.9
'38003, 동부,'100003, 97세,2019,158,31,127,24.4,158,31,127,24.4
'38003, 동부,'100004, 98세,2019,92,16,76,21.1,91,15,76,19.7
'38003, 동부,'100005, 99세,2019,67,13,54,24.1,66,12,54,22.2
'38003, 동부,'101,100세이상,2019,93,15,78,19.2,93,15,78,19.2
'38003, 동부,'102,15세미만,2019,295613,152549,143064,106.6,293449,151434,142015,106.6
'38003, 동부,'103,15~64세,2019,1577661,822793,754868,109,1526321,790100,736221,107.3
'38003, 동부,'104,65세이상,2019,263549,113259,150290,75.4,262277,112681,149596,75.3
'38003, 동부,'126,평균연령,2019,41,39.8,42.3,,41.2,40,42.4,
'38003, 동부,'127,중위연령,2019,42.5,40.9,44.2,,42.9,41.4,44.4,
'38030, 진주시,'000,합계,2019,354166,176860,177306,99.7,347014,172576,174438,98.9
'38030, 진주시,'005,0~4세,2019,12820,6566,6254,105,12748,6528,6220,105
'38030, 진주시,'005001, 0세,2019,2048,1008,1040,96.9,2037,1003,1034,97
'38030, 진주시,'005002, 1세,2019,2277,1197,1080,110.8,2257,1188,1069,111.1
'38030, 진주시,'005003, 2세,2019,2532,1296,1236,104.9,2515,1284,1231,104.3
'38030, 진주시,'005004, 3세,2019,2862,1492,1370,108.9,2847,1484,1363,108.9
'38030, 진주시,'005005, 4세,2019,3101,1573,1528,102.9,3092,1569,1523,103
'38030, 진주시,'010,5~9세,2019,16702,8800,7902,111.4,16658,8773,7885,111.3
'38030, 진주시,'010001, 5세,2019,3250,1688,1562,108.1,3232,1674,1558,107.4
'38030, 진주시,'010002, 6세,2019,3122,1686,1436,117.4,3118,1685,1433,117.6
'38030, 진주시,'010003, 7세,2019,3491,1790,1701,105.2,3479,1785,1694,105.4
'38030, 진주시,'010004, 8세,2019,3495,1862,1633,114,3488,1857,1631,113.9
'38030, 진주시,'010005, 9세,2019,3344,1774,1570,113,3341,1772,1569,112.9
'38030, 진주시,'015,10~14세,2019,16592,8638,7954,108.6,16573,8626,7947,108.5
'38030, 진주시,'015001, 10세,2019,3215,1687,1528,110.4,3210,1685,1525,110.5
'38030, 진주시,'015002, 11세,2019,3493,1821,1672,108.9,3487,1817,1670,108.8
'38030, 진주시,'015003, 12세,2019,3525,1780,1745,102,3522,1778,1744,101.9
'38030, 진주시,'015004, 13세,2019,3230,1705,1525,111.8,3228,1703,1525,111.7
'38030, 진주시,'015005, 14세,2019,3129,1645,1484,110.8,3126,1643,1483,110.8
'38030, 진주시,'020,15~19세,2019,20596,11054,9542,115.8,20307,10905,9402,116
'38030, 진주시,'020001, 15세,2019,3548,1912,1636,116.9,3543,1909,1634,116.8
'38030, 진주시,'020002, 16세,2019,3573,1910,1663,114.9,3566,1907,1659,114.9
'38030, 진주시,'020003, 17세,2019,3812,2118,1694,125,3796,2112,1684,125.4
'38030, 진주시,'020004, 18세,2019,4347,2330,2017,115.5,4281,2302,1979,116.3
'38030, 진주시,'020005, 19세,2019,5316,2784,2532,110,5121,2675,2446,109.4
'38030, 진주시,'025,20~24세,2019,28020,15421,12599,122.4,26847,14777,12070,122.4
'38030, 진주시,'025001, 20세,2019,5219,2569,2650,96.9,5048,2481,2567,96.6
'38030, 진주시,'025002, 21세,2019,5782,2944,2838,103.7,5539,2817,2722,103.5
'38030, 진주시,'025003, 22세,2019,5920,3258,2662,122.4,5663,3123,2540,123
'38030, 진주시,'025004, 23세,2019,5780,3491,2289,152.5,5535,3344,2191,152.6
'38030, 진주시,'025005, 24세,2019,5319,3159,2160,146.3,5062,3012,2050,146.9
'38030, 진주시,'030,25~29세,2019,22302,12517,9785,127.9,20809,11596,9213,125.9
'38030, 진주시,'030001, 25세,2019,5068,2947,2121,138.9,4747,2762,1985,139.1
'38030, 진주시,'030002, 26세,2019,4684,2664,2020,131.9,4393,2490,1903,130.8
'38030, 진주시,'030003, 27세,2019,4442,2463,1979,124.5,4181,2298,1883,122
'38030, 진주시,'030004, 28세,2019,4063,2222,1841,120.7,3762,2029,1733,117.1
'38030, 진주시,'030005, 29세,2019,4045,2221,1824,121.8,3726,2017,1709,118
'38030, 진주시,'035,30~34세,2019,19777,10538,9239,114.1,18463,9670,8793,110
'38030, 진주시,'035001, 30세,2019,4036,2231,1805,123.6,3759,2056,1703,120.7
'38030, 진주시,'035002, 31세,2019,3789,2058,1731,118.9,3533,1895,1638,115.7
'38030, 진주시,'035003, 32세,2019,3998,2041,1957,104.3,3725,1862,1863,99.9
'38030, 진주시,'035004, 33세,2019,4029,2133,1896,112.5,3768,1946,1822,106.8
'38030, 진주시,'035005, 34세,2019,3925,2075,1850,112.2,3678,1911,1767,108.1
'38030, 진주시,'040,35~39세,2019,24681,12354,12327,100.2,23753,11754,11999,98
'38030, 진주시,'040001, 35세,2019,4262,2141,2121,100.9,4034,1988,2046,97.2
'38030, 진주시,'040002, 36세,2019,4717,2337,2380,98.2,4515,2197,2318,94.8
'38030, 진주시,'040003, 37세,2019,5130,2573,2557,100.6,4953,2454,2499,98.2
'38030, 진주시,'040004, 38세,2019,5186,2586,2600,99.5,5009,2482,2527,98.2
'38030, 진주시,'040005, 39세,2019,5386,2717,2669,101.8,5242,2633,2609,100.9
'38030, 진주시,'045,40~44세,2019,25193,12613,12580,100.3,24664,12279,12385,99.1
'38030, 진주시,'045001, 40세,2019,5238,2662,2576,103.3,5103,2584,2519,102.6
'38030, 진주시,'045002, 41세,2019,4883,2458,2425,101.4,4770,2382,2388,99.7
'38030, 진주시,'045003, 42세,2019,4878,2402,2476,97,4777,2334,2443,95.5
'38030, 진주시,'045004, 43세,2019,5003,2489,2514,99,4903,2424,2479,97.8
'38030, 진주시,'045005, 44세,2019,5191,2602,2589,100.5,5111,2555,2556,100
'38030, 진주시,'050,45~49세,2019,29923,14974,14949,100.2,29511,14744,14767,99.8
'38030, 진주시,'050001, 45세,2019,5773,2855,2918,97.8,5687,2808,2879,97.5
'38030, 진주시,'050002, 46세,2019,6018,3030,2988,101.4,5946,2993,2953,101.4
'38030, 진주시,'050003, 47세,2019,5691,2899,2792,103.8,5594,2844,2750,103.4
'38030, 진주시,'050004, 48세,2019,6132,3082,3050,101,6043,3030,3013,100.6
'38030, 진주시,'050005, 49세,2019,6309,3108,3201,97.1,6241,3069,3172,96.8
'38030, 진주시,'055,50~54세,2019,29130,14570,14560,100.1,28768,14371,14397,99.8
'38030, 진주시,'055001, 50세,2019,6321,3161,3160,100,6228,3109,3119,99.7
'38030, 진주시,'055002, 51세,2019,6188,3113,3075,101.2,6116,3071,3045,100.9
'38030, 진주시,'055003, 52세,2019,5687,2774,2913,95.2,5613,2741,2872,95.4
'38030, 진주시,'055004, 53세,2019,5488,2844,2644,107.6,5420,2804,2616,107.2
'38030, 진주시,'055005, 54세,2019,5446,2678,2768,96.7,5391,2646,2745,96.4
'38030, 진주시,'060,55~59세,2019,28701,14117,14584,96.8,28441,13983,14458,96.7
'38030, 진주시,'060001, 55세,2019,4695,2298,2397,95.9,4618,2263,2355,96.1
'38030, 진주시,'060002, 56세,2019,5396,2725,2671,102,5337,2696,2641,102.1
'38030, 진주시,'060003, 57세,2019,5758,2891,2867,100.8,5713,2868,2845,100.8
'38030, 진주시,'060004, 58세,2019,6684,3268,3416,95.7,6644,3246,3398,95.5
'38030, 진주시,'060005, 59세,2019,6168,2935,3233,90.8,6129,2910,3219,90.4
'38030, 진주시,'065,60~64세,2019,24817,12099,12718,95.1,24677,12029,12648,95.1
'38030, 진주시,'065001, 60세,2019,5229,2578,2651,97.2,5194,2560,2634,97.2
'38030, 진주시,'065002, 61세,2019,5172,2507,2665,94.1,5134,2490,2644,94.2
'38030, 진주시,'065003, 62세,2019,5017,2502,2515,99.5,4990,2487,2503,99.4
'38030, 진주시,'065004, 63세,2019,4609,2297,2312,99.4,4582,2285,2297,99.5
'38030, 진주시,'065005, 64세,2019,4790,2215,2575,86,4777,2207,2570,85.9
'38030, 진주시,'070,65~69세,2019,17331,8239,9092,90.6,17260,8208,9052,90.7
'38030, 진주시,'070001, 65세,2019,4090,2034,2056,98.9,4074,2030,2044,99.3
'38030, 진주시,'070002, 66세,2019,3419,1609,1810,88.9,3404,1603,1801,89
'38030, 진주시,'070003, 67세,2019,3705,1730,1975,87.6,3691,1723,1968,87.6
'38030, 진주시,'070004, 68세,2019,2925,1373,1552,88.5,2912,1363,1549,88
'38030, 진주시,'070005, 69세,2019,3192,1493,1699,87.9,3179,1489,1690,88.1
'38030, 진주시,'075,70~74세,2019,13454,6145,7309,84.1,13432,6130,7302,83.9
'38030, 진주시,'075001, 70세,2019,3100,1394,1706,81.7,3092,1387,1705,81.3
'38030, 진주시,'075002, 71세,2019,3057,1416,1641,86.3,3053,1415,1638,86.4
'38030, 진주시,'075003, 72세,2019,2882,1336,1546,86.4,2879,1333,1546,86.2
'38030, 진주시,'075004, 73세,2019,2187,997,1190,83.8,2185,995,1190,83.6
'38030, 진주시,'075005, 74세,2019,2228,1002,1226,81.7,2223,1000,1223,81.8
'38030, 진주시,'080,75~79세,2019,11293,4571,6722,68,11280,4563,6717,67.9
'38030, 진주시,'080001, 75세,2019,2287,976,1311,74.4,2283,973,1310,74.3
'38030, 진주시,'080002, 76세,2019,2284,955,1329,71.9,2284,955,1329,71.9
'38030, 진주시,'080003, 77세,2019,2497,1001,1496,66.9,2493,999,1494,66.9
'38030, 진주시,'080004, 78세,2019,2184,880,1304,67.5,2180,878,1302,67.4
'38030, 진주시,'080005, 79세,2019,2041,759,1282,59.2,2040,758,1282,59.1
'38030, 진주시,'085,80~84세,2019,7589,2471,5118,48.3,7582,2468,5114,48.3
'38030, 진주시,'085001, 80세,2019,1871,655,1216,53.9,1869,655,1214,54
'38030, 진주시,'085002, 81세,2019,1604,529,1075,49.2,1603,529,1074,49.3
'38030, 진주시,'085003, 82세,2019,1486,516,970,53.2,1486,516,970,53.2
'38030, 진주시,'085004, 83세,2019,1400,426,974,43.7,1397,424,973,43.6
'38030, 진주시,'085005, 84세,2019,1228,345,883,39.1,1227,344,883,39
'38030, 진주시,'086,85세이상,2019,5245,1173,4072,28.8,5241,1172,4069,28.8
'38030, 진주시,'090,85~89세,2019,3719,885,2834,31.2,3716,884,2832,31.2
'38030, 진주시,'090001, 85세,2019,1066,297,769,38.6,1065,296,769,38.5
'38030, 진주시,'090002, 86세,2019,823,190,633,30,822,190,632,30.1
'38030, 진주시,'090003, 87세,2019,762,187,575,32.5,761,187,574,32.6
'38030, 진주시,'090004, 88세,2019,578,129,449,28.7,578,129,449,28.7
'38030, 진주시,'090005, 89세,2019,490,82,408,20.1,490,82,408,20.1
'38030, 진주시,'095,90~94세,2019,1248,243,1005,24.2,1247,243,1004,24.2
'38030, 진주시,'095001, 90세,2019,391,86,305,28.2,391,86,305,28.2
'38030, 진주시,'095002, 91세,2019,305,62,243,25.5,305,62,243,25.5
'38030, 진주시,'095003, 92세,2019,235,39,196,19.9,235,39,196,19.9
'38030, 진주시,'095004, 93세,2019,157,29,128,22.7,156,29,127,22.8
'38030, 진주시,'095005, 94세,2019,160,27,133,20.3,160,27,133,20.3
'38030, 진주시,'100,95~99세,2019,252,40,212,18.9,252,40,212,18.9
'38030, 진주시,'100001, 95세,2019,85,18,67,26.9,85,18,67,26.9
'38030, 진주시,'100002, 96세,2019,65,11,54,20.4,65,11,54,20.4
'38030, 진주시,'100003, 97세,2019,47,6,41,14.6,47,6,41,14.6
'38030, 진주시,'100004, 98세,2019,33,X,29,13.8,33,X,29,13.8
'38030, 진주시,'100005, 99세,2019,22,X,21,4.8,22,X,21,4.8
'38030, 진주시,'101,100세이상,2019,26,5,21,23.8,26,5,21,23.8
'38030, 진주시,'102,15세미만,2019,46114,24004,22110,108.6,45979,23927,22052,108.5
'38030, 진주시,'103,15~64세,2019,253140,130257,122883,106,246240,126108,120132,105
'38030, 진주시,'104,65세이상,2019,54912,22599,32313,69.9,54795,22541,32254,69.9
'38030, 진주시,'126,평균연령,2019,42,40.3,43.7,,42.2,40.4,43.9,
'38030, 진주시,'127,중위연령,2019,43.1,41,45.2,,43.6,41.5,45.5,
'38050, 통영시,'000,합계,2019,129931,67013,62918,106.5,124592,62723,61869,101.4
'38050, 통영시,'005,0~4세,2019,4215,2100,2115,99.3,4211,2098,2113,99.3
'38050, 통영시,'005001, 0세,2019,546,282,264,106.8,546,282,264,106.8
'38050, 통영시,'005002, 1세,2019,672,324,348,93.1,668,322,346,93.1
'38050, 통영시,'005003, 2세,2019,866,415,451,92,866,415,451,92
'38050, 통영시,'005004, 3세,2019,982,505,477,105.9,982,505,477,105.9
'38050, 통영시,'005005, 4세,2019,1149,574,575,99.8,1149,574,575,99.8
'38050, 통영시,'010,5~9세,2019,6671,3404,3267,104.2,6664,3399,3265,104.1
'38050, 통영시,'010001, 5세,2019,1155,585,570,102.6,1155,585,570,102.6
'38050, 통영시,'010002, 6세,2019,1223,643,580,110.9,1219,640,579,110.5
'38050, 통영시,'010003, 7세,2019,1398,705,693,101.7,1397,705,692,101.9
'38050, 통영시,'010004, 8세,2019,1451,728,723,100.7,1450,727,723,100.6
'38050, 통영시,'010005, 9세,2019,1444,743,701,106,1443,742,701,105.8
'38050, 통영시,'015,10~14세,2019,6407,3306,3101,106.6,6397,3298,3099,106.4
'38050, 통영시,'015001, 10세,2019,1357,720,637,113,1354,717,637,112.6
'38050, 통영시,'015002, 11세,2019,1403,702,701,100.1,1401,701,700,100.1
'38050, 통영시,'015003, 12세,2019,1353,689,664,103.8,1351,687,664,103.5
'38050, 통영시,'015004, 13세,2019,1145,602,543,110.9,1143,601,542,110.9
'38050, 통영시,'015005, 14세,2019,1149,593,556,106.7,1148,592,556,106.5
'38050, 통영시,'020,15~19세,2019,5628,3051,2577,118.4,5595,3029,2566,118
'38050, 통영시,'020001, 15세,2019,1154,614,540,113.7,1150,611,539,113.4
'38050, 통영시,'020002, 16세,2019,1159,579,580,99.8,1158,579,579,100
'38050, 통영시,'020003, 17세,2019,1214,633,581,109,1210,630,580,108.6
'38050, 통영시,'020004, 18세,2019,1216,653,563,116,1211,648,563,115.1
'38050, 통영시,'020005, 19세,2019,885,572,313,182.7,866,561,305,183.9
'38050, 통영시,'025,20~24세,2019,5756,3661,2095,174.7,5231,3216,2015,159.6
'38050, 통영시,'025001, 20세,2019,1060,748,312,239.7,1020,716,304,235.5
'38050, 통영시,'025002, 21세,2019,1131,744,387,192.2,1079,704,375,187.7
'38050, 통영시,'025003, 22세,2019,1158,711,447,159.1,1052,616,436,141.3
'38050, 통영시,'025004, 23세,2019,1202,737,465,158.5,1042,596,446,133.6
'38050, 통영시,'025005, 24세,2019,1205,721,484,149,1038,584,454,128.6
'38050, 통영시,'030,25~29세,2019,6131,3575,2556,139.9,5016,2627,2389,110
'38050, 통영시,'030001, 25세,2019,1167,701,466,150.4,966,531,435,122.1
'38050, 통영시,'030002, 26세,2019,1248,724,524,138.2,1017,530,487,108.8
'38050, 통영시,'030003, 27세,2019,1267,722,545,132.5,1044,530,514,103.1
'38050, 통영시,'030004, 28세,2019,1177,688,489,140.7,970,512,458,111.8
'38050, 통영시,'030005, 29세,2019,1272,740,532,139.1,1019,524,495,105.9
'38050, 통영시,'035,30~34세,2019,6893,4011,2882,139.2,5706,2993,2713,110.3
'38050, 통영시,'035001, 30세,2019,1251,744,507,146.7,1021,548,473,115.9
'38050, 통영시,'035002, 31세,2019,1298,781,517,151.1,1059,572,487,117.5
'38050, 통영시,'035003, 32세,2019,1405,799,606,131.8,1158,596,562,106
'38050, 통영시,'035004, 33세,2019,1364,803,561,143.1,1158,625,533,117.3
'38050, 통영시,'035005, 34세,2019,1575,884,691,127.9,1310,652,658,99.1
'38050, 통영시,'040,35~39세,2019,10430,5695,4735,120.3,9495,4903,4592,106.8
'38050, 통영시,'040001, 35세,2019,1782,997,785,127,1553,807,746,108.2
'38050, 통영시,'040002, 36세,2019,1856,986,870,113.3,1660,817,843,96.9
'38050, 통영시,'040003, 37세,2019,2192,1210,982,123.2,1991,1039,952,109.1
'38050, 통영시,'040004, 38세,2019,2166,1172,994,117.9,2005,1035,970,106.7
'38050, 통영시,'040005, 39세,2019,2434,1330,1104,120.5,2286,1205,1081,111.5
'38050, 통영시,'045,40~44세,2019,10376,5721,4655,122.9,9795,5256,4539,115.8
'38050, 통영시,'045001, 40세,2019,2148,1169,979,119.4,2007,1055,952,110.8
'38050, 통영시,'045002, 41세,2019,2019,1132,887,127.6,1889,1018,871,116.9
'38050, 통영시,'045003, 42세,2019,2082,1134,948,119.6,1963,1043,920,113.4
'38050, 통영시,'045004, 43세,2019,1937,1085,852,127.3,1843,1011,832,121.5
'38050, 통영시,'045005, 44세,2019,2190,1201,989,121.4,2093,1129,964,117.1
'38050, 통영시,'050,45~49세,2019,11262,6164,5098,120.9,10898,5892,5006,117.7
'38050, 통영시,'050001, 45세,2019,2161,1205,956,126,2090,1156,934,123.8
'38050, 통영시,'050002, 46세,2019,2291,1231,1060,116.1,2216,1178,1038,113.5
'38050, 통영시,'050003, 47세,2019,2247,1247,1000,124.7,2162,1179,983,119.9
'38050, 통영시,'050004, 48세,2019,2301,1235,1066,115.9,2230,1180,1050,112.4
'38050, 통영시,'050005, 49세,2019,2262,1246,1016,122.6,2200,1199,1001,119.8
'38050, 통영시,'055,50~54세,2019,10713,5494,5219,105.3,10475,5350,5125,104.4
'38050, 통영시,'055001, 50세,2019,2217,1160,1057,109.7,2167,1134,1033,109.8
'38050, 통영시,'055002, 51세,2019,2298,1229,1069,115,2234,1181,1053,112.2
'38050, 통영시,'055003, 52세,2019,2116,1065,1051,101.3,2070,1041,1029,101.2
'38050, 통영시,'055004, 53세,2019,2019,1008,1011,99.7,1988,986,1002,98.4
'38050, 통영시,'055005, 54세,2019,2063,1032,1031,100.1,2016,1008,1008,100
'38050, 통영시,'060,55~59세,2019,11610,5726,5884,97.3,11432,5632,5800,97.1
'38050, 통영시,'060001, 55세,2019,1856,956,900,106.2,1806,932,874,106.6
'38050, 통영시,'060002, 56세,2019,2101,1083,1018,106.4,2057,1058,999,105.9
'38050, 통영시,'060003, 57세,2019,2377,1160,1217,95.3,2336,1139,1197,95.2
'38050, 통영시,'060004, 58세,2019,2633,1260,1373,91.8,2612,1248,1364,91.5
'38050, 통영시,'060005, 59세,2019,2643,1267,1376,92.1,2621,1255,1366,91.9
'38050, 통영시,'065,60~64세,2019,10821,5290,5531,95.6,10728,5244,5484,95.6
'38050, 통영시,'065001, 60세,2019,2372,1160,1212,95.7,2348,1151,1197,96.2
'38050, 통영시,'065002, 61세,2019,2140,1048,1092,96,2119,1039,1080,96.2
'38050, 통영시,'065003, 62세,2019,2151,1041,1110,93.8,2134,1033,1101,93.8
'38050, 통영시,'065004, 63세,2019,2081,1023,1058,96.7,2064,1013,1051,96.4
'38050, 통영시,'065005, 64세,2019,2077,1018,1059,96.1,2063,1008,1055,95.5
'38050, 통영시,'070,65~69세,2019,7726,3770,3956,95.3,7686,3751,3935,95.3
'38050, 통영시,'070001, 65세,2019,1705,813,892,91.1,1695,808,887,91.1
'38050, 통영시,'070002, 66세,2019,1533,734,799,91.9,1522,727,795,91.4
'38050, 통영시,'070003, 67세,2019,1739,878,861,102,1729,874,855,102.2
'38050, 통영시,'070004, 68세,2019,1460,717,743,96.5,1454,715,739,96.8
'38050, 통영시,'070005, 69세,2019,1289,628,661,95,1286,627,659,95.1
'38050, 통영시,'075,70~74세,2019,5850,2802,3048,91.9,5832,2796,3036,92.1
'38050, 통영시,'075001, 70세,2019,1399,703,696,101,1397,703,694,101.3
'38050, 통영시,'075002, 71세,2019,1408,669,739,90.5,1402,667,735,90.7
'38050, 통영시,'075003, 72세,2019,1243,587,656,89.5,1241,586,655,89.5
'38050, 통영시,'075004, 73세,2019,820,395,425,92.9,816,393,423,92.9
'38050, 통영시,'075005, 74세,2019,980,448,532,84.2,976,447,529,84.5
'38050, 통영시,'080,75~79세,2019,4671,1854,2817,65.8,4669,1853,2816,65.8
'38050, 통영시,'080001, 75세,2019,892,376,516,72.9,891,376,515,73
'38050, 통영시,'080002, 76세,2019,983,419,564,74.3,982,418,564,74.1
'38050, 통영시,'080003, 77세,2019,1108,435,673,64.6,1108,435,673,64.6
'38050, 통영시,'080004, 78세,2019,907,346,561,61.7,907,346,561,61.7
'38050, 통영시,'080005, 79세,2019,781,278,503,55.3,781,278,503,55.3
'38050, 통영시,'085,80~84세,2019,2885,948,1937,48.9,2882,947,1935,48.9
'38050, 통영시,'085001, 80세,2019,701,255,446,57.2,700,254,446,57
'38050, 통영시,'085002, 81세,2019,604,182,422,43.1,603,182,421,43.2
'38050, 통영시,'085003, 82세,2019,604,197,407,48.4,603,197,406,48.5
'38050, 통영시,'085004, 83세,2019,513,169,344,49.1,513,169,344,49.1
'38050, 통영시,'085005, 84세,2019,463,145,318,45.6,463,145,318,45.6
'38050, 통영시,'086,85세이상,2019,1886,441,1445,30.5,1880,439,1441,30.5
'38050, 통영시,'090,85~89세,2019,1361,350,1011,34.6,1358,350,1008,34.7
'38050, 통영시,'090001, 85세,2019,367,104,263,39.5,367,104,263,39.5
'38050, 통영시,'090002, 86세,2019,321,82,239,34.3,320,82,238,34.5
'38050, 통영시,'090003, 87세,2019,284,70,214,32.7,284,70,214,32.7
'38050, 통영시,'090004, 88세,2019,228,57,171,33.3,226,57,169,33.7
'38050, 통영시,'090005, 89세,2019,161,37,124,29.8,161,37,124,29.8
'38050, 통영시,'095,90~94세,2019,447,81,366,22.1,444,79,365,21.6
'38050, 통영시,'095001, 90세,2019,140,25,115,21.7,140,25,115,21.7
'38050, 통영시,'095002, 91세,2019,117,27,90,30,116,26,90,28.9
'38050, 통영시,'095003, 92세,2019,89,11,78,14.1,88,11,77,14.3
'38050, 통영시,'095004, 93세,2019,57,9,48,18.8,56,8,48,16.7
'38050, 통영시,'095005, 94세,2019,44,9,35,25.7,44,9,35,25.7
'38050, 통영시,'100,95~99세,2019,73,9,64,14.1,73,9,64,14.1
'38050, 통영시,'100001, 95세,2019,25,X,21,19,25,X,21,19
'38050, 통영시,'100002, 96세,2019,19,X,17,11.8,19,X,17,11.8
'38050, 통영시,'100003, 97세,2019,21,X,18,16.7,21,X,18,16.7
'38050, 통영시,'100004, 98세,2019,6,X,6,0,6,X,6,0
'38050, 통영시,'100005, 99세,2019,X,X,X,0,X,X,X,0
'38050, 통영시,'101,100세이상,2019,5,X,X,25,5,X,X,25
'38050, 통영시,'102,15세미만,2019,17293,8810,8483,103.9,17272,8795,8477,103.8
'38050, 통영시,'103,15~64세,2019,89620,48388,41232,117.4,84371,44142,40229,109.7
'38050, 통영시,'104,65세이상,2019,23018,9815,13203,74.3,22949,9786,13163,74.3
'38050, 통영시,'126,평균연령,2019,44.2,42.6,46,,44.6,43.1,46.1,
'38050, 통영시,'127,중위연령,2019,46.1,44.2,48.4,,46.9,45.5,48.7,
'38060, 사천시,'000,합계,2019,111110,57277,53833,106.4,106363,53648,52715,101.8
'38060, 사천시,'005,0~4세,2019,3761,1923,1838,104.6,3652,1870,1782,104.9
'38060, 사천시,'005001, 0세,2019,505,248,257,96.5,497,245,252,97.2
'38060, 사천시,'005002, 1세,2019,656,327,329,99.4,638,319,319,100
'38060, 사천시,'005003, 2세,2019,783,404,379,106.6,757,392,365,107.4
'38060, 사천시,'005004, 3세,2019,890,483,407,118.7,865,468,397,117.9
'38060, 사천시,'005005, 4세,2019,927,461,466,98.9,895,446,449,99.3
'38060, 사천시,'010,5~9세,2019,5146,2677,2469,108.4,5060,2642,2418,109.3
'38060, 사천시,'010001, 5세,2019,998,493,505,97.6,968,484,484,100
'38060, 사천시,'010002, 6세,2019,945,502,443,113.3,924,493,431,114.4
'38060, 사천시,'010003, 7세,2019,1058,550,508,108.3,1039,541,498,108.6
'38060, 사천시,'010004, 8세,2019,1064,587,477,123.1,1058,583,475,122.7
'38060, 사천시,'010005, 9세,2019,1081,545,536,101.7,1071,541,530,102.1
'38060, 사천시,'015,10~14세,2019,5056,2572,2484,103.5,5021,2556,2465,103.7
'38060, 사천시,'015001, 10세,2019,1070,533,537,99.3,1064,529,535,98.9
'38060, 사천시,'015002, 11세,2019,1056,541,515,105,1051,540,511,105.7
'38060, 사천시,'015003, 12세,2019,1053,540,513,105.3,1046,536,510,105.1
'38060, 사천시,'015004, 13세,2019,974,505,469,107.7,963,501,462,108.4
'38060, 사천시,'015005, 14세,2019,903,453,450,100.7,897,450,447,100.7
'38060, 사천시,'020,15~19세,2019,4612,2519,2093,120.4,4565,2490,2075,120
'38060, 사천시,'020001, 15세,2019,965,506,459,110.2,956,502,454,110.6
'38060, 사천시,'020002, 16세,2019,920,477,443,107.7,917,475,442,107.5
'38060, 사천시,'020003, 17세,2019,971,499,472,105.7,967,496,471,105.3
'38060, 사천시,'020004, 18세,2019,1022,548,474,115.6,1015,542,473,114.6
'38060, 사천시,'020005, 19세,2019,734,489,245,199.6,710,475,235,202.1
'38060, 사천시,'025,20~24세,2019,4939,3346,1593,210,4536,3037,1499,202.6
'38060, 사천시,'025001, 20세,2019,836,595,241,246.9,807,579,228,253.9
'38060, 사천시,'025002, 21세,2019,962,697,265,263,916,658,258,255
'38060, 사천시,'025003, 22세,2019,1016,676,340,198.8,943,622,321,193.8
'38060, 사천시,'025004, 23세,2019,1043,675,368,183.4,933,591,342,172.8
'38060, 사천시,'025005, 24세,2019,1082,703,379,185.5,937,587,350,167.7
'38060, 사천시,'030,25~29세,2019,5994,3825,2169,176.3,5012,3026,1986,152.4
'38060, 사천시,'030001, 25세,2019,1180,773,407,189.9,1006,632,374,169
'38060, 사천시,'030002, 26세,2019,1196,777,419,185.4,996,618,378,163.5
'38060, 사천시,'030003, 27세,2019,1212,755,457,165.2,1013,596,417,142.9
'38060, 사천시,'030004, 28세,2019,1163,741,422,175.6,962,574,388,147.9
'38060, 사천시,'030005, 29세,2019,1243,779,464,167.9,1035,606,429,141.3
'38060, 사천시,'035,30~34세,2019,5835,3503,2332,150.2,4893,2720,2173,125.2
'38060, 사천시,'035001, 30세,2019,1220,766,454,168.7,1011,590,421,140.1
'38060, 사천시,'035002, 31세,2019,1103,678,425,159.5,910,514,396,129.8
'38060, 사천시,'035003, 32세,2019,1136,654,482,135.7,943,489,454,107.7
'38060, 사천시,'035004, 33세,2019,1199,727,472,154,1015,584,431,135.5
'38060, 사천시,'035005, 34세,2019,1177,678,499,135.9,1014,543,471,115.3
'38060, 사천시,'040,35~39세,2019,8228,4464,3764,118.6,7460,3826,3634,105.3
'38060, 사천시,'040001, 35세,2019,1311,731,580,126,1144,602,542,111.1
'38060, 사천시,'040002, 36세,2019,1578,876,702,124.8,1422,744,678,109.7
'38060, 사천시,'040003, 37세,2019,1733,954,779,122.5,1578,820,758,108.2
'38060, 사천시,'040004, 38세,2019,1779,956,823,116.2,1620,826,794,104
'38060, 사천시,'040005, 39세,2019,1827,947,880,107.6,1696,834,862,96.8
'38060, 사천시,'045,40~44세,2019,8452,4569,3883,117.7,7950,4173,3777,110.5
'38060, 사천시,'045001, 40세,2019,1736,940,796,118.1,1627,851,776,109.7
'38060, 사천시,'045002, 41세,2019,1673,902,771,117,1564,813,751,108.3
'38060, 사천시,'045003, 42세,2019,1698,915,783,116.9,1611,851,760,112
'38060, 사천시,'045004, 43세,2019,1602,900,702,128.2,1505,825,680,121.3
'38060, 사천시,'045005, 44세,2019,1743,912,831,109.7,1643,833,810,102.8
'38060, 사천시,'050,45~49세,2019,9487,5197,4290,121.1,9152,4947,4205,117.6
'38060, 사천시,'050001, 45세,2019,1821,1005,816,123.2,1746,944,802,117.7
'38060, 사천시,'050002, 46세,2019,1967,1064,903,117.8,1893,1006,887,113.4
'38060, 사천시,'050003, 47세,2019,1852,1039,813,127.8,1779,986,793,124.3
'38060, 사천시,'050004, 48세,2019,1978,1087,891,122,1916,1042,874,119.2
'38060, 사천시,'050005, 49세,2019,1869,1002,867,115.6,1818,969,849,114.1
'38060, 사천시,'055,50~54세,2019,8927,4742,4185,113.3,8693,4582,4111,111.5
'38060, 사천시,'055001, 50세,2019,1948,1056,892,118.4,1894,1018,876,116.2
'38060, 사천시,'055002, 51세,2019,1794,957,837,114.3,1747,922,825,111.8
'38060, 사천시,'055003, 52세,2019,1699,851,848,100.4,1655,822,833,98.7
'38060, 사천시,'055004, 53세,2019,1747,964,783,123.1,1708,939,769,122.1
'38060, 사천시,'055005, 54세,2019,1739,914,825,110.8,1689,881,808,109
'38060, 사천시,'060,55~59세,2019,9124,4654,4470,104.1,8961,4566,4395,103.9
'38060, 사천시,'060001, 55세,2019,1405,714,691,103.3,1382,704,678,103.8
'38060, 사천시,'060002, 56세,2019,1679,904,775,116.6,1628,875,753,116.2
'38060, 사천시,'060003, 57세,2019,1848,965,883,109.3,1815,946,869,108.9
'38060, 사천시,'060004, 58세,2019,2129,1058,1071,98.8,2101,1043,1058,98.6
'38060, 사천시,'060005, 59세,2019,2063,1013,1050,96.5,2035,998,1037,96.2
'38060, 사천시,'065,60~64세,2019,8587,4116,4471,92.1,8502,4074,4428,92
'38060, 사천시,'065001, 60세,2019,1734,847,887,95.5,1710,838,872,96.1
'38060, 사천시,'065002, 61세,2019,1697,808,889,90.9,1678,798,880,90.7
'38060, 사천시,'065003, 62세,2019,1731,824,907,90.8,1720,817,903,90.5
'38060, 사천시,'065004, 63세,2019,1580,770,810,95.1,1564,763,801,95.3
'38060, 사천시,'065005, 64세,2019,1845,867,978,88.7,1830,858,972,88.3
'38060, 사천시,'070,65~69세,2019,6500,3102,3398,91.3,6472,3086,3386,91.1
'38060, 사천시,'070001, 65세,2019,1516,762,754,101.1,1510,757,753,100.5
'38060, 사천시,'070002, 66세,2019,1170,550,620,88.7,1165,546,619,88.2
'38060, 사천시,'070003, 67세,2019,1408,669,739,90.5,1399,665,734,90.6
'38060, 사천시,'070004, 68세,2019,1192,546,646,84.5,1189,546,643,84.9
'38060, 사천시,'070005, 69세,2019,1214,575,639,90,1209,572,637,89.8
'38060, 사천시,'075,70~74세,2019,5489,2448,3041,80.5,5470,2437,3033,80.3
'38060, 사천시,'075001, 70세,2019,1219,567,652,87,1213,563,650,86.6
'38060, 사천시,'075002, 71세,2019,1227,576,651,88.5,1222,573,649,88.3
'38060, 사천시,'075003, 72세,2019,1196,531,665,79.8,1194,529,665,79.5
'38060, 사천시,'075004, 73세,2019,896,400,496,80.6,890,398,492,80.9
'38060, 사천시,'075005, 74세,2019,951,374,577,64.8,951,374,577,64.8
'38060, 사천시,'080,75~79세,2019,4809,1871,2938,63.7,4805,1869,2936,63.7
'38060, 사천시,'080001, 75세,2019,937,381,556,68.5,937,381,556,68.5
'38060, 사천시,'080002, 76세,2019,969,406,563,72.1,969,406,563,72.1
'38060, 사천시,'080003, 77세,2019,1056,381,675,56.4,1056,381,675,56.4
'38060, 사천시,'080004, 78세,2019,977,398,579,68.7,976,397,579,68.6
'38060, 사천시,'080005, 79세,2019,870,305,565,54,867,304,563,54
'38060, 사천시,'085,80~84세,2019,3598,1215,2383,51,3593,1213,2380,51
'38060, 사천시,'085001, 80세,2019,866,314,552,56.9,865,314,551,57
'38060, 사천시,'085002, 81세,2019,724,250,474,52.7,723,250,473,52.9
'38060, 사천시,'085003, 82세,2019,735,255,480,53.1,734,254,480,52.9
'38060, 사천시,'085004, 83세,2019,699,217,482,45,699,217,482,45
'38060, 사천시,'085005, 84세,2019,574,179,395,45.3,572,178,394,45.2
'38060, 사천시,'086,85세이상,2019,2566,534,2032,26.3,2566,534,2032,26.3
'38060, 사천시,'090,85~89세,2019,1843,427,1416,30.2,1843,427,1416,30.2
'38060, 사천시,'090001, 85세,2019,496,145,351,41.3,496,145,351,41.3
'38060, 사천시,'090002, 86세,2019,395,98,297,33,395,98,297,33
'38060, 사천시,'090003, 87세,2019,409,86,323,26.6,409,86,323,26.6
'38060, 사천시,'090004, 88세,2019,311,62,249,24.9,311,62,249,24.9
'38060, 사천시,'090005, 89세,2019,232,36,196,18.4,232,36,196,18.4
'38060, 사천시,'095,90~94세,2019,598,94,504,18.7,598,94,504,18.7
'38060, 사천시,'095001, 90세,2019,181,28,153,18.3,181,28,153,18.3
'38060, 사천시,'095002, 91세,2019,138,29,109,26.6,138,29,109,26.6
'38060, 사천시,'095003, 92세,2019,117,16,101,15.8,117,16,101,15.8
'38060, 사천시,'095004, 93세,2019,92,12,80,15,92,12,80,15
'38060, 사천시,'095005, 94세,2019,70,9,61,14.8,70,9,61,14.8
'38060, 사천시,'100,95~99세,2019,116,11,105,10.5,116,11,105,10.5
'38060, 사천시,'100001, 95세,2019,38,X,36,5.6,38,X,36,5.6
'38060, 사천시,'100002, 96세,2019,24,X,22,9.1,24,X,22,9.1
'38060, 사천시,'100003, 97세,2019,33,X,31,6.5,33,X,31,6.5
'38060, 사천시,'100004, 98세,2019,15,X,11,36.4,15,X,11,36.4
'38060, 사천시,'100005, 99세,2019,6,X,5,20,6,X,5,20
'38060, 사천시,'101,100세이상,2019,9,X,7,28.6,9,X,7,28.6
'38060, 사천시,'102,15세미만,2019,13963,7172,6791,105.6,13733,7068,6665,106
'38060, 사천시,'103,15~64세,2019,74185,40935,33250,123.1,69724,37441,32283,116
'38060, 사천시,'104,65세이상,2019,22962,9170,13792,66.5,22906,9139,13767,66.4
'38060, 사천시,'126,평균연령,2019,45.4,42.9,48,,45.8,43.4,48.3,
'38060, 사천시,'127,중위연령,2019,46.9,44.2,50,,47.8,45.5,50.4,
'38070, 김해시,'000,합계,2019,549331,282374,266957,105.8,522270,263300,258970,101.7
'38070, 김해시,'005,0~4세,2019,22973,11796,11177,105.5,22513,11569,10944,105.7
'38070, 김해시,'005001, 0세,2019,3658,1889,1769,106.8,3574,1840,1734,106.1
'38070, 김해시,'005002, 1세,2019,3983,2043,1940,105.3,3904,2010,1894,106.1
'38070, 김해시,'005003, 2세,2019,4505,2316,2189,105.8,4432,2277,2155,105.7
'38070, 김해시,'005004, 3세,2019,5261,2682,2579,104,5147,2633,2514,104.7
'38070, 김해시,'005005, 4세,2019,5566,2866,2700,106.1,5456,2809,2647,106.1
'38070, 김해시,'010,5~9세,2019,29493,14916,14577,102.3,29160,14745,14415,102.3
'38070, 김해시,'010001, 5세,2019,5696,2893,2803,103.2,5621,2852,2769,103
'38070, 김해시,'010002, 6세,2019,5597,2829,2768,102.2,5512,2784,2728,102.1
'38070, 김해시,'010003, 7세,2019,6241,3092,3149,98.2,6172,3063,3109,98.5
'38070, 김해시,'010004, 8세,2019,6055,3067,2988,102.6,5997,3036,2961,102.5
'38070, 김해시,'010005, 9세,2019,5904,3035,2869,105.8,5858,3010,2848,105.7
'38070, 김해시,'015,10~14세,2019,29725,15425,14300,107.9,29499,15316,14183,108
'38070, 김해시,'015001, 10세,2019,5735,2976,2759,107.9,5685,2953,2732,108.1
'38070, 김해시,'015002, 11세,2019,6120,3148,2972,105.9,6068,3127,2941,106.3
'38070, 김해시,'015003, 12세,2019,6405,3262,3143,103.8,6358,3237,3121,103.7
'38070, 김해시,'015004, 13세,2019,5781,3017,2764,109.2,5749,3000,2749,109.1
'38070, 김해시,'015005, 14세,2019,5684,3022,2662,113.5,5639,2999,2640,113.6
'38070, 김해시,'020,15~19세,2019,30560,16147,14413,112,30176,15941,14235,112
'38070, 김해시,'020001, 15세,2019,5911,3113,2798,111.3,5875,3094,2781,111.3
'38070, 김해시,'020002, 16세,2019,5760,2985,2775,107.6,5723,2966,2757,107.6
'38070, 김해시,'020003, 17세,2019,5910,3033,2877,105.4,5866,3008,2858,105.2
'38070, 김해시,'020004, 18세,2019,6506,3427,3079,111.3,6431,3382,3049,110.9
'38070, 김해시,'020005, 19세,2019,6473,3589,2884,124.4,6281,3491,2790,125.1
'38070, 김해시,'025,20~24세,2019,35885,20374,15511,131.4,32920,18230,14690,124.1
'38070, 김해시,'025001, 20세,2019,6835,3907,2928,133.4,6467,3690,2777,132.9
'38070, 김해시,'025002, 21세,2019,7158,4100,3058,134.1,6687,3788,2899,130.7
'38070, 김해시,'025003, 22세,2019,7276,4076,3200,127.4,6676,3646,3030,120.3
'38070, 김해시,'025004, 23세,2019,7334,4164,3170,131.4,6658,3641,3017,120.7
'38070, 김해시,'025005, 24세,2019,7282,4127,3155,130.8,6432,3465,2967,116.8
'38070, 김해시,'030,25~29세,2019,35810,20349,15461,131.6,30585,16384,14201,115.4
'38070, 김해시,'030001, 25세,2019,7355,4147,3208,129.3,6465,3460,3005,115.1
'38070, 김해시,'030002, 26세,2019,7249,4188,3061,136.8,6227,3409,2818,121
'38070, 김해시,'030003, 27세,2019,7288,4095,3193,128.2,6239,3301,2938,112.4
'38070, 김해시,'030004, 28세,2019,7021,3969,3052,130,5964,3186,2778,114.7
'38070, 김해시,'030005, 29세,2019,6897,3950,2947,134,5690,3028,2662,113.7
'38070, 김해시,'035,30~34세,2019,34539,19232,15307,125.6,28869,14892,13977,106.5
'38070, 김해시,'035001, 30세,2019,6650,3766,2884,130.6,5546,2932,2614,112.2
'38070, 김해시,'035002, 31세,2019,6651,3724,2927,127.2,5458,2804,2654,105.7
'38070, 김해시,'035003, 32세,2019,6740,3720,3020,123.2,5548,2820,2728,103.4
'38070, 김해시,'035004, 33세,2019,7105,3943,3162,124.7,5995,3096,2899,106.8
'38070, 김해시,'035005, 34세,2019,7393,4079,3314,123.1,6322,3240,3082,105.1
'38070, 김해시,'040,35~39세,2019,46033,24241,21792,111.2,42033,21209,20824,101.8
'38070, 김해시,'040001, 35세,2019,7740,4158,3582,116.1,6784,3424,3360,101.9
'38070, 김해시,'040002, 36세,2019,8737,4624,4113,112.4,7855,3963,3892,101.8
'38070, 김해시,'040003, 37세,2019,9601,5043,4558,110.6,8775,4419,4356,101.4
'38070, 김해시,'040004, 38세,2019,9795,5173,4622,111.9,9066,4626,4440,104.2
'38070, 김해시,'040005, 39세,2019,10160,5243,4917,106.6,9553,4777,4776,100
'38070, 김해시,'045,40~44세,2019,46556,23666,22890,103.4,43902,21789,22113,98.5
'38070, 김해시,'045001, 40세,2019,9733,5042,4691,107.5,9100,4589,4511,101.7
'38070, 김해시,'045002, 41세,2019,9042,4642,4400,105.5,8468,4237,4231,100.1
'38070, 김해시,'045003, 42세,2019,8986,4556,4430,102.8,8488,4200,4288,97.9
'38070, 김해시,'045004, 43세,2019,8943,4531,4412,102.7,8451,4170,4281,97.4
'38070, 김해시,'045005, 44세,2019,9852,4895,4957,98.7,9395,4593,4802,95.6
'38070, 김해시,'050,45~49세,2019,54810,27475,27335,100.5,52919,26255,26664,98.5
'38070, 김해시,'050001, 45세,2019,10660,5313,5347,99.4,10233,5028,5205,96.6
'38070, 김해시,'050002, 46세,2019,10956,5364,5592,95.9,10585,5128,5457,94
'38070, 김해시,'050003, 47세,2019,10655,5391,5264,102.4,10300,5156,5144,100.2
'38070, 김해시,'050004, 48세,2019,11617,5883,5734,102.6,11229,5642,5587,101
'38070, 김해시,'050005, 49세,2019,10922,5524,5398,102.3,10572,5301,5271,100.6
'38070, 김해시,'055,50~54세,2019,50741,25828,24913,103.7,49386,25018,24368,102.7
'38070, 김해시,'055001, 50세,2019,10944,5505,5439,101.2,10633,5325,5308,100.3
'38070, 김해시,'055002, 51세,2019,10997,5552,5445,102,10707,5370,5337,100.6
'38070, 김해시,'055003, 52세,2019,9991,5043,4948,101.9,9729,4889,4840,101
'38070, 김해시,'055004, 53세,2019,9537,4978,4559,109.2,9273,4818,4455,108.1
'38070, 김해시,'055005, 54세,2019,9272,4750,4522,105,9044,4616,4428,104.2
'38070, 김해시,'060,55~59세,2019,43174,22674,20500,110.6,42214,22147,20067,110.4
'38070, 김해시,'060001, 55세,2019,8190,4232,3958,106.9,7958,4107,3851,106.6
'38070, 김해시,'060002, 56세,2019,8708,4691,4017,116.8,8467,4544,3923,115.8
'38070, 김해시,'060003, 57세,2019,8788,4661,4127,112.9,8593,4563,4030,113.2
'38070, 김해시,'060004, 58세,2019,8967,4631,4336,106.8,8831,4553,4278,106.4
'38070, 김해시,'060005, 59세,2019,8521,4459,4062,109.8,8365,4380,3985,109.9
'38070, 김해시,'065,60~64세,2019,32002,16505,15497,106.5,31523,16256,15267,106.5
'38070, 김해시,'065001, 60세,2019,7400,3906,3494,111.8,7291,3844,3447,111.5
'38070, 김해시,'065002, 61세,2019,6725,3491,3234,107.9,6606,3434,3172,108.3
'38070, 김해시,'065003, 62세,2019,6574,3365,3209,104.9,6485,3316,3169,104.6
'38070, 김해시,'065004, 63세,2019,5639,2860,2779,102.9,5550,2816,2734,103
'38070, 김해시,'065005, 64세,2019,5664,2883,2781,103.7,5591,2846,2745,103.7
'38070, 김해시,'070,65~69세,2019,19693,9689,10004,96.9,19442,9575,9867,97
'38070, 김해시,'070001, 65세,2019,4747,2419,2328,103.9,4676,2390,2286,104.5
'38070, 김해시,'070002, 66세,2019,3958,1931,2027,95.3,3899,1905,1994,95.5
'38070, 김해시,'070003, 67세,2019,4297,2102,2195,95.8,4241,2073,2168,95.6
'38070, 김해시,'070004, 68세,2019,3303,1585,1718,92.3,3269,1570,1699,92.4
'38070, 김해시,'070005, 69세,2019,3388,1652,1736,95.2,3357,1637,1720,95.2
'38070, 김해시,'075,70~74세,2019,13744,6184,7560,81.8,13632,6134,7498,81.8
'38070, 김해시,'075001, 70세,2019,3214,1494,1720,86.9,3184,1478,1706,86.6
'38070, 김해시,'075002, 71세,2019,3271,1454,1817,80,3254,1446,1808,80
'38070, 김해시,'075003, 72세,2019,2967,1314,1653,79.5,2947,1306,1641,79.6
'38070, 김해시,'075004, 73세,2019,2150,984,1166,84.4,2131,977,1154,84.7
'38070, 김해시,'075005, 74세,2019,2142,938,1204,77.9,2116,927,1189,78
'38070, 김해시,'080,75~79세,2019,11227,4392,6835,64.3,11178,4376,6802,64.3
'38070, 김해시,'080001, 75세,2019,2324,983,1341,73.3,2318,981,1337,73.4
'38070, 김해시,'080002, 76세,2019,2328,959,1369,70.1,2319,955,1364,70
'38070, 김해시,'080003, 77세,2019,2574,1004,1570,63.9,2562,1000,1562,64
'38070, 김해시,'080004, 78세,2019,2060,743,1317,56.4,2049,741,1308,56.7
'38070, 김해시,'080005, 79세,2019,1941,703,1238,56.8,1930,699,1231,56.8
'38070, 김해시,'085,80~84세,2019,7339,2352,4987,47.2,7313,2341,4972,47.1
'38070, 김해시,'085001, 80세,2019,1855,646,1209,53.4,1848,643,1205,53.4
'38070, 김해시,'085002, 81세,2019,1547,525,1022,51.4,1538,522,1016,51.4
'38070, 김해시,'085003, 82세,2019,1455,455,1000,45.5,1450,453,997,45.4
'38070, 김해시,'085004, 83세,2019,1302,391,911,42.9,1299,389,910,42.7
'38070, 김해시,'085005, 84세,2019,1180,335,845,39.6,1178,334,844,39.6
'38070, 김해시,'086,85세이상,2019,5027,1129,3898,29,5006,1123,3883,28.9
'38070, 김해시,'090,85~89세,2019,3620,870,2750,31.6,3609,869,2740,31.7
'38070, 김해시,'090001, 85세,2019,1026,284,742,38.3,1021,284,737,38.5
'38070, 김해시,'090002, 86세,2019,810,206,604,34.1,809,206,603,34.2
'38070, 김해시,'090003, 87세,2019,749,172,577,29.8,744,171,573,29.8
'38070, 김해시,'090004, 88세,2019,542,111,431,25.8,542,111,431,25.8
'38070, 김해시,'090005, 89세,2019,493,97,396,24.5,493,97,396,24.5
'38070, 김해시,'095,90~94세,2019,1174,218,956,22.8,1168,215,953,22.6
'38070, 김해시,'095001, 90세,2019,400,79,321,24.6,398,78,320,24.4
'38070, 김해시,'095002, 91세,2019,311,52,259,20.1,309,51,258,19.8
'38070, 김해시,'095003, 92세,2019,213,41,172,23.8,212,41,171,24
'38070, 김해시,'095004, 93세,2019,132,28,104,26.9,132,28,104,26.9
'38070, 김해시,'095005, 94세,2019,118,18,100,18,117,17,100,17
'38070, 김해시,'100,95~99세,2019,206,35,171,20.5,202,33,169,19.5
'38070, 김해시,'100001, 95세,2019,62,14,48,29.2,60,13,47,27.7
'38070, 김해시,'100002, 96세,2019,70,12,58,20.7,70,12,58,20.7
'38070, 김해시,'100003, 97세,2019,35,6,29,20.7,35,6,29,20.7
'38070, 김해시,'100004, 98세,2019,23,X,22,4.5,22,X,21,4.8
'38070, 김해시,'100005, 99세,2019,16,X,14,14.3,15,X,14,7.1
'38070, 김해시,'101,100세이상,2019,27,6,21,28.6,27,6,21,28.6
'38070, 김해시,'102,15세미만,2019,82191,42137,40054,105.2,81172,41630,39542,105.3
'38070, 김해시,'103,15~64세,2019,410110,216491,193619,111.8,384527,198121,186406,106.3
'38070, 김해시,'104,65세이상,2019,57030,23746,33284,71.3,56571,23549,33022,71.3
'38070, 김해시,'126,평균연령,2019,39.7,38.6,40.8,,39.9,38.9,40.9,
'38070, 김해시,'127,중위연령,2019,41,39.8,42.4,,41.7,40.7,42.8,
'38080, 밀양시,'000,합계,2019,103402,50463,52939,95.3,99277,48632,50645,96
'38080, 밀양시,'005,0~4세,2019,2629,1315,1314,100.1,2618,1312,1306,100.5
'38080, 밀양시,'005001, 0세,2019,462,221,241,91.7,461,221,240,92.1
'38080, 밀양시,'005002, 1세,2019,465,246,219,112.3,462,245,217,112.9
'38080, 밀양시,'005003, 2세,2019,541,262,279,93.9,537,261,276,94.6
'38080, 밀양시,'005004, 3세,2019,598,289,309,93.5,596,288,308,93.5
'38080, 밀양시,'005005, 4세,2019,563,297,266,111.7,562,297,265,112.1
'38080, 밀양시,'010,5~9세,2019,3206,1635,1571,104.1,3202,1633,1569,104.1
'38080, 밀양시,'010001, 5세,2019,593,298,295,101,592,297,295,100.7
'38080, 밀양시,'010002, 6세,2019,618,294,324,90.7,617,293,324,90.4
'38080, 밀양시,'010003, 7세,2019,652,354,298,118.8,652,354,298,118.8
'38080, 밀양시,'010004, 8세,2019,665,329,336,97.9,664,329,335,98.2
'38080, 밀양시,'010005, 9세,2019,678,360,318,113.2,677,360,317,113.6
'38080, 밀양시,'015,10~14세,2019,3596,1842,1754,105,3593,1841,1752,105.1
'38080, 밀양시,'015001, 10세,2019,661,340,321,105.9,661,340,321,105.9
'38080, 밀양시,'015002, 11세,2019,757,374,383,97.7,756,374,382,97.9
'38080, 밀양시,'015003, 12세,2019,778,403,375,107.5,777,403,374,107.8
'38080, 밀양시,'015004, 13세,2019,704,366,338,108.3,703,365,338,108
'38080, 밀양시,'015005, 14세,2019,696,359,337,106.5,696,359,337,106.5
'38080, 밀양시,'020,15~19세,2019,4170,2263,1907,118.7,4120,2248,1872,120.1
'38080, 밀양시,'020001, 15세,2019,758,410,348,117.8,754,409,345,118.6
'38080, 밀양시,'020002, 16세,2019,830,428,402,106.5,828,428,400,107
'38080, 밀양시,'020003, 17세,2019,818,429,389,110.3,815,428,387,110.6
'38080, 밀양시,'020004, 18세,2019,914,496,418,118.7,904,491,413,118.9
'38080, 밀양시,'020005, 19세,2019,850,500,350,142.9,819,492,327,150.5
'38080, 밀양시,'025,20~24세,2019,5322,2860,2462,116.2,4392,2618,1774,147.6
'38080, 밀양시,'025001, 20세,2019,929,539,390,138.2,852,518,334,155.1
'38080, 밀양시,'025002, 21세,2019,1013,563,450,125.1,856,532,324,164.2
'38080, 밀양시,'025003, 22세,2019,1063,531,532,99.8,866,483,383,126.1
'38080, 밀양시,'025004, 23세,2019,1211,646,565,114.3,952,574,378,151.9
'38080, 밀양시,'025005, 24세,2019,1106,581,525,110.7,866,511,355,143.9
'38080, 밀양시,'030,25~29세,2019,5168,2847,2321,122.7,4122,2376,1746,136.1
'38080, 밀양시,'030001, 25세,2019,1126,619,507,122.1,882,526,356,147.8
'38080, 밀양시,'030002, 26세,2019,1122,639,483,132.3,894,542,352,154
'38080, 밀양시,'030003, 27세,2019,1003,548,455,120.4,809,456,353,129.2
'38080, 밀양시,'030004, 28세,2019,1000,545,455,119.8,808,444,364,122
'38080, 밀양시,'030005, 29세,2019,917,496,421,117.8,729,408,321,127.1
'38080, 밀양시,'035,30~34세,2019,4496,2427,2069,117.3,3765,2012,1753,114.8
'38080, 밀양시,'035001, 30세,2019,886,495,391,126.6,717,396,321,123.4
'38080, 밀양시,'035002, 31세,2019,871,500,371,134.8,712,412,300,137.3
'38080, 밀양시,'035003, 32세,2019,870,458,412,111.2,729,371,358,103.6
'38080, 밀양시,'035004, 33세,2019,941,482,459,105,804,410,394,104.1
'38080, 밀양시,'035005, 34세,2019,928,492,436,112.8,803,423,380,111.3
'38080, 밀양시,'040,35~39세,2019,5589,2935,2654,110.6,5114,2673,2441,109.5
'38080, 밀양시,'040001, 35세,2019,1001,527,474,111.2,877,459,418,109.8
'38080, 밀양시,'040002, 36세,2019,1088,570,518,110,978,500,478,104.6
'38080, 밀양시,'040003, 37세,2019,1116,607,509,119.3,1030,563,467,120.6
'38080, 밀양시,'040004, 38세,2019,1195,617,578,106.7,1117,584,533,109.6
'38080, 밀양시,'040005, 39세,2019,1189,614,575,106.8,1112,567,545,104
'38080, 밀양시,'045,40~44세,2019,5761,3078,2683,114.7,5467,2934,2533,115.8
'38080, 밀양시,'045001, 40세,2019,1190,627,563,111.4,1129,598,531,112.6
'38080, 밀양시,'045002, 41세,2019,1122,601,521,115.4,1058,570,488,116.8
'38080, 밀양시,'045003, 42세,2019,1132,579,553,104.7,1066,549,517,106.2
'38080, 밀양시,'045004, 43세,2019,1105,609,496,122.8,1048,575,473,121.6
'38080, 밀양시,'045005, 44세,2019,1212,662,550,120.4,1166,642,524,122.5
'38080, 밀양시,'050,45~49세,2019,7129,3711,3418,108.6,6918,3604,3314,108.8
'38080, 밀양시,'050001, 45세,2019,1306,679,627,108.3,1263,658,605,108.8
'38080, 밀양시,'050002, 46세,2019,1404,731,673,108.6,1362,712,650,109.5
'38080, 밀양시,'050003, 47세,2019,1407,755,652,115.8,1362,731,631,115.8
'38080, 밀양시,'050004, 48세,2019,1536,802,734,109.3,1491,777,714,108.8
'38080, 밀양시,'050005, 49세,2019,1476,744,732,101.6,1440,726,714,101.7
'38080, 밀양시,'055,50~54세,2019,8448,4246,4202,101,8323,4191,4132,101.4
'38080, 밀양시,'055001, 50세,2019,1585,822,763,107.7,1552,809,743,108.9
'38080, 밀양시,'055002, 51세,2019,1676,879,797,110.3,1654,867,787,110.2
'38080, 밀양시,'055003, 52세,2019,1715,830,885,93.8,1687,819,868,94.4
'38080, 밀양시,'055004, 53세,2019,1738,879,859,102.3,1716,870,846,102.8
'38080, 밀양시,'055005, 54세,2019,1734,836,898,93.1,1714,826,888,93
'38080, 밀양시,'060,55~59세,2019,10161,5068,5093,99.5,10027,5004,5023,99.6
'38080, 밀양시,'060001, 55세,2019,1680,845,835,101.2,1645,826,819,100.9
'38080, 밀양시,'060002, 56세,2019,1916,978,938,104.3,1889,964,925,104.2
'38080, 밀양시,'060003, 57세,2019,2047,1009,1038,97.2,2016,994,1022,97.3
'38080, 밀양시,'060004, 58세,2019,2241,1116,1125,99.2,2223,1110,1113,99.7
'38080, 밀양시,'060005, 59세,2019,2277,1120,1157,96.8,2254,1110,1144,97
'38080, 밀양시,'065,60~64세,2019,10748,5244,5504,95.3,10687,5213,5474,95.2
'38080, 밀양시,'065001, 60세,2019,2122,1022,1100,92.9,2111,1015,1096,92.6
'38080, 밀양시,'065002, 61세,2019,2180,1045,1135,92.1,2166,1039,1127,92.2
'38080, 밀양시,'065003, 62세,2019,2274,1105,1169,94.5,2258,1097,1161,94.5
'38080, 밀양시,'065004, 63세,2019,2098,1047,1051,99.6,2089,1042,1047,99.5
'38080, 밀양시,'065005, 64세,2019,2074,1025,1049,97.7,2063,1020,1043,97.8
'38080, 밀양시,'070,65~69세,2019,8197,3916,4281,91.5,8172,3905,4267,91.5
'38080, 밀양시,'070001, 65세,2019,1774,859,915,93.9,1764,856,908,94.3
'38080, 밀양시,'070002, 66세,2019,1621,786,835,94.1,1618,785,833,94.2
'38080, 밀양시,'070003, 67세,2019,1862,887,975,91,1860,886,974,91
'38080, 밀양시,'070004, 68세,2019,1539,708,831,85.2,1533,705,828,85.1
'38080, 밀양시,'070005, 69세,2019,1401,676,725,93.2,1397,673,724,93
'38080, 밀양시,'075,70~74세,2019,6171,2844,3327,85.5,6157,2840,3317,85.6
'38080, 밀양시,'075001, 70세,2019,1452,695,757,91.8,1448,693,755,91.8
'38080, 밀양시,'075002, 71세,2019,1394,641,753,85.1,1392,641,751,85.4
'38080, 밀양시,'075003, 72세,2019,1367,605,762,79.4,1366,605,761,79.5
'38080, 밀양시,'075004, 73세,2019,969,443,526,84.2,965,441,524,84.2
'38080, 밀양시,'075005, 74세,2019,989,460,529,87,986,460,526,87.5
'38080, 밀양시,'080,75~79세,2019,5599,2176,3423,63.6,5594,2174,3420,63.6
'38080, 밀양시,'080001, 75세,2019,1051,429,622,69,1051,429,622,69
'38080, 밀양시,'080002, 76세,2019,1149,457,692,66,1148,457,691,66.1
'38080, 밀양시,'080003, 77세,2019,1361,541,820,66,1361,541,820,66
'38080, 밀양시,'080004, 78세,2019,1102,409,693,59,1100,408,692,59
'38080, 밀양시,'080005, 79세,2019,936,340,596,57,934,339,595,57
'38080, 밀양시,'085,80~84세,2019,4244,1364,2880,47.4,4240,1363,2877,47.4
'38080, 밀양시,'085001, 80세,2019,1035,346,689,50.2,1035,346,689,50.2
'38080, 밀양시,'085002, 81세,2019,889,273,616,44.3,888,273,615,44.4
'38080, 밀양시,'085003, 82세,2019,905,300,605,49.6,905,300,605,49.6
'38080, 밀양시,'085004, 83세,2019,704,229,475,48.2,702,228,474,48.1
'38080, 밀양시,'085005, 84세,2019,711,216,495,43.6,710,216,494,43.7
'38080, 밀양시,'086,85세이상,2019,2768,692,2076,33.3,2766,691,2075,33.3
'38080, 밀양시,'090,85~89세,2019,2050,546,1504,36.3,2049,546,1503,36.3
'38080, 밀양시,'090001, 85세,2019,602,180,422,42.7,601,180,421,42.8
'38080, 밀양시,'090002, 86세,2019,476,127,349,36.4,476,127,349,36.4
'38080, 밀양시,'090003, 87세,2019,416,104,312,33.3,416,104,312,33.3
'38080, 밀양시,'090004, 88세,2019,303,77,226,34.1,303,77,226,34.1
'38080, 밀양시,'090005, 89세,2019,253,58,195,29.7,253,58,195,29.7
'38080, 밀양시,'095,90~94세,2019,591,125,466,26.8,590,124,466,26.6
'38080, 밀양시,'095001, 90세,2019,217,56,161,34.8,216,55,161,34.2
'38080, 밀양시,'095002, 91세,2019,141,32,109,29.4,141,32,109,29.4
'38080, 밀양시,'095003, 92세,2019,114,18,96,18.8,114,18,96,18.8
'38080, 밀양시,'095004, 93세,2019,61,12,49,24.5,61,12,49,24.5
'38080, 밀양시,'095005, 94세,2019,58,7,51,13.7,58,7,51,13.7
'38080, 밀양시,'100,95~99세,2019,118,20,98,20.4,118,20,98,20.4
'38080, 밀양시,'100001, 95세,2019,32,5,27,18.5,32,5,27,18.5
'38080, 밀양시,'100002, 96세,2019,36,6,30,20,36,6,30,20
'38080, 밀양시,'100003, 97세,2019,25,X,23,8.7,25,X,23,8.7
'38080, 밀양시,'100004, 98세,2019,16,X,12,33.3,16,X,12,33.3
'38080, 밀양시,'100005, 99세,2019,9,X,6,50,9,X,6,50
'38080, 밀양시,'101,100세이상,2019,9,X,8,12.5,9,X,8,12.5
'38080, 밀양시,'102,15세미만,2019,9431,4792,4639,103.3,9413,4786,4627,103.4
'38080, 밀양시,'103,15~64세,2019,66992,34679,32313,107.3,62935,32873,30062,109.4
'38080, 밀양시,'104,65세이상,2019,26979,10992,15987,68.8,26929,10973,15956,68.8
'38080, 밀양시,'126,평균연령,2019,49.1,47,51.1,,49.8,47.5,52,
'38080, 밀양시,'127,중위연령,2019,52.8,50.4,55.1,,53.8,51.3,56.3,
'38090, 거제시,'000,합계,2019,251226,135173,116053,116.5,240640,127498,113142,112.7
'38090, 거제시,'005,0~4세,2019,13030,6739,6291,107.1,12680,6544,6136,106.6
'38090, 거제시,'005001, 0세,2019,1714,922,792,116.4,1679,904,775,116.6
'38090, 거제시,'005002, 1세,2019,2181,1143,1038,110.1,2108,1104,1004,110
'38090, 거제시,'005003, 2세,2019,2643,1381,1262,109.4,2565,1340,1225,109.4
'38090, 거제시,'005004, 3세,2019,3109,1559,1550,100.6,3026,1513,1513,100
'38090, 거제시,'005005, 4세,2019,3383,1734,1649,105.2,3302,1683,1619,104
'38090, 거제시,'010,5~9세,2019,16483,8499,7984,106.5,16223,8368,7855,106.5
'38090, 거제시,'010001, 5세,2019,3198,1622,1576,102.9,3140,1597,1543,103.5
'38090, 거제시,'010002, 6세,2019,3232,1667,1565,106.5,3179,1646,1533,107.4
'38090, 거제시,'010003, 7세,2019,3446,1828,1618,113,3382,1790,1592,112.4
'38090, 거제시,'010004, 8세,2019,3403,1737,1666,104.3,3361,1710,1651,103.6
'38090, 거제시,'010005, 9세,2019,3204,1645,1559,105.5,3161,1625,1536,105.8
'38090, 거제시,'015,10~14세,2019,13855,7173,6682,107.3,13733,7110,6623,107.4
'38090, 거제시,'015001, 10세,2019,2887,1496,1391,107.5,2861,1487,1374,108.2
'38090, 거제시,'015002, 11세,2019,2970,1538,1432,107.4,2940,1522,1418,107.3
'38090, 거제시,'015003, 12세,2019,2963,1550,1413,109.7,2938,1539,1399,110
'38090, 거제시,'015004, 13세,2019,2594,1320,1274,103.6,2576,1309,1267,103.3
'38090, 거제시,'015005, 14세,2019,2441,1269,1172,108.3,2418,1253,1165,107.6
'38090, 거제시,'020,15~19세,2019,12714,6954,5760,120.7,12619,6890,5729,120.3
'38090, 거제시,'020001, 15세,2019,2652,1397,1255,111.3,2639,1391,1248,111.5
'38090, 거제시,'020002, 16세,2019,2593,1373,1220,112.5,2582,1367,1215,112.5
'38090, 거제시,'020003, 17세,2019,2772,1492,1280,116.6,2761,1485,1276,116.4
'38090, 거제시,'020004, 18세,2019,2788,1524,1264,120.6,2772,1514,1258,120.3
'38090, 거제시,'020005, 19세,2019,1909,1168,741,157.6,1865,1133,732,154.8
'38090, 거제시,'025,20~24세,2019,11590,7221,4369,165.3,10658,6513,4145,157.1
'38090, 거제시,'025001, 20세,2019,2156,1469,687,213.8,2061,1397,664,210.4
'38090, 거제시,'025002, 21세,2019,2340,1510,830,181.9,2195,1406,789,178.2
'38090, 거제시,'025003, 22세,2019,2342,1456,886,164.3,2150,1308,842,155.3
'38090, 거제시,'025004, 23세,2019,2326,1386,940,147.4,2097,1202,895,134.3
'38090, 거제시,'025005, 24세,2019,2426,1400,1026,136.5,2155,1200,955,125.7
'38090, 거제시,'030,25~29세,2019,13050,7567,5483,138,11209,6103,5106,119.5
'38090, 거제시,'030001, 25세,2019,2367,1406,961,146.3,2097,1198,899,133.3
'38090, 거제시,'030002, 26세,2019,2414,1382,1032,133.9,2103,1142,961,118.8
'38090, 거제시,'030003, 27세,2019,2592,1493,1099,135.9,2176,1154,1022,112.9
'38090, 거제시,'030004, 28세,2019,2679,1524,1155,131.9,2263,1196,1067,112.1
'38090, 거제시,'030005, 29세,2019,2998,1762,1236,142.6,2570,1413,1157,122.1
'38090, 거제시,'035,30~34세,2019,18148,10316,7832,131.7,16009,8629,7380,116.9
'38090, 거제시,'035001, 30세,2019,3056,1781,1275,139.7,2612,1434,1178,121.7
'38090, 거제시,'035002, 31세,2019,3210,1840,1370,134.3,2770,1498,1272,117.8
'38090, 거제시,'035003, 32세,2019,3506,1962,1544,127.1,3082,1623,1459,111.2
'38090, 거제시,'035004, 33세,2019,4069,2355,1714,137.4,3637,2011,1626,123.7
'38090, 거제시,'035005, 34세,2019,4307,2378,1929,123.3,3908,2063,1845,111.8
'38090, 거제시,'040,35~39세,2019,26586,14976,11610,129,24914,13713,11201,122.4
'38090, 거제시,'040001, 35세,2019,4664,2581,2083,123.9,4273,2286,1987,115
'38090, 거제시,'040002, 36세,2019,5210,2947,2263,130.2,4845,2667,2178,122.5
'38090, 거제시,'040003, 37세,2019,5497,3074,2423,126.9,5160,2818,2342,120.3
'38090, 거제시,'040004, 38세,2019,5558,3152,2406,131,5265,2936,2329,126.1
'38090, 거제시,'040005, 39세,2019,5657,3222,2435,132.3,5371,3006,2365,127.1
'38090, 거제시,'045,40~44세,2019,23542,12999,10543,123.3,22494,12244,10250,119.5
'38090, 거제시,'045001, 40세,2019,5211,2917,2294,127.2,4935,2712,2223,122
'38090, 거제시,'045002, 41세,2019,4612,2584,2028,127.4,4371,2424,1947,124.5
'38090, 거제시,'045003, 42세,2019,4590,2541,2049,124,4401,2406,1995,120.6
'38090, 거제시,'045004, 43세,2019,4600,2507,2093,119.8,4422,2367,2055,115.2
'38090, 거제시,'045005, 44세,2019,4529,2450,2079,117.8,4365,2335,2030,115
'38090, 거제시,'050,45~49세,2019,24736,13772,10964,125.6,23949,13235,10714,123.5
'38090, 거제시,'050001, 45세,2019,4964,2678,2286,117.1,4797,2557,2240,114.2
'38090, 거제시,'050002, 46세,2019,5056,2772,2284,121.4,4897,2670,2227,119.9
'38090, 거제시,'050003, 47세,2019,4975,2839,2136,132.9,4805,2720,2085,130.5
'38090, 거제시,'050004, 48세,2019,5033,2856,2177,131.2,4881,2754,2127,129.5
'38090, 거제시,'050005, 49세,2019,4708,2627,2081,126.2,4569,2534,2035,124.5
'38090, 거제시,'055,50~54세,2019,20705,11394,9311,122.4,20165,11057,9108,121.4
'38090, 거제시,'055001, 50세,2019,4495,2468,2027,121.8,4365,2379,1986,119.8
'38090, 거제시,'055002, 51세,2019,4360,2354,2006,117.3,4255,2290,1965,116.5
'38090, 거제시,'055003, 52세,2019,4052,2207,1845,119.6,3939,2135,1804,118.3
'38090, 거제시,'055004, 53세,2019,3958,2272,1686,134.8,3863,2220,1643,135.1
'38090, 거제시,'055005, 54세,2019,3840,2093,1747,119.8,3743,2033,1710,118.9
'38090, 거제시,'060,55~59세,2019,17735,8989,8746,102.8,17357,8766,8591,102
'38090, 거제시,'060001, 55세,2019,3061,1628,1433,113.6,2970,1573,1397,112.6
'38090, 거제시,'060002, 56세,2019,3419,1810,1609,112.5,3333,1761,1572,112
'38090, 거제시,'060003, 57세,2019,3548,1815,1733,104.7,3480,1771,1709,103.6
'38090, 거제시,'060004, 58세,2019,3867,1835,2032,90.3,3807,1801,2006,89.8
'38090, 거제시,'060005, 59세,2019,3840,1901,1939,98,3767,1860,1907,97.5
'38090, 거제시,'065,60~64세,2019,14979,8000,6979,114.6,14767,7865,6902,114
'38090, 거제시,'065001, 60세,2019,3318,1780,1538,115.7,3263,1748,1515,115.4
'38090, 거제시,'065002, 61세,2019,3180,1733,1447,119.8,3137,1704,1433,118.9
'38090, 거제시,'065003, 62세,2019,3147,1734,1413,122.7,3094,1701,1393,122.1
'38090, 거제시,'065004, 63세,2019,2695,1404,1291,108.8,2665,1384,1281,108
'38090, 거제시,'065005, 64세,2019,2639,1349,1290,104.6,2608,1328,1280,103.8
'38090, 거제시,'070,65~69세,2019,8756,4454,4302,103.5,8643,4387,4256,103.1
'38090, 거제시,'070001, 65세,2019,2065,1070,995,107.5,2038,1053,985,106.9
'38090, 거제시,'070002, 66세,2019,1807,899,908,99,1781,883,898,98.3
'38090, 거제시,'070003, 67세,2019,2069,1037,1032,100.5,2054,1026,1028,99.8
'38090, 거제시,'070004, 68세,2019,1420,728,692,105.2,1401,717,684,104.8
'38090, 거제시,'070005, 69세,2019,1395,720,675,106.7,1369,708,661,107.1
'38090, 거제시,'075,70~74세,2019,5768,2892,2876,100.6,5722,2867,2855,100.4
'38090, 거제시,'075001, 70세,2019,1458,743,715,103.9,1445,735,710,103.5
'38090, 거제시,'075002, 71세,2019,1382,741,641,115.6,1371,735,636,115.6
'38090, 거제시,'075003, 72세,2019,1274,635,639,99.4,1264,630,634,99.4
'38090, 거제시,'075004, 73세,2019,806,392,414,94.7,798,388,410,94.6
'38090, 거제시,'075005, 74세,2019,848,381,467,81.6,844,379,465,81.5
'38090, 거제시,'080,75~79세,2019,4420,1808,2612,69.2,4391,1795,2596,69.1
'38090, 거제시,'080001, 75세,2019,862,381,481,79.2,854,378,476,79.4
'38090, 거제시,'080002, 76세,2019,955,411,544,75.6,948,407,541,75.2
'38090, 거제시,'080003, 77세,2019,1058,415,643,64.5,1053,413,640,64.5
'38090, 거제시,'080004, 78세,2019,847,326,521,62.6,842,325,517,62.9
'38090, 거제시,'080005, 79세,2019,698,275,423,65,694,272,422,64.5
'38090, 거제시,'085,80~84세,2019,2961,945,2016,46.9,2948,941,2007,46.9
'38090, 거제시,'085001, 80세,2019,726,238,488,48.8,725,238,487,48.9
'38090, 거제시,'085002, 81세,2019,594,201,393,51.1,587,200,387,51.7
'38090, 거제시,'085003, 82세,2019,584,189,395,47.8,583,188,395,47.6
'38090, 거제시,'085004, 83세,2019,555,176,379,46.4,553,175,378,46.3
'38090, 거제시,'085005, 84세,2019,502,141,361,39.1,500,140,360,38.9
'38090, 거제시,'086,85세이상,2019,2168,475,1693,28.1,2159,471,1688,27.9
'38090, 거제시,'090,85~89세,2019,1542,369,1173,31.5,1536,366,1170,31.3
'38090, 거제시,'090001, 85세,2019,404,106,298,35.6,402,105,297,35.4
'38090, 거제시,'090002, 86세,2019,362,87,275,31.6,361,87,274,31.8
'38090, 거제시,'090003, 87세,2019,326,86,240,35.8,326,86,240,35.8
'38090, 거제시,'090004, 88세,2019,239,56,183,30.6,237,55,182,30.2
'38090, 거제시,'090005, 89세,2019,211,34,177,19.2,210,33,177,18.6
'38090, 거제시,'095,90~94세,2019,511,87,424,20.5,508,86,422,20.4
'38090, 거제시,'095001, 90세,2019,195,37,158,23.4,193,37,156,23.7
'38090, 거제시,'095002, 91세,2019,128,22,106,20.8,128,22,106,20.8
'38090, 거제시,'095003, 92세,2019,62,8,54,14.8,62,8,54,14.8
'38090, 거제시,'095004, 93세,2019,68,14,54,25.9,67,13,54,24.1
'38090, 거제시,'095005, 94세,2019,58,6,52,11.5,58,6,52,11.5
'38090, 거제시,'100,95~99세,2019,106,19,87,21.8,106,19,87,21.8
'38090, 거제시,'100001, 95세,2019,38,X,36,5.6,38,X,36,5.6
'38090, 거제시,'100002, 96세,2019,26,7,19,36.8,26,7,19,36.8
'38090, 거제시,'100003, 97세,2019,22,X,18,22.2,22,X,18,22.2
'38090, 거제시,'100004, 98세,2019,12,X,8,50,12,X,8,50
'38090, 거제시,'100005, 99세,2019,8,X,6,33.3,8,X,6,33.3
'38090, 거제시,'101,100세이상,2019,9,X,9,0,9,X,9,0
'38090, 거제시,'102,15세미만,2019,43368,22411,20957,106.9,42636,22022,20614,106.8
'38090, 거제시,'103,15~64세,2019,183785,102188,81597,125.2,174141,95015,79126,120.1
'38090, 거제시,'104,65세이상,2019,24073,10574,13499,78.3,23863,10461,13402,78.1
'38090, 거제시,'126,평균연령,2019,38.9,38.1,39.8,,39,38.3,39.9,
'38090, 거제시,'127,중위연령,2019,40,39.4,40.9,,40.5,40,41.1,
'38100, 양산시,'000,합계,2019,347221,175280,171941,101.9,338292,169497,168795,100.4
'38100, 양산시,'005,0~4세,2019,16873,8604,8269,104.1,16740,8535,8205,104
'38100, 양산시,'005001, 0세,2019,2697,1355,1342,101,2679,1348,1331,101.3
'38100, 양산시,'005002, 1세,2019,3069,1584,1485,106.7,3040,1568,1472,106.5
'38100, 양산시,'005003, 2세,2019,3394,1734,1660,104.5,3374,1723,1651,104.4
'38100, 양산시,'005004, 3세,2019,3792,1943,1849,105.1,3759,1928,1831,105.3
'38100, 양산시,'005005, 4세,2019,3921,1988,1933,102.8,3888,1968,1920,102.5
'38100, 양산시,'010,5~9세,2019,19314,9899,9415,105.1,19201,9843,9358,105.2
'38100, 양산시,'010001, 5세,2019,3921,2063,1858,111,3892,2050,1842,111.3
'38100, 양산시,'010002, 6세,2019,3789,1883,1906,98.8,3761,1866,1895,98.5
'38100, 양산시,'010003, 7세,2019,4080,2135,1945,109.8,4055,2123,1932,109.9
'38100, 양산시,'010004, 8세,2019,3942,1989,1953,101.8,3931,1984,1947,101.9
'38100, 양산시,'010005, 9세,2019,3582,1829,1753,104.3,3562,1820,1742,104.5
'38100, 양산시,'015,10~14세,2019,16515,8440,8075,104.5,16437,8397,8040,104.4
'38100, 양산시,'015001, 10세,2019,3378,1744,1634,106.7,3362,1734,1628,106.5
'38100, 양산시,'015002, 11세,2019,3546,1831,1715,106.8,3534,1825,1709,106.8
'38100, 양산시,'015003, 12세,2019,3459,1764,1695,104.1,3434,1749,1685,103.8
'38100, 양산시,'015004, 13세,2019,3133,1579,1554,101.6,3118,1573,1545,101.8
'38100, 양산시,'015005, 14세,2019,2999,1522,1477,103,2989,1516,1473,102.9
'38100, 양산시,'020,15~19세,2019,17209,8900,8309,107.1,17028,8802,8226,107
'38100, 양산시,'020001, 15세,2019,3252,1623,1629,99.6,3238,1614,1624,99.4
'38100, 양산시,'020002, 16세,2019,3234,1640,1594,102.9,3220,1633,1587,102.9
'38100, 양산시,'020003, 17세,2019,3521,1726,1795,96.2,3497,1713,1784,96
'38100, 양산시,'020004, 18세,2019,3692,1929,1763,109.4,3658,1906,1752,108.8
'38100, 양산시,'020005, 19세,2019,3510,1982,1528,129.7,3415,1936,1479,130.9
'38100, 양산시,'025,20~24세,2019,18767,10644,8123,131,17924,10072,7852,128.3
'38100, 양산시,'025001, 20세,2019,3443,2018,1425,141.6,3376,1974,1402,140.8
'38100, 양산시,'025002, 21세,2019,3644,2182,1462,149.2,3504,2082,1422,146.4
'38100, 양산시,'025003, 22세,2019,3698,2047,1651,124,3517,1919,1598,120.1
'38100, 양산시,'025004, 23세,2019,3943,2178,1765,123.4,3735,2043,1692,120.7
'38100, 양산시,'025005, 24세,2019,4039,2219,1820,121.9,3792,2054,1738,118.2
'38100, 양산시,'030,25~29세,2019,21132,11328,9804,115.5,19509,10195,9314,109.5
'38100, 양산시,'030001, 25세,2019,3986,2183,1803,121.1,3710,1994,1716,116.2
'38100, 양산시,'030002, 26세,2019,4230,2299,1931,119.1,3936,2091,1845,113.3
'38100, 양산시,'030003, 27세,2019,4295,2185,2110,103.6,3959,1961,1998,98.1
'38100, 양산시,'030004, 28세,2019,4361,2337,2024,115.5,4016,2095,1921,109.1
'38100, 양산시,'030005, 29세,2019,4260,2324,1936,120,3888,2054,1834,112
'38100, 양산시,'035,30~34세,2019,22617,11806,10811,109.2,20848,10583,10265,103.1
'38100, 양산시,'035001, 30세,2019,4299,2249,2050,109.7,3940,1990,1950,102.1
'38100, 양산시,'035002, 31세,2019,4319,2259,2060,109.7,3929,2003,1926,104
'38100, 양산시,'035003, 32세,2019,4582,2307,2275,101.4,4222,2065,2157,95.7
'38100, 양산시,'035004, 33세,2019,4544,2410,2134,112.9,4187,2148,2039,105.3
'38100, 양산시,'035005, 34세,2019,4873,2581,2292,112.6,4570,2377,2193,108.4
'38100, 양산시,'040,35~39세,2019,31485,16366,15119,108.2,30119,15423,14696,104.9
'38100, 양산시,'040001, 35세,2019,5425,2826,2599,108.7,5101,2604,2497,104.3
'38100, 양산시,'040002, 36세,2019,5946,3122,2824,110.6,5651,2921,2730,107
'38100, 양산시,'040003, 37세,2019,6581,3394,3187,106.5,6303,3213,3090,104
'38100, 양산시,'040004, 38세,2019,6675,3497,3178,110,6416,3300,3116,105.9
'38100, 양산시,'040005, 39세,2019,6858,3527,3331,105.9,6648,3385,3263,103.7
'38100, 양산시,'045,40~44세,2019,28879,14789,14090,105,28022,14227,13795,103.1
'38100, 양산시,'045001, 40세,2019,6188,3136,3052,102.8,5975,2992,2983,100.3
'38100, 양산시,'045002, 41세,2019,5655,2948,2707,108.9,5483,2837,2646,107.2
'38100, 양산시,'045003, 42세,2019,5756,2937,2819,104.2,5597,2834,2763,102.6
'38100, 양산시,'045004, 43세,2019,5372,2757,2615,105.4,5218,2649,2569,103.1
'38100, 양산시,'045005, 44세,2019,5908,3011,2897,103.9,5749,2915,2834,102.9
'38100, 양산시,'050,45~49세,2019,30654,15528,15126,102.7,29971,15111,14860,101.7
'38100, 양산시,'050001, 45세,2019,6078,3113,2965,105,5943,3023,2920,103.5
'38100, 양산시,'050002, 46세,2019,6017,3057,2960,103.3,5904,2988,2916,102.5
'38100, 양산시,'050003, 47세,2019,5989,3081,2908,105.9,5849,2992,2857,104.7
'38100, 양산시,'050004, 48세,2019,6229,3160,3069,103,6082,3077,3005,102.4
'38100, 양산시,'050005, 49세,2019,6341,3117,3224,96.7,6193,3031,3162,95.9
'38100, 양산시,'055,50~54세,2019,29383,14639,14744,99.3,28853,14346,14507,98.9
'38100, 양산시,'055001, 50세,2019,6265,3116,3149,99,6148,3053,3095,98.6
'38100, 양산시,'055002, 51세,2019,6210,2971,3239,91.7,6082,2897,3185,91
'38100, 양산시,'055003, 52세,2019,5754,2820,2934,96.1,5663,2776,2887,96.2
'38100, 양산시,'055004, 53세,2019,5587,2898,2689,107.8,5484,2841,2643,107.5
'38100, 양산시,'055005, 54세,2019,5567,2834,2733,103.7,5476,2779,2697,103
'38100, 양산시,'060,55~59세,2019,27584,14100,13484,104.6,27231,13914,13317,104.5
'38100, 양산시,'060001, 55세,2019,4988,2563,2425,105.7,4912,2522,2390,105.5
'38100, 양산시,'060002, 56세,2019,5359,2786,2573,108.3,5276,2747,2529,108.6
'38100, 양산시,'060003, 57세,2019,5540,2840,2700,105.2,5468,2800,2668,104.9
'38100, 양산시,'060004, 58세,2019,5959,2984,2975,100.3,5910,2960,2950,100.3
'38100, 양산시,'060005, 59세,2019,5738,2927,2811,104.1,5665,2885,2780,103.8
'38100, 양산시,'065,60~64세,2019,23062,11331,11731,96.6,22837,11218,11619,96.5
'38100, 양산시,'065001, 60세,2019,5157,2558,2599,98.4,5106,2530,2576,98.2
'38100, 양산시,'065002, 61세,2019,4767,2346,2421,96.9,4712,2315,2397,96.6
'38100, 양산시,'065003, 62세,2019,4644,2334,2310,101,4602,2311,2291,100.9
'38100, 양산시,'065004, 63세,2019,4124,1992,2132,93.4,4080,1978,2102,94.1
'38100, 양산시,'065005, 64세,2019,4370,2101,2269,92.6,4337,2084,2253,92.5
'38100, 양산시,'070,65~69세,2019,15275,7421,7854,94.5,15164,7372,7792,94.6
'38100, 양산시,'070001, 65세,2019,3560,1719,1841,93.4,3533,1709,1824,93.7
'38100, 양산시,'070002, 66세,2019,3136,1532,1604,95.5,3112,1518,1594,95.2
'38100, 양산시,'070003, 67세,2019,3325,1584,1741,91,3304,1575,1729,91.1
'38100, 양산시,'070004, 68세,2019,2571,1264,1307,96.7,2547,1254,1293,97
'38100, 양산시,'070005, 69세,2019,2683,1322,1361,97.1,2668,1316,1352,97.3
'38100, 양산시,'075,70~74세,2019,10748,4923,5825,84.5,10713,4908,5805,84.5
'38100, 양산시,'075001, 70세,2019,2476,1168,1308,89.3,2465,1164,1301,89.5
'38100, 양산시,'075002, 71세,2019,2577,1198,1379,86.9,2565,1192,1373,86.8
'38100, 양산시,'075003, 72세,2019,2268,1004,1264,79.4,2261,1002,1259,79.6
'38100, 양산시,'075004, 73세,2019,1718,756,962,78.6,1715,755,960,78.6
'38100, 양산시,'075005, 74세,2019,1709,797,912,87.4,1707,795,912,87.2
'38100, 양산시,'080,75~79세,2019,8859,3698,5161,71.7,8847,3695,5152,71.7
'38100, 양산시,'080001, 75세,2019,1761,813,948,85.8,1759,813,946,85.9
'38100, 양산시,'080002, 76세,2019,1916,798,1118,71.4,1913,797,1116,71.4
'38100, 양산시,'080003, 77세,2019,2005,850,1155,73.6,2002,848,1154,73.5
'38100, 양산시,'080004, 78세,2019,1609,641,968,66.2,1607,641,966,66.4
'38100, 양산시,'080005, 79세,2019,1568,596,972,61.3,1566,596,970,61.4
'38100, 양산시,'085,80~84세,2019,5442,1971,3471,56.8,5430,1965,3465,56.7
'38100, 양산시,'085001, 80세,2019,1422,545,877,62.1,1419,544,875,62.2
'38100, 양산시,'085002, 81세,2019,1148,419,729,57.5,1143,416,727,57.2
'38100, 양산시,'085003, 82세,2019,1057,373,684,54.5,1057,373,684,54.5
'38100, 양산시,'085004, 83세,2019,926,324,602,53.8,926,324,602,53.8
'38100, 양산시,'085005, 84세,2019,889,310,579,53.5,885,308,577,53.4
'38100, 양산시,'086,85세이상,2019,3423,893,2530,35.3,3418,891,2527,35.3
'38100, 양산시,'090,85~89세,2019,2422,691,1731,39.9,2420,690,1730,39.9
'38100, 양산시,'090001, 85세,2019,693,209,484,43.2,692,208,484,43
'38100, 양산시,'090002, 86세,2019,559,184,375,49.1,559,184,375,49.1
'38100, 양산시,'090003, 87세,2019,491,127,364,34.9,490,127,363,35
'38100, 양산시,'090004, 88세,2019,372,96,276,34.8,372,96,276,34.8
'38100, 양산시,'090005, 89세,2019,307,75,232,32.3,307,75,232,32.3
'38100, 양산시,'095,90~94세,2019,819,171,648,26.4,817,171,646,26.5
'38100, 양산시,'095001, 90세,2019,274,69,205,33.7,273,69,204,33.8
'38100, 양산시,'095002, 91세,2019,192,41,151,27.2,192,41,151,27.2
'38100, 양산시,'095003, 92세,2019,170,37,133,27.8,169,37,132,28
'38100, 양산시,'095004, 93세,2019,110,13,97,13.4,110,13,97,13.4
'38100, 양산시,'095005, 94세,2019,73,11,62,17.7,73,11,62,17.7
'38100, 양산시,'100,95~99세,2019,167,30,137,21.9,166,29,137,21.2
'38100, 양산시,'100001, 95세,2019,59,9,50,18,58,8,50,16
'38100, 양산시,'100002, 96세,2019,48,11,37,29.7,48,11,37,29.7
'38100, 양산시,'100003, 97세,2019,34,6,28,21.4,34,6,28,21.4
'38100, 양산시,'100004, 98세,2019,16,X,15,6.7,16,X,15,6.7
'38100, 양산시,'100005, 99세,2019,10,X,7,42.9,10,X,7,42.9
'38100, 양산시,'101,100세이상,2019,15,X,14,7.1,15,X,14,7.1
'38100, 양산시,'102,15세미만,2019,52702,26943,25759,104.6,52378,26775,25603,104.6
'38100, 양산시,'103,15~64세,2019,250772,129431,121341,106.7,242342,123891,118451,104.6
'38100, 양산시,'104,65세이상,2019,43747,18906,24841,76.1,43572,18831,24741,76.1
'38100, 양산시,'126,평균연령,2019,40.7,39.6,41.7,,40.8,39.8,41.8,
'38100, 양산시,'127,중위연령,2019,41.6,40.5,42.8,,42,41,43,
'38110, 창원시,'000,합계,2019,1036862,528300,508562,103.9,1015638,515032,500606,102.9
'38110, 창원시,'005,0~4세,2019,38710,19973,18737,106.6,38422,19827,18595,106.6
'38110, 창원시,'005001, 0세,2019,6281,3255,3026,107.6,6221,3223,2998,107.5
'38110, 창원시,'005002, 1세,2019,6842,3511,3331,105.4,6787,3481,3306,105.3
'38110, 창원시,'005003, 2세,2019,7638,3953,3685,107.3,7572,3921,3651,107.4
'38110, 창원시,'005004, 3세,2019,8688,4432,4256,104.1,8631,4402,4229,104.1
'38110, 창원시,'005005, 4세,2019,9261,4822,4439,108.6,9211,4800,4411,108.8
'38110, 창원시,'010,5~9세,2019,48870,25342,23528,107.7,48707,25260,23447,107.7
'38110, 창원시,'010001, 5세,2019,9294,4854,4440,109.3,9236,4829,4407,109.6
'38110, 창원시,'010002, 6세,2019,9510,4903,4607,106.4,9479,4886,4593,106.4
'38110, 창원시,'010003, 7세,2019,10437,5427,5010,108.3,10403,5413,4990,108.5
'38110, 창원시,'010004, 8세,2019,10056,5205,4851,107.3,10037,5195,4842,107.3
'38110, 창원시,'010005, 9세,2019,9573,4953,4620,107.2,9552,4937,4615,107
'38110, 창원시,'015,10~14세,2019,47413,24624,22789,108.1,47315,24576,22739,108.1
'38110, 창원시,'015001, 10세,2019,9399,4889,4510,108.4,9374,4879,4495,108.5
'38110, 창원시,'015002, 11세,2019,9822,4949,4873,101.6,9805,4940,4865,101.5
'38110, 창원시,'015003, 12세,2019,10022,5282,4740,111.4,9994,5265,4729,111.3
'38110, 창원시,'015004, 13세,2019,9191,4834,4357,110.9,9173,4825,4348,111
'38110, 창원시,'015005, 14세,2019,8979,4670,4309,108.4,8969,4667,4302,108.5
'38110, 창원시,'020,15~19세,2019,52454,28265,24189,116.9,52111,28112,23999,117.1
'38110, 창원시,'020001, 15세,2019,9878,5180,4698,110.3,9855,5171,4684,110.4
'38110, 창원시,'020002, 16세,2019,9650,5221,4429,117.9,9629,5208,4421,117.8
'38110, 창원시,'020003, 17세,2019,10057,5345,4712,113.4,10022,5326,4696,113.4
'38110, 창원시,'020004, 18세,2019,11273,6025,5248,114.8,11177,5980,5197,115.1
'38110, 창원시,'020005, 19세,2019,11596,6494,5102,127.3,11428,6427,5001,128.5
'38110, 창원시,'025,20~24세,2019,63555,36101,27454,131.5,61488,34874,26614,131
'38110, 창원시,'025001, 20세,2019,11635,6734,4901,137.4,11378,6595,4783,137.9
'38110, 창원시,'025002, 21세,2019,12255,7037,5218,134.9,11934,6871,5063,135.7
'38110, 창원시,'025003, 22세,2019,12856,7257,5599,129.6,12458,7023,5435,129.2
'38110, 창원시,'025004, 23세,2019,13334,7510,5824,128.9,12820,7191,5629,127.7
'38110, 창원시,'025005, 24세,2019,13475,7563,5912,127.9,12898,7194,5704,126.1
'38110, 창원시,'030,25~29세,2019,67092,37498,29594,126.7,63472,35058,28414,123.4
'38110, 창원시,'030001, 25세,2019,13565,7602,5963,127.5,12970,7221,5749,125.6
'38110, 창원시,'030002, 26세,2019,13527,7559,5968,126.7,12865,7095,5770,123
'38110, 창원시,'030003, 27세,2019,13789,7688,6101,126,13052,7205,5847,123.2
'38110, 창원시,'030004, 28세,2019,13184,7316,5868,124.7,12445,6812,5633,120.9
'38110, 창원시,'030005, 29세,2019,13027,7333,5694,128.8,12140,6725,5415,124.2
'38110, 창원시,'035,30~34세,2019,64059,35243,28816,122.3,59827,32336,27491,117.6
'38110, 창원시,'035001, 30세,2019,12706,7055,5651,124.8,11816,6447,5369,120.1
'38110, 창원시,'035002, 31세,2019,12456,6857,5599,122.5,11626,6294,5332,118
'38110, 창원시,'035003, 32세,2019,12708,6989,5719,122.2,11809,6366,5443,117
'38110, 창원시,'035004, 33세,2019,12740,7074,5666,124.8,11897,6484,5413,119.8
'38110, 창원시,'035005, 34세,2019,13449,7268,6181,117.6,12679,6745,5934,113.7
'38110, 창원시,'040,35~39세,2019,81522,42774,38748,110.4,78574,40785,37789,107.9
'38110, 창원시,'040001, 35세,2019,13903,7499,6404,117.1,13215,7004,6211,112.8
'38110, 창원시,'040002, 36세,2019,15595,8269,7326,112.9,14945,7834,7111,110.2
'38110, 창원시,'040003, 37세,2019,17000,8839,8161,108.3,16389,8444,7945,106.3
'38110, 창원시,'040004, 38세,2019,17298,9099,8199,111,16772,8752,8020,109.1
'38110, 창원시,'040005, 39세,2019,17726,9068,8658,104.7,17253,8751,8502,102.9
'38110, 창원시,'045,40~44세,2019,77937,40259,37678,106.9,75998,39012,36986,105.5
'38110, 창원시,'045001, 40세,2019,16492,8546,7946,107.6,16033,8254,7779,106.1
'38110, 창원시,'045002, 41세,2019,15288,7981,7307,109.2,14872,7717,7155,107.9
'38110, 창원시,'045003, 42세,2019,15373,7964,7409,107.5,15018,7734,7284,106.2
'38110, 창원시,'045004, 43세,2019,14954,7773,7181,108.2,14581,7523,7058,106.6
'38110, 창원시,'045005, 44세,2019,15830,7995,7835,102,15494,7784,7710,101
'38110, 창원시,'050,45~49세,2019,91460,45798,45662,100.3,89651,44703,44948,99.5
'38110, 창원시,'050001, 45세,2019,17532,8881,8651,102.7,17182,8667,8515,101.8
'38110, 창원시,'050002, 46세,2019,17982,9013,8969,100.5,17649,8813,8836,99.7
'38110, 창원시,'050003, 47세,2019,17497,8897,8600,103.5,17129,8671,8458,102.5
'38110, 창원시,'050004, 48세,2019,19189,9443,9746,96.9,18802,9200,9602,95.8
'38110, 창원시,'050005, 49세,2019,19260,9564,9696,98.6,18889,9352,9537,98.1
'38110, 창원시,'055,50~54세,2019,93877,46221,47656,97,92346,45368,46978,96.6
'38110, 창원시,'055001, 50세,2019,19494,9714,9780,99.3,19154,9515,9639,98.7
'38110, 창원시,'055002, 51세,2019,19744,9514,10230,93,19407,9334,10073,92.7
'38110, 창원시,'055003, 52세,2019,18091,8777,9314,94.2,17802,8607,9195,93.6
'38110, 창원시,'055004, 53세,2019,18081,9136,8945,102.1,17797,8991,8806,102.1
'38110, 창원시,'055005, 54세,2019,18467,9080,9387,96.7,18186,8921,9265,96.3
'38110, 창원시,'060,55~59세,2019,93999,47062,46937,100.3,92905,46506,46399,100.2
'38110, 창원시,'060001, 55세,2019,16268,8080,8188,98.7,15997,7938,8059,98.5
'38110, 창원시,'060002, 56세,2019,18224,9293,8931,104.1,17943,9147,8796,104
'38110, 창원시,'060003, 57세,2019,18935,9531,9404,101.4,18723,9420,9303,101.3
'38110, 창원시,'060004, 58세,2019,20458,10199,10259,99.4,20303,10126,10177,99.5
'38110, 창원시,'060005, 59세,2019,20114,9959,10155,98.1,19939,9875,10064,98.1
'38110, 창원시,'065,60~64세,2019,78139,38736,39403,98.3,77543,38424,39119,98.2
'38110, 창원시,'065001, 60세,2019,17383,8771,8612,101.8,17242,8696,8546,101.8
'38110, 창원시,'065002, 61세,2019,16063,8148,7915,102.9,15922,8068,7854,102.7
'38110, 창원시,'065003, 62세,2019,15514,7684,7830,98.1,15401,7626,7775,98.1
'38110, 창원시,'065004, 63세,2019,14382,6981,7401,94.3,14275,6926,7349,94.2
'38110, 창원시,'065005, 64세,2019,14797,7152,7645,93.6,14703,7108,7595,93.6
'38110, 창원시,'070,65~69세,2019,50332,24918,25414,98,50058,24787,25271,98.1
'38110, 창원시,'070001, 65세,2019,11950,6049,5901,102.5,11877,6018,5859,102.7
'38110, 창원시,'070002, 66세,2019,10497,5255,5242,100.2,10416,5214,5202,100.2
'38110, 창원시,'070003, 67세,2019,11091,5548,5543,100.1,11045,5525,5520,100.1
'38110, 창원시,'070004, 68세,2019,8514,4072,4442,91.7,8474,4053,4421,91.7
'38110, 창원시,'070005, 69세,2019,8280,3994,4286,93.2,8246,3977,4269,93.2
'38110, 창원시,'075,70~74세,2019,34246,16434,17812,92.3,34141,16392,17749,92.4
'38110, 창원시,'075001, 70세,2019,8444,4133,4311,95.9,8410,4121,4289,96.1
'38110, 창원시,'075002, 71세,2019,7908,3868,4040,95.7,7892,3861,4031,95.8
'38110, 창원시,'075003, 72세,2019,7403,3495,3908,89.4,7374,3483,3891,89.5
'38110, 창원시,'075004, 73세,2019,5323,2585,2738,94.4,5308,2578,2730,94.4
'38110, 창원시,'075005, 74세,2019,5168,2353,2815,83.6,5157,2349,2808,83.7
'38110, 창원시,'080,75~79세,2019,25641,10767,14874,72.4,25586,10748,14838,72.4
'38110, 창원시,'080001, 75세,2019,5460,2452,3008,81.5,5443,2449,2994,81.8
'38110, 창원시,'080002, 76세,2019,5311,2255,3056,73.8,5302,2251,3051,73.8
'38110, 창원시,'080003, 77세,2019,5658,2408,3250,74.1,5650,2405,3245,74.1
'38110, 창원시,'080004, 78세,2019,4829,1969,2860,68.8,4820,1966,2854,68.9
'38110, 창원시,'080005, 79세,2019,4383,1683,2700,62.3,4371,1677,2694,62.2
'38110, 창원시,'085,80~84세,2019,16572,5727,10845,52.8,16532,5714,10818,52.8
'38110, 창원시,'085001, 80세,2019,4087,1497,2590,57.8,4078,1495,2583,57.9
'38110, 창원시,'085002, 81세,2019,3508,1283,2225,57.7,3494,1278,2216,57.7
'38110, 창원시,'085003, 82세,2019,3323,1130,2193,51.5,3317,1128,2189,51.5
'38110, 창원시,'085004, 83세,2019,2972,975,1997,48.8,2965,973,1992,48.8
'38110, 창원시,'085005, 84세,2019,2682,842,1840,45.8,2678,840,1838,45.7
'38110, 창원시,'086,85세이상,2019,10984,2558,8426,30.4,10962,2550,8412,30.3
'38110, 창원시,'090,85~89세,2019,8001,1977,6024,32.8,7989,1974,6015,32.8
'38110, 창원시,'090001, 85세,2019,2260,636,1624,39.2,2257,635,1622,39.1
'38110, 창원시,'090002, 86세,2019,1791,489,1302,37.6,1788,488,1300,37.5
'38110, 창원시,'090003, 87세,2019,1678,394,1284,30.7,1677,394,1283,30.7
'38110, 창원시,'090004, 88세,2019,1225,261,964,27.1,1224,261,963,27.1
'38110, 창원시,'090005, 89세,2019,1047,197,850,23.2,1043,196,847,23.1
'38110, 창원시,'095,90~94세,2019,2502,503,1999,25.2,2494,499,1995,25
'38110, 창원시,'095001, 90세,2019,874,192,682,28.2,873,191,682,28
'38110, 창원시,'095002, 91세,2019,614,120,494,24.3,613,120,493,24.3
'38110, 창원시,'095003, 92세,2019,442,93,349,26.6,440,91,349,26.1
'38110, 창원시,'095004, 93세,2019,321,55,266,20.7,319,54,265,20.4
'38110, 창원시,'095005, 94세,2019,251,43,208,20.7,249,43,206,20.9
'38110, 창원시,'100,95~99세,2019,435,74,361,20.5,433,73,360,20.3
'38110, 창원시,'100001, 95세,2019,146,25,121,20.7,146,25,121,20.7
'38110, 창원시,'100002, 96세,2019,134,17,117,14.5,134,17,117,14.5
'38110, 창원시,'100003, 97세,2019,79,19,60,31.7,78,19,59,32.2
'38110, 창원시,'100004, 98세,2019,44,8,36,22.2,43,7,36,19.4
'38110, 창원시,'100005, 99세,2019,32,5,27,18.5,32,5,27,18.5
'38110, 창원시,'101,100세이상,2019,46,X,42,9.5,46,X,42,9.5
'38110, 창원시,'102,15세미만,2019,134993,69939,65054,107.5,134444,69663,64781,107.5
'38110, 창원시,'103,15~64세,2019,764094,397957,366137,108.7,743915,385178,358737,107.4
'38110, 창원시,'104,65세이상,2019,137775,60404,77371,78.1,137279,60191,77088,78.1
'38110, 창원시,'126,평균연령,2019,41.9,40.7,43.2,,42,40.8,43.3,
'38110, 창원시,'127,중위연령,2019,43.5,41.7,45.3,,43.8,42.1,45.5,
'38111, 의창구,'000,합계,2019,256001,130662,125339,104.2,250901,127671,123230,103.6
'38111, 의창구,'005,0~4세,2019,9828,5071,4757,106.6,9762,5037,4725,106.6
'38111, 의창구,'005001, 0세,2019,1649,859,790,108.7,1630,849,781,108.7
'38111, 의창구,'005002, 1세,2019,1739,880,859,102.4,1722,871,851,102.4
'38111, 의창구,'005003, 2세,2019,1985,1040,945,110.1,1971,1035,936,110.6
'38111, 의창구,'005004, 3세,2019,2146,1088,1058,102.8,2137,1082,1055,102.6
'38111, 의창구,'005005, 4세,2019,2309,1204,1105,109,2302,1200,1102,108.9
'38111, 의창구,'010,5~9세,2019,11519,5952,5567,106.9,11468,5922,5546,106.8
'38111, 의창구,'010001, 5세,2019,2274,1204,1070,112.5,2262,1196,1066,112.2
'38111, 의창구,'010002, 6세,2019,2222,1118,1104,101.3,2209,1111,1098,101.2
'38111, 의창구,'010003, 7세,2019,2429,1255,1174,106.9,2420,1251,1169,107
'38111, 의창구,'010004, 8세,2019,2345,1231,1114,110.5,2337,1226,1111,110.4
'38111, 의창구,'010005, 9세,2019,2249,1144,1105,103.5,2240,1138,1102,103.3
'38111, 의창구,'015,10~14세,2019,10554,5502,5052,108.9,10535,5492,5043,108.9
'38111, 의창구,'015001, 10세,2019,2164,1101,1063,103.6,2161,1099,1062,103.5
'38111, 의창구,'015002, 11세,2019,2187,1143,1044,109.5,2183,1139,1044,109.1
'38111, 의창구,'015003, 12세,2019,2206,1155,1051,109.9,2202,1152,1050,109.7
'38111, 의창구,'015004, 13세,2019,2008,1033,975,105.9,2004,1033,971,106.4
'38111, 의창구,'015005, 14세,2019,1989,1070,919,116.4,1985,1069,916,116.7
'38111, 의창구,'020,15~19세,2019,12888,6961,5927,117.4,12823,6935,5888,117.8
'38111, 의창구,'020001, 15세,2019,2238,1173,1065,110.1,2228,1169,1059,110.4
'38111, 의창구,'020002, 16세,2019,2220,1172,1048,111.8,2214,1170,1044,112.1
'38111, 의창구,'020003, 17세,2019,2378,1316,1062,123.9,2367,1312,1055,124.4
'38111, 의창구,'020004, 18세,2019,2788,1469,1319,111.4,2773,1462,1311,111.5
'38111, 의창구,'020005, 19세,2019,3264,1831,1433,127.8,3241,1822,1419,128.4
'38111, 의창구,'025,20~24세,2019,17713,10020,7693,130.2,17241,9763,7478,130.6
'38111, 의창구,'025001, 20세,2019,3201,1778,1423,124.9,3140,1754,1386,126.6
'38111, 의창구,'025002, 21세,2019,3406,1924,1482,129.8,3334,1885,1449,130.1
'38111, 의창구,'025003, 22세,2019,3638,2039,1599,127.5,3540,1989,1551,128.2
'38111, 의창구,'025004, 23세,2019,3721,2121,1600,132.6,3603,2053,1550,132.5
'38111, 의창구,'025005, 24세,2019,3747,2158,1589,135.8,3624,2082,1542,135
'38111, 의창구,'030,25~29세,2019,18155,10094,8061,125.2,17324,9573,7751,123.5
'38111, 의창구,'030001, 25세,2019,3804,2136,1668,128.1,3659,2054,1605,128
'38111, 의창구,'030002, 26세,2019,3665,2015,1650,122.1,3496,1918,1578,121.5
'38111, 의창구,'030003, 27세,2019,3709,2077,1632,127.3,3551,1973,1578,125
'38111, 의창구,'030004, 28세,2019,3604,1985,1619,122.6,3456,1885,1571,120
'38111, 의창구,'030005, 29세,2019,3373,1881,1492,126.1,3162,1743,1419,122.8
'38111, 의창구,'035,30~34세,2019,16146,8856,7290,121.5,15153,8234,6919,119
'38111, 의창구,'035001, 30세,2019,3217,1762,1455,121.1,3009,1635,1374,119
'38111, 의창구,'035002, 31세,2019,3159,1709,1450,117.9,2961,1586,1375,115.3
'38111, 의창구,'035003, 32세,2019,3156,1751,1405,124.6,2933,1608,1325,121.4
'38111, 의창구,'035004, 33세,2019,3140,1776,1364,130.2,2952,1653,1299,127.3
'38111, 의창구,'035005, 34세,2019,3474,1858,1616,115,3298,1752,1546,113.3
'38111, 의창구,'040,35~39세,2019,20047,10470,9577,109.3,19354,10019,9335,107.3
'38111, 의창구,'040001, 35세,2019,3476,1856,1620,114.6,3326,1742,1584,110
'38111, 의창구,'040002, 36세,2019,3834,1999,1835,108.9,3686,1907,1779,107.2
'38111, 의창구,'040003, 37세,2019,4210,2201,2009,109.6,4061,2110,1951,108.1
'38111, 의창구,'040004, 38세,2019,4195,2161,2034,106.2,4070,2081,1989,104.6
'38111, 의창구,'040005, 39세,2019,4332,2253,2079,108.4,4211,2179,2032,107.2
'38111, 의창구,'045,40~44세,2019,18035,9431,8604,109.6,17557,9144,8413,108.7
'38111, 의창구,'045001, 40세,2019,3770,1984,1786,111.1,3662,1922,1740,110.5
'38111, 의창구,'045002, 41세,2019,3597,1908,1689,113,3493,1847,1646,112.2
'38111, 의창구,'045003, 42세,2019,3504,1833,1671,109.7,3417,1784,1633,109.2
'38111, 의창구,'045004, 43세,2019,3532,1836,1696,108.3,3436,1775,1661,106.9
'38111, 의창구,'045005, 44세,2019,3632,1870,1762,106.1,3549,1816,1733,104.8
'38111, 의창구,'050,45~49세,2019,22360,10873,11487,94.7,21913,10617,11296,94
'38111, 의창구,'050001, 45세,2019,4065,2037,2028,100.4,3983,1993,1990,100.2
'38111, 의창구,'050002, 46세,2019,4388,2122,2266,93.6,4302,2079,2223,93.5
'38111, 의창구,'050003, 47세,2019,4307,2164,2143,101,4211,2109,2102,100.3
'38111, 의창구,'050004, 48세,2019,4710,2216,2494,88.9,4624,2162,2462,87.8
'38111, 의창구,'050005, 49세,2019,4890,2334,2556,91.3,4793,2274,2519,90.3
'38111, 의창구,'055,50~54세,2019,25175,12047,13128,91.8,24742,11816,12926,91.4
'38111, 의창구,'055001, 50세,2019,5083,2439,2644,92.2,4989,2388,2601,91.8
'38111, 의창구,'055002, 51세,2019,5217,2420,2797,86.5,5115,2368,2747,86.2
'38111, 의창구,'055003, 52세,2019,4849,2252,2597,86.7,4781,2215,2566,86.3
'38111, 의창구,'055004, 53세,2019,4891,2416,2475,97.6,4811,2372,2439,97.3
'38111, 의창구,'055005, 54세,2019,5135,2520,2615,96.4,5046,2473,2573,96.1
'38111, 의창구,'060,55~59세,2019,24558,12524,12034,104.1,24258,12372,11886,104.1
'38111, 의창구,'060001, 55세,2019,4294,2119,2175,97.4,4221,2082,2139,97.3
'38111, 의창구,'060002, 56세,2019,4813,2488,2325,107,4732,2445,2287,106.9
'38111, 의창구,'060003, 57세,2019,5008,2575,2433,105.8,4946,2541,2405,105.7
'38111, 의창구,'060004, 58세,2019,5295,2708,2587,104.7,5253,2692,2561,105.1
'38111, 의창구,'060005, 59세,2019,5148,2634,2514,104.8,5106,2612,2494,104.7
'38111, 의창구,'065,60~64세,2019,18817,9504,9313,102.1,18685,9432,9253,101.9
'38111, 의창구,'065001, 60세,2019,4299,2250,2049,109.8,4268,2231,2037,109.5
'38111, 의창구,'065002, 61세,2019,3943,2042,1901,107.4,3910,2021,1889,107
'38111, 의창구,'065003, 62세,2019,3772,1858,1914,97.1,3751,1848,1903,97.1
'38111, 의창구,'065004, 63세,2019,3447,1701,1746,97.4,3424,1691,1733,97.6
'38111, 의창구,'065005, 64세,2019,3356,1653,1703,97.1,3332,1641,1691,97
'38111, 의창구,'070,65~69세,2019,11417,5803,5614,103.4,11361,5779,5582,103.5
'38111, 의창구,'070001, 65세,2019,2816,1432,1384,103.5,2801,1425,1376,103.6
'38111, 의창구,'070002, 66세,2019,2428,1232,1196,103,2412,1225,1187,103.2
'38111, 의창구,'070003, 67세,2019,2494,1291,1203,107.3,2483,1287,1196,107.6
'38111, 의창구,'070004, 68세,2019,1894,938,956,98.1,1885,934,951,98.2
'38111, 의창구,'070005, 69세,2019,1785,910,875,104,1780,908,872,104.1
'38111, 의창구,'075,70~74세,2019,7148,3563,3585,99.4,7116,3552,3564,99.7
'38111, 의창구,'075001, 70세,2019,1791,917,874,104.9,1780,915,865,105.8
'38111, 의창구,'075002, 71세,2019,1680,851,829,102.7,1672,845,827,102.2
'38111, 의창구,'075003, 72세,2019,1547,755,792,95.3,1540,753,787,95.7
'38111, 의창구,'075004, 73세,2019,1091,546,545,100.2,1087,545,542,100.6
'38111, 의창구,'075005, 74세,2019,1039,494,545,90.6,1037,494,543,91
'38111, 의창구,'080,75~79세,2019,5392,2242,3150,71.2,5378,2241,3137,71.4
'38111, 의창구,'080001, 75세,2019,1110,512,598,85.6,1105,512,593,86.3
'38111, 의창구,'080002, 76세,2019,1159,489,670,73,1156,489,667,73.3
'38111, 의창구,'080003, 77세,2019,1195,500,695,71.9,1194,500,694,72
'38111, 의창구,'080004, 78세,2019,979,392,587,66.8,975,391,584,67
'38111, 의창구,'080005, 79세,2019,949,349,600,58.2,948,349,599,58.3
'38111, 의창구,'085,80~84세,2019,3650,1204,2446,49.2,3636,1200,2436,49.3
'38111, 의창구,'085001, 80세,2019,851,277,574,48.3,847,276,571,48.3
'38111, 의창구,'085002, 81세,2019,737,254,483,52.6,733,253,480,52.7
'38111, 의창구,'085003, 82세,2019,749,239,510,46.9,747,238,509,46.8
'38111, 의창구,'085004, 83세,2019,666,223,443,50.3,663,222,441,50.3
'38111, 의창구,'085005, 84세,2019,647,211,436,48.4,646,211,435,48.5
'38111, 의창구,'086,85세이상,2019,2599,545,2054,26.5,2595,543,2052,26.5
'38111, 의창구,'090,85~89세,2019,1888,413,1475,28,1887,413,1474,28
'38111, 의창구,'090001, 85세,2019,497,108,389,27.8,497,108,389,27.8
'38111, 의창구,'090002, 86세,2019,439,108,331,32.6,439,108,331,32.6
'38111, 의창구,'090003, 87세,2019,424,90,334,26.9,424,90,334,26.9
'38111, 의창구,'090004, 88세,2019,278,64,214,29.9,278,64,214,29.9
'38111, 의창구,'090005, 89세,2019,250,43,207,20.8,249,43,206,20.9
'38111, 의창구,'095,90~94세,2019,602,118,484,24.4,600,116,484,24
'38111, 의창구,'095001, 90세,2019,210,41,169,24.3,210,41,169,24.3
'38111, 의창구,'095002, 91세,2019,153,27,126,21.4,153,27,126,21.4
'38111, 의창구,'095003, 92세,2019,101,20,81,24.7,100,19,81,23.5
'38111, 의창구,'095004, 93세,2019,79,15,64,23.4,78,14,64,21.9
'38111, 의창구,'095005, 94세,2019,59,15,44,34.1,59,15,44,34.1
'38111, 의창구,'100,95~99세,2019,95,13,82,15.9,94,13,81,16
'38111, 의창구,'100001, 95세,2019,34,X,30,13.3,34,X,30,13.3
'38111, 의창구,'100002, 96세,2019,27,X,23,17.4,27,X,23,17.4
'38111, 의창구,'100003, 97세,2019,23,5,18,27.8,22,5,17,29.4
'38111, 의창구,'100004, 98세,2019,5,X,5,0,5,X,5,0
'38111, 의창구,'100005, 99세,2019,6,X,6,0,6,X,6,0
'38111, 의창구,'101,100세이상,2019,14,X,13,7.7,14,X,13,7.7
'38111, 의창구,'102,15세미만,2019,31901,16525,15376,107.5,31765,16451,15314,107.4
'38111, 의창구,'103,15~64세,2019,193894,100780,93114,108.2,189050,97905,91145,107.4
'38111, 의창구,'104,65세이상,2019,30206,13357,16849,79.3,30086,13315,16771,79.4
'38111, 의창구,'126,평균연령,2019,41.5,40.3,42.7,,41.6,40.4,42.8,
'38111, 의창구,'127,중위연령,2019,43.1,41.2,45.1,,43.4,41.5,45.3,
'38112, 성산구,'000,합계,2019,219951,114488,105463,108.6,214760,110853,103907,106.7
'38112, 성산구,'005,0~4세,2019,8019,4063,3956,102.7,7945,4026,3919,102.7
'38112, 성산구,'005001, 0세,2019,1341,663,678,97.8,1331,658,673,97.8
'38112, 성산구,'005002, 1세,2019,1514,775,739,104.9,1494,763,731,104.4
'38112, 성산구,'005003, 2세,2019,1536,783,753,104,1520,774,746,103.8
'38112, 성산구,'005004, 3세,2019,1774,892,882,101.1,1759,887,872,101.7
'38112, 성산구,'005005, 4세,2019,1854,950,904,105.1,1841,944,897,105.2
'38112, 성산구,'010,5~9세,2019,9975,5134,4841,106.1,9937,5115,4822,106.1
'38112, 성산구,'010001, 5세,2019,1842,950,892,106.5,1826,943,883,106.8
'38112, 성산구,'010002, 6세,2019,1911,988,923,107,1904,984,920,107
'38112, 성산구,'010003, 7세,2019,2156,1092,1064,102.6,2148,1090,1058,103
'38112, 성산구,'010004, 8세,2019,2066,1070,996,107.4,2065,1069,996,107.3
'38112, 성산구,'010005, 9세,2019,2000,1034,966,107,1994,1029,965,106.6
'38112, 성산구,'015,10~14세,2019,10866,5747,5119,112.3,10837,5733,5104,112.3
'38112, 성산구,'015001, 10세,2019,2044,1082,962,112.5,2034,1080,954,113.2
'38112, 성산구,'015002, 11세,2019,2189,1114,1075,103.6,2185,1111,1074,103.4
'38112, 성산구,'015003, 12세,2019,2307,1245,1062,117.2,2298,1239,1059,117
'38112, 성산구,'015004, 13세,2019,2155,1167,988,118.1,2152,1165,987,118
'38112, 성산구,'015005, 14세,2019,2171,1139,1032,110.4,2168,1138,1030,110.5
'38112, 성산구,'020,15~19세,2019,12340,6874,5466,125.8,12297,6849,5448,125.7
'38112, 성산구,'020001, 15세,2019,2388,1261,1127,111.9,2382,1259,1123,112.1
'38112, 성산구,'020002, 16세,2019,2418,1348,1070,126,2414,1346,1068,126
'38112, 성산구,'020003, 17세,2019,2577,1378,1199,114.9,2572,1376,1196,115.1
'38112, 성산구,'020004, 18세,2019,2783,1544,1239,124.6,2772,1535,1237,124.1
'38112, 성산구,'020005, 19세,2019,2174,1343,831,161.6,2157,1333,824,161.8
'38112, 성산구,'025,20~24세,2019,14416,8403,6013,139.7,13977,8086,5891,137.3
'38112, 성산구,'025001, 20세,2019,2436,1590,846,187.9,2395,1564,831,188.2
'38112, 성산구,'025002, 21세,2019,2663,1648,1015,162.4,2605,1611,994,162.1
'38112, 성산구,'025003, 22세,2019,2793,1597,1196,133.5,2723,1546,1177,131.4
'38112, 성산구,'025004, 23세,2019,3187,1784,1403,127.2,3064,1689,1375,122.8
'38112, 성산구,'025005, 24세,2019,3337,1784,1553,114.9,3190,1676,1514,110.7
'38112, 성산구,'030,25~29세,2019,17599,10005,7594,131.7,16548,9215,7333,125.7
'38112, 성산구,'030001, 25세,2019,3389,1922,1467,131,3247,1818,1429,127.2
'38112, 성산구,'030002, 26세,2019,3477,1955,1522,128.4,3298,1821,1477,123.3
'38112, 성산구,'030003, 27세,2019,3633,2075,1558,133.2,3384,1885,1499,125.8
'38112, 성산구,'030004, 28세,2019,3579,2000,1579,126.7,3360,1837,1523,120.6
'38112, 성산구,'030005, 29세,2019,3521,2053,1468,139.9,3259,1854,1405,132
'38112, 성산구,'035,30~34세,2019,16437,9575,6862,139.5,15302,8697,6605,131.7
'38112, 성산구,'035001, 30세,2019,3414,1985,1429,138.9,3175,1804,1371,131.6
'38112, 성산구,'035002, 31세,2019,3286,1898,1388,136.7,3073,1733,1340,129.3
'38112, 성산구,'035003, 32세,2019,3337,1959,1378,142.2,3101,1776,1325,134
'38112, 성산구,'035004, 33세,2019,3231,1881,1350,139.3,3007,1706,1301,131.1
'38112, 성산구,'035005, 34세,2019,3169,1852,1317,140.6,2946,1678,1268,132.3
'38112, 성산구,'040,35~39세,2019,16827,8880,7947,111.7,16058,8307,7751,107.2
'38112, 성산구,'040001, 35세,2019,3107,1740,1367,127.3,2924,1594,1330,119.8
'38112, 성산구,'040002, 36세,2019,3351,1824,1527,119.4,3180,1695,1485,114.1
'38112, 성산구,'040003, 37세,2019,3390,1753,1637,107.1,3218,1631,1587,102.8
'38112, 성산구,'040004, 38세,2019,3471,1788,1683,106.2,3337,1693,1644,103
'38112, 성산구,'040005, 39세,2019,3508,1775,1733,102.4,3399,1694,1705,99.4
'38112, 성산구,'045,40~44세,2019,16551,8117,8434,96.2,16080,7791,8289,94
'38112, 성산구,'045001, 40세,2019,3380,1712,1668,102.6,3268,1624,1644,98.8
'38112, 성산구,'045002, 41세,2019,3190,1601,1589,100.8,3077,1525,1552,98.3
'38112, 성산구,'045003, 42세,2019,3305,1635,1670,97.9,3208,1569,1639,95.7
'38112, 성산구,'045004, 43세,2019,3262,1586,1676,94.6,3200,1546,1654,93.5
'38112, 성산구,'045005, 44세,2019,3414,1583,1831,86.5,3327,1527,1800,84.8
'38112, 성산구,'050,45~49세,2019,21842,10347,11495,90,21437,10084,11353,88.8
'38112, 성산구,'050001, 45세,2019,3941,1841,2100,87.7,3857,1783,2074,86
'38112, 성산구,'050002, 46세,2019,4112,1908,2204,86.6,4042,1860,2182,85.2
'38112, 성산구,'050003, 47세,2019,4266,2061,2205,93.5,4185,2005,2180,92
'38112, 성산구,'050004, 48세,2019,4687,2223,2464,90.2,4608,2178,2430,89.6
'38112, 성산구,'050005, 49세,2019,4836,2314,2522,91.8,4745,2258,2487,90.8
'38112, 성산구,'055,50~54세,2019,23011,11025,11986,92,22702,10845,11857,91.5
'38112, 성산구,'055001, 50세,2019,4749,2228,2521,88.4,4674,2179,2495,87.3
'38112, 성산구,'055002, 51세,2019,4829,2240,2589,86.5,4767,2209,2558,86.4
'38112, 성산구,'055003, 52세,2019,4436,2096,2340,89.6,4375,2059,2316,88.9
'38112, 성산구,'055004, 53세,2019,4409,2210,2199,100.5,4352,2178,2174,100.2
'38112, 성산구,'055005, 54세,2019,4588,2251,2337,96.3,4534,2220,2314,95.9
'38112, 성산구,'060,55~59세,2019,21956,11317,10639,106.4,21732,11208,10524,106.5
'38112, 성산구,'060001, 55세,2019,4015,1961,2054,95.5,3962,1933,2029,95.3
'38112, 성산구,'060002, 56세,2019,4440,2311,2129,108.5,4380,2276,2104,108.2
'38112, 성산구,'060003, 57세,2019,4435,2292,2143,107,4391,2272,2119,107.2
'38112, 성산구,'060004, 58세,2019,4659,2396,2263,105.9,4628,2384,2244,106.2
'38112, 성산구,'060005, 59세,2019,4407,2357,2050,115,4371,2343,2028,115.5
'38112, 성산구,'065,60~64세,2019,13893,7507,6386,117.6,13768,7444,6324,117.7
'38112, 성산구,'065001, 60세,2019,3500,1961,1539,127.4,3467,1943,1524,127.5
'38112, 성산구,'065002, 61세,2019,3095,1733,1362,127.2,3066,1717,1349,127.3
'38112, 성산구,'065003, 62세,2019,2646,1437,1209,118.9,2621,1423,1198,118.8
'38112, 성산구,'065004, 63세,2019,2357,1200,1157,103.7,2340,1194,1146,104.2
'38112, 성산구,'065005, 64세,2019,2295,1176,1119,105.1,2274,1167,1107,105.4
'38112, 성산구,'070,65~69세,2019,6919,3739,3180,117.6,6873,3716,3157,117.7
'38112, 성산구,'070001, 65세,2019,1695,922,773,119.3,1684,917,767,119.6
'38112, 성산구,'070002, 66세,2019,1553,846,707,119.7,1537,837,700,119.6
'38112, 성산구,'070003, 67세,2019,1470,796,674,118.1,1465,794,671,118.3
'38112, 성산구,'070004, 68세,2019,1185,612,573,106.8,1177,607,570,106.5
'38112, 성산구,'070005, 69세,2019,1016,563,453,124.3,1010,561,449,124.9
'38112, 성산구,'075,70~74세,2019,3873,1930,1943,99.3,3857,1920,1937,99.1
'38112, 성산구,'075001, 70세,2019,979,477,502,95,975,474,501,94.6
'38112, 성산구,'075002, 71세,2019,924,455,469,97,923,455,468,97.2
'38112, 성산구,'075003, 72세,2019,878,457,421,108.6,873,453,420,107.9
'38112, 성산구,'075004, 73세,2019,575,289,286,101,571,287,284,101.1
'38112, 성산구,'075005, 74세,2019,517,252,265,95.1,515,251,264,95.1
'38112, 성산구,'080,75~79세,2019,2566,1014,1552,65.3,2559,1011,1548,65.3
'38112, 성산구,'080001, 75세,2019,537,224,313,71.6,536,224,312,71.8
'38112, 성산구,'080002, 76세,2019,526,223,303,73.6,526,223,303,73.6
'38112, 성산구,'080003, 77세,2019,581,234,347,67.4,578,233,345,67.5
'38112, 성산구,'080004, 78세,2019,474,188,286,65.7,473,187,286,65.4
'38112, 성산구,'080005, 79세,2019,448,145,303,47.9,446,144,302,47.7
'38112, 성산구,'085,80~84세,2019,1759,551,1208,45.6,1755,548,1207,45.4
'38112, 성산구,'085001, 80세,2019,436,142,294,48.3,436,142,294,48.3
'38112, 성산구,'085002, 81세,2019,376,129,247,52.2,374,128,246,52
'38112, 성산구,'085003, 82세,2019,324,102,222,45.9,323,101,222,45.5
'38112, 성산구,'085004, 83세,2019,319,91,228,39.9,319,91,228,39.9
'38112, 성산구,'085005, 84세,2019,304,87,217,40.1,303,86,217,39.6
'38112, 성산구,'086,85세이상,2019,1102,260,842,30.9,1096,258,838,30.8
'38112, 성산구,'090,85~89세,2019,821,195,626,31.2,817,194,623,31.1
'38112, 성산구,'090001, 85세,2019,244,62,182,34.1,243,61,182,33.5
'38112, 성산구,'090002, 86세,2019,206,62,144,43.1,205,62,143,43.4
'38112, 성산구,'090003, 87세,2019,154,29,125,23.2,154,29,125,23.2
'38112, 성산구,'090004, 88세,2019,120,24,96,25,120,24,96,25
'38112, 성산구,'090005, 89세,2019,97,18,79,22.8,95,18,77,23.4
'38112, 성산구,'095,90~94세,2019,237,57,180,31.7,235,56,179,31.3
'38112, 성산구,'095001, 90세,2019,89,23,66,34.8,88,22,66,33.3
'38112, 성산구,'095002, 91세,2019,44,7,37,18.9,43,7,36,19.4
'38112, 성산구,'095003, 92세,2019,55,16,39,41,55,16,39,41
'38112, 성산구,'095004, 93세,2019,25,X,21,19,25,X,21,19
'38112, 성산구,'095005, 94세,2019,24,7,17,41.2,24,7,17,41.2
'38112, 성산구,'100,95~99세,2019,38,8,30,26.7,38,8,30,26.7
'38112, 성산구,'100001, 95세,2019,19,X,16,18.8,19,X,16,18.8
'38112, 성산구,'100002, 96세,2019,8,X,6,33.3,8,X,6,33.3
'38112, 성산구,'100003, 97세,2019,8,X,6,33.3,8,X,6,33.3
'38112, 성산구,'100004, 98세,2019,X,X,X,50,X,X,X,50
'38112, 성산구,'100005, 99세,2019,X,X,X,,X,X,X,
'38112, 성산구,'101,100세이상,2019,6,X,6,0,6,X,6,0
'38112, 성산구,'102,15세미만,2019,28860,14944,13916,107.4,28719,14874,13845,107.4
'38112, 성산구,'103,15~64세,2019,174872,92050,82822,111.1,169901,88526,81375,108.8
'38112, 성산구,'104,65세이상,2019,16219,7494,8725,85.9,16140,7453,8687,85.8
'38112, 성산구,'126,평균연령,2019,39.5,38.6,40.5,,39.6,38.7,40.5,
'38112, 성산구,'127,중위연령,2019,41,39.2,43,,41.4,39.6,43.1,
'38113, 마산합포구,'000,합계,2019,177579,88712,88867,99.8,174434,86830,87604,99.1
'38113, 마산합포구,'005,0~4세,2019,5917,3085,2832,108.9,5890,3077,2813,109.4
'38113, 마산합포구,'005001, 0세,2019,971,518,453,114.3,965,516,449,114.9
'38113, 마산합포구,'005002, 1세,2019,1025,511,514,99.4,1022,510,512,99.6
'38113, 마산합포구,'005003, 2세,2019,1156,624,532,117.3,1149,622,527,118
'38113, 마산합포구,'005004, 3세,2019,1343,715,628,113.9,1338,712,626,113.7
'38113, 마산합포구,'005005, 4세,2019,1422,717,705,101.7,1416,717,699,102.6
'38113, 마산합포구,'010,5~9세,2019,7282,3738,3544,105.5,7270,3735,3535,105.7
'38113, 마산합포구,'010001, 5세,2019,1403,724,679,106.6,1399,723,676,107
'38113, 마산합포구,'010002, 6세,2019,1489,776,713,108.8,1488,776,712,109
'38113, 마산합포구,'010003, 7세,2019,1554,792,762,103.9,1551,791,760,104.1
'38113, 마산합포구,'010004, 8세,2019,1503,768,735,104.5,1500,767,733,104.6
'38113, 마산합포구,'010005, 9세,2019,1333,678,655,103.5,1332,678,654,103.7
'38113, 마산합포구,'015,10~14세,2019,6513,3365,3148,106.9,6499,3357,3142,106.8
'38113, 마산합포구,'015001, 10세,2019,1343,714,629,113.5,1339,711,628,113.2
'38113, 마산합포구,'015002, 11세,2019,1316,680,636,106.9,1315,680,635,107.1
'38113, 마산합포구,'015003, 12세,2019,1407,720,687,104.8,1403,718,685,104.8
'38113, 마산합포구,'015004, 13세,2019,1258,621,637,97.5,1254,618,636,97.2
'38113, 마산합포구,'015005, 14세,2019,1189,630,559,112.7,1188,630,558,112.9
'38113, 마산합포구,'020,15~19세,2019,8383,4433,3950,112.2,8265,4391,3874,113.3
'38113, 마산합포구,'020001, 15세,2019,1345,676,669,101,1342,675,667,101.2
'38113, 마산합포구,'020002, 16세,2019,1396,732,664,110.2,1394,731,663,110.3
'38113, 마산합포구,'020003, 17세,2019,1534,754,780,96.7,1524,747,777,96.1
'38113, 마산합포구,'020004, 18세,2019,1818,969,849,114.1,1780,955,825,115.8
'38113, 마산합포구,'020005, 19세,2019,2290,1302,988,131.8,2225,1283,942,136.2
'38113, 마산합포구,'025,20~24세,2019,11127,6276,4851,129.4,10637,6010,4627,129.9
'38113, 마산합포구,'025001, 20세,2019,2038,1110,928,119.6,1951,1055,896,117.7
'38113, 마산합포구,'025002, 21세,2019,2237,1230,1007,122.1,2148,1192,956,124.7
'38113, 마산합포구,'025003, 22세,2019,2350,1312,1038,126.4,2247,1256,991,126.7
'38113, 마산합포구,'025004, 23세,2019,2270,1307,963,135.7,2160,1251,909,137.6
'38113, 마산합포구,'025005, 24세,2019,2232,1317,915,143.9,2131,1256,875,143.5
'38113, 마산합포구,'030,25~29세,2019,9790,5476,4314,126.9,9262,5137,4125,124.5
'38113, 마산합포구,'030001, 25세,2019,2145,1228,917,133.9,2041,1158,883,131.1
'38113, 마산합포구,'030002, 26세,2019,1973,1110,863,128.6,1883,1049,834,125.8
'38113, 마산합포구,'030003, 27세,2019,1987,1079,908,118.8,1885,1017,868,117.2
'38113, 마산합포구,'030004, 28세,2019,1895,1062,833,127.5,1777,987,790,124.9
'38113, 마산합포구,'030005, 29세,2019,1790,997,793,125.7,1676,926,750,123.5
'38113, 마산합포구,'035,30~34세,2019,9458,5120,4338,118,8933,4769,4164,114.5
'38113, 마산합포구,'035001, 30세,2019,1833,1001,832,120.3,1715,920,795,115.7
'38113, 마산합포구,'035002, 31세,2019,1798,994,804,123.6,1691,925,766,120.8
'38113, 마산합포구,'035003, 32세,2019,1833,973,860,113.1,1737,909,828,109.8
'38113, 마산합포구,'035004, 33세,2019,1908,1048,860,121.9,1804,977,827,118.1
'38113, 마산합포구,'035005, 34세,2019,2086,1104,982,112.4,1986,1038,948,109.5
'38113, 마산합포구,'040,35~39세,2019,12942,6859,6083,112.8,12553,6602,5951,110.9
'38113, 마산합포구,'040001, 35세,2019,2116,1139,977,116.6,2034,1083,951,113.9
'38113, 마산합포구,'040002, 36세,2019,2450,1294,1156,111.9,2368,1235,1133,109
'38113, 마산합포구,'040003, 37세,2019,2713,1411,1302,108.4,2641,1367,1274,107.3
'38113, 마산합포구,'040004, 38세,2019,2829,1551,1278,121.4,2747,1502,1245,120.6
'38113, 마산합포구,'040005, 39세,2019,2834,1464,1370,106.9,2763,1415,1348,105
'38113, 마산합포구,'045,40~44세,2019,12006,6461,5545,116.5,11702,6258,5444,115
'38113, 마산합포구,'045001, 40세,2019,2697,1430,1267,112.9,2635,1392,1243,112
'38113, 마산합포구,'045002, 41세,2019,2362,1272,1090,116.7,2300,1230,1070,115
'38113, 마산합포구,'045003, 42세,2019,2313,1282,1031,124.3,2257,1245,1012,123
'38113, 마산합포구,'045004, 43세,2019,2216,1189,1027,115.8,2157,1145,1012,113.1
'38113, 마산합포구,'045005, 44세,2019,2418,1288,1130,114,2353,1246,1107,112.6
'38113, 마산합포구,'050,45~49세,2019,13367,6869,6498,105.7,13124,6719,6405,104.9
'38113, 마산합포구,'050001, 45세,2019,2552,1330,1222,108.8,2509,1305,1204,108.4
'38113, 마산합포구,'050002, 46세,2019,2671,1396,1275,109.5,2628,1368,1260,108.6
'38113, 마산합포구,'050003, 47세,2019,2458,1283,1175,109.2,2400,1246,1154,108
'38113, 마산합포구,'050004, 48세,2019,2859,1417,1442,98.3,2813,1384,1429,96.9
'38113, 마산합포구,'050005, 49세,2019,2827,1443,1384,104.3,2774,1416,1358,104.3
'38113, 마산합포구,'055,50~54세,2019,14187,7111,7076,100.5,13981,7002,6979,100.3
'38113, 마산합포구,'055001, 50세,2019,2911,1474,1437,102.6,2868,1454,1414,102.8
'38113, 마산합포구,'055002, 51세,2019,2963,1437,1526,94.2,2916,1407,1509,93.2
'38113, 마산합포구,'055003, 52세,2019,2750,1399,1351,103.6,2712,1377,1335,103.1
'38113, 마산합포구,'055004, 53세,2019,2705,1394,1311,106.3,2663,1375,1288,106.8
'38113, 마산합포구,'055005, 54세,2019,2858,1407,1451,97,2822,1389,1433,96.9
'38113, 마산합포구,'060,55~59세,2019,15616,7461,8155,91.5,15473,7390,8083,91.4
'38113, 마산합포구,'060001, 55세,2019,2497,1237,1260,98.2,2459,1221,1238,98.6
'38113, 마산합포구,'060002, 56세,2019,2866,1400,1466,95.5,2827,1381,1446,95.5
'38113, 마산합포구,'060003, 57세,2019,3140,1522,1618,94.1,3112,1507,1605,93.9
'38113, 마산합포구,'060004, 58세,2019,3549,1634,1915,85.3,3536,1628,1908,85.3
'38113, 마산합포구,'060005, 59세,2019,3564,1668,1896,88,3539,1653,1886,87.6
'38113, 마산합포구,'065,60~64세,2019,16203,7662,8541,89.7,16131,7624,8507,89.6
'38113, 마산합포구,'065001, 60세,2019,3409,1588,1821,87.2,3396,1582,1814,87.2
'38113, 마산합포구,'065002, 61세,2019,3139,1504,1635,92,3128,1495,1633,91.5
'38113, 마산합포구,'065003, 62세,2019,3229,1566,1663,94.2,3207,1555,1652,94.1
'38113, 마산합포구,'065004, 63세,2019,3109,1454,1655,87.9,3096,1449,1647,88
'38113, 마산합포구,'065005, 64세,2019,3317,1550,1767,87.7,3304,1543,1761,87.6
'38113, 마산합포구,'070,65~69세,2019,11685,5574,6111,91.2,11642,5551,6091,91.1
'38113, 마산합포구,'070001, 65세,2019,2698,1331,1367,97.4,2684,1324,1360,97.4
'38113, 마산합포구,'070002, 66세,2019,2351,1108,1243,89.1,2339,1103,1236,89.2
'38113, 마산합포구,'070003, 67세,2019,2598,1234,1364,90.5,2589,1229,1360,90.4
'38113, 마산합포구,'070004, 68세,2019,1942,910,1032,88.2,1938,907,1031,88
'38113, 마산합포구,'070005, 69세,2019,2096,991,1105,89.7,2092,988,1104,89.5
'38113, 마산합포구,'075,70~74세,2019,8779,4076,4703,86.7,8764,4071,4693,86.7
'38113, 마산합포구,'075001, 70세,2019,2141,1047,1094,95.7,2138,1045,1093,95.6
'38113, 마산합포구,'075002, 71세,2019,1979,939,1040,90.3,1977,939,1038,90.5
'38113, 마산합포구,'075003, 72세,2019,1895,842,1053,80,1889,841,1048,80.2
'38113, 마산합포구,'075004, 73세,2019,1373,625,748,83.6,1373,625,748,83.6
'38113, 마산합포구,'075005, 74세,2019,1391,623,768,81.1,1387,621,766,81.1
'38113, 마산합포구,'080,75~79세,2019,6885,2895,3990,72.6,6878,2889,3989,72.4
'38113, 마산합포구,'080001, 75세,2019,1455,642,813,79,1454,641,813,78.8
'38113, 마산합포구,'080002, 76세,2019,1400,579,821,70.5,1399,578,821,70.4
'38113, 마산합포구,'080003, 77세,2019,1515,672,843,79.7,1514,672,842,79.8
'38113, 마산합포구,'080004, 78세,2019,1366,551,815,67.6,1366,551,815,67.6
'38113, 마산합포구,'080005, 79세,2019,1149,451,698,64.6,1145,447,698,64
'38113, 마산합포구,'085,80~84세,2019,4376,1506,2870,52.5,4370,1505,2865,52.5
'38113, 마산합포구,'085001, 80세,2019,1077,394,683,57.7,1074,393,681,57.7
'38113, 마산합포구,'085002, 81세,2019,917,333,584,57,916,333,583,57.1
'38113, 마산합포구,'085003, 82세,2019,921,306,615,49.8,920,306,614,49.8
'38113, 마산합포구,'085004, 83세,2019,804,261,543,48.1,803,261,542,48.2
'38113, 마산합포구,'085005, 84세,2019,657,212,445,47.6,657,212,445,47.6
'38113, 마산합포구,'086,85세이상,2019,3063,745,2318,32.1,3060,743,2317,32.1
'38113, 마산합포구,'090,85~89세,2019,2222,582,1640,35.5,2222,582,1640,35.5
'38113, 마산합포구,'090001, 85세,2019,620,195,425,45.9,620,195,425,45.9
'38113, 마산합포구,'090002, 86세,2019,466,120,346,34.7,466,120,346,34.7
'38113, 마산합포구,'090003, 87세,2019,466,126,340,37.1,466,126,340,37.1
'38113, 마산합포구,'090004, 88세,2019,349,76,273,27.8,349,76,273,27.8
'38113, 마산합포구,'090005, 89세,2019,321,65,256,25.4,321,65,256,25.4
'38113, 마산합포구,'095,90~94세,2019,698,139,559,24.9,696,138,558,24.7
'38113, 마산합포구,'095001, 90세,2019,242,53,189,28,242,53,189,28
'38113, 마산합포구,'095002, 91세,2019,163,30,133,22.6,163,30,133,22.6
'38113, 마산합포구,'095003, 92세,2019,133,32,101,31.7,132,31,101,30.7
'38113, 마산합포구,'095004, 93세,2019,91,17,74,23,91,17,74,23
'38113, 마산합포구,'095005, 94세,2019,69,7,62,11.3,68,7,61,11.5
'38113, 마산합포구,'100,95~99세,2019,132,23,109,21.1,131,22,109,20.2
'38113, 마산합포구,'100001, 95세,2019,36,7,29,24.1,36,7,29,24.1
'38113, 마산합포구,'100002, 96세,2019,48,6,42,14.3,48,6,42,14.3
'38113, 마산합포구,'100003, 97세,2019,26,7,19,36.8,26,7,19,36.8
'38113, 마산합포구,'100004, 98세,2019,17,X,14,21.4,16,X,14,14.3
'38113, 마산합포구,'100005, 99세,2019,5,X,5,0,5,X,5,0
'38113, 마산합포구,'101,100세이상,2019,11,X,10,10,11,X,10,10
'38113, 마산합포구,'102,15세미만,2019,19712,10188,9524,107,19659,10169,9490,107.2
'38113, 마산합포구,'103,15~64세,2019,123079,63728,59351,107.4,120061,61902,58159,106.4
'38113, 마산합포구,'104,65세이상,2019,34788,14796,19992,74,34714,14759,19955,74
'38113, 마산합포구,'126,평균연령,2019,45.1,43.3,46.9,,45.2,43.4,47,
'38113, 마산합포구,'127,중위연령,2019,47.1,44.6,49.5,,47.4,45.1,49.8,
'38114, 마산회원구,'000,합계,2019,192446,96351,96095,100.3,189575,94740,94835,99.9
'38114, 마산회원구,'005,0~4세,2019,5808,3000,2808,106.8,5778,2980,2798,106.5
'38114, 마산회원구,'005001, 0세,2019,854,461,393,117.3,844,457,387,118.1
'38114, 마산회원구,'005002, 1세,2019,965,497,468,106.2,963,495,468,105.8
'38114, 마산회원구,'005003, 2세,2019,1159,592,567,104.4,1152,587,565,103.9
'38114, 마산회원구,'005004, 3세,2019,1324,666,658,101.2,1317,660,657,100.5
'38114, 마산회원구,'005005, 4세,2019,1506,784,722,108.6,1502,781,721,108.3
'38114, 마산회원구,'010,5~9세,2019,8369,4402,3967,111,8355,4395,3960,111
'38114, 마산회원구,'010001, 5세,2019,1519,820,699,117.3,1515,819,696,117.7
'38114, 마산회원구,'010002, 6세,2019,1563,796,767,103.8,1561,795,766,103.8
'38114, 마산회원구,'010003, 7세,2019,1812,965,847,113.9,1805,961,844,113.9
'38114, 마산회원구,'010004, 8세,2019,1765,937,828,113.2,1765,937,828,113.2
'38114, 마산회원구,'010005, 9세,2019,1710,884,826,107,1709,883,826,106.9
'38114, 마산회원구,'015,10~14세,2019,8821,4613,4208,109.6,8811,4609,4202,109.7
'38114, 마산회원구,'015001, 10세,2019,1662,902,760,118.7,1660,902,758,119
'38114, 마산회원구,'015002, 11세,2019,1811,910,901,101,1809,909,900,101
'38114, 마산회원구,'015003, 12세,2019,1860,1001,859,116.5,1856,998,858,116.3
'38114, 마산회원구,'015004, 13세,2019,1746,928,818,113.4,1745,928,817,113.6
'38114, 마산회원구,'015005, 14세,2019,1742,872,870,100.2,1741,872,869,100.3
'38114, 마산회원구,'020,15~19세,2019,9858,5132,4726,108.6,9788,5104,4684,109
'38114, 마산회원구,'020001, 15세,2019,1869,975,894,109.1,1869,975,894,109.1
'38114, 마산회원구,'020002, 16세,2019,1823,996,827,120.4,1821,994,827,120.2
'38114, 마산회원구,'020003, 17세,2019,1760,921,839,109.8,1756,919,837,109.8
'38114, 마산회원구,'020004, 18세,2019,2075,1077,998,107.9,2059,1072,987,108.6
'38114, 마산회원구,'020005, 19세,2019,2331,1163,1168,99.6,2283,1144,1139,100.4
'38114, 마산회원구,'025,20~24세,2019,11661,6297,5364,117.4,11352,6133,5219,117.5
'38114, 마산회원구,'025001, 20세,2019,2345,1249,1096,114,2305,1230,1075,114.4
'38114, 마산회원구,'025002, 21세,2019,2305,1236,1069,115.6,2251,1213,1038,116.9
'38114, 마산회원구,'025003, 22세,2019,2365,1305,1060,123.1,2311,1278,1033,123.7
'38114, 마산회원구,'025004, 23세,2019,2318,1266,1052,120.3,2247,1223,1024,119.4
'38114, 마산회원구,'025005, 24세,2019,2328,1241,1087,114.2,2238,1189,1049,113.3
'38114, 마산회원구,'030,25~29세,2019,11052,5989,5063,118.3,10592,5725,4867,117.6
'38114, 마산회원구,'030001, 25세,2019,2270,1202,1068,112.5,2193,1169,1024,114.2
'38114, 마산회원구,'030002, 26세,2019,2359,1268,1091,116.2,2285,1216,1069,113.8
'38114, 마산회원구,'030003, 27세,2019,2237,1215,1022,118.9,2149,1174,975,120.4
'38114, 마산회원구,'030004, 28세,2019,2040,1126,914,123.2,1939,1065,874,121.9
'38114, 마산회원구,'030005, 29세,2019,2146,1178,968,121.7,2026,1101,925,119
'38114, 마산회원구,'035,30~34세,2019,9850,5243,4607,113.8,9249,4858,4391,110.6
'38114, 마산회원구,'035001, 30세,2019,2008,1104,904,122.1,1876,1018,858,118.6
'38114, 마산회원구,'035002, 31세,2019,1945,1049,896,117.1,1819,973,846,115
'38114, 마산회원구,'035003, 32세,2019,1985,1046,939,111.4,1851,956,895,106.8
'38114, 마산회원구,'035004, 33세,2019,1941,1019,922,110.5,1813,934,879,106.3
'38114, 마산회원구,'035005, 34세,2019,1971,1025,946,108.4,1890,977,913,107
'38114, 마산회원구,'040,35~39세,2019,13549,7079,6470,109.4,13201,6883,6318,108.9
'38114, 마산회원구,'040001, 35세,2019,2271,1208,1063,113.6,2174,1150,1024,112.3
'38114, 마산회원구,'040002, 36세,2019,2495,1321,1174,112.5,2430,1286,1144,112.4
'38114, 마산회원구,'040003, 37세,2019,2873,1482,1391,106.5,2806,1448,1358,106.6
'38114, 마산회원구,'040004, 38세,2019,2854,1507,1347,111.9,2789,1467,1322,111
'38114, 마산회원구,'040005, 39세,2019,3056,1561,1495,104.4,3002,1532,1470,104.2
'38114, 마산회원구,'045,40~44세,2019,14187,7187,7000,102.7,13961,7067,6894,102.5
'38114, 마산회원구,'045001, 40세,2019,2886,1494,1392,107.3,2834,1471,1363,107.9
'38114, 마산회원구,'045002, 41세,2019,2786,1411,1375,102.6,2746,1394,1352,103.1
'38114, 마산회원구,'045003, 42세,2019,2842,1420,1422,99.9,2802,1396,1406,99.3
'38114, 마산회원구,'045004, 43세,2019,2712,1399,1313,106.5,2658,1365,1293,105.6
'38114, 마산회원구,'045005, 44세,2019,2961,1463,1498,97.7,2921,1441,1480,97.4
'38114, 마산회원구,'050,45~49세,2019,16678,8483,8195,103.5,16445,8348,8097,103.1
'38114, 마산회원구,'050001, 45세,2019,3256,1680,1576,106.6,3214,1658,1556,106.6
'38114, 마산회원구,'050002, 46세,2019,3284,1690,1594,106,3243,1664,1579,105.4
'38114, 마산회원구,'050003, 47세,2019,3129,1607,1522,105.6,3087,1584,1503,105.4
'38114, 마산회원구,'050004, 48세,2019,3526,1746,1780,98.1,3461,1708,1753,97.4
'38114, 마산회원구,'050005, 49세,2019,3483,1760,1723,102.1,3440,1734,1706,101.6
'38114, 마산회원구,'055,50~54세,2019,17383,8662,8721,99.3,17170,8544,8626,99
'38114, 마산회원구,'055001, 50세,2019,3636,1866,1770,105.4,3594,1842,1752,105.1
'38114, 마산회원구,'055002, 51세,2019,3646,1794,1852,96.9,3602,1766,1836,96.2
'38114, 마산회원구,'055003, 52세,2019,3376,1651,1725,95.7,3333,1624,1709,95
'38114, 마산회원구,'055004, 53세,2019,3407,1750,1657,105.6,3361,1735,1626,106.7
'38114, 마산회원구,'055005, 54세,2019,3318,1601,1717,93.2,3280,1577,1703,92.6
'38114, 마산회원구,'060,55~59세,2019,17739,8768,8971,97.7,17571,8683,8888,97.7
'38114, 마산회원구,'060001, 55세,2019,2937,1464,1473,99.4,2898,1443,1455,99.2
'38114, 마산회원구,'060002, 56세,2019,3311,1662,1649,100.8,3264,1640,1624,101
'38114, 마산회원구,'060003, 57세,2019,3709,1825,1884,96.9,3679,1808,1871,96.6
'38114, 마산회원구,'060004, 58세,2019,3896,1973,1923,102.6,3876,1961,1915,102.4
'38114, 마산회원구,'060005, 59세,2019,3886,1844,2042,90.3,3854,1831,2023,90.5
'38114, 마산회원구,'065,60~64세,2019,16334,7784,8550,91,16231,7729,8502,90.9
'38114, 마산회원구,'065001, 60세,2019,3420,1650,1770,93.2,3398,1638,1760,93.1
'38114, 마산회원구,'065002, 61세,2019,3270,1566,1704,91.9,3244,1553,1691,91.8
'38114, 마산회원구,'065003, 62세,2019,3301,1553,1748,88.8,3283,1543,1740,88.7
'38114, 마산회원구,'065004, 63세,2019,3046,1452,1594,91.1,3020,1436,1584,90.7
'38114, 마산회원구,'065005, 64세,2019,3297,1563,1734,90.1,3286,1559,1727,90.3
'38114, 마산회원구,'070,65~69세,2019,11606,5541,6065,91.4,11555,5521,6034,91.5
'38114, 마산회원구,'070001, 65세,2019,2647,1291,1356,95.2,2632,1286,1346,95.5
'38114, 마산회원구,'070002, 66세,2019,2383,1163,1220,95.3,2369,1158,1211,95.6
'38114, 마산회원구,'070003, 67세,2019,2586,1279,1307,97.9,2576,1274,1302,97.8
'38114, 마산회원구,'070004, 68세,2019,2021,932,1089,85.6,2014,930,1084,85.8
'38114, 마산회원구,'070005, 69세,2019,1969,876,1093,80.1,1964,873,1091,80
'38114, 마산회원구,'075,70~74세,2019,8132,3895,4237,91.9,8117,3891,4226,92.1
'38114, 마산회원구,'075001, 70세,2019,2003,942,1061,88.8,1997,941,1056,89.1
'38114, 마산회원구,'075002, 71세,2019,1937,945,992,95.3,1936,945,991,95.4
'38114, 마산회원구,'075003, 72세,2019,1727,830,897,92.5,1725,830,895,92.7
'38114, 마산회원구,'075004, 73세,2019,1236,610,626,97.4,1232,608,624,97.4
'38114, 마산회원구,'075005, 74세,2019,1229,568,661,85.9,1227,567,660,85.9
'38114, 마산회원구,'080,75~79세,2019,5855,2545,3310,76.9,5844,2541,3303,76.9
'38114, 마산회원구,'080001, 75세,2019,1325,609,716,85.1,1321,608,713,85.3
'38114, 마산회원구,'080002, 76세,2019,1235,547,688,79.5,1232,545,687,79.3
'38114, 마산회원구,'080003, 77세,2019,1223,533,690,77.2,1222,532,690,77.1
'38114, 마산회원구,'080004, 78세,2019,1110,465,645,72.1,1110,465,645,72.1
'38114, 마산회원구,'080005, 79세,2019,962,391,571,68.5,959,391,568,68.8
'38114, 마산회원구,'085,80~84세,2019,3490,1261,2229,56.6,3483,1260,2223,56.7
'38114, 마산회원구,'085001, 80세,2019,914,365,549,66.5,913,365,548,66.6
'38114, 마산회원구,'085002, 81세,2019,769,290,479,60.5,766,290,476,60.9
'38114, 마산회원구,'085003, 82세,2019,628,236,392,60.2,627,236,391,60.4
'38114, 마산회원구,'085004, 83세,2019,623,202,421,48,622,202,420,48.1
'38114, 마산회원구,'085005, 84세,2019,556,168,388,43.3,555,167,388,43
'38114, 마산회원구,'086,85세이상,2019,2074,470,1604,29.3,2072,469,1603,29.3
'38114, 마산회원구,'090,85~89세,2019,1502,372,1130,32.9,1500,371,1129,32.9
'38114, 마산회원구,'090001, 85세,2019,438,133,305,43.6,437,133,304,43.8
'38114, 마산회원구,'090002, 86세,2019,329,89,240,37.1,329,89,240,37.1
'38114, 마산회원구,'090003, 87세,2019,305,79,226,35,305,79,226,35
'38114, 마산회원구,'090004, 88세,2019,250,39,211,18.5,250,39,211,18.5
'38114, 마산회원구,'090005, 89세,2019,180,32,148,21.6,179,31,148,20.9
'38114, 마산회원구,'095,90~94세,2019,478,82,396,20.7,478,82,396,20.7
'38114, 마산회원구,'095001, 90세,2019,171,30,141,21.3,171,30,141,21.3
'38114, 마산회원구,'095002, 91세,2019,114,24,90,26.7,114,24,90,26.7
'38114, 마산회원구,'095003, 92세,2019,87,13,74,17.6,87,13,74,17.6
'38114, 마산회원구,'095004, 93세,2019,56,7,49,14.3,56,7,49,14.3
'38114, 마산회원구,'095005, 94세,2019,50,8,42,19,50,8,42,19
'38114, 마산회원구,'100,95~99세,2019,86,15,71,21.1,86,15,71,21.1
'38114, 마산회원구,'100001, 95세,2019,20,X,16,25,20,X,16,25
'38114, 마산회원구,'100002, 96세,2019,27,X,24,12.5,27,X,24,12.5
'38114, 마산회원구,'100003, 97세,2019,15,X,13,15.4,15,X,13,15.4
'38114, 마산회원구,'100004, 98세,2019,12,X,9,33.3,12,X,9,33.3
'38114, 마산회원구,'100005, 99세,2019,12,X,9,33.3,12,X,9,33.3
'38114, 마산회원구,'101,100세이상,2019,8,X,7,14.3,8,X,7,14.3
'38114, 마산회원구,'102,15세미만,2019,22998,12015,10983,109.4,22944,11984,10960,109.3
'38114, 마산회원구,'103,15~64세,2019,138291,70624,67667,104.4,135560,69074,66486,103.9
'38114, 마산회원구,'104,65세이상,2019,31157,13712,17445,78.6,31071,13682,17389,78.7
'38114, 마산회원구,'126,평균연령,2019,43.7,42.4,45,,43.8,42.5,45,
'38114, 마산회원구,'127,중위연령,2019,45.9,44.5,47.4,,46.1,44.7,47.6,
'38115, 진해구,'000,합계,2019,190885,98087,92798,105.7,185968,94938,91030,104.3
'38115, 진해구,'005,0~4세,2019,9138,4754,4384,108.4,9047,4707,4340,108.5
'38115, 진해구,'005001, 0세,2019,1466,754,712,105.9,1451,743,708,104.9
'38115, 진해구,'005002, 1세,2019,1599,848,751,112.9,1586,842,744,113.2
'38115, 진해구,'005003, 2세,2019,1802,914,888,102.9,1780,903,877,103
'38115, 진해구,'005004, 3세,2019,2101,1071,1030,104,2080,1061,1019,104.1
'38115, 진해구,'005005, 4세,2019,2170,1167,1003,116.4,2150,1158,992,116.7
'38115, 진해구,'010,5~9세,2019,11725,6116,5609,109,11677,6093,5584,109.1
'38115, 진해구,'010001, 5세,2019,2256,1156,1100,105.1,2234,1148,1086,105.7
'38115, 진해구,'010002, 6세,2019,2325,1225,1100,111.4,2317,1220,1097,111.2
'38115, 진해구,'010003, 7세,2019,2486,1323,1163,113.8,2479,1320,1159,113.9
'38115, 진해구,'010004, 8세,2019,2377,1199,1178,101.8,2370,1196,1174,101.9
'38115, 진해구,'010005, 9세,2019,2281,1213,1068,113.6,2277,1209,1068,113.2
'38115, 진해구,'015,10~14세,2019,10659,5397,5262,102.6,10633,5385,5248,102.6
'38115, 진해구,'015001, 10세,2019,2186,1090,1096,99.5,2180,1087,1093,99.5
'38115, 진해구,'015002, 11세,2019,2319,1102,1217,90.6,2313,1101,1212,90.8
'38115, 진해구,'015003, 12세,2019,2242,1161,1081,107.4,2235,1158,1077,107.5
'38115, 진해구,'015004, 13세,2019,2024,1085,939,115.5,2018,1081,937,115.4
'38115, 진해구,'015005, 14세,2019,1888,959,929,103.2,1887,958,929,103.1
'38115, 진해구,'020,15~19세,2019,8985,4865,4120,118.1,8938,4833,4105,117.7
'38115, 진해구,'020001, 15세,2019,2038,1095,943,116.1,2034,1093,941,116.2
'38115, 진해구,'020002, 16세,2019,1793,973,820,118.7,1786,967,819,118.1
'38115, 진해구,'020003, 17세,2019,1808,976,832,117.3,1803,972,831,117
'38115, 진해구,'020004, 18세,2019,1809,966,843,114.6,1793,956,837,114.2
'38115, 진해구,'020005, 19세,2019,1537,855,682,125.4,1522,845,677,124.8
'38115, 진해구,'025,20~24세,2019,8638,5105,3533,144.5,8281,4882,3399,143.6
'38115, 진해구,'025001, 20세,2019,1615,1007,608,165.6,1587,992,595,166.7
'38115, 진해구,'025002, 21세,2019,1644,999,645,154.9,1596,970,626,155
'38115, 진해구,'025003, 22세,2019,1710,1004,706,142.2,1637,954,683,139.7
'38115, 진해구,'025004, 23세,2019,1838,1032,806,128,1746,975,771,126.5
'38115, 진해구,'025005, 24세,2019,1831,1063,768,138.4,1715,991,724,136.9
'38115, 진해구,'030,25~29세,2019,10496,5934,4562,130.1,9746,5408,4338,124.7
'38115, 진해구,'030001, 25세,2019,1957,1114,843,132.1,1830,1022,808,126.5
'38115, 진해구,'030002, 26세,2019,2053,1211,842,143.8,1903,1091,812,134.4
'38115, 진해구,'030003, 27세,2019,2223,1242,981,126.6,2083,1156,927,124.7
'38115, 진해구,'030004, 28세,2019,2066,1143,923,123.8,1913,1038,875,118.6
'38115, 진해구,'030005, 29세,2019,2197,1224,973,125.8,2017,1101,916,120.2
'38115, 진해구,'035,30~34세,2019,12168,6449,5719,112.8,11190,5778,5412,106.8
'38115, 진해구,'035001, 30세,2019,2234,1203,1031,116.7,2041,1070,971,110.2
'38115, 진해구,'035002, 31세,2019,2268,1207,1061,113.8,2082,1077,1005,107.2
'38115, 진해구,'035003, 32세,2019,2397,1260,1137,110.8,2187,1117,1070,104.4
'38115, 진해구,'035004, 33세,2019,2520,1350,1170,115.4,2321,1214,1107,109.7
'38115, 진해구,'035005, 34세,2019,2749,1429,1320,108.3,2559,1300,1259,103.3
'38115, 진해구,'040,35~39세,2019,18157,9486,8671,109.4,17408,8974,8434,106.4
'38115, 진해구,'040001, 35세,2019,2933,1556,1377,113,2757,1435,1322,108.5
'38115, 진해구,'040002, 36세,2019,3465,1831,1634,112.1,3281,1711,1570,109
'38115, 진해구,'040003, 37세,2019,3814,1992,1822,109.3,3663,1888,1775,106.4
'38115, 진해구,'040004, 38세,2019,3949,2092,1857,112.7,3829,2009,1820,110.4
'38115, 진해구,'040005, 39세,2019,3996,2015,1981,101.7,3878,1931,1947,99.2
'38115, 진해구,'045,40~44세,2019,17158,9063,8095,112,16698,8752,7946,110.1
'38115, 진해구,'045001, 40세,2019,3759,1926,1833,105.1,3634,1845,1789,103.1
'38115, 진해구,'045002, 41세,2019,3353,1789,1564,114.4,3256,1721,1535,112.1
'38115, 진해구,'045003, 42세,2019,3409,1794,1615,111.1,3334,1740,1594,109.2
'38115, 진해구,'045004, 43세,2019,3232,1763,1469,120,3130,1692,1438,117.7
'38115, 진해구,'045005, 44세,2019,3405,1791,1614,111,3344,1754,1590,110.3
'38115, 진해구,'050,45~49세,2019,17213,9226,7987,115.5,16732,8935,7797,114.6
'38115, 진해구,'050001, 45세,2019,3718,1993,1725,115.5,3619,1928,1691,114
'38115, 진해구,'050002, 46세,2019,3527,1897,1630,116.4,3434,1842,1592,115.7
'38115, 진해구,'050003, 47세,2019,3337,1782,1555,114.6,3246,1727,1519,113.7
'38115, 진해구,'050004, 48세,2019,3407,1841,1566,117.6,3296,1768,1528,115.7
'38115, 진해구,'050005, 49세,2019,3224,1713,1511,113.4,3137,1670,1467,113.8
'38115, 진해구,'055,50~54세,2019,14121,7376,6745,109.4,13751,7161,6590,108.7
'38115, 진해구,'055001, 50세,2019,3115,1707,1408,121.2,3029,1652,1377,120
'38115, 진해구,'055002, 51세,2019,3089,1623,1466,110.7,3007,1584,1423,111.3
'38115, 진해구,'055003, 52세,2019,2680,1379,1301,106,2601,1332,1269,105
'38115, 진해구,'055004, 53세,2019,2669,1366,1303,104.8,2610,1331,1279,104.1
'38115, 진해구,'055005, 54세,2019,2568,1301,1267,102.7,2504,1262,1242,101.6
'38115, 진해구,'060,55~59세,2019,14130,6992,7138,98,13871,6853,7018,97.6
'38115, 진해구,'060001, 55세,2019,2525,1299,1226,106,2457,1259,1198,105.1
'38115, 진해구,'060002, 56세,2019,2794,1432,1362,105.1,2740,1405,1335,105.2
'38115, 진해구,'060003, 57세,2019,2643,1317,1326,99.3,2595,1292,1303,99.2
'38115, 진해구,'060004, 58세,2019,3059,1488,1571,94.7,3010,1461,1549,94.3
'38115, 진해구,'060005, 59세,2019,3109,1456,1653,88.1,3069,1436,1633,87.9
'38115, 진해구,'065,60~64세,2019,12892,6279,6613,94.9,12728,6195,6533,94.8
'38115, 진해구,'065001, 60세,2019,2755,1322,1433,92.3,2713,1302,1411,92.3
'38115, 진해구,'065002, 61세,2019,2616,1303,1313,99.2,2574,1282,1292,99.2
'38115, 진해구,'065003, 62세,2019,2566,1270,1296,98,2539,1257,1282,98
'38115, 진해구,'065004, 63세,2019,2423,1174,1249,94,2395,1156,1239,93.3
'38115, 진해구,'065005, 64세,2019,2532,1210,1322,91.5,2507,1198,1309,91.5
'38115, 진해구,'070,65~69세,2019,8705,4261,4444,95.9,8627,4220,4407,95.8
'38115, 진해구,'070001, 65세,2019,2094,1073,1021,105.1,2076,1066,1010,105.5
'38115, 진해구,'070002, 66세,2019,1782,906,876,103.4,1759,891,868,102.6
'38115, 진해구,'070003, 67세,2019,1943,948,995,95.3,1932,941,991,95
'38115, 진해구,'070004, 68세,2019,1472,680,792,85.9,1460,675,785,86
'38115, 진해구,'070005, 69세,2019,1414,654,760,86.1,1400,647,753,85.9
'38115, 진해구,'075,70~74세,2019,6314,2970,3344,88.8,6287,2958,3329,88.9
'38115, 진해구,'075001, 70세,2019,1530,750,780,96.2,1520,746,774,96.4
'38115, 진해구,'075002, 71세,2019,1388,678,710,95.5,1384,677,707,95.8
'38115, 진해구,'075003, 72세,2019,1356,611,745,82,1347,606,741,81.8
'38115, 진해구,'075004, 73세,2019,1048,515,533,96.6,1045,513,532,96.4
'38115, 진해구,'075005, 74세,2019,992,416,576,72.2,991,416,575,72.3
'38115, 진해구,'080,75~79세,2019,4943,2071,2872,72.1,4927,2066,2861,72.2
'38115, 진해구,'080001, 75세,2019,1033,465,568,81.9,1027,464,563,82.4
'38115, 진해구,'080002, 76세,2019,991,417,574,72.6,989,416,573,72.6
'38115, 진해구,'080003, 77세,2019,1144,469,675,69.5,1142,468,674,69.4
'38115, 진해구,'080004, 78세,2019,900,373,527,70.8,896,372,524,71
'38115, 진해구,'080005, 79세,2019,875,347,528,65.7,873,346,527,65.7
'38115, 진해구,'085,80~84세,2019,3297,1205,2092,57.6,3288,1201,2087,57.5
'38115, 진해구,'085001, 80세,2019,809,319,490,65.1,808,319,489,65.2
'38115, 진해구,'085002, 81세,2019,709,277,432,64.1,705,274,431,63.6
'38115, 진해구,'085003, 82세,2019,701,247,454,54.4,700,247,453,54.5
'38115, 진해구,'085004, 83세,2019,560,198,362,54.7,558,197,361,54.6
'38115, 진해구,'085005, 84세,2019,518,164,354,46.3,517,164,353,46.5
'38115, 진해구,'086,85세이상,2019,2146,538,1608,33.5,2139,537,1602,33.5
'38115, 진해구,'090,85~89세,2019,1568,415,1153,36,1563,414,1149,36
'38115, 진해구,'090001, 85세,2019,461,138,323,42.7,460,138,322,42.9
'38115, 진해구,'090002, 86세,2019,351,110,241,45.6,349,109,240,45.4
'38115, 진해구,'090003, 87세,2019,329,70,259,27,328,70,258,27.1
'38115, 진해구,'090004, 88세,2019,228,58,170,34.1,227,58,169,34.3
'38115, 진해구,'090005, 89세,2019,199,39,160,24.4,199,39,160,24.4
'38115, 진해구,'095,90~94세,2019,487,107,380,28.2,485,107,378,28.3
'38115, 진해구,'095001, 90세,2019,162,45,117,38.5,162,45,117,38.5
'38115, 진해구,'095002, 91세,2019,140,32,108,29.6,140,32,108,29.6
'38115, 진해구,'095003, 92세,2019,66,12,54,22.2,66,12,54,22.2
'38115, 진해구,'095004, 93세,2019,70,12,58,20.7,69,12,57,21.1
'38115, 진해구,'095005, 94세,2019,49,6,43,14,48,6,42,14.3
'38115, 진해구,'100,95~99세,2019,84,15,69,21.7,84,15,69,21.7
'38115, 진해구,'100001, 95세,2019,37,7,30,23.3,37,7,30,23.3
'38115, 진해구,'100002, 96세,2019,24,X,22,9.1,24,X,22,9.1
'38115, 진해구,'100003, 97세,2019,7,X,X,75,7,X,X,75
'38115, 진해구,'100004, 98세,2019,7,X,6,16.7,7,X,6,16.7
'38115, 진해구,'100005, 99세,2019,9,X,7,28.6,9,X,7,28.6
'38115, 진해구,'101,100세이상,2019,7,X,6,16.7,7,X,6,16.7
'38115, 진해구,'102,15세미만,2019,31522,16267,15255,106.6,31357,16185,15172,106.7
'38115, 진해구,'103,15~64세,2019,133958,70775,63183,112,129343,67771,61572,110.1
'38115, 진해구,'104,65세이상,2019,25405,11045,14360,76.9,25268,10982,14286,76.9
'38115, 진해구,'126,평균연령,2019,40.6,39.4,41.9,,40.7,39.5,42,
'38115, 진해구,'127,중위연령,2019,41.5,40.5,42.7,,41.7,40.8,42.8,
'38310, 의령군,'000,합계,2019,26040,12736,13304,95.7,24990,12093,12897,93.8
'38310, 의령군,'005,0~4세,2019,522,260,262,99.2,521,259,262,98.9
'38310, 의령군,'005001, 0세,2019,83,38,45,84.4,82,37,45,82.2
'38310, 의령군,'005002, 1세,2019,107,42,65,64.6,107,42,65,64.6
'38310, 의령군,'005003, 2세,2019,96,55,41,134.1,96,55,41,134.1
'38310, 의령군,'005004, 3세,2019,115,51,64,79.7,115,51,64,79.7
'38310, 의령군,'005005, 4세,2019,121,74,47,157.4,121,74,47,157.4
'38310, 의령군,'010,5~9세,2019,626,334,292,114.4,624,333,291,114.4
'38310, 의령군,'010001, 5세,2019,119,68,51,133.3,119,68,51,133.3
'38310, 의령군,'010002, 6세,2019,117,62,55,112.7,116,61,55,110.9
'38310, 의령군,'010003, 7세,2019,135,81,54,150,134,81,53,152.8
'38310, 의령군,'010004, 8세,2019,133,66,67,98.5,133,66,67,98.5
'38310, 의령군,'010005, 9세,2019,122,57,65,87.7,122,57,65,87.7
'38310, 의령군,'015,10~14세,2019,666,357,309,115.5,664,357,307,116.3
'38310, 의령군,'015001, 10세,2019,139,80,59,135.6,138,80,58,137.9
'38310, 의령군,'015002, 11세,2019,132,67,65,103.1,132,67,65,103.1
'38310, 의령군,'015003, 12세,2019,133,62,71,87.3,133,62,71,87.3
'38310, 의령군,'015004, 13세,2019,128,70,58,120.7,128,70,58,120.7
'38310, 의령군,'015005, 14세,2019,134,78,56,139.3,133,78,55,141.8
'38310, 의령군,'020,15~19세,2019,833,464,369,125.7,825,461,364,126.6
'38310, 의령군,'020001, 15세,2019,177,90,87,103.4,176,90,86,104.7
'38310, 의령군,'020002, 16세,2019,163,90,73,123.3,162,90,72,125
'38310, 의령군,'020003, 17세,2019,199,102,97,105.2,199,102,97,105.2
'38310, 의령군,'020004, 18세,2019,163,97,66,147,162,96,66,145.5
'38310, 의령군,'020005, 19세,2019,131,85,46,184.8,126,83,43,193
'38310, 의령군,'025,20~24세,2019,942,565,377,149.9,837,500,337,148.4
'38310, 의령군,'025001, 20세,2019,167,112,55,203.6,158,103,55,187.3
'38310, 의령군,'025002, 21세,2019,176,113,63,179.4,160,102,58,175.9
'38310, 의령군,'025003, 22세,2019,188,113,75,150.7,165,100,65,153.8
'38310, 의령군,'025004, 23세,2019,206,102,104,98.1,180,87,93,93.5
'38310, 의령군,'025005, 24세,2019,205,125,80,156.3,174,108,66,163.6
'38310, 의령군,'030,25~29세,2019,1104,621,483,128.6,877,490,387,126.6
'38310, 의령군,'030001, 25세,2019,203,125,78,160.3,167,102,65,156.9
'38310, 의령군,'030002, 26세,2019,232,121,111,109,190,100,90,111.1
'38310, 의령군,'030003, 27세,2019,243,136,107,127.1,184,101,83,121.7
'38310, 의령군,'030004, 28세,2019,220,121,99,122.2,173,95,78,121.8
'38310, 의령군,'030005, 29세,2019,206,118,88,134.1,163,92,71,129.6
'38310, 의령군,'035,30~34세,2019,1032,573,459,124.8,800,425,375,113.3
'38310, 의령군,'035001, 30세,2019,199,109,90,121.1,155,80,75,106.7
'38310, 의령군,'035002, 31세,2019,216,123,93,132.3,165,86,79,108.9
'38310, 의령군,'035003, 32세,2019,206,118,88,134.1,151,85,66,128.8
'38310, 의령군,'035004, 33세,2019,237,123,114,107.9,186,93,93,100
'38310, 의령군,'035005, 34세,2019,174,100,74,135.1,143,81,62,130.6
'38310, 의령군,'040,35~39세,2019,1154,626,528,118.6,987,517,470,110
'38310, 의령군,'040001, 35세,2019,217,121,96,126,172,89,83,107.2
'38310, 의령군,'040002, 36세,2019,231,121,110,110,188,95,93,102.2
'38310, 의령군,'040003, 37세,2019,228,127,101,125.7,191,102,89,114.6
'38310, 의령군,'040004, 38세,2019,235,123,112,109.8,216,111,105,105.7
'38310, 의령군,'040005, 39세,2019,243,134,109,122.9,220,120,100,120
'38310, 의령군,'045,40~44세,2019,1196,678,518,130.9,1113,622,491,126.7
'38310, 의령군,'045001, 40세,2019,263,154,109,141.3,240,136,104,130.8
'38310, 의령군,'045002, 41세,2019,217,128,89,143.8,198,117,81,144.4
'38310, 의령군,'045003, 42세,2019,215,122,93,131.2,201,116,85,136.5
'38310, 의령군,'045004, 43세,2019,225,126,99,127.3,211,114,97,117.5
'38310, 의령군,'045005, 44세,2019,276,148,128,115.6,263,139,124,112.1
'38310, 의령군,'050,45~49세,2019,1627,942,685,137.5,1549,901,648,139
'38310, 의령군,'050001, 45세,2019,299,188,111,169.4,285,180,105,171.4
'38310, 의령군,'050002, 46세,2019,316,180,136,132.4,296,167,129,129.5
'38310, 의령군,'050003, 47세,2019,309,167,142,117.6,290,160,130,123.1
'38310, 의령군,'050004, 48세,2019,355,207,148,139.9,348,203,145,140
'38310, 의령군,'050005, 49세,2019,348,200,148,135.1,330,191,139,137.4
'38310, 의령군,'055,50~54세,2019,2011,1122,889,126.2,1934,1076,858,125.4
'38310, 의령군,'055001, 50세,2019,411,251,160,156.9,388,237,151,157
'38310, 의령군,'055002, 51세,2019,411,225,186,121,398,216,182,118.7
'38310, 의령군,'055003, 52세,2019,369,202,167,121,355,193,162,119.1
'38310, 의령군,'055004, 53세,2019,385,204,181,112.7,376,200,176,113.6
'38310, 의령군,'055005, 54세,2019,435,240,195,123.1,417,230,187,123
'38310, 의령군,'060,55~59세,2019,2499,1307,1192,109.6,2463,1282,1181,108.6
'38310, 의령군,'060001, 55세,2019,385,200,185,108.1,377,196,181,108.3
'38310, 의령군,'060002, 56세,2019,422,232,190,122.1,412,225,187,120.3
'38310, 의령군,'060003, 57세,2019,512,268,244,109.8,504,262,242,108.3
'38310, 의령군,'060004, 58세,2019,593,313,280,111.8,588,310,278,111.5
'38310, 의령군,'060005, 59세,2019,587,294,293,100.3,582,289,293,98.6
'38310, 의령군,'065,60~64세,2019,2682,1398,1284,108.9,2664,1390,1274,109.1
'38310, 의령군,'065001, 60세,2019,546,288,258,111.6,543,286,257,111.3
'38310, 의령군,'065002, 61세,2019,524,270,254,106.3,518,269,249,108
'38310, 의령군,'065003, 62세,2019,524,283,241,117.4,524,283,241,117.4
'38310, 의령군,'065004, 63세,2019,532,277,255,108.6,529,277,252,109.9
'38310, 의령군,'065005, 64세,2019,556,280,276,101.4,550,275,275,100
'38310, 의령군,'070,65~69세,2019,2113,1041,1072,97.1,2104,1035,1069,96.8
'38310, 의령군,'070001, 65세,2019,460,231,229,100.9,455,229,226,101.3
'38310, 의령군,'070002, 66세,2019,381,191,190,100.5,381,191,190,100.5
'38310, 의령군,'070003, 67세,2019,513,261,252,103.6,511,259,252,102.8
'38310, 의령군,'070004, 68세,2019,359,171,188,91,358,170,188,90.4
'38310, 의령군,'070005, 69세,2019,400,187,213,87.8,399,186,213,87.3
'38310, 의령군,'075,70~74세,2019,1812,821,991,82.8,1809,820,989,82.9
'38310, 의령군,'075001, 70세,2019,425,189,236,80.1,425,189,236,80.1
'38310, 의령군,'075002, 71세,2019,406,198,208,95.2,403,197,206,95.6
'38310, 의령군,'075003, 72세,2019,385,180,205,87.8,385,180,205,87.8
'38310, 의령군,'075004, 73세,2019,296,132,164,80.5,296,132,164,80.5
'38310, 의령군,'075005, 74세,2019,300,122,178,68.5,300,122,178,68.5
'38310, 의령군,'080,75~79세,2019,2092,728,1364,53.4,2092,728,1364,53.4
'38310, 의령군,'080001, 75세,2019,357,125,232,53.9,357,125,232,53.9
'38310, 의령군,'080002, 76세,2019,394,132,262,50.4,394,132,262,50.4
'38310, 의령군,'080003, 77세,2019,462,169,293,57.7,462,169,293,57.7
'38310, 의령군,'080004, 78세,2019,476,164,312,52.6,476,164,312,52.6
'38310, 의령군,'080005, 79세,2019,403,138,265,52.1,403,138,265,52.1
'38310, 의령군,'085,80~84세,2019,1811,590,1221,48.3,1809,588,1221,48.2
'38310, 의령군,'085001, 80세,2019,416,148,268,55.2,416,148,268,55.2
'38310, 의령군,'085002, 81세,2019,345,121,224,54,344,120,224,53.6
'38310, 의령군,'085003, 82세,2019,370,132,238,55.5,370,132,238,55.5
'38310, 의령군,'085004, 83세,2019,376,103,273,37.7,376,103,273,37.7
'38310, 의령군,'085005, 84세,2019,304,86,218,39.4,303,85,218,39
'38310, 의령군,'086,85세이상,2019,1318,309,1009,30.6,1318,309,1009,30.6
'38310, 의령군,'090,85~89세,2019,965,232,733,31.7,965,232,733,31.7
'38310, 의령군,'090001, 85세,2019,258,63,195,32.3,258,63,195,32.3
'38310, 의령군,'090002, 86세,2019,216,60,156,38.5,216,60,156,38.5
'38310, 의령군,'090003, 87세,2019,205,48,157,30.6,205,48,157,30.6
'38310, 의령군,'090004, 88세,2019,153,36,117,30.8,153,36,117,30.8
'38310, 의령군,'090005, 89세,2019,133,25,108,23.1,133,25,108,23.1
'38310, 의령군,'095,90~94세,2019,288,65,223,29.1,288,65,223,29.1
'38310, 의령군,'095001, 90세,2019,100,20,80,25,100,20,80,25
'38310, 의령군,'095002, 91세,2019,74,20,54,37,74,20,54,37
'38310, 의령군,'095003, 92세,2019,57,12,45,26.7,57,12,45,26.7
'38310, 의령군,'095004, 93세,2019,37,9,28,32.1,37,9,28,32.1
'38310, 의령군,'095005, 94세,2019,20,X,16,25,20,X,16,25
'38310, 의령군,'100,95~99세,2019,60,11,49,22.4,60,11,49,22.4
'38310, 의령군,'100001, 95세,2019,14,X,12,16.7,14,X,12,16.7
'38310, 의령군,'100002, 96세,2019,21,X,18,16.7,21,X,18,16.7
'38310, 의령군,'100003, 97세,2019,15,X,11,36.4,15,X,11,36.4
'38310, 의령군,'100004, 98세,2019,X,X,X,0,X,X,X,0
'38310, 의령군,'100005, 99세,2019,6,X,X,50,6,X,X,50
'38310, 의령군,'101,100세이상,2019,5,X,X,25,5,X,X,25
'38310, 의령군,'102,15세미만,2019,1814,951,863,110.2,1809,949,860,110.3
'38310, 의령군,'103,15~64세,2019,15080,8296,6784,122.3,14049,7664,6385,120
'38310, 의령군,'104,65세이상,2019,9146,3489,5657,61.7,9132,3480,5652,61.6
'38310, 의령군,'126,평균연령,2019,54,50.6,57.1,,54.7,51.4,57.8,
'38310, 의령군,'127,중위연령,2019,58,54.3,61.1,,58.8,55.5,61.9,
'38320, 함안군,'000,합계,2019,66611,34951,31660,110.4,61765,31041,30724,101
'38320, 함안군,'005,0~4세,2019,1903,946,957,98.9,1870,932,938,99.4
'38320, 함안군,'005001, 0세,2019,315,148,167,88.6,307,144,163,88.3
'38320, 함안군,'005002, 1세,2019,311,152,159,95.6,303,149,154,96.8
'38320, 함안군,'005003, 2세,2019,354,182,172,105.8,346,177,169,104.7
'38320, 함안군,'005004, 3세,2019,442,225,217,103.7,439,225,214,105.1
'38320, 함안군,'005005, 4세,2019,481,239,242,98.8,475,237,238,99.6
'38320, 함안군,'010,5~9세,2019,2747,1372,1375,99.8,2730,1366,1364,100.1
'38320, 함안군,'010001, 5세,2019,473,230,243,94.7,470,229,241,95
'38320, 함안군,'010002, 6세,2019,523,274,249,110,522,273,249,109.6
'38320, 함안군,'010003, 7세,2019,573,279,294,94.9,569,277,292,94.9
'38320, 함안군,'010004, 8세,2019,606,293,313,93.6,599,291,308,94.5
'38320, 함안군,'010005, 9세,2019,572,296,276,107.2,570,296,274,108
'38320, 함안군,'015,10~14세,2019,2958,1527,1431,106.7,2947,1521,1426,106.7
'38320, 함안군,'015001, 10세,2019,633,323,310,104.2,630,321,309,103.9
'38320, 함안군,'015002, 11세,2019,627,317,310,102.3,625,316,309,102.3
'38320, 함안군,'015003, 12세,2019,612,318,294,108.2,609,317,292,108.6
'38320, 함안군,'015004, 13세,2019,544,294,250,117.6,542,293,249,117.7
'38320, 함안군,'015005, 14세,2019,542,275,267,103,541,274,267,102.6
'38320, 함안군,'020,15~19세,2019,2778,1494,1284,116.4,2744,1472,1272,115.7
'38320, 함안군,'020001, 15세,2019,554,305,249,122.5,549,304,245,124.1
'38320, 함안군,'020002, 16세,2019,603,316,287,110.1,599,314,285,110.2
'38320, 함안군,'020003, 17세,2019,564,285,279,102.2,562,284,278,102.2
'38320, 함안군,'020004, 18세,2019,604,315,289,109,599,311,288,108
'38320, 함안군,'020005, 19세,2019,453,273,180,151.7,435,259,176,147.2
'38320, 함안군,'025,20~24세,2019,3068,2011,1057,190.3,2538,1560,978,159.5
'38320, 함안군,'025001, 20세,2019,510,338,172,196.5,458,295,163,181
'38320, 함안군,'025002, 21세,2019,600,396,204,194.1,542,346,196,176.5
'38320, 함안군,'025003, 22세,2019,619,397,222,178.8,515,307,208,147.6
'38320, 함안군,'025004, 23세,2019,610,396,214,185,481,290,191,151.8
'38320, 함안군,'025005, 24세,2019,729,484,245,197.6,542,322,220,146.4
'38320, 함안군,'030,25~29세,2019,3663,2360,1303,181.1,2522,1400,1122,124.8
'38320, 함안군,'030001, 25세,2019,743,483,260,185.8,539,307,232,132.3
'38320, 함안군,'030002, 26세,2019,745,474,271,174.9,535,301,234,128.6
'38320, 함안군,'030003, 27세,2019,727,453,274,165.3,500,259,241,107.5
'38320, 함안군,'030004, 28세,2019,712,480,232,206.9,464,271,193,140.4
'38320, 함안군,'030005, 29세,2019,736,470,266,176.7,484,262,222,118
'38320, 함안군,'035,30~34세,2019,3594,2299,1295,177.5,2444,1294,1150,112.5
'38320, 함안군,'035001, 30세,2019,701,461,240,192.1,454,240,214,112.1
'38320, 함안군,'035002, 31세,2019,698,449,249,180.3,465,244,221,110.4
'38320, 함안군,'035003, 32세,2019,725,455,270,168.5,474,245,229,107
'38320, 함안군,'035004, 33세,2019,732,463,269,172.1,512,272,240,113.3
'38320, 함안군,'035005, 34세,2019,738,471,267,176.4,539,293,246,119.1
'38320, 함안군,'040,35~39세,2019,4458,2492,1966,126.8,3704,1877,1827,102.7
'38320, 함안군,'040001, 35세,2019,756,410,346,118.5,585,271,314,86.3
'38320, 함안군,'040002, 36세,2019,866,482,384,125.5,706,345,361,95.6
'38320, 함안군,'040003, 37세,2019,889,501,388,129.1,727,375,352,106.5
'38320, 함안군,'040004, 38세,2019,913,520,393,132.3,791,421,370,113.8
'38320, 함안군,'040005, 39세,2019,1034,579,455,127.3,895,465,430,108.1
'38320, 함안군,'045,40~44세,2019,4652,2601,2051,126.8,4189,2231,1958,113.9
'38320, 함안군,'045001, 40세,2019,911,526,385,136.6,789,423,366,115.6
'38320, 함안군,'045002, 41세,2019,880,474,406,116.7,774,394,380,103.7
'38320, 함안군,'045003, 42세,2019,959,546,413,132.2,868,470,398,118.1
'38320, 함안군,'045004, 43세,2019,893,495,398,124.4,811,429,382,112.3
'38320, 함안군,'045005, 44세,2019,1009,560,449,124.7,947,515,432,119.2
'38320, 함안군,'050,45~49세,2019,5261,2944,2317,127.1,4974,2734,2240,122.1
'38320, 함안군,'050001, 45세,2019,1032,574,458,125.3,969,524,445,117.8
'38320, 함안군,'050002, 46세,2019,1024,567,457,124.1,963,522,441,118.4
'38320, 함안군,'050003, 47세,2019,1051,593,458,129.5,989,555,434,127.9
'38320, 함안군,'050004, 48세,2019,1098,621,477,130.2,1048,580,468,123.9
'38320, 함안군,'050005, 49세,2019,1056,589,467,126.1,1005,553,452,122.3
'38320, 함안군,'055,50~54세,2019,5301,2888,2413,119.7,5103,2764,2339,118.2
'38320, 함안군,'055001, 50세,2019,1052,593,459,129.2,995,557,438,127.2
'38320, 함안군,'055002, 51세,2019,1092,603,489,123.3,1060,581,479,121.3
'38320, 함안군,'055003, 52세,2019,1023,562,461,121.9,983,540,443,121.9
'38320, 함안군,'055004, 53세,2019,1084,597,487,122.6,1047,571,476,120
'38320, 함안군,'055005, 54세,2019,1050,533,517,103.1,1018,515,503,102.4
'38320, 함안군,'060,55~59세,2019,5689,2997,2692,111.3,5580,2937,2643,111.1
'38320, 함안군,'060001, 55세,2019,985,533,452,117.9,964,524,440,119.1
'38320, 함안군,'060002, 56세,2019,1050,563,487,115.6,1019,549,470,116.8
'38320, 함안군,'060003, 57세,2019,1107,590,517,114.1,1088,576,512,112.5
'38320, 함안군,'060004, 58세,2019,1306,689,617,111.7,1285,677,608,111.3
'38320, 함안군,'060005, 59세,2019,1241,622,619,100.5,1224,611,613,99.7
'38320, 함안군,'065,60~64세,2019,5749,3055,2694,113.4,5676,3011,2665,113
'38320, 함안군,'065001, 60세,2019,1140,611,529,115.5,1125,604,521,115.9
'38320, 함안군,'065002, 61세,2019,1195,658,537,122.5,1180,650,530,122.6
'38320, 함안군,'065003, 62세,2019,1190,624,566,110.2,1176,615,561,109.6
'38320, 함안군,'065004, 63세,2019,1110,556,554,100.4,1094,547,547,100
'38320, 함안군,'065005, 64세,2019,1114,606,508,119.3,1101,595,506,117.6
'38320, 함안군,'070,65~69세,2019,4194,2060,2134,96.5,4164,2043,2121,96.3
'38320, 함안군,'070001, 65세,2019,985,471,514,91.6,978,465,513,90.6
'38320, 함안군,'070002, 66세,2019,849,435,414,105.1,843,432,411,105.1
'38320, 함안군,'070003, 67세,2019,867,407,460,88.5,865,405,460,88
'38320, 함안군,'070004, 68세,2019,692,358,334,107.2,687,356,331,107.6
'38320, 함안군,'070005, 69세,2019,801,389,412,94.4,791,385,406,94.8
'38320, 함안군,'075,70~74세,2019,3199,1507,1692,89.1,3188,1502,1686,89.1
'38320, 함안군,'075001, 70세,2019,733,355,378,93.9,729,355,374,94.9
'38320, 함안군,'075002, 71세,2019,769,399,370,107.8,765,396,369,107.3
'38320, 함안군,'075003, 72세,2019,691,327,364,89.8,690,327,363,90.1
'38320, 함안군,'075004, 73세,2019,496,222,274,81,495,221,274,80.7
'38320, 함안군,'075005, 74세,2019,510,204,306,66.7,509,203,306,66.3
'38320, 함안군,'080,75~79세,2019,3218,1219,1999,61,3213,1218,1995,61.1
'38320, 함안군,'080001, 75세,2019,600,244,356,68.5,600,244,356,68.5
'38320, 함안군,'080002, 76세,2019,593,240,353,68,590,239,351,68.1
'38320, 함안군,'080003, 77세,2019,724,273,451,60.5,724,273,451,60.5
'38320, 함안군,'080004, 78세,2019,681,247,434,56.9,680,247,433,57
'38320, 함안군,'080005, 79세,2019,620,215,405,53.1,619,215,404,53.2
'38320, 함안군,'085,80~84세,2019,2450,774,1676,46.2,2450,774,1676,46.2
'38320, 함안군,'085001, 80세,2019,567,185,382,48.4,567,185,382,48.4
'38320, 함안군,'085002, 81세,2019,525,165,360,45.8,525,165,360,45.8
'38320, 함안군,'085003, 82세,2019,521,164,357,45.9,521,164,357,45.9
'38320, 함안군,'085004, 83세,2019,424,139,285,48.8,424,139,285,48.8
'38320, 함안군,'085005, 84세,2019,413,121,292,41.4,413,121,292,41.4
'38320, 함안군,'086,85세이상,2019,1729,405,1324,30.6,1729,405,1324,30.6
'38320, 함안군,'090,85~89세,2019,1266,321,945,34,1266,321,945,34
'38320, 함안군,'090001, 85세,2019,373,103,270,38.1,373,103,270,38.1
'38320, 함안군,'090002, 86세,2019,278,71,207,34.3,278,71,207,34.3
'38320, 함안군,'090003, 87세,2019,264,66,198,33.3,264,66,198,33.3
'38320, 함안군,'090004, 88세,2019,199,40,159,25.2,199,40,159,25.2
'38320, 함안군,'090005, 89세,2019,152,41,111,36.9,152,41,111,36.9
'38320, 함안군,'095,90~94세,2019,405,76,329,23.1,405,76,329,23.1
'38320, 함안군,'095001, 90세,2019,136,25,111,22.5,136,25,111,22.5
'38320, 함안군,'095002, 91세,2019,111,19,92,20.7,111,19,92,20.7
'38320, 함안군,'095003, 92세,2019,61,11,50,22,61,11,50,22
'38320, 함안군,'095004, 93세,2019,56,12,44,27.3,56,12,44,27.3
'38320, 함안군,'095005, 94세,2019,41,9,32,28.1,41,9,32,28.1
'38320, 함안군,'100,95~99세,2019,55,8,47,17,55,8,47,17
'38320, 함안군,'100001, 95세,2019,22,6,16,37.5,22,6,16,37.5
'38320, 함안군,'100002, 96세,2019,13,X,13,0,13,X,13,0
'38320, 함안군,'100003, 97세,2019,7,X,7,0,7,X,7,0
'38320, 함안군,'100004, 98세,2019,7,X,6,16.7,7,X,6,16.7
'38320, 함안군,'100005, 99세,2019,6,X,5,20,6,X,5,20
'38320, 함안군,'101,100세이상,2019,X,X,X,0,X,X,X,0
'38320, 함안군,'102,15세미만,2019,7608,3845,3763,102.2,7547,3819,3728,102.4
'38320, 함안군,'103,15~64세,2019,44213,25141,19072,131.8,39474,21280,18194,117
'38320, 함안군,'104,65세이상,2019,14790,5965,8825,67.6,14744,5942,8802,67.5
'38320, 함안군,'126,평균연령,2019,46.5,44.2,49.1,,47.4,45.5,49.4,
'38320, 함안군,'127,중위연령,2019,48.3,45.6,51.7,,50.2,48.5,52.4,
'38330, 창녕군,'000,합계,2019,62370,31701,30669,103.4,58462,29034,29428,98.7
'38330, 창녕군,'005,0~4세,2019,1692,877,815,107.6,1642,850,792,107.3
'38330, 창녕군,'005001, 0세,2019,318,163,155,105.2,312,162,150,108
'38330, 창녕군,'005002, 1세,2019,330,164,166,98.8,318,157,161,97.5
'38330, 창녕군,'005003, 2세,2019,326,173,153,113.1,317,170,147,115.6
'38330, 창녕군,'005004, 3세,2019,364,194,170,114.1,355,189,166,113.9
'38330, 창녕군,'005005, 4세,2019,354,183,171,107,340,172,168,102.4
'38330, 창녕군,'010,5~9세,2019,1939,1015,924,109.8,1899,997,902,110.5
'38330, 창녕군,'010001, 5세,2019,374,193,181,106.6,363,189,174,108.6
'38330, 창녕군,'010002, 6세,2019,384,205,179,114.5,376,201,175,114.9
'38330, 창녕군,'010003, 7세,2019,383,193,190,101.6,376,189,187,101.1
'38330, 창녕군,'010004, 8세,2019,417,220,197,111.7,411,216,195,110.8
'38330, 창녕군,'010005, 9세,2019,381,204,177,115.3,373,202,171,118.1
'38330, 창녕군,'015,10~14세,2019,1828,996,832,119.7,1796,982,814,120.6
'38330, 창녕군,'015001, 10세,2019,383,197,186,105.9,372,192,180,106.7
'38330, 창녕군,'015002, 11세,2019,369,190,179,106.1,361,185,176,105.1
'38330, 창녕군,'015003, 12세,2019,392,235,157,149.7,389,232,157,147.8
'38330, 창녕군,'015004, 13세,2019,348,180,168,107.1,342,180,162,111.1
'38330, 창녕군,'015005, 14세,2019,336,194,142,136.6,332,193,139,138.8
'38330, 창녕군,'020,15~19세,2019,2471,1379,1092,126.3,2421,1348,1073,125.6
'38330, 창녕군,'020001, 15세,2019,378,210,168,125,376,209,167,125.1
'38330, 창녕군,'020002, 16세,2019,550,283,267,106,546,282,264,106.8
'38330, 창녕군,'020003, 17세,2019,601,355,246,144.3,596,352,244,144.3
'38330, 창녕군,'020004, 18세,2019,596,325,271,119.9,579,316,263,120.2
'38330, 창녕군,'020005, 19세,2019,346,206,140,147.1,324,189,135,140
'38330, 창녕군,'025,20~24세,2019,2648,1698,950,178.7,2170,1357,813,166.9
'38330, 창녕군,'025001, 20세,2019,456,313,143,218.9,417,281,136,206.6
'38330, 창녕군,'025002, 21세,2019,543,360,183,196.7,471,314,157,200
'38330, 창녕군,'025003, 22세,2019,513,307,206,149,423,241,182,132.4
'38330, 창녕군,'025004, 23세,2019,551,342,209,163.6,428,248,180,137.8
'38330, 창녕군,'025005, 24세,2019,585,376,209,179.9,431,273,158,172.8
'38330, 창녕군,'030,25~29세,2019,3133,1910,1223,156.2,2276,1283,993,129.2
'38330, 창녕군,'030001, 25세,2019,583,354,229,154.6,423,239,184,129.9
'38330, 창녕군,'030002, 26세,2019,629,371,258,143.8,455,248,207,119.8
'38330, 창녕군,'030003, 27세,2019,646,415,231,179.7,459,272,187,145.5
'38330, 창녕군,'030004, 28세,2019,627,368,259,142.1,458,248,210,118.1
'38330, 창녕군,'030005, 29세,2019,648,402,246,163.4,481,276,205,134.6
'38330, 창녕군,'035,30~34세,2019,3045,1885,1160,162.5,2267,1314,953,137.9
'38330, 창녕군,'035001, 30세,2019,646,410,236,173.7,486,298,188,158.5
'38330, 창녕군,'035002, 31세,2019,592,368,224,164.3,411,238,173,137.6
'38330, 창녕군,'035003, 32세,2019,613,392,221,177.4,452,266,186,143
'38330, 창녕군,'035004, 33세,2019,617,373,244,152.9,472,262,210,124.8
'38330, 창녕군,'035005, 34세,2019,577,342,235,145.5,446,250,196,127.6
'38330, 창녕군,'040,35~39세,2019,3560,2001,1559,128.4,3010,1608,1402,114.7
'38330, 창녕군,'040001, 35세,2019,671,371,300,123.7,553,288,265,108.7
'38330, 창녕군,'040002, 36세,2019,668,383,285,134.4,548,294,254,115.7
'38330, 창녕군,'040003, 37세,2019,748,402,346,116.2,638,324,314,103.2
'38330, 창녕군,'040004, 38세,2019,700,432,268,161.2,596,356,240,148.3
'38330, 창녕군,'040005, 39세,2019,773,413,360,114.7,675,346,329,105.2
'38330, 창녕군,'045,40~44세,2019,3275,1874,1401,133.8,2929,1660,1269,130.8
'38330, 창녕군,'045001, 40세,2019,728,405,323,125.4,649,350,299,117.1
'38330, 창녕군,'045002, 41세,2019,657,365,292,125,569,312,257,121.4
'38330, 창녕군,'045003, 42세,2019,603,361,242,149.2,544,323,221,146.2
'38330, 창녕군,'045004, 43세,2019,635,374,261,143.3,568,333,235,141.7
'38330, 창녕군,'045005, 44세,2019,652,369,283,130.4,599,342,257,133.1
'38330, 창녕군,'050,45~49세,2019,4070,2298,1772,129.7,3790,2116,1674,126.4
'38330, 창녕군,'050001, 45세,2019,778,442,336,131.5,704,387,317,122.1
'38330, 창녕군,'050002, 46세,2019,770,423,347,121.9,712,387,325,119.1
'38330, 창녕군,'050003, 47세,2019,754,403,351,114.8,700,371,329,112.8
'38330, 창녕군,'050004, 48세,2019,885,503,382,131.7,832,472,360,131.1
'38330, 창녕군,'050005, 49세,2019,883,527,356,148,842,499,343,145.5
'38330, 창녕군,'055,50~54세,2019,4832,2617,2215,118.1,4646,2515,2131,118
'38330, 창녕군,'055001, 50세,2019,962,515,447,115.2,919,491,428,114.7
'38330, 창녕군,'055002, 51세,2019,949,520,429,121.2,916,499,417,119.7
'38330, 창녕군,'055003, 52세,2019,927,494,433,114.1,880,466,414,112.6
'38330, 창녕군,'055004, 53세,2019,983,543,440,123.4,955,530,425,124.7
'38330, 창녕군,'055005, 54세,2019,1011,545,466,117,976,529,447,118.3
'38330, 창녕군,'060,55~59세,2019,6006,2949,3057,96.5,5883,2880,3003,95.9
'38330, 창녕군,'060001, 55세,2019,1015,471,544,86.6,991,463,528,87.7
'38330, 창녕군,'060002, 56세,2019,1127,570,557,102.3,1098,550,548,100.4
'38330, 창녕군,'060003, 57세,2019,1203,629,574,109.6,1170,609,561,108.6
'38330, 창녕군,'060004, 58세,2019,1283,612,671,91.2,1261,597,664,89.9
'38330, 창녕군,'060005, 59세,2019,1378,667,711,93.8,1363,661,702,94.2
'38330, 창녕군,'065,60~64세,2019,6235,3157,3078,102.6,6146,3103,3043,102
'38330, 창녕군,'065001, 60세,2019,1283,661,622,106.3,1262,647,615,105.2
'38330, 창녕군,'065002, 61세,2019,1217,635,582,109.1,1185,618,567,109
'38330, 창녕군,'065003, 62세,2019,1315,663,652,101.7,1298,650,648,100.3
'38330, 창녕군,'065004, 63세,2019,1193,607,586,103.6,1186,605,581,104.1
'38330, 창녕군,'065005, 64세,2019,1227,591,636,92.9,1215,583,632,92.2
'38330, 창녕군,'070,65~69세,2019,4672,2270,2402,94.5,4638,2256,2382,94.7
'38330, 창녕군,'070001, 65세,2019,980,496,484,102.5,970,491,479,102.5
'38330, 창녕군,'070002, 66세,2019,926,439,487,90.1,913,434,479,90.6
'38330, 창녕군,'070003, 67세,2019,1067,509,558,91.2,1063,508,555,91.5
'38330, 창녕군,'070004, 68세,2019,817,402,415,96.9,816,401,415,96.6
'38330, 창녕군,'070005, 69세,2019,882,424,458,92.6,876,422,454,93
'38330, 창녕군,'075,70~74세,2019,3844,1825,2019,90.4,3835,1818,2017,90.1
'38330, 창녕군,'075001, 70세,2019,878,419,459,91.3,875,417,458,91
'38330, 창녕군,'075002, 71세,2019,852,427,425,100.5,850,425,425,100
'38330, 창녕군,'075003, 72세,2019,868,410,458,89.5,867,410,457,89.7
'38330, 창녕군,'075004, 73세,2019,634,294,340,86.5,633,293,340,86.2
'38330, 창녕군,'075005, 74세,2019,612,275,337,81.6,610,273,337,81
'38330, 창녕군,'080,75~79세,2019,3939,1459,2480,58.8,3936,1458,2478,58.8
'38330, 창녕군,'080001, 75세,2019,727,278,449,61.9,726,278,448,62.1
'38330, 창녕군,'080002, 76세,2019,747,285,462,61.7,747,285,462,61.7
'38330, 창녕군,'080003, 77세,2019,888,319,569,56.1,887,319,568,56.2
'38330, 창녕군,'080004, 78세,2019,846,322,524,61.5,846,322,524,61.5
'38330, 창녕군,'080005, 79세,2019,731,255,476,53.6,730,254,476,53.4
'38330, 창녕군,'085,80~84세,2019,3076,993,2083,47.7,3075,992,2083,47.6
'38330, 창녕군,'085001, 80세,2019,742,233,509,45.8,742,233,509,45.8
'38330, 창녕군,'085002, 81세,2019,722,234,488,48,722,234,488,48
'38330, 창녕군,'085003, 82세,2019,616,223,393,56.7,615,222,393,56.5
'38330, 창녕군,'085004, 83세,2019,494,147,347,42.4,494,147,347,42.4
'38330, 창녕군,'085005, 84세,2019,502,156,346,45.1,502,156,346,45.1
'38330, 창녕군,'086,85세이상,2019,2105,498,1607,31,2103,497,1606,30.9
'38330, 창녕군,'090,85~89세,2019,1572,403,1169,34.5,1572,403,1169,34.5
'38330, 창녕군,'090001, 85세,2019,442,108,334,32.3,442,108,334,32.3
'38330, 창녕군,'090002, 86세,2019,381,104,277,37.5,381,104,277,37.5
'38330, 창녕군,'090003, 87세,2019,348,100,248,40.3,348,100,248,40.3
'38330, 창녕군,'090004, 88세,2019,216,50,166,30.1,216,50,166,30.1
'38330, 창녕군,'090005, 89세,2019,185,41,144,28.5,185,41,144,28.5
'38330, 창녕군,'095,90~94세,2019,462,85,377,22.5,461,85,376,22.6
'38330, 창녕군,'095001, 90세,2019,159,36,123,29.3,158,36,122,29.5
'38330, 창녕군,'095002, 91세,2019,132,19,113,16.8,132,19,113,16.8
'38330, 창녕군,'095003, 92세,2019,78,13,65,20,78,13,65,20
'38330, 창녕군,'095004, 93세,2019,55,11,44,25,55,11,44,25
'38330, 창녕군,'095005, 94세,2019,38,6,32,18.8,38,6,32,18.8
'38330, 창녕군,'100,95~99세,2019,64,8,56,14.3,63,7,56,12.5
'38330, 창녕군,'100001, 95세,2019,25,X,21,19,25,X,21,19
'38330, 창녕군,'100002, 96세,2019,17,X,16,6.3,16,X,16,0
'38330, 창녕군,'100003, 97세,2019,11,X,9,22.2,11,X,9,22.2
'38330, 창녕군,'100004, 98세,2019,5,X,X,25,5,X,X,25
'38330, 창녕군,'100005, 99세,2019,6,X,6,0,6,X,6,0
'38330, 창녕군,'101,100세이상,2019,7,X,5,40,7,X,5,40
'38330, 창녕군,'102,15세미만,2019,5459,2888,2571,112.3,5337,2829,2508,112.8
'38330, 창녕군,'103,15~64세,2019,39275,21768,17507,124.3,35538,19184,16354,117.3
'38330, 창녕군,'104,65세이상,2019,17636,7045,10591,66.5,17587,7021,10566,66.4
'38330, 창녕군,'126,평균연령,2019,50.1,47,53.2,,51.1,48.2,54,
'38330, 창녕군,'127,중위연령,2019,53.7,49.8,57.5,,55.4,52,58.4,
'38340, 고성군,'000,합계,2019,50887,25867,25020,103.4,49059,24581,24478,100.4
'38340, 고성군,'005,0~4세,2019,1081,559,522,107.1,1079,557,522,106.7
'38340, 고성군,'005001, 0세,2019,150,76,74,102.7,150,76,74,102.7
'38340, 고성군,'005002, 1세,2019,189,101,88,114.8,189,101,88,114.8
'38340, 고성군,'005003, 2세,2019,188,101,87,116.1,187,100,87,114.9
'38340, 고성군,'005004, 3세,2019,245,135,110,122.7,245,135,110,122.7
'38340, 고성군,'005005, 4세,2019,309,146,163,89.6,308,145,163,89
'38340, 고성군,'010,5~9세,2019,1799,911,888,102.6,1794,907,887,102.3
'38340, 고성군,'010001, 5세,2019,324,152,172,88.4,321,149,172,86.6
'38340, 고성군,'010002, 6세,2019,330,159,171,93,329,159,170,93.5
'38340, 고성군,'010003, 7세,2019,362,184,178,103.4,362,184,178,103.4
'38340, 고성군,'010004, 8세,2019,395,201,194,103.6,394,200,194,103.1
'38340, 고성군,'010005, 9세,2019,388,215,173,124.3,388,215,173,124.3
'38340, 고성군,'015,10~14세,2019,1825,960,865,111,1820,956,864,110.6
'38340, 고성군,'015001, 10세,2019,349,180,169,106.5,349,180,169,106.5
'38340, 고성군,'015002, 11세,2019,386,196,190,103.2,386,196,190,103.2
'38340, 고성군,'015003, 12세,2019,366,218,148,147.3,365,217,148,146.6
'38340, 고성군,'015004, 13세,2019,349,181,168,107.7,347,179,168,106.5
'38340, 고성군,'015005, 14세,2019,375,185,190,97.4,373,184,189,97.4
'38340, 고성군,'020,15~19세,2019,2409,1442,967,149.1,2400,1436,964,149
'38340, 고성군,'020001, 15세,2019,393,218,175,124.6,393,218,175,124.6
'38340, 고성군,'020002, 16세,2019,606,360,246,146.3,605,359,246,145.9
'38340, 고성군,'020003, 17세,2019,581,338,243,139.1,579,337,242,139.3
'38340, 고성군,'020004, 18세,2019,545,331,214,154.7,545,331,214,154.7
'38340, 고성군,'020005, 19세,2019,284,195,89,219.1,278,191,87,219.5
'38340, 고성군,'025,20~24세,2019,1860,1190,670,177.6,1726,1096,630,174
'38340, 고성군,'025001, 20세,2019,333,238,95,250.5,326,235,91,258.2
'38340, 고성군,'025002, 21세,2019,365,236,129,182.9,345,224,121,185.1
'38340, 고성군,'025003, 22세,2019,351,225,126,178.6,333,214,119,179.8
'38340, 고성군,'025004, 23세,2019,428,258,170,151.8,385,220,165,133.3
'38340, 고성군,'025005, 24세,2019,383,233,150,155.3,337,203,134,151.5
'38340, 고성군,'030,25~29세,2019,2023,1231,792,155.4,1645,961,684,140.5
'38340, 고성군,'030001, 25세,2019,405,230,175,131.4,350,195,155,125.8
'38340, 고성군,'030002, 26세,2019,389,225,164,137.2,323,177,146,121.2
'38340, 고성군,'030003, 27세,2019,417,265,152,174.3,340,208,132,157.6
'38340, 고성군,'030004, 28세,2019,407,259,148,175,324,198,126,157.1
'38340, 고성군,'030005, 29세,2019,405,252,153,164.7,308,183,125,146.4
'38340, 고성군,'035,30~34세,2019,2055,1211,844,143.5,1605,866,739,117.2
'38340, 고성군,'035001, 30세,2019,410,247,163,151.5,311,175,136,128.7
'38340, 고성군,'035002, 31세,2019,360,203,157,129.3,282,146,136,107.4
'38340, 고성군,'035003, 32세,2019,411,248,163,152.1,314,176,138,127.5
'38340, 고성군,'035004, 33세,2019,413,246,167,147.3,327,177,150,118
'38340, 고성군,'035005, 34세,2019,461,267,194,137.6,371,192,179,107.3
'38340, 고성군,'040,35~39세,2019,2874,1650,1224,134.8,2560,1408,1152,122.2
'38340, 고성군,'040001, 35세,2019,483,269,214,125.7,398,207,191,108.4
'38340, 고성군,'040002, 36세,2019,548,324,224,144.6,478,270,208,129.8
'38340, 고성군,'040003, 37세,2019,593,351,242,145,528,300,228,131.6
'38340, 고성군,'040004, 38세,2019,609,334,275,121.5,559,295,264,111.7
'38340, 고성군,'040005, 39세,2019,641,372,269,138.3,597,336,261,128.7
'38340, 고성군,'045,40~44세,2019,2835,1589,1246,127.5,2654,1466,1188,123.4
'38340, 고성군,'045001, 40세,2019,584,350,234,149.6,547,322,225,143.1
'38340, 고성군,'045002, 41세,2019,537,313,224,139.7,490,278,212,131.1
'38340, 고성군,'045003, 42세,2019,538,287,251,114.3,504,268,236,113.6
'38340, 고성군,'045004, 43세,2019,552,302,250,120.8,526,286,240,119.2
'38340, 고성군,'045005, 44세,2019,624,337,287,117.4,587,312,275,113.5
'38340, 고성군,'050,45~49세,2019,3721,2065,1656,124.7,3587,1979,1608,123.1
'38340, 고성군,'050001, 45세,2019,652,359,293,122.5,623,340,283,120.1
'38340, 고성군,'050002, 46세,2019,694,387,307,126.1,669,367,302,121.5
'38340, 고성군,'050003, 47세,2019,680,390,290,134.5,654,377,277,136.1
'38340, 고성군,'050004, 48세,2019,855,452,403,112.2,830,435,395,110.1
'38340, 고성군,'050005, 49세,2019,840,477,363,131.4,811,460,351,131.1
'38340, 고성군,'055,50~54세,2019,4028,2213,1815,121.9,3930,2160,1770,122
'38340, 고성군,'055001, 50세,2019,786,459,327,140.4,762,448,314,142.7
'38340, 고성군,'055002, 51세,2019,818,437,381,114.7,799,427,372,114.8
'38340, 고성군,'055003, 52세,2019,813,481,332,144.9,793,467,326,143.3
'38340, 고성군,'055004, 53세,2019,800,428,372,115.1,783,419,364,115.1
'38340, 고성군,'055005, 54세,2019,811,408,403,101.2,793,399,394,101.3
'38340, 고성군,'060,55~59세,2019,4757,2436,2321,105,4699,2408,2291,105.1
'38340, 고성군,'060001, 55세,2019,756,413,343,120.4,739,408,331,123.3
'38340, 고성군,'060002, 56세,2019,871,468,403,116.1,854,456,398,114.6
'38340, 고성군,'060003, 57세,2019,971,483,488,99,964,478,486,98.4
'38340, 고성군,'060004, 58세,2019,1076,540,536,100.7,1070,537,533,100.8
'38340, 고성군,'060005, 59세,2019,1083,532,551,96.6,1072,529,543,97.4
'38340, 고성군,'065,60~64세,2019,4779,2407,2372,101.5,4747,2392,2355,101.6
'38340, 고성군,'065001, 60세,2019,990,509,481,105.8,985,508,477,106.5
'38340, 고성군,'065002, 61세,2019,920,462,458,100.9,917,459,458,100.2
'38340, 고성군,'065003, 62세,2019,970,507,463,109.5,957,501,456,109.9
'38340, 고성군,'065004, 63세,2019,958,494,464,106.5,949,489,460,106.3
'38340, 고성군,'065005, 64세,2019,941,435,506,86,939,435,504,86.3
'38340, 고성군,'070,65~69세,2019,3957,1901,2056,92.5,3940,1890,2050,92.2
'38340, 고성군,'070001, 65세,2019,878,434,444,97.7,872,430,442,97.3
'38340, 고성군,'070002, 66세,2019,762,361,401,90,760,359,401,89.5
'38340, 고성군,'070003, 67세,2019,876,419,457,91.7,875,418,457,91.5
'38340, 고성군,'070004, 68세,2019,745,369,376,98.1,742,368,374,98.4
'38340, 고성군,'070005, 69세,2019,696,318,378,84.1,691,315,376,83.8
'38340, 고성군,'075,70~74세,2019,3392,1587,1805,87.9,3386,1585,1801,88
'38340, 고성군,'075001, 70세,2019,764,391,373,104.8,764,391,373,104.8
'38340, 고성군,'075002, 71세,2019,757,371,386,96.1,754,369,385,95.8
'38340, 고성군,'075003, 72세,2019,740,345,395,87.3,738,345,393,87.8
'38340, 고성군,'075004, 73세,2019,532,236,296,79.7,532,236,296,79.7
'38340, 고성군,'075005, 74세,2019,599,244,355,68.7,598,244,354,68.9
'38340, 고성군,'080,75~79세,2019,3138,1249,1889,66.1,3136,1249,1887,66.2
'38340, 고성군,'080001, 75세,2019,556,250,306,81.7,555,250,305,82
'38340, 고성군,'080002, 76세,2019,621,256,365,70.1,621,256,365,70.1
'38340, 고성군,'080003, 77세,2019,698,260,438,59.4,698,260,438,59.4
'38340, 고성군,'080004, 78세,2019,640,243,397,61.2,640,243,397,61.2
'38340, 고성군,'080005, 79세,2019,623,240,383,62.7,622,240,382,62.8
'38340, 고성군,'085,80~84세,2019,2484,833,1651,50.5,2482,832,1650,50.4
'38340, 고성군,'085001, 80세,2019,619,214,405,52.8,619,214,405,52.8
'38340, 고성군,'085002, 81세,2019,483,160,323,49.5,483,160,323,49.5
'38340, 고성군,'085003, 82세,2019,476,157,319,49.2,475,156,319,48.9
'38340, 고성군,'085004, 83세,2019,486,168,318,52.8,485,168,317,53
'38340, 고성군,'085005, 84세,2019,420,134,286,46.9,420,134,286,46.9
'38340, 고성군,'086,85세이상,2019,1870,433,1437,30.1,1869,433,1436,30.2
'38340, 고성군,'090,85~89세,2019,1363,333,1030,32.3,1362,333,1029,32.4
'38340, 고성군,'090001, 85세,2019,388,115,273,42.1,387,115,272,42.3
'38340, 고성군,'090002, 86세,2019,322,84,238,35.3,322,84,238,35.3
'38340, 고성군,'090003, 87세,2019,272,52,220,23.6,272,52,220,23.6
'38340, 고성군,'090004, 88세,2019,198,43,155,27.7,198,43,155,27.7
'38340, 고성군,'090005, 89세,2019,183,39,144,27.1,183,39,144,27.1
'38340, 고성군,'095,90~94세,2019,425,86,339,25.4,425,86,339,25.4
'38340, 고성군,'095001, 90세,2019,150,41,109,37.6,150,41,109,37.6
'38340, 고성군,'095002, 91세,2019,100,18,82,22,100,18,82,22
'38340, 고성군,'095003, 92세,2019,80,17,63,27,80,17,63,27
'38340, 고성군,'095004, 93세,2019,67,6,61,9.8,67,6,61,9.8
'38340, 고성군,'095005, 94세,2019,28,X,24,16.7,28,X,24,16.7
'38340, 고성군,'100,95~99세,2019,79,14,65,21.5,79,14,65,21.5
'38340, 고성군,'100001, 95세,2019,28,9,19,47.4,28,9,19,47.4
'38340, 고성군,'100002, 96세,2019,22,X,18,22.2,22,X,18,22.2
'38340, 고성군,'100003, 97세,2019,15,X,14,7.1,15,X,14,7.1
'38340, 고성군,'100004, 98세,2019,10,X,10,0,10,X,10,0
'38340, 고성군,'100005, 99세,2019,X,X,X,0,X,X,X,0
'38340, 고성군,'101,100세이상,2019,X,X,X,0,X,X,X,0
'38340, 고성군,'102,15세미만,2019,4705,2430,2275,106.8,4693,2420,2273,106.5
'38340, 고성군,'103,15~64세,2019,31341,17434,13907,125.4,29553,16172,13381,120.9
'38340, 고성군,'104,65세이상,2019,14841,6003,8838,67.9,14813,5989,8824,67.9
'38340, 고성군,'126,평균연령,2019,50.4,47.4,53.4,,50.9,48,53.7,
'38340, 고성군,'127,중위연령,2019,53.7,50.3,57.6,,54.7,51.5,58,
'38350, 남해군,'000,합계,2019,42169,20688,21481,96.3,40990,19742,21248,92.9
'38350, 남해군,'005,0~4세,2019,657,340,317,107.3,657,340,317,107.3
'38350, 남해군,'005001, 0세,2019,115,55,60,91.7,115,55,60,91.7
'38350, 남해군,'005002, 1세,2019,97,47,50,94,97,47,50,94
'38350, 남해군,'005003, 2세,2019,128,75,53,141.5,128,75,53,141.5
'38350, 남해군,'005004, 3세,2019,147,68,79,86.1,147,68,79,86.1
'38350, 남해군,'005005, 4세,2019,170,95,75,126.7,170,95,75,126.7
'38350, 남해군,'010,5~9세,2019,977,530,447,118.6,974,528,446,118.4
'38350, 남해군,'010001, 5세,2019,189,108,81,133.3,189,108,81,133.3
'38350, 남해군,'010002, 6세,2019,150,70,80,87.5,149,70,79,88.6
'38350, 남해군,'010003, 7세,2019,195,99,96,103.1,195,99,96,103.1
'38350, 남해군,'010004, 8세,2019,207,132,75,176,207,132,75,176
'38350, 남해군,'010005, 9세,2019,236,121,115,105.2,234,119,115,103.5
'38350, 남해군,'015,10~14세,2019,1199,632,567,111.5,1197,631,566,111.5
'38350, 남해군,'015001, 10세,2019,227,122,105,116.2,227,122,105,116.2
'38350, 남해군,'015002, 11세,2019,242,135,107,126.2,241,135,106,127.4
'38350, 남해군,'015003, 12세,2019,249,123,126,97.6,248,122,126,96.8
'38350, 남해군,'015004, 13세,2019,237,125,112,111.6,237,125,112,111.6
'38350, 남해군,'015005, 14세,2019,244,127,117,108.5,244,127,117,108.5
'38350, 남해군,'020,15~19세,2019,1990,1066,924,115.4,1980,1058,922,114.8
'38350, 남해군,'020001, 15세,2019,283,145,138,105.1,283,145,138,105.1
'38350, 남해군,'020002, 16세,2019,423,197,226,87.2,421,195,226,86.3
'38350, 남해군,'020003, 17세,2019,495,261,234,111.5,495,261,234,111.5
'38350, 남해군,'020004, 18세,2019,428,210,218,96.3,426,209,217,96.3
'38350, 남해군,'020005, 19세,2019,361,253,108,234.3,355,248,107,231.8
'38350, 남해군,'025,20~24세,2019,1668,1155,513,225.1,1524,1030,494,208.5
'38350, 남해군,'025001, 20세,2019,301,216,85,254.1,289,208,81,256.8
'38350, 남해군,'025002, 21세,2019,328,235,93,252.7,314,222,92,241.3
'38350, 남해군,'025003, 22세,2019,360,265,95,278.9,327,235,92,255.4
'38350, 남해군,'025004, 23세,2019,358,233,125,186.4,320,200,120,166.7
'38350, 남해군,'025005, 24세,2019,321,206,115,179.1,274,165,109,151.4
'38350, 남해군,'030,25~29세,2019,1527,979,548,178.6,1263,741,522,142
'38350, 남해군,'030001, 25세,2019,295,189,106,178.3,249,148,101,146.5
'38350, 남해군,'030002, 26세,2019,327,210,117,179.5,263,152,111,136.9
'38350, 남해군,'030003, 27세,2019,302,196,106,184.9,254,154,100,154
'38350, 남해군,'030004, 28세,2019,282,183,99,184.8,234,138,96,143.8
'38350, 남해군,'030005, 29세,2019,321,201,120,167.5,263,149,114,130.7
'38350, 남해군,'035,30~34세,2019,1334,808,526,153.6,1071,588,483,121.7
'38350, 남해군,'035001, 30세,2019,268,169,99,170.7,227,135,92,146.7
'38350, 남해군,'035002, 31세,2019,255,149,106,140.6,201,102,99,103
'38350, 남해군,'035003, 32세,2019,275,159,116,137.1,214,111,103,107.8
'38350, 남해군,'035004, 33세,2019,259,158,101,156.4,212,120,92,130.4
'38350, 남해군,'035005, 34세,2019,277,173,104,166.3,217,120,97,123.7
'38350, 남해군,'040,35~39세,2019,1624,881,743,118.6,1432,721,711,101.4
'38350, 남해군,'040001, 35세,2019,268,149,119,125.2,228,120,108,111.1
'38350, 남해군,'040002, 36세,2019,296,160,136,117.6,254,121,133,91
'38350, 남해군,'040003, 37세,2019,322,177,145,122.1,287,148,139,106.5
'38350, 남해군,'040004, 38세,2019,363,193,170,113.5,323,161,162,99.4
'38350, 남해군,'040005, 39세,2019,375,202,173,116.8,340,171,169,101.2
'38350, 남해군,'045,40~44세,2019,1826,997,829,120.3,1727,914,813,112.4
'38350, 남해군,'045001, 40세,2019,330,180,150,120,303,156,147,106.1
'38350, 남해군,'045002, 41세,2019,320,183,137,133.6,302,167,135,123.7
'38350, 남해군,'045003, 42세,2019,341,184,157,117.2,330,176,154,114.3
'38350, 남해군,'045004, 43세,2019,390,211,179,117.9,366,193,173,111.6
'38350, 남해군,'045005, 44세,2019,445,239,206,116,426,222,204,108.8
'38350, 남해군,'050,45~49세,2019,2756,1554,1202,129.3,2698,1512,1186,127.5
'38350, 남해군,'050001, 45세,2019,463,258,205,125.9,450,249,201,123.9
'38350, 남해군,'050002, 46세,2019,549,292,257,113.6,536,284,252,112.7
'38350, 남해군,'050003, 47세,2019,543,308,235,131.1,530,297,233,127.5
'38350, 남해군,'050004, 48세,2019,616,366,250,146.4,606,359,247,145.3
'38350, 남해군,'050005, 49세,2019,585,330,255,129.4,576,323,253,127.7
'38350, 남해군,'055,50~54세,2019,3144,1688,1456,115.9,3096,1665,1431,116.4
'38350, 남해군,'055001, 50세,2019,662,357,305,117,645,347,298,116.4
'38350, 남해군,'055002, 51세,2019,611,326,285,114.4,601,321,280,114.6
'38350, 남해군,'055003, 52세,2019,593,317,276,114.9,581,313,268,116.8
'38350, 남해군,'055004, 53세,2019,637,365,272,134.2,632,362,270,134.1
'38350, 남해군,'055005, 54세,2019,641,323,318,101.6,637,322,315,102.2
'38350, 남해군,'060,55~59세,2019,4133,2077,2056,101,4099,2061,2038,101.1
'38350, 남해군,'060001, 55세,2019,644,327,317,103.2,638,323,315,102.5
'38350, 남해군,'060002, 56세,2019,710,370,340,108.8,699,367,332,110.5
'38350, 남해군,'060003, 57세,2019,894,459,435,105.5,890,457,433,105.5
'38350, 남해군,'060004, 58세,2019,950,444,506,87.7,945,442,503,87.9
'38350, 남해군,'060005, 59세,2019,935,477,458,104.1,927,472,455,103.7
'38350, 남해군,'065,60~64세,2019,4139,2028,2111,96.1,4103,2014,2089,96.4
'38350, 남해군,'065001, 60세,2019,804,375,429,87.4,794,374,420,89
'38350, 남해군,'065002, 61세,2019,803,417,386,108,796,415,381,108.9
'38350, 남해군,'065003, 62세,2019,888,437,451,96.9,887,436,451,96.7
'38350, 남해군,'065004, 63세,2019,784,402,382,105.2,771,395,376,105.1
'38350, 남해군,'065005, 64세,2019,860,397,463,85.7,855,394,461,85.5
'38350, 남해군,'070,65~69세,2019,3475,1663,1812,91.8,3465,1658,1807,91.8
'38350, 남해군,'070001, 65세,2019,661,332,329,100.9,660,332,328,101.2
'38350, 남해군,'070002, 66세,2019,675,328,347,94.5,674,328,346,94.8
'38350, 남해군,'070003, 67세,2019,793,354,439,80.6,788,351,437,80.3
'38350, 남해군,'070004, 68세,2019,727,335,392,85.5,727,335,392,85.5
'38350, 남해군,'070005, 69세,2019,619,314,305,103,616,312,304,102.6
'38350, 남해군,'075,70~74세,2019,3359,1569,1790,87.7,3352,1565,1787,87.6
'38350, 남해군,'075001, 70세,2019,801,378,423,89.4,798,376,422,89.1
'38350, 남해군,'075002, 71세,2019,682,314,368,85.3,680,312,368,84.8
'38350, 남해군,'075003, 72세,2019,715,343,372,92.2,713,343,370,92.7
'38350, 남해군,'075004, 73세,2019,586,274,312,87.8,586,274,312,87.8
'38350, 남해군,'075005, 74세,2019,575,260,315,82.5,575,260,315,82.5
'38350, 남해군,'080,75~79세,2019,3330,1279,2051,62.4,3324,1275,2049,62.2
'38350, 남해군,'080001, 75세,2019,538,230,308,74.7,536,228,308,74
'38350, 남해군,'080002, 76세,2019,593,230,363,63.4,593,230,363,63.4
'38350, 남해군,'080003, 77세,2019,801,299,502,59.6,800,298,502,59.4
'38350, 남해군,'080004, 78세,2019,698,261,437,59.7,696,260,436,59.6
'38350, 남해군,'080005, 79세,2019,700,259,441,58.7,699,259,440,58.9
'38350, 남해군,'085,80~84세,2019,2746,895,1851,48.4,2744,894,1850,48.3
'38350, 남해군,'085001, 80세,2019,661,242,419,57.8,661,242,419,57.8
'38350, 남해군,'085002, 81세,2019,545,203,342,59.4,544,203,341,59.5
'38350, 남해군,'085003, 82세,2019,564,180,384,46.9,564,180,384,46.9
'38350, 남해군,'085004, 83세,2019,486,139,347,40.1,486,139,347,40.1
'38350, 남해군,'085005, 84세,2019,490,131,359,36.5,489,130,359,36.2
'38350, 남해군,'086,85세이상,2019,2285,547,1738,31.5,2284,547,1737,31.5
'38350, 남해군,'090,85~89세,2019,1631,429,1202,35.7,1630,429,1201,35.7
'38350, 남해군,'090001, 85세,2019,437,128,309,41.4,437,128,309,41.4
'38350, 남해군,'090002, 86세,2019,348,98,250,39.2,348,98,250,39.2
'38350, 남해군,'090003, 87세,2019,351,96,255,37.6,350,96,254,37.8
'38350, 남해군,'090004, 88세,2019,261,52,209,24.9,261,52,209,24.9
'38350, 남해군,'090005, 89세,2019,234,55,179,30.7,234,55,179,30.7
'38350, 남해군,'095,90~94세,2019,541,106,435,24.4,541,106,435,24.4
'38350, 남해군,'095001, 90세,2019,175,31,144,21.5,175,31,144,21.5
'38350, 남해군,'095002, 91세,2019,121,27,94,28.7,121,27,94,28.7
'38350, 남해군,'095003, 92세,2019,104,24,80,30,104,24,80,30
'38350, 남해군,'095004, 93세,2019,72,14,58,24.1,72,14,58,24.1
'38350, 남해군,'095005, 94세,2019,69,10,59,16.9,69,10,59,16.9
'38350, 남해군,'100,95~99세,2019,107,12,95,12.6,107,12,95,12.6
'38350, 남해군,'100001, 95세,2019,36,X,34,5.9,36,X,34,5.9
'38350, 남해군,'100002, 96세,2019,32,7,25,28,32,7,25,28
'38350, 남해군,'100003, 97세,2019,22,X,20,10,22,X,20,10
'38350, 남해군,'100004, 98세,2019,12,X,11,9.1,12,X,11,9.1
'38350, 남해군,'100005, 99세,2019,5,X,5,0,5,X,5,0
'38350, 남해군,'101,100세이상,2019,6,X,6,0,6,X,6,0
'38350, 남해군,'102,15세미만,2019,2833,1502,1331,112.8,2828,1499,1329,112.8
'38350, 남해군,'103,15~64세,2019,24141,13233,10908,121.3,22993,12304,10689,115.1
'38350, 남해군,'104,65세이상,2019,15195,5953,9242,64.4,15169,5939,9230,64.3
'38350, 남해군,'126,평균연령,2019,54.1,50.4,57.6,,54.6,51.2,57.8,
'38350, 남해군,'127,중위연령,2019,58.1,54.1,61.5,,58.7,55.4,61.7,
'38360, 하동군,'000,합계,2019,42583,21017,21566,97.5,41828,20699,21129,98
'38360, 하동군,'005,0~4세,2019,909,442,467,94.6,908,442,466,94.8
'38360, 하동군,'005001, 0세,2019,181,92,89,103.4,180,92,88,104.5
'38360, 하동군,'005002, 1세,2019,167,83,84,98.8,167,83,84,98.8
'38360, 하동군,'005003, 2세,2019,168,84,84,100,168,84,84,100
'38360, 하동군,'005004, 3세,2019,181,70,111,63.1,181,70,111,63.1
'38360, 하동군,'005005, 4세,2019,212,113,99,114.1,212,113,99,114.1
'38360, 하동군,'010,5~9세,2019,1131,615,516,119.2,1130,615,515,119.4
'38360, 하동군,'010001, 5세,2019,209,112,97,115.5,209,112,97,115.5
'38360, 하동군,'010002, 6세,2019,180,101,79,127.8,180,101,79,127.8
'38360, 하동군,'010003, 7세,2019,218,115,103,111.7,218,115,103,111.7
'38360, 하동군,'010004, 8세,2019,262,145,117,123.9,262,145,117,123.9
'38360, 하동군,'010005, 9세,2019,262,142,120,118.3,261,142,119,119.3
'38360, 하동군,'015,10~14세,2019,1362,735,627,117.2,1360,734,626,117.3
'38360, 하동군,'015001, 10세,2019,234,104,130,80,234,104,130,80
'38360, 하동군,'015002, 11세,2019,303,168,135,124.4,302,168,134,125.4
'38360, 하동군,'015003, 12세,2019,269,162,107,151.4,269,162,107,151.4
'38360, 하동군,'015004, 13세,2019,280,154,126,122.2,279,153,126,121.4
'38360, 하동군,'015005, 14세,2019,276,147,129,114,276,147,129,114
'38360, 하동군,'020,15~19세,2019,1278,731,547,133.6,1272,728,544,133.8
'38360, 하동군,'020001, 15세,2019,285,159,126,126.2,285,159,126,126.2
'38360, 하동군,'020002, 16세,2019,239,127,112,113.4,239,127,112,113.4
'38360, 하동군,'020003, 17세,2019,264,147,117,125.6,264,147,117,125.6
'38360, 하동군,'020004, 18세,2019,281,148,133,111.3,281,148,133,111.3
'38360, 하동군,'020005, 19세,2019,209,150,59,254.2,203,147,56,262.5
'38360, 하동군,'025,20~24세,2019,1515,987,528,186.9,1426,954,472,202.1
'38360, 하동군,'025001, 20세,2019,282,224,58,386.2,278,224,54,414.8
'38360, 하동군,'025002, 21세,2019,322,229,93,246.2,311,226,85,265.9
'38360, 하동군,'025003, 22세,2019,312,195,117,166.7,295,187,108,173.1
'38360, 하동군,'025004, 23세,2019,306,179,127,140.9,282,171,111,154.1
'38360, 하동군,'025005, 24세,2019,293,160,133,120.3,260,146,114,128.1
'38360, 하동군,'030,25~29세,2019,1624,926,698,132.7,1457,857,600,142.8
'38360, 하동군,'030001, 25세,2019,309,181,128,141.4,287,176,111,158.6
'38360, 하동군,'030002, 26세,2019,343,194,149,130.2,304,180,124,145.2
'38360, 하동군,'030003, 27세,2019,338,182,156,116.7,303,166,137,121.2
'38360, 하동군,'030004, 28세,2019,341,202,139,145.3,308,186,122,152.5
'38360, 하동군,'030005, 29세,2019,293,167,126,132.5,255,149,106,140.6
'38360, 하동군,'035,30~34세,2019,1386,759,627,121.1,1245,693,552,125.5
'38360, 하동군,'035001, 30세,2019,316,173,143,121,281,153,128,119.5
'38360, 하동군,'035002, 31세,2019,303,173,130,133.1,270,158,112,141.1
'38360, 하동군,'035003, 32세,2019,269,155,114,136,242,143,99,144.4
'38360, 하동군,'035004, 33세,2019,263,146,117,124.8,243,135,108,125
'38360, 하동군,'035005, 34세,2019,235,112,123,91.1,209,104,105,99
'38360, 하동군,'040,35~39세,2019,1654,880,774,113.7,1572,846,726,116.5
'38360, 하동군,'040001, 35세,2019,338,181,157,115.3,321,172,149,115.4
'38360, 하동군,'040002, 36세,2019,286,143,143,100,267,138,129,107
'38360, 하동군,'040003, 37세,2019,361,188,173,108.7,343,180,163,110.4
'38360, 하동군,'040004, 38세,2019,336,184,152,121.1,321,177,144,122.9
'38360, 하동군,'040005, 39세,2019,333,184,149,123.5,320,179,141,127
'38360, 하동군,'045,40~44세,2019,2037,1114,923,120.7,1983,1086,897,121.1
'38360, 하동군,'045001, 40세,2019,382,219,163,134.4,366,209,157,133.1
'38360, 하동군,'045002, 41세,2019,399,206,193,106.7,389,198,191,103.7
'38360, 하동군,'045003, 42세,2019,353,193,160,120.6,344,190,154,123.4
'38360, 하동군,'045004, 43세,2019,417,238,179,133,410,233,177,131.6
'38360, 하동군,'045005, 44세,2019,486,258,228,113.2,474,256,218,117.4
'38360, 하동군,'050,45~49세,2019,3019,1660,1359,122.1,2963,1635,1328,123.1
'38360, 하동군,'050001, 45세,2019,516,279,237,117.7,504,273,231,118.2
'38360, 하동군,'050002, 46세,2019,605,335,270,124.1,595,331,264,125.4
'38360, 하동군,'050003, 47세,2019,544,300,244,123,534,292,242,120.7
'38360, 하동군,'050004, 48세,2019,636,343,293,117.1,622,341,281,121.4
'38360, 하동군,'050005, 49세,2019,718,403,315,127.9,708,398,310,128.4
'38360, 하동군,'055,50~54세,2019,3640,1991,1649,120.7,3595,1973,1622,121.6
'38360, 하동군,'055001, 50세,2019,714,420,294,142.9,705,417,288,144.8
'38360, 하동군,'055002, 51세,2019,718,392,326,120.2,707,387,320,120.9
'38360, 하동군,'055003, 52세,2019,743,404,339,119.2,732,399,333,119.8
'38360, 하동군,'055004, 53세,2019,722,399,323,123.5,713,396,317,124.9
'38360, 하동군,'055005, 54세,2019,743,376,367,102.5,738,374,364,102.7
'38360, 하동군,'060,55~59세,2019,4453,2310,2143,107.8,4400,2289,2111,108.4
'38360, 하동군,'060001, 55세,2019,668,331,337,98.2,654,325,329,98.8
'38360, 하동군,'060002, 56세,2019,815,444,371,119.7,799,436,363,120.1
'38360, 하동군,'060003, 57세,2019,910,480,430,111.6,903,478,425,112.5
'38360, 하동군,'060004, 58세,2019,1029,525,504,104.2,1024,524,500,104.8
'38360, 하동군,'060005, 59세,2019,1031,530,501,105.8,1020,526,494,106.5
'38360, 하동군,'065,60~64세,2019,4383,2230,2153,103.6,4349,2216,2133,103.9
'38360, 하동군,'065001, 60세,2019,862,441,421,104.8,853,439,414,106
'38360, 하동군,'065002, 61세,2019,877,446,431,103.5,866,441,425,103.8
'38360, 하동군,'065003, 62세,2019,897,451,446,101.1,893,451,442,102
'38360, 하동군,'065004, 63세,2019,860,461,399,115.5,851,455,396,114.9
'38360, 하동군,'065005, 64세,2019,887,431,456,94.5,886,430,456,94.3
'38360, 하동군,'070,65~69세,2019,3496,1697,1799,94.3,3479,1693,1786,94.8
'38360, 하동군,'070001, 65세,2019,766,391,375,104.3,761,391,370,105.7
'38360, 하동군,'070002, 66세,2019,676,310,366,84.7,670,308,362,85.1
'38360, 하동군,'070003, 67세,2019,747,367,380,96.6,743,365,378,96.6
'38360, 하동군,'070004, 68세,2019,652,312,340,91.8,650,312,338,92.3
'38360, 하동군,'070005, 69세,2019,655,317,338,93.8,655,317,338,93.8
'38360, 하동군,'075,70~74세,2019,3029,1377,1652,83.4,3025,1376,1649,83.4
'38360, 하동군,'075001, 70세,2019,660,314,346,90.8,659,314,345,91
'38360, 하동군,'075002, 71세,2019,681,323,358,90.2,680,323,357,90.5
'38360, 하동군,'075003, 72세,2019,663,298,365,81.6,662,297,365,81.4
'38360, 하동군,'075004, 73세,2019,499,226,273,82.8,498,226,272,83.1
'38360, 하동군,'075005, 74세,2019,526,216,310,69.7,526,216,310,69.7
'38360, 하동군,'080,75~79세,2019,3125,1208,1917,63,3124,1207,1917,63
'38360, 하동군,'080001, 75세,2019,587,252,335,75.2,587,252,335,75.2
'38360, 하동군,'080002, 76세,2019,580,241,339,71.1,580,241,339,71.1
'38360, 하동군,'080003, 77세,2019,744,272,472,57.6,743,271,472,57.4
'38360, 하동군,'080004, 78세,2019,599,228,371,61.5,599,228,371,61.5
'38360, 하동군,'080005, 79세,2019,615,215,400,53.8,615,215,400,53.8
'38360, 하동군,'085,80~84세,2019,2586,862,1724,50,2585,862,1723,50
'38360, 하동군,'085001, 80세,2019,666,243,423,57.4,665,243,422,57.6
'38360, 하동군,'085002, 81세,2019,486,167,319,52.4,486,167,319,52.4
'38360, 하동군,'085003, 82세,2019,529,185,344,53.8,529,185,344,53.8
'38360, 하동군,'085004, 83세,2019,477,142,335,42.4,477,142,335,42.4
'38360, 하동군,'085005, 84세,2019,428,125,303,41.3,428,125,303,41.3
'38360, 하동군,'086,85세이상,2019,1956,493,1463,33.7,1955,493,1462,33.7
'38360, 하동군,'090,85~89세,2019,1371,372,999,37.2,1370,372,998,37.3
'38360, 하동군,'090001, 85세,2019,391,118,273,43.2,391,118,273,43.2
'38360, 하동군,'090002, 86세,2019,273,70,203,34.5,273,70,203,34.5
'38360, 하동군,'090003, 87세,2019,284,73,211,34.6,284,73,211,34.6
'38360, 하동군,'090004, 88세,2019,232,67,165,40.6,231,67,164,40.9
'38360, 하동군,'090005, 89세,2019,191,44,147,29.9,191,44,147,29.9
'38360, 하동군,'095,90~94세,2019,490,106,384,27.6,490,106,384,27.6
'38360, 하동군,'095001, 90세,2019,146,36,110,32.7,146,36,110,32.7
'38360, 하동군,'095002, 91세,2019,113,22,91,24.2,113,22,91,24.2
'38360, 하동군,'095003, 92세,2019,112,26,86,30.2,112,26,86,30.2
'38360, 하동군,'095004, 93세,2019,71,16,55,29.1,71,16,55,29.1
'38360, 하동군,'095005, 94세,2019,48,6,42,14.3,48,6,42,14.3
'38360, 하동군,'100,95~99세,2019,81,14,67,20.9,81,14,67,20.9
'38360, 하동군,'100001, 95세,2019,29,6,23,26.1,29,6,23,26.1
'38360, 하동군,'100002, 96세,2019,28,X,26,7.7,28,X,26,7.7
'38360, 하동군,'100003, 97세,2019,11,X,8,37.5,11,X,8,37.5
'38360, 하동군,'100004, 98세,2019,8,X,6,33.3,8,X,6,33.3
'38360, 하동군,'100005, 99세,2019,5,X,X,25,5,X,X,25
'38360, 하동군,'101,100세이상,2019,14,X,13,7.7,14,X,13,7.7
'38360, 하동군,'102,15세미만,2019,3402,1792,1610,111.3,3398,1791,1607,111.4
'38360, 하동군,'103,15~64세,2019,24989,13588,11401,119.2,24262,13277,10985,120.9
'38360, 하동군,'104,65세이상,2019,14192,5637,8555,65.9,14168,5631,8537,66
'38360, 하동군,'126,평균연령,2019,53.4,50.4,56.3,,53.6,50.6,56.7,
'38360, 하동군,'127,중위연령,2019,57.3,54.1,59.8,,57.6,54.4,60.3,
'38370, 산청군,'000,합계,2019,33579,16247,17332,93.7,32659,15815,16844,93.9
'38370, 산청군,'005,0~4세,2019,717,365,352,103.7,717,365,352,103.7
'38370, 산청군,'005001, 0세,2019,140,67,73,91.8,140,67,73,91.8
'38370, 산청군,'005002, 1세,2019,124,65,59,110.2,124,65,59,110.2
'38370, 산청군,'005003, 2세,2019,152,79,73,108.2,152,79,73,108.2
'38370, 산청군,'005004, 3세,2019,139,63,76,82.9,139,63,76,82.9
'38370, 산청군,'005005, 4세,2019,162,91,71,128.2,162,91,71,128.2
'38370, 산청군,'010,5~9세,2019,802,449,353,127.2,801,448,353,126.9
'38370, 산청군,'010001, 5세,2019,132,67,65,103.1,131,66,65,101.5
'38370, 산청군,'010002, 6세,2019,150,81,69,117.4,150,81,69,117.4
'38370, 산청군,'010003, 7세,2019,161,94,67,140.3,161,94,67,140.3
'38370, 산청군,'010004, 8세,2019,169,101,68,148.5,169,101,68,148.5
'38370, 산청군,'010005, 9세,2019,190,106,84,126.2,190,106,84,126.2
'38370, 산청군,'015,10~14세,2019,990,529,461,114.8,988,528,460,114.8
'38370, 산청군,'015001, 10세,2019,173,89,84,106,173,89,84,106
'38370, 산청군,'015002, 11세,2019,185,107,78,137.2,185,107,78,137.2
'38370, 산청군,'015003, 12세,2019,222,117,105,111.4,221,116,105,110.5
'38370, 산청군,'015004, 13세,2019,207,112,95,117.9,206,112,94,119.1
'38370, 산청군,'015005, 14세,2019,203,104,99,105.1,203,104,99,105.1
'38370, 산청군,'020,15~19세,2019,1151,575,576,99.8,1146,575,571,100.7
'38370, 산청군,'020001, 15세,2019,202,103,99,104,202,103,99,104
'38370, 산청군,'020002, 16세,2019,282,140,142,98.6,281,140,141,99.3
'38370, 산청군,'020003, 17세,2019,272,122,150,81.3,272,122,150,81.3
'38370, 산청군,'020004, 18세,2019,253,127,126,100.8,252,127,125,101.6
'38370, 산청군,'020005, 19세,2019,142,83,59,140.7,139,83,56,148.2
'38370, 산청군,'025,20~24세,2019,1045,618,427,144.7,943,590,353,167.1
'38370, 산청군,'025001, 20세,2019,174,123,51,241.2,165,120,45,266.7
'38370, 산청군,'025002, 21세,2019,214,141,73,193.2,200,139,61,227.9
'38370, 산청군,'025003, 22세,2019,214,113,101,111.9,196,105,91,115.4
'38370, 산청군,'025004, 23세,2019,209,117,92,127.2,188,111,77,144.2
'38370, 산청군,'025005, 24세,2019,234,124,110,112.7,194,115,79,145.6
'38370, 산청군,'030,25~29세,2019,1221,633,588,107.7,973,525,448,117.2
'38370, 산청군,'030001, 25세,2019,243,126,117,107.7,197,109,88,123.9
'38370, 산청군,'030002, 26세,2019,262,130,132,98.5,204,104,100,104
'38370, 산청군,'030003, 27세,2019,241,131,110,119.1,199,113,86,131.4
'38370, 산청군,'030004, 28세,2019,242,125,117,106.8,191,105,86,122.1
'38370, 산청군,'030005, 29세,2019,233,121,112,108,182,94,88,106.8
'38370, 산청군,'035,30~34세,2019,1137,614,523,117.4,954,518,436,118.8
'38370, 산청군,'035001, 30세,2019,228,118,110,107.3,192,99,93,106.5
'38370, 산청군,'035002, 31세,2019,255,153,102,150,204,125,79,158.2
'38370, 산청군,'035003, 32세,2019,224,116,108,107.4,187,97,90,107.8
'38370, 산청군,'035004, 33세,2019,213,110,103,106.8,185,95,90,105.6
'38370, 산청군,'035005, 34세,2019,217,117,100,117,186,102,84,121.4
'38370, 산청군,'040,35~39세,2019,1357,739,618,119.6,1247,677,570,118.8
'38370, 산청군,'040001, 35세,2019,246,131,115,113.9,223,121,102,118.6
'38370, 산청군,'040002, 36세,2019,236,118,118,100,221,111,110,100.9
'38370, 산청군,'040003, 37세,2019,284,151,133,113.5,262,140,122,114.8
'38370, 산청군,'040004, 38세,2019,290,165,125,132,260,147,113,130.1
'38370, 산청군,'040005, 39세,2019,301,174,127,137,281,158,123,128.5
'38370, 산청군,'045,40~44세,2019,1378,749,629,119.1,1319,713,606,117.7
'38370, 산청군,'045001, 40세,2019,267,147,120,122.5,253,138,115,120
'38370, 산청군,'045002, 41세,2019,272,151,121,124.8,259,141,118,119.5
'38370, 산청군,'045003, 42세,2019,275,159,116,137.1,266,155,111,139.6
'38370, 산청군,'045004, 43세,2019,266,140,126,111.1,253,133,120,110.8
'38370, 산청군,'045005, 44세,2019,298,152,146,104.1,288,146,142,102.8
'38370, 산청군,'050,45~49세,2019,2151,1203,948,126.9,2091,1178,913,129
'38370, 산청군,'050001, 45세,2019,396,221,175,126.3,381,218,163,133.7
'38370, 산청군,'050002, 46세,2019,408,224,184,121.7,393,216,177,122
'38370, 산청군,'050003, 47세,2019,398,234,164,142.7,387,228,159,143.4
'38370, 산청군,'050004, 48세,2019,464,270,194,139.2,454,267,187,142.8
'38370, 산청군,'050005, 49세,2019,485,254,231,110,476,249,227,109.7
'38370, 산청군,'055,50~54세,2019,2846,1524,1322,115.3,2790,1497,1293,115.8
'38370, 산청군,'055001, 50세,2019,555,304,251,121.1,547,300,247,121.5
'38370, 산청군,'055002, 51세,2019,558,273,285,95.8,546,269,277,97.1
'38370, 산청군,'055003, 52세,2019,562,304,258,117.8,553,299,254,117.7
'38370, 산청군,'055004, 53세,2019,585,338,247,136.8,568,328,240,136.7
'38370, 산청군,'055005, 54세,2019,586,305,281,108.5,576,301,275,109.5
'38370, 산청군,'060,55~59세,2019,3440,1759,1681,104.6,3396,1732,1664,104.1
'38370, 산청군,'060001, 55세,2019,490,269,221,121.7,483,264,219,120.5
'38370, 산청군,'060002, 56세,2019,591,319,272,117.3,580,311,269,115.6
'38370, 산청군,'060003, 57세,2019,723,366,357,102.5,714,359,355,101.1
'38370, 산청군,'060004, 58세,2019,824,411,413,99.5,816,408,408,100
'38370, 산청군,'060005, 59세,2019,812,394,418,94.3,803,390,413,94.4
'38370, 산청군,'065,60~64세,2019,3510,1803,1707,105.6,3486,1795,1691,106.2
'38370, 산청군,'065001, 60세,2019,645,321,324,99.1,640,320,320,100
'38370, 산청군,'065002, 61세,2019,705,375,330,113.6,699,374,325,115.1
'38370, 산청군,'065003, 62세,2019,702,361,341,105.9,697,359,338,106.2
'38370, 산청군,'065004, 63세,2019,712,368,344,107,710,366,344,106.4
'38370, 산청군,'065005, 64세,2019,746,378,368,102.7,740,376,364,103.3
'38370, 산청군,'070,65~69세,2019,2857,1437,1420,101.2,2843,1429,1414,101.1
'38370, 산청군,'070001, 65세,2019,654,325,329,98.8,648,323,325,99.4
'38370, 산청군,'070002, 66세,2019,581,291,290,100.3,578,289,289,100
'38370, 산청군,'070003, 67세,2019,621,317,304,104.3,619,316,303,104.3
'38370, 산청군,'070004, 68세,2019,486,244,242,100.8,485,243,242,100.4
'38370, 산청군,'070005, 69세,2019,515,260,255,102,513,258,255,101.2
'38370, 산청군,'075,70~74세,2019,2438,1156,1282,90.2,2429,1152,1277,90.2
'38370, 산청군,'075001, 70세,2019,523,271,252,107.5,518,268,250,107.2
'38370, 산청군,'075002, 71세,2019,555,290,265,109.4,555,290,265,109.4
'38370, 산청군,'075003, 72세,2019,534,245,289,84.8,533,245,288,85.1
'38370, 산청군,'075004, 73세,2019,411,176,235,74.9,409,175,234,74.8
'38370, 산청군,'075005, 74세,2019,415,174,241,72.2,414,174,240,72.5
'38370, 산청군,'080,75~79세,2019,2698,999,1699,58.8,2697,999,1698,58.8
'38370, 산청군,'080001, 75세,2019,505,202,303,66.7,505,202,303,66.7
'38370, 산청군,'080002, 76세,2019,493,173,320,54.1,493,173,320,54.1
'38370, 산청군,'080003, 77세,2019,620,236,384,61.5,619,236,383,61.6
'38370, 산청군,'080004, 78세,2019,559,215,344,62.5,559,215,344,62.5
'38370, 산청군,'080005, 79세,2019,521,173,348,49.7,521,173,348,49.7
'38370, 산청군,'085,80~84세,2019,2230,711,1519,46.8,2229,710,1519,46.7
'38370, 산청군,'085001, 80세,2019,517,184,333,55.3,516,183,333,55
'38370, 산청군,'085002, 81세,2019,504,165,339,48.7,504,165,339,48.7
'38370, 산청군,'085003, 82세,2019,426,131,295,44.4,426,131,295,44.4
'38370, 산청군,'085004, 83세,2019,403,121,282,42.9,403,121,282,42.9
'38370, 산청군,'085005, 84세,2019,380,110,270,40.7,380,110,270,40.7
'38370, 산청군,'086,85세이상,2019,1611,384,1227,31.3,1610,384,1226,31.3
'38370, 산청군,'090,85~89세,2019,1151,289,862,33.5,1150,289,861,33.6
'38370, 산청군,'090001, 85세,2019,334,87,247,35.2,334,87,247,35.2
'38370, 산청군,'090002, 86세,2019,275,72,203,35.5,275,72,203,35.5
'38370, 산청군,'090003, 87세,2019,230,65,165,39.4,230,65,165,39.4
'38370, 산청군,'090004, 88세,2019,171,35,136,25.7,171,35,136,25.7
'38370, 산청군,'090005, 89세,2019,141,30,111,27,140,30,110,27.3
'38370, 산청군,'095,90~94세,2019,381,78,303,25.7,381,78,303,25.7
'38370, 산청군,'095001, 90세,2019,122,35,87,40.2,122,35,87,40.2
'38370, 산청군,'095002, 91세,2019,98,21,77,27.3,98,21,77,27.3
'38370, 산청군,'095003, 92세,2019,76,14,62,22.6,76,14,62,22.6
'38370, 산청군,'095004, 93세,2019,44,6,38,15.8,44,6,38,15.8
'38370, 산청군,'095005, 94세,2019,41,X,39,5.1,41,X,39,5.1
'38370, 산청군,'100,95~99세,2019,74,17,57,29.8,74,17,57,29.8
'38370, 산청군,'100001, 95세,2019,18,X,14,28.6,18,X,14,28.6
'38370, 산청군,'100002, 96세,2019,27,5,22,22.7,27,5,22,22.7
'38370, 산청군,'100003, 97세,2019,17,5,12,41.7,17,5,12,41.7
'38370, 산청군,'100004, 98세,2019,6,X,5,20,6,X,5,20
'38370, 산청군,'100005, 99세,2019,6,X,X,50,6,X,X,50
'38370, 산청군,'101,100세이상,2019,5,X,5,0,5,X,5,0
'38370, 산청군,'102,15세미만,2019,2509,1343,1166,115.2,2506,1341,1165,115.1
'38370, 산청군,'103,15~64세,2019,19236,10217,9019,113.3,18345,9800,8545,114.7
'38370, 산청군,'104,65세이상,2019,11834,4687,7147,65.6,11808,4674,7134,65.5
'38370, 산청군,'126,평균연령,2019,54.2,51.3,56.8,,54.7,51.7,57.5,
'38370, 산청군,'127,중위연령,2019,58.2,55.5,60.6,,58.7,56.1,61.3,
'38380, 함양군,'000,합계,2019,37384,18088,19296,93.7,36726,17728,18998,93.3
'38380, 함양군,'005,0~4세,2019,796,378,418,90.4,795,377,418,90.2
'38380, 함양군,'005001, 0세,2019,133,64,69,92.8,133,64,69,92.8
'38380, 함양군,'005002, 1세,2019,148,65,83,78.3,147,64,83,77.1
'38380, 함양군,'005003, 2세,2019,154,70,84,83.3,154,70,84,83.3
'38380, 함양군,'005004, 3세,2019,166,89,77,115.6,166,89,77,115.6
'38380, 함양군,'005005, 4세,2019,195,90,105,85.7,195,90,105,85.7
'38380, 함양군,'010,5~9세,2019,1114,590,524,112.6,1111,589,522,112.8
'38380, 함양군,'010001, 5세,2019,197,102,95,107.4,197,102,95,107.4
'38380, 함양군,'010002, 6세,2019,219,114,105,108.6,219,114,105,108.6
'38380, 함양군,'010003, 7세,2019,225,125,100,125,225,125,100,125
'38380, 함양군,'010004, 8세,2019,208,105,103,101.9,206,104,102,102
'38380, 함양군,'010005, 9세,2019,265,144,121,119,264,144,120,120
'38380, 함양군,'015,10~14세,2019,1344,686,658,104.3,1342,686,656,104.6
'38380, 함양군,'015001, 10세,2019,238,117,121,96.7,238,117,121,96.7
'38380, 함양군,'015002, 11세,2019,283,144,139,103.6,282,144,138,104.3
'38380, 함양군,'015003, 12세,2019,287,151,136,111,287,151,136,111
'38380, 함양군,'015004, 13세,2019,274,142,132,107.6,274,142,132,107.6
'38380, 함양군,'015005, 14세,2019,262,132,130,101.5,261,132,129,102.3
'38380, 함양군,'020,15~19세,2019,1436,757,679,111.5,1431,757,674,112.3
'38380, 함양군,'020001, 15세,2019,289,165,124,133.1,289,165,124,133.1
'38380, 함양군,'020002, 16세,2019,294,147,147,100,294,147,147,100
'38380, 함양군,'020003, 17세,2019,303,145,158,91.8,302,145,157,92.4
'38380, 함양군,'020004, 18세,2019,334,176,158,111.4,334,176,158,111.4
'38380, 함양군,'020005, 19세,2019,216,124,92,134.8,212,124,88,140.9
'38380, 함양군,'025,20~24세,2019,1326,867,459,188.9,1250,814,436,186.7
'38380, 함양군,'025001, 20세,2019,231,166,65,255.4,226,162,64,253.1
'38380, 함양군,'025002, 21세,2019,279,208,71,293,272,203,69,294.2
'38380, 함양군,'025003, 22세,2019,254,173,81,213.6,243,168,75,224
'38380, 함양군,'025004, 23세,2019,270,147,123,119.5,249,130,119,109.2
'38380, 함양군,'025005, 24세,2019,292,173,119,145.4,260,151,109,138.5
'38380, 함양군,'030,25~29세,2019,1321,728,593,122.8,1197,657,540,121.7
'38380, 함양군,'030001, 25세,2019,284,151,133,113.5,269,141,128,110.2
'38380, 함양군,'030002, 26세,2019,273,153,120,127.5,247,140,107,130.8
'38380, 함양군,'030003, 27세,2019,250,138,112,123.2,226,124,102,121.6
'38380, 함양군,'030004, 28세,2019,273,145,128,113.3,239,125,114,109.6
'38380, 함양군,'030005, 29세,2019,241,141,100,141,216,127,89,142.7
'38380, 함양군,'035,30~34세,2019,1227,663,564,117.6,1122,600,522,114.9
'38380, 함양군,'035001, 30세,2019,207,112,95,117.9,189,101,88,114.8
'38380, 함양군,'035002, 31세,2019,261,145,116,125,239,131,108,121.3
'38380, 함양군,'035003, 32세,2019,238,119,119,100,219,107,112,95.5
'38380, 함양군,'035004, 33세,2019,224,125,99,126.3,203,115,88,130.7
'38380, 함양군,'035005, 34세,2019,297,162,135,120,272,146,126,115.9
'38380, 함양군,'040,35~39세,2019,1599,827,772,107.1,1509,776,733,105.9
'38380, 함양군,'040001, 35세,2019,262,135,127,106.3,230,116,114,101.8
'38380, 함양군,'040002, 36세,2019,300,148,152,97.4,286,141,145,97.2
'38380, 함양군,'040003, 37세,2019,345,167,178,93.8,324,156,168,92.9
'38380, 함양군,'040004, 38세,2019,349,203,146,139,337,194,143,135.7
'38380, 함양군,'040005, 39세,2019,343,174,169,103,332,169,163,103.7
'38380, 함양군,'045,40~44세,2019,1826,967,859,112.6,1765,943,822,114.7
'38380, 함양군,'045001, 40세,2019,348,182,166,109.6,337,177,160,110.6
'38380, 함양군,'045002, 41세,2019,330,168,162,103.7,320,164,156,105.1
'38380, 함양군,'045003, 42세,2019,351,176,175,100.6,334,169,165,102.4
'38380, 함양군,'045004, 43세,2019,355,187,168,111.3,339,182,157,115.9
'38380, 함양군,'045005, 44세,2019,442,254,188,135.1,435,251,184,136.4
'38380, 함양군,'050,45~49세,2019,2671,1491,1180,126.4,2631,1471,1160,126.8
'38380, 함양군,'050001, 45세,2019,477,271,206,131.6,472,268,204,131.4
'38380, 함양군,'050002, 46세,2019,500,280,220,127.3,491,275,216,127.3
'38380, 함양군,'050003, 47세,2019,502,286,216,132.4,493,281,212,132.5
'38380, 함양군,'050004, 48세,2019,590,332,258,128.7,586,331,255,129.8
'38380, 함양군,'050005, 49세,2019,602,322,280,115,589,316,273,115.8
'38380, 함양군,'055,50~54세,2019,3175,1703,1472,115.7,3121,1675,1446,115.8
'38380, 함양군,'055001, 50세,2019,668,341,327,104.3,653,335,318,105.3
'38380, 함양군,'055002, 51세,2019,653,360,293,122.9,644,354,290,122.1
'38380, 함양군,'055003, 52세,2019,602,313,289,108.3,587,307,280,109.6
'38380, 함양군,'055004, 53세,2019,588,325,263,123.6,578,317,261,121.5
'38380, 함양군,'055005, 54세,2019,664,364,300,121.3,659,362,297,121.9
'38380, 함양군,'060,55~59세,2019,3618,1865,1753,106.4,3571,1844,1727,106.8
'38380, 함양군,'060001, 55세,2019,607,324,283,114.5,598,323,275,117.5
'38380, 함양군,'060002, 56세,2019,634,334,300,111.3,621,325,296,109.8
'38380, 함양군,'060003, 57세,2019,701,363,338,107.4,695,361,334,108.1
'38380, 함양군,'060004, 58세,2019,835,429,406,105.7,826,426,400,106.5
'38380, 함양군,'060005, 59세,2019,841,415,426,97.4,831,409,422,96.9
'38380, 함양군,'065,60~64세,2019,3714,1827,1887,96.8,3692,1815,1877,96.7
'38380, 함양군,'065001, 60세,2019,731,374,357,104.8,727,372,355,104.8
'38380, 함양군,'065002, 61세,2019,659,310,349,88.8,655,307,348,88.2
'38380, 함양군,'065003, 62세,2019,760,381,379,100.5,754,378,376,100.5
'38380, 함양군,'065004, 63세,2019,786,372,414,89.9,781,370,411,90
'38380, 함양군,'065005, 64세,2019,778,390,388,100.5,775,388,387,100.3
'38380, 함양군,'070,65~69세,2019,2860,1382,1478,93.5,2845,1377,1468,93.8
'38380, 함양군,'070001, 65세,2019,599,304,295,103.1,593,302,291,103.8
'38380, 함양군,'070002, 66세,2019,530,257,273,94.1,529,257,272,94.5
'38380, 함양군,'070003, 67세,2019,670,328,342,95.9,666,325,341,95.3
'38380, 함양군,'070004, 68세,2019,510,238,272,87.5,506,238,268,88.8
'38380, 함양군,'070005, 69세,2019,551,255,296,86.1,551,255,296,86.1
'38380, 함양군,'075,70~74세,2019,2599,1145,1454,78.7,2595,1141,1454,78.5
'38380, 함양군,'075001, 70세,2019,585,286,299,95.7,584,285,299,95.3
'38380, 함양군,'075002, 71세,2019,564,261,303,86.1,564,261,303,86.1
'38380, 함양군,'075003, 72세,2019,579,236,343,68.8,579,236,343,68.8
'38380, 함양군,'075004, 73세,2019,412,180,232,77.6,411,179,232,77.2
'38380, 함양군,'075005, 74세,2019,459,182,277,65.7,457,180,277,65
'38380, 함양군,'080,75~79세,2019,2845,1053,1792,58.8,2840,1049,1791,58.6
'38380, 함양군,'080001, 75세,2019,517,210,307,68.4,516,209,307,68.1
'38380, 함양군,'080002, 76세,2019,540,168,372,45.2,538,167,371,45
'38380, 함양군,'080003, 77세,2019,649,249,400,62.3,648,248,400,62
'38380, 함양군,'080004, 78세,2019,563,206,357,57.7,563,206,357,57.7
'38380, 함양군,'080005, 79세,2019,576,220,356,61.8,575,219,356,61.5
'38380, 함양군,'085,80~84세,2019,2324,785,1539,51,2321,783,1538,50.9
'38380, 함양군,'085001, 80세,2019,571,204,367,55.6,571,204,367,55.6
'38380, 함양군,'085002, 81세,2019,516,184,332,55.4,514,182,332,54.8
'38380, 함양군,'085003, 82세,2019,482,180,302,59.6,481,180,301,59.8
'38380, 함양군,'085004, 83세,2019,412,128,284,45.1,412,128,284,45.1
'38380, 함양군,'085005, 84세,2019,343,89,254,35,343,89,254,35
'38380, 함양군,'086,85세이상,2019,1589,374,1215,30.8,1588,374,1214,30.8
'38380, 함양군,'090,85~89세,2019,1141,268,873,30.7,1140,268,872,30.7
'38380, 함양군,'090001, 85세,2019,314,82,232,35.3,314,82,232,35.3
'38380, 함양군,'090002, 86세,2019,251,53,198,26.8,251,53,198,26.8
'38380, 함양군,'090003, 87세,2019,226,56,170,32.9,225,56,169,33.1
'38380, 함양군,'090004, 88세,2019,191,44,147,29.9,191,44,147,29.9
'38380, 함양군,'090005, 89세,2019,159,33,126,26.2,159,33,126,26.2
'38380, 함양군,'095,90~94세,2019,359,87,272,32,359,87,272,32
'38380, 함양군,'095001, 90세,2019,100,25,75,33.3,100,25,75,33.3
'38380, 함양군,'095002, 91세,2019,85,19,66,28.8,85,19,66,28.8
'38380, 함양군,'095003, 92세,2019,79,16,63,25.4,79,16,63,25.4
'38380, 함양군,'095004, 93세,2019,55,19,36,52.8,55,19,36,52.8
'38380, 함양군,'095005, 94세,2019,40,8,32,25,40,8,32,25
'38380, 함양군,'100,95~99세,2019,80,18,62,29,80,18,62,29
'38380, 함양군,'100001, 95세,2019,31,5,26,19.2,31,5,26,19.2
'38380, 함양군,'100002, 96세,2019,16,6,10,60,16,6,10,60
'38380, 함양군,'100003, 97세,2019,18,X,14,28.6,18,X,14,28.6
'38380, 함양군,'100004, 98세,2019,9,X,7,28.6,9,X,7,28.6
'38380, 함양군,'100005, 99세,2019,6,X,5,20,6,X,5,20
'38380, 함양군,'101,100세이상,2019,9,X,8,12.5,9,X,8,12.5
'38380, 함양군,'102,15세미만,2019,3254,1654,1600,103.4,3248,1652,1596,103.5
'38380, 함양군,'103,15~64세,2019,21913,11695,10218,114.5,21289,11352,9937,114.2
'38380, 함양군,'104,65세이상,2019,12217,4739,7478,63.4,12189,4724,7465,63.3
'38380, 함양군,'126,평균연령,2019,52.6,49.7,55.3,,52.8,49.9,55.5,
'38380, 함양군,'127,중위연령,2019,56.4,53.2,59.3,,56.8,53.6,59.6,
'38390, 거창군,'000,합계,2019,59888,29499,30389,97.1,59132,29129,30003,97.1
'38390, 거창군,'005,0~4세,2019,1584,814,770,105.7,1583,813,770,105.6
'38390, 거창군,'005001, 0세,2019,241,111,130,85.4,241,111,130,85.4
'38390, 거창군,'005002, 1세,2019,279,146,133,109.8,279,146,133,109.8
'38390, 거창군,'005003, 2세,2019,313,170,143,118.9,313,170,143,118.9
'38390, 거창군,'005004, 3세,2019,379,203,176,115.3,378,202,176,114.8
'38390, 거창군,'005005, 4세,2019,372,184,188,97.9,372,184,188,97.9
'38390, 거창군,'010,5~9세,2019,2365,1228,1137,108,2362,1226,1136,107.9
'38390, 거창군,'010001, 5세,2019,453,230,223,103.1,453,230,223,103.1
'38390, 거창군,'010002, 6세,2019,427,217,210,103.3,424,215,209,102.9
'38390, 거창군,'010003, 7세,2019,507,271,236,114.8,507,271,236,114.8
'38390, 거창군,'010004, 8세,2019,507,256,251,102,507,256,251,102
'38390, 거창군,'010005, 9세,2019,471,254,217,117.1,471,254,217,117.1
'38390, 거창군,'015,10~14세,2019,2525,1294,1231,105.1,2524,1293,1231,105
'38390, 거창군,'015001, 10세,2019,509,263,246,106.9,509,263,246,106.9
'38390, 거창군,'015002, 11세,2019,532,272,260,104.6,532,272,260,104.6
'38390, 거창군,'015003, 12세,2019,529,267,262,101.9,529,267,262,101.9
'38390, 거창군,'015004, 13세,2019,451,229,222,103.2,451,229,222,103.2
'38390, 거창군,'015005, 14세,2019,504,263,241,109.1,503,262,241,108.7
'38390, 거창군,'020,15~19세,2019,3465,2027,1438,141,3454,2022,1432,141.2
'38390, 거창군,'020001, 15세,2019,571,296,275,107.6,570,296,274,108
'38390, 거창군,'020002, 16세,2019,722,420,302,139.1,721,419,302,138.7
'38390, 거창군,'020003, 17세,2019,804,453,351,129.1,803,452,351,128.8
'38390, 거창군,'020004, 18세,2019,762,455,307,148.2,758,454,304,149.3
'38390, 거창군,'020005, 19세,2019,606,403,203,198.5,602,401,201,199.5
'38390, 거창군,'025,20~24세,2019,3057,2057,1000,205.7,2989,2019,970,208.1
'38390, 거창군,'025001, 20세,2019,575,394,181,217.7,570,392,178,220.2
'38390, 거창군,'025002, 21세,2019,588,411,177,232.2,579,405,174,232.8
'38390, 거창군,'025003, 22세,2019,687,480,207,231.9,673,473,200,236.5
'38390, 거창군,'025004, 23세,2019,591,402,189,212.7,574,393,181,217.1
'38390, 거창군,'025005, 24세,2019,616,370,246,150.4,593,356,237,150.2
'38390, 거창군,'030,25~29세,2019,2403,1363,1040,131.1,2242,1278,964,132.6
'38390, 거창군,'030001, 25세,2019,518,293,225,130.2,479,272,207,131.4
'38390, 거창군,'030002, 26세,2019,529,305,224,136.2,499,289,210,137.6
'38390, 거창군,'030003, 27세,2019,472,265,207,128,451,255,196,130.1
'38390, 거창군,'030004, 28세,2019,432,254,178,142.7,398,231,167,138.3
'38390, 거창군,'030005, 29세,2019,452,246,206,119.4,415,231,184,125.5
'38390, 거창군,'035,30~34세,2019,2309,1230,1079,114,2170,1158,1012,114.4
'38390, 거창군,'035001, 30세,2019,392,222,170,130.6,372,211,161,131.1
'38390, 거창군,'035002, 31세,2019,425,241,184,131,398,226,172,131.4
'38390, 거창군,'035003, 32세,2019,509,259,250,103.6,475,248,227,109.3
'38390, 거창군,'035004, 33세,2019,512,271,241,112.4,478,251,227,110.6
'38390, 거창군,'035005, 34세,2019,471,237,234,101.3,447,222,225,98.7
'38390, 거창군,'040,35~39세,2019,2988,1472,1516,97.1,2897,1426,1471,96.9
'38390, 거창군,'040001, 35세,2019,475,243,232,104.7,459,233,226,103.1
'38390, 거창군,'040002, 36세,2019,574,284,290,97.9,554,275,279,98.6
'38390, 거창군,'040003, 37세,2019,612,288,324,88.9,592,277,315,87.9
'38390, 거창군,'040004, 38세,2019,641,331,310,106.8,626,323,303,106.6
'38390, 거창군,'040005, 39세,2019,686,326,360,90.6,666,318,348,91.4
'38390, 거창군,'045,40~44세,2019,3272,1659,1613,102.9,3208,1633,1575,103.7
'38390, 거창군,'045001, 40세,2019,650,342,308,111,636,337,299,112.7
'38390, 거창군,'045002, 41세,2019,566,285,281,101.4,556,280,276,101.4
'38390, 거창군,'045003, 42세,2019,666,341,325,104.9,642,328,314,104.5
'38390, 거창군,'045004, 43세,2019,688,335,353,94.9,678,333,345,96.5
'38390, 거창군,'045005, 44세,2019,702,356,346,102.9,696,355,341,104.1
'38390, 거창군,'050,45~49세,2019,4382,2263,2119,106.8,4333,2248,2085,107.8
'38390, 거창군,'050001, 45세,2019,795,414,381,108.7,785,411,374,109.9
'38390, 거창군,'050002, 46세,2019,866,417,449,92.9,853,412,441,93.4
'38390, 거창군,'050003, 47세,2019,821,442,379,116.6,811,438,373,117.4
'38390, 거창군,'050004, 48세,2019,947,500,447,111.9,942,499,443,112.6
'38390, 거창군,'050005, 49세,2019,953,490,463,105.8,942,488,454,107.5
'38390, 거창군,'055,50~54세,2019,4972,2538,2434,104.3,4910,2509,2401,104.5
'38390, 거창군,'055001, 50세,2019,1001,519,482,107.7,990,516,474,108.9
'38390, 거창군,'055002, 51세,2019,1060,531,529,100.4,1041,521,520,100.2
'38390, 거창군,'055003, 52세,2019,959,488,471,103.6,948,483,465,103.9
'38390, 거창군,'055004, 53세,2019,949,505,444,113.7,941,501,440,113.9
'38390, 거창군,'055005, 54세,2019,1003,495,508,97.4,990,488,502,97.2
'38390, 거창군,'060,55~59세,2019,5338,2728,2610,104.5,5288,2708,2580,105
'38390, 거창군,'060001, 55세,2019,847,446,401,111.2,834,441,393,112.2
'38390, 거창군,'060002, 56세,2019,952,515,437,117.8,938,510,428,119.2
'38390, 거창군,'060003, 57세,2019,1090,559,531,105.3,1081,554,527,105.1
'38390, 거창군,'060004, 58세,2019,1240,609,631,96.5,1230,605,625,96.8
'38390, 거창군,'060005, 59세,2019,1209,599,610,98.2,1205,598,607,98.5
'38390, 거창군,'065,60~64세,2019,5245,2604,2641,98.6,5206,2584,2622,98.6
'38390, 거창군,'065001, 60세,2019,1154,553,601,92,1146,548,598,91.6
'38390, 거창군,'065002, 61세,2019,980,484,496,97.6,968,479,489,98
'38390, 거창군,'065003, 62세,2019,1079,537,542,99.1,1069,532,537,99.1
'38390, 거창군,'065004, 63세,2019,1014,505,509,99.2,1011,504,507,99.4
'38390, 거창군,'065005, 64세,2019,1018,525,493,106.5,1012,521,491,106.1
'38390, 거창군,'070,65~69세,2019,3953,1842,2111,87.3,3942,1837,2105,87.3
'38390, 거창군,'070001, 65세,2019,880,416,464,89.7,877,414,463,89.4
'38390, 거창군,'070002, 66세,2019,810,387,423,91.5,808,387,421,91.9
'38390, 거창군,'070003, 67세,2019,918,426,492,86.6,916,426,490,86.9
'38390, 거창군,'070004, 68세,2019,652,297,355,83.7,652,297,355,83.7
'38390, 거창군,'070005, 69세,2019,693,316,377,83.8,689,313,376,83.2
'38390, 거창군,'075,70~74세,2019,3428,1519,1909,79.6,3425,1516,1909,79.4
'38390, 거창군,'075001, 70세,2019,797,375,422,88.9,796,374,422,88.6
'38390, 거창군,'075002, 71세,2019,816,349,467,74.7,816,349,467,74.7
'38390, 거창군,'075003, 72세,2019,685,320,365,87.7,684,319,365,87.4
'38390, 거창군,'075004, 73세,2019,580,256,324,79,579,255,324,78.7
'38390, 거창군,'075005, 74세,2019,550,219,331,66.2,550,219,331,66.2
'38390, 거창군,'080,75~79세,2019,3555,1317,2238,58.8,3553,1316,2237,58.8
'38390, 거창군,'080001, 75세,2019,667,247,420,58.8,666,246,420,58.6
'38390, 거창군,'080002, 76세,2019,667,262,405,64.7,667,262,405,64.7
'38390, 거창군,'080003, 77세,2019,804,288,516,55.8,804,288,516,55.8
'38390, 거창군,'080004, 78세,2019,718,276,442,62.4,718,276,442,62.4
'38390, 거창군,'080005, 79세,2019,699,244,455,53.6,698,244,454,53.7
'38390, 거창군,'085,80~84세,2019,2967,970,1997,48.6,2967,970,1997,48.6
'38390, 거창군,'085001, 80세,2019,746,271,475,57.1,746,271,475,57.1
'38390, 거창군,'085002, 81세,2019,626,223,403,55.3,626,223,403,55.3
'38390, 거창군,'085003, 82세,2019,570,163,407,40,570,163,407,40
'38390, 거창군,'085004, 83세,2019,559,185,374,49.5,559,185,374,49.5
'38390, 거창군,'085005, 84세,2019,466,128,338,37.9,466,128,338,37.9
'38390, 거창군,'086,85세이상,2019,2080,574,1506,38.1,2079,573,1506,38
'38390, 거창군,'090,85~89세,2019,1479,429,1050,40.9,1479,429,1050,40.9
'38390, 거창군,'090001, 85세,2019,396,129,267,48.3,396,129,267,48.3
'38390, 거창군,'090002, 86세,2019,389,124,265,46.8,389,124,265,46.8
'38390, 거창군,'090003, 87세,2019,264,61,203,30,264,61,203,30
'38390, 거창군,'090004, 88세,2019,234,70,164,42.7,234,70,164,42.7
'38390, 거창군,'090005, 89세,2019,196,45,151,29.8,196,45,151,29.8
'38390, 거창군,'095,90~94세,2019,493,115,378,30.4,493,115,378,30.4
'38390, 거창군,'095001, 90세,2019,169,38,131,29,169,38,131,29
'38390, 거창군,'095002, 91세,2019,120,29,91,31.9,120,29,91,31.9
'38390, 거창군,'095003, 92세,2019,90,25,65,38.5,90,25,65,38.5
'38390, 거창군,'095004, 93세,2019,63,15,48,31.3,63,15,48,31.3
'38390, 거창군,'095005, 94세,2019,51,8,43,18.6,51,8,43,18.6
'38390, 거창군,'100,95~99세,2019,93,25,68,36.8,93,25,68,36.8
'38390, 거창군,'100001, 95세,2019,34,11,23,47.8,34,11,23,47.8
'38390, 거창군,'100002, 96세,2019,24,7,17,41.2,24,7,17,41.2
'38390, 거창군,'100003, 97세,2019,11,X,10,10,11,X,10,10
'38390, 거창군,'100004, 98세,2019,12,X,9,33.3,12,X,9,33.3
'38390, 거창군,'100005, 99세,2019,12,X,9,33.3,12,X,9,33.3
'38390, 거창군,'101,100세이상,2019,15,5,10,50,14,X,10,40
'38390, 거창군,'102,15세미만,2019,6474,3336,3138,106.3,6469,3332,3137,106.2
'38390, 거창군,'103,15~64세,2019,37431,19941,17490,114,36697,19585,17112,114.5
'38390, 거창군,'104,65세이상,2019,15983,6222,9761,63.7,15966,6212,9754,63.7
'38390, 거창군,'126,평균연령,2019,48.4,45.4,51.3,,48.5,45.5,51.5,
'38390, 거창군,'127,중위연령,2019,51.6,48.7,54.6,,51.8,48.9,54.9,
'38400, 합천군,'000,합계,2019,42449,20358,22091,92.2,41604,19912,21692,91.8
'38400, 합천군,'005,0~4세,2019,704,366,338,108.3,704,366,338,108.3
'38400, 합천군,'005001, 0세,2019,143,65,78,83.3,143,65,78,83.3
'38400, 합천군,'005002, 1세,2019,123,58,65,89.2,123,58,65,89.2
'38400, 합천군,'005003, 2세,2019,117,65,52,125,117,65,52,125
'38400, 합천군,'005004, 3세,2019,167,99,68,145.6,167,99,68,145.6
'38400, 합천군,'005005, 4세,2019,154,79,75,105.3,154,79,75,105.3
'38400, 합천군,'010,5~9세,2019,968,504,464,108.6,967,504,463,108.9
'38400, 합천군,'010001, 5세,2019,181,83,98,84.7,181,83,98,84.7
'38400, 합천군,'010002, 6세,2019,192,100,92,108.7,191,100,91,109.9
'38400, 합천군,'010003, 7세,2019,197,106,91,116.5,197,106,91,116.5
'38400, 합천군,'010004, 8세,2019,221,120,101,118.8,221,120,101,118.8
'38400, 합천군,'010005, 9세,2019,177,95,82,115.9,177,95,82,115.9
'38400, 합천군,'015,10~14세,2019,1134,589,545,108.1,1134,589,545,108.1
'38400, 합천군,'015001, 10세,2019,208,100,108,92.6,208,100,108,92.6
'38400, 합천군,'015002, 11세,2019,235,125,110,113.6,235,125,110,113.6
'38400, 합천군,'015003, 12세,2019,256,137,119,115.1,256,137,119,115.1
'38400, 합천군,'015004, 13세,2019,210,113,97,116.5,210,113,97,116.5
'38400, 합천군,'015005, 14세,2019,225,114,111,102.7,225,114,111,102.7
'38400, 합천군,'020,15~19세,2019,1248,690,558,123.7,1241,687,554,124
'38400, 합천군,'020001, 15세,2019,237,116,121,95.9,237,116,121,95.9
'38400, 합천군,'020002, 16세,2019,256,135,121,111.6,254,134,120,111.7
'38400, 합천군,'020003, 17세,2019,292,169,123,137.4,292,169,123,137.4
'38400, 합천군,'020004, 18세,2019,283,154,129,119.4,282,154,128,120.3
'38400, 합천군,'020005, 19세,2019,180,116,64,181.3,176,114,62,183.9
'38400, 합천군,'025,20~24세,2019,1453,871,582,149.7,1359,821,538,152.6
'38400, 합천군,'025001, 20세,2019,278,179,99,180.8,269,176,93,189.2
'38400, 합천군,'025002, 21세,2019,282,171,111,154.1,273,168,105,160
'38400, 합천군,'025003, 22세,2019,294,181,113,160.2,274,170,104,163.5
'38400, 합천군,'025004, 23세,2019,289,167,122,136.9,262,153,109,140.4
'38400, 합천군,'025005, 24세,2019,310,173,137,126.3,281,154,127,121.3
'38400, 합천군,'030,25~29세,2019,1431,813,618,131.6,1248,714,534,133.7
'38400, 합천군,'030001, 25세,2019,299,172,127,135.4,263,153,110,139.1
'38400, 합천군,'030002, 26세,2019,298,172,126,136.5,262,151,111,136
'38400, 합천군,'030003, 27세,2019,315,188,127,148,270,163,107,152.3
'38400, 합천군,'030004, 28세,2019,280,145,135,107.4,245,127,118,107.6
'38400, 합천군,'030005, 29세,2019,239,136,103,132,208,120,88,136.4
'38400, 합천군,'035,30~34세,2019,1326,761,565,134.7,1162,660,502,131.5
'38400, 합천군,'035001, 30세,2019,241,147,94,156.4,208,123,85,144.7
'38400, 합천군,'035002, 31세,2019,257,147,110,133.6,226,129,97,133
'38400, 합천군,'035003, 32세,2019,270,142,128,110.9,239,121,118,102.5
'38400, 합천군,'035004, 33세,2019,285,166,119,139.5,246,145,101,143.6
'38400, 합천군,'035005, 34세,2019,273,159,114,139.5,243,142,101,140.6
'38400, 합천군,'040,35~39세,2019,1583,854,729,117.1,1492,805,687,117.2
'38400, 합천군,'040001, 35세,2019,268,148,120,123.3,245,134,111,120.7
'38400, 합천군,'040002, 36세,2019,305,165,140,117.9,286,154,132,116.7
'38400, 합천군,'040003, 37세,2019,334,179,155,115.5,318,172,146,117.8
'38400, 합천군,'040004, 38세,2019,330,169,161,105,306,157,149,105.4
'38400, 합천군,'040005, 39세,2019,346,193,153,126.1,337,188,149,126.2
'38400, 합천군,'045,40~44세,2019,1750,962,788,122.1,1673,924,749,123.4
'38400, 합천군,'045001, 40세,2019,352,206,146,141.1,327,192,135,142.2
'38400, 합천군,'045002, 41세,2019,335,180,155,116.1,321,174,147,118.4
'38400, 합천군,'045003, 42세,2019,355,194,161,120.5,337,188,149,126.2
'38400, 합천군,'045004, 43세,2019,344,183,161,113.7,333,177,156,113.5
'38400, 합천군,'045005, 44세,2019,364,199,165,120.6,355,193,162,119.1
'38400, 합천군,'050,45~49세,2019,2584,1476,1108,133.2,2520,1448,1072,135.1
'38400, 합천군,'050001, 45세,2019,428,252,176,143.2,414,246,168,146.4
'38400, 합천군,'050002, 46세,2019,490,271,219,123.7,474,267,207,129
'38400, 합천군,'050003, 47세,2019,506,295,211,139.8,498,290,208,139.4
'38400, 합천군,'050004, 48세,2019,562,321,241,133.2,551,316,235,134.5
'38400, 합천군,'050005, 49세,2019,598,337,261,129.1,583,329,254,129.5
'38400, 합천군,'055,50~54세,2019,3299,1811,1488,121.7,3235,1785,1450,123.1
'38400, 합천군,'055001, 50세,2019,614,340,274,124.1,600,336,264,127.3
'38400, 합천군,'055002, 51세,2019,693,392,301,130.2,677,387,290,133.4
'38400, 합천군,'055003, 52세,2019,647,336,311,108,632,330,302,109.3
'38400, 합천군,'055004, 53세,2019,687,375,312,120.2,674,368,306,120.3
'38400, 합천군,'055005, 54세,2019,658,368,290,126.9,652,364,288,126.4
'38400, 합천군,'060,55~59세,2019,4302,2234,2068,108,4244,2202,2042,107.8
'38400, 합천군,'060001, 55세,2019,676,372,304,122.4,665,366,299,122.4
'38400, 합천군,'060002, 56세,2019,715,382,333,114.7,701,375,326,115
'38400, 합천군,'060003, 57세,2019,850,461,389,118.5,835,448,387,115.8
'38400, 합천군,'060004, 58세,2019,1078,549,529,103.8,1070,546,524,104.2
'38400, 합천군,'060005, 59세,2019,983,470,513,91.6,973,467,506,92.3
'38400, 합천군,'065,60~64세,2019,4412,2243,2169,103.4,4394,2234,2160,103.4
'38400, 합천군,'065001, 60세,2019,961,484,477,101.5,957,481,476,101.1
'38400, 합천군,'065002, 61세,2019,859,457,402,113.7,857,456,401,113.7
'38400, 합천군,'065003, 62세,2019,867,441,426,103.5,859,437,422,103.6
'38400, 합천군,'065004, 63세,2019,889,469,420,111.7,887,468,419,111.7
'38400, 합천군,'065005, 64세,2019,836,392,444,88.3,834,392,442,88.7
'38400, 합천군,'070,65~69세,2019,3690,1794,1896,94.6,3674,1786,1888,94.6
'38400, 합천군,'070001, 65세,2019,764,378,386,97.9,762,377,385,97.9
'38400, 합천군,'070002, 66세,2019,721,352,369,95.4,716,350,366,95.6
'38400, 합천군,'070003, 67세,2019,805,391,414,94.4,802,389,413,94.2
'38400, 합천군,'070004, 68세,2019,707,336,371,90.6,703,335,368,91
'38400, 합천군,'070005, 69세,2019,693,337,356,94.7,691,335,356,94.1
'38400, 합천군,'075,70~74세,2019,3317,1441,1876,76.8,3312,1439,1873,76.8
'38400, 합천군,'075001, 70세,2019,771,363,408,89,768,361,407,88.7
'38400, 합천군,'075002, 71세,2019,743,328,415,79,742,328,414,79.2
'38400, 합천군,'075003, 72세,2019,722,300,422,71.1,721,300,421,71.3
'38400, 합천군,'075004, 73세,2019,522,218,304,71.7,522,218,304,71.7
'38400, 합천군,'075005, 74세,2019,559,232,327,70.9,559,232,327,70.9
'38400, 합천군,'080,75~79세,2019,3851,1397,2454,56.9,3849,1397,2452,57
'38400, 합천군,'080001, 75세,2019,669,245,424,57.8,669,245,424,57.8
'38400, 합천군,'080002, 76세,2019,699,259,440,58.9,698,259,439,59
'38400, 합천군,'080003, 77세,2019,905,325,580,56,905,325,580,56
'38400, 합천군,'080004, 78세,2019,795,294,501,58.7,794,294,500,58.8
'38400, 합천군,'080005, 79세,2019,783,274,509,53.8,783,274,509,53.8
'38400, 합천군,'085,80~84세,2019,3229,1045,2184,47.8,3229,1045,2184,47.8
'38400, 합천군,'085001, 80세,2019,812,259,553,46.8,812,259,553,46.8
'38400, 합천군,'085002, 81세,2019,650,217,433,50.1,650,217,433,50.1
'38400, 합천군,'085003, 82세,2019,672,217,455,47.7,672,217,455,47.7
'38400, 합천군,'085004, 83세,2019,563,192,371,51.8,563,192,371,51.8
'38400, 합천군,'085005, 84세,2019,532,160,372,43,532,160,372,43
'38400, 합천군,'086,85세이상,2019,2168,507,1661,30.5,2167,506,1661,30.5
'38400, 합천군,'090,85~89세,2019,1606,388,1218,31.9,1605,387,1218,31.8
'38400, 합천군,'090001, 85세,2019,507,128,379,33.8,507,128,379,33.8
'38400, 합천군,'090002, 86세,2019,394,108,286,37.8,394,108,286,37.8
'38400, 합천군,'090003, 87세,2019,296,67,229,29.3,296,67,229,29.3
'38400, 합천군,'090004, 88세,2019,216,45,171,26.3,215,44,171,25.7
'38400, 합천군,'090005, 89세,2019,193,40,153,26.1,193,40,153,26.1
'38400, 합천군,'095,90~94세,2019,447,105,342,30.7,447,105,342,30.7
'38400, 합천군,'095001, 90세,2019,154,42,112,37.5,154,42,112,37.5
'38400, 합천군,'095002, 91세,2019,119,28,91,30.8,119,28,91,30.8
'38400, 합천군,'095003, 92세,2019,88,21,67,31.3,88,21,67,31.3
'38400, 합천군,'095004, 93세,2019,49,6,43,14,49,6,43,14
'38400, 합천군,'095005, 94세,2019,37,8,29,27.6,37,8,29,27.6
'38400, 합천군,'100,95~99세,2019,106,12,94,12.8,106,12,94,12.8
'38400, 합천군,'100001, 95세,2019,24,6,18,33.3,24,6,18,33.3
'38400, 합천군,'100002, 96세,2019,31,X,28,10.7,31,X,28,10.7
'38400, 합천군,'100003, 97세,2019,23,X,21,9.5,23,X,21,9.5
'38400, 합천군,'100004, 98세,2019,16,X,16,0,16,X,16,0
'38400, 합천군,'100005, 99세,2019,12,X,11,9.1,12,X,11,9.1
'38400, 합천군,'101,100세이상,2019,9,X,7,28.6,9,X,7,28.6
'38400, 합천군,'102,15세미만,2019,2806,1459,1347,108.3,2805,1459,1346,108.4
'38400, 합천군,'103,15~64세,2019,23388,12715,10673,119.1,22568,12280,10288,119.4
'38400, 합천군,'104,65세이상,2019,16255,6184,10071,61.4,16231,6173,10058,61.4
'38400, 합천군,'126,평균연령,2019,55.6,52.2,58.7,,56,52.5,59.1,
'38400, 합천군,'127,중위연령,2019,59.4,56.3,62.7,,59.8,56.8,63.2,
'39,제주특별자치도,'000,합계,2019,665048,336598,328450,102.5,637031,320102,316929,101
'39,제주특별자치도,'005,0~4세,2019,27919,14361,13558,105.9,27192,14014,13178,106.3
'39,제주특별자치도,'005001, 0세,2019,4629,2349,2280,103,4533,2295,2238,102.5
'39,제주특별자치도,'005002, 1세,2019,5090,2609,2481,105.2,4948,2545,2403,105.9
'39,제주특별자치도,'005003, 2세,2019,5543,2867,2676,107.1,5358,2787,2571,108.4
'39,제주특별자치도,'005004, 3세,2019,6176,3209,2967,108.2,6015,3124,2891,108.1
'39,제주특별자치도,'005005, 4세,2019,6481,3327,3154,105.5,6338,3263,3075,106.1
'39,제주특별자치도,'010,5~9세,2019,34975,18031,16944,106.4,34535,17793,16742,106.3
'39,제주특별자치도,'010001, 5세,2019,6627,3401,3226,105.4,6504,3330,3174,104.9
'39,제주특별자치도,'010002, 6세,2019,6741,3457,3284,105.3,6646,3398,3248,104.6
'39,제주특별자치도,'010003, 7세,2019,7407,3779,3628,104.2,7331,3744,3587,104.4
'39,제주특별자치도,'010004, 8세,2019,7258,3745,3513,106.6,7188,3712,3476,106.8
'39,제주특별자치도,'010005, 9세,2019,6942,3649,3293,110.8,6866,3609,3257,110.8
'39,제주특별자치도,'015,10~14세,2019,33921,17634,16287,108.3,33607,17485,16122,108.5
'39,제주특별자치도,'015001, 10세,2019,6757,3490,3267,106.8,6670,3451,3219,107.2
'39,제주특별자치도,'015002, 11세,2019,6974,3584,3390,105.7,6904,3554,3350,106.1
'39,제주특별자치도,'015003, 12세,2019,7255,3729,3526,105.8,7210,3706,3504,105.8
'39,제주특별자치도,'015004, 13세,2019,6536,3404,3132,108.7,6484,3379,3105,108.8
'39,제주특별자치도,'015005, 14세,2019,6399,3427,2972,115.3,6339,3395,2944,115.3
'39,제주특별자치도,'020,15~19세,2019,35120,18533,16587,111.7,34442,18165,16277,111.6
'39,제주특별자치도,'020001, 15세,2019,6818,3597,3221,111.7,6779,3576,3203,111.6
'39,제주특별자치도,'020002, 16세,2019,6926,3618,3308,109.4,6870,3590,3280,109.5
'39,제주특별자치도,'020003, 17세,2019,6825,3630,3195,113.6,6768,3599,3169,113.6
'39,제주특별자치도,'020004, 18세,2019,7407,3893,3514,110.8,7276,3836,3440,111.5
'39,제주특별자치도,'020005, 19세,2019,7144,3795,3349,113.3,6749,3564,3185,111.9
'39,제주특별자치도,'025,20~24세,2019,39681,21948,17733,123.8,35730,19414,16316,119
'39,제주특별자치도,'025001, 20세,2019,7264,4154,3110,133.6,6744,3864,2880,134.2
'39,제주특별자치도,'025002, 21세,2019,7836,4425,3411,129.7,7104,3987,3117,127.9
'39,제주특별자치도,'025003, 22세,2019,7943,4365,3578,122,7166,3880,3286,118.1
'39,제주특별자치도,'025004, 23세,2019,8139,4463,3676,121.4,7183,3808,3375,112.8
'39,제주특별자치도,'025005, 24세,2019,8499,4541,3958,114.7,7533,3875,3658,105.9
'39,제주특별자치도,'030,25~29세,2019,42615,23141,19474,118.8,37483,19645,17838,110.1
'39,제주특별자치도,'030001, 25세,2019,8755,4811,3944,122,7734,4087,3647,112.1
'39,제주특별자치도,'030002, 26세,2019,8953,4815,4138,116.4,7934,4097,3837,106.8
'39,제주특별자치도,'030003, 27세,2019,8769,4851,3918,123.8,7763,4157,3606,115.3
'39,제주특별자치도,'030004, 28세,2019,8200,4405,3795,116.1,7215,3752,3463,108.3
'39,제주특별자치도,'030005, 29세,2019,7938,4259,3679,115.8,6837,3552,3285,108.1
'39,제주특별자치도,'035,30~34세,2019,38640,20202,18438,109.6,33707,17229,16478,104.6
'39,제주특별자치도,'035001, 30세,2019,7538,3950,3588,110.1,6492,3320,3172,104.7
'39,제주특별자치도,'035002, 31세,2019,7287,3865,3422,112.9,6233,3219,3014,106.8
'39,제주특별자치도,'035003, 32세,2019,7736,4033,3703,108.9,6692,3421,3271,104.6
'39,제주특별자치도,'035004, 33세,2019,7802,4063,3739,108.7,6868,3515,3353,104.8
'39,제주특별자치도,'035005, 34세,2019,8277,4291,3986,107.7,7422,3754,3668,102.3
'39,제주특별자치도,'040,35~39세,2019,52071,26633,25438,104.7,48208,24407,23801,102.5
'39,제주특별자치도,'040001, 35세,2019,8825,4515,4310,104.8,8015,4032,3983,101.2
'39,제주특별자치도,'040002, 36세,2019,9833,5014,4819,104,9077,4578,4499,101.8
'39,제주특별자치도,'040003, 37세,2019,11193,5742,5451,105.3,10328,5239,5089,102.9
'39,제주특별자치도,'040004, 38세,2019,11067,5689,5378,105.8,10323,5259,5064,103.9
'39,제주특별자치도,'040005, 39세,2019,11153,5673,5480,103.5,10465,5299,5166,102.6
'39,제주특별자치도,'045,40~44세,2019,51564,26618,24946,106.7,48919,25241,23678,106.6
'39,제주특별자치도,'045001, 40세,2019,11045,5567,5478,101.6,10372,5209,5163,100.9
'39,제주특별자치도,'045002, 41세,2019,9625,4907,4718,104,9036,4599,4437,103.7
'39,제주특별자치도,'045003, 42세,2019,10275,5305,4970,106.7,9790,5052,4738,106.6
'39,제주특별자치도,'045004, 43세,2019,10102,5347,4755,112.5,9614,5095,4519,112.7
'39,제주특별자치도,'045005, 44세,2019,10517,5492,5025,109.3,10107,5286,4821,109.6
'39,제주특별자치도,'050,45~49세,2019,60650,31477,29173,107.9,58827,30456,28371,107.3
'39,제주특별자치도,'050001, 45세,2019,11857,6212,5645,110,11448,6001,5447,110.2
'39,제주특별자치도,'050002, 46세,2019,11766,6030,5736,105.1,11387,5821,5566,104.6
'39,제주특별자치도,'050003, 47세,2019,12143,6272,5871,106.8,11787,6061,5726,105.9
'39,제주특별자치도,'050004, 48세,2019,12840,6733,6107,110.3,12486,6519,5967,109.3
'39,제주특별자치도,'050005, 49세,2019,12044,6230,5814,107.2,11719,6054,5665,106.9
'39,제주특별자치도,'055,50~54세,2019,55216,28916,26300,109.9,53977,28229,25748,109.6
'39,제주특별자치도,'055001, 50세,2019,11727,6152,5575,110.3,11448,5982,5466,109.4
'39,제주특별자치도,'055002, 51세,2019,11684,6080,5604,108.5,11397,5919,5478,108.1
'39,제주특별자치도,'055003, 52세,2019,10645,5561,5084,109.4,10396,5423,4973,109
'39,제주특별자치도,'055004, 53세,2019,10891,5744,5147,111.6,10676,5641,5035,112
'39,제주특별자치도,'055005, 54세,2019,10269,5379,4890,110,10060,5264,4796,109.8
'39,제주특별자치도,'060,55~59세,2019,51721,26431,25290,104.5,50806,25984,24822,104.7
'39,제주특별자치도,'060001, 55세,2019,10011,5174,4837,107,9814,5092,4722,107.8
'39,제주특별자치도,'060002, 56세,2019,10903,5626,5277,106.6,10675,5514,5161,106.8
'39,제주특별자치도,'060003, 57세,2019,10109,5164,4945,104.4,9924,5069,4855,104.4
'39,제주특별자치도,'060004, 58세,2019,10257,5179,5078,102,10119,5111,5008,102.1
'39,제주특별자치도,'060005, 59세,2019,10441,5288,5153,102.6,10274,5198,5076,102.4
'39,제주특별자치도,'065,60~64세,2019,43485,21772,21713,100.3,42832,21481,21351,100.6
'39,제주특별자치도,'065001, 60세,2019,9534,4779,4755,100.5,9396,4715,4681,100.7
'39,제주특별자치도,'065002, 61세,2019,8844,4483,4361,102.8,8702,4422,4280,103.3
'39,제주특별자치도,'065003, 62세,2019,8711,4389,4322,101.6,8603,4342,4261,101.9
'39,제주특별자치도,'065004, 63세,2019,8113,4044,4069,99.4,7963,3976,3987,99.7
'39,제주특별자치도,'065005, 64세,2019,8283,4077,4206,96.9,8168,4026,4142,97.2
'39,제주특별자치도,'070,65~69세,2019,28149,13592,14557,93.4,27779,13415,14364,93.4
'39,제주특별자치도,'070001, 65세,2019,6602,3267,3335,98,6488,3212,3276,98
'39,제주특별자치도,'070002, 66세,2019,5559,2647,2912,90.9,5485,2606,2879,90.5
'39,제주특별자치도,'070003, 67세,2019,5895,2872,3023,95,5829,2844,2985,95.3
'39,제주특별자치도,'070004, 68세,2019,5071,2470,2601,95,4996,2442,2554,95.6
'39,제주특별자치도,'070005, 69세,2019,5022,2336,2686,87,4981,2311,2670,86.6
'39,제주특별자치도,'075,70~74세,2019,24055,11316,12739,88.8,23874,11227,12647,88.8
'39,제주특별자치도,'075001, 70세,2019,5054,2377,2677,88.8,5002,2358,2644,89.2
'39,제주특별자치도,'075002, 71세,2019,5311,2567,2744,93.5,5272,2548,2724,93.5
'39,제주특별자치도,'075003, 72세,2019,5135,2411,2724,88.5,5094,2388,2706,88.2
'39,제주특별자치도,'075004, 73세,2019,4450,2052,2398,85.6,4424,2038,2386,85.4
'39,제주특별자치도,'075005, 74세,2019,4105,1909,2196,86.9,4082,1895,2187,86.6
'39,제주특별자치도,'080,75~79세,2019,19572,8347,11225,74.4,19496,8310,11186,74.3
'39,제주특별자치도,'080001, 75세,2019,4116,1854,2262,82,4097,1843,2254,81.8
'39,제주특별자치도,'080002, 76세,2019,3885,1688,2197,76.8,3864,1673,2191,76.4
'39,제주특별자치도,'080003, 77세,2019,4185,1802,2383,75.6,4172,1799,2373,75.8
'39,제주특별자치도,'080004, 78세,2019,3941,1644,2297,71.6,3925,1638,2287,71.6
'39,제주특별자치도,'080005, 79세,2019,3445,1359,2086,65.1,3438,1357,2081,65.2
'39,제주특별자치도,'085,80~84세,2019,14187,5118,9069,56.4,14143,5096,9047,56.3
'39,제주특별자치도,'085001, 80세,2019,3378,1304,2074,62.9,3366,1297,2069,62.7
'39,제주특별자치도,'085002, 81세,2019,3112,1178,1934,60.9,3105,1177,1928,61
'39,제주특별자치도,'085003, 82세,2019,2821,1004,1817,55.3,2810,997,1813,55
'39,제주특별자치도,'085004, 83세,2019,2487,850,1637,51.9,2480,847,1633,51.9
'39,제주특별자치도,'085005, 84세,2019,2389,782,1607,48.7,2382,778,1604,48.5
'39,제주특별자치도,'086,85세이상,2019,11507,2528,8979,28.2,11474,2511,8963,28
'39,제주특별자치도,'090,85~89세,2019,8012,2057,5955,34.5,7989,2045,5944,34.4
'39,제주특별자치도,'090001, 85세,2019,2233,686,1547,44.3,2230,683,1547,44.1
'39,제주특별자치도,'090002, 86세,2019,2007,531,1476,36,1998,527,1471,35.8
'39,제주특별자치도,'090003, 87세,2019,1518,364,1154,31.5,1513,363,1150,31.6
'39,제주특별자치도,'090004, 88세,2019,1146,264,882,29.9,1144,263,881,29.9
'39,제주특별자치도,'090005, 89세,2019,1108,212,896,23.7,1104,209,895,23.4
'39,제주특별자치도,'095,90~94세,2019,2416,375,2041,18.4,2409,371,2038,18.2
'39,제주특별자치도,'095001, 90세,2019,851,160,691,23.2,849,158,691,22.9
'39,제주특별자치도,'095002, 91세,2019,592,87,505,17.2,591,86,505,17
'39,제주특별자치도,'095003, 92세,2019,444,59,385,15.3,443,59,384,15.4
'39,제주특별자치도,'095004, 93세,2019,293,43,250,17.2,291,42,249,16.9
'39,제주특별자치도,'095005, 94세,2019,236,26,210,12.4,235,26,209,12.4
'39,제주특별자치도,'100,95~99세,2019,958,88,870,10.1,957,88,869,10.1
'39,제주특별자치도,'100001, 95세,2019,148,21,127,16.5,148,21,127,16.5
'39,제주특별자치도,'100002, 96세,2019,385,27,358,7.5,385,27,358,7.5
'39,제주특별자치도,'100003, 97세,2019,217,25,192,13,217,25,192,13
'39,제주특별자치도,'100004, 98세,2019,134,7,127,5.5,133,7,126,5.6
'39,제주특별자치도,'100005, 99세,2019,74,8,66,12.1,74,8,66,12.1
'39,제주특별자치도,'101,100세이상,2019,121,8,113,7.1,119,7,112,6.3
'39,제주특별자치도,'102,15세미만,2019,96815,50026,46789,106.9,95334,49292,46042,107.1
'39,제주특별자치도,'103,15~64세,2019,470763,245671,225092,109.1,444931,230251,214680,107.3
'39,제주특별자치도,'104,65세이상,2019,97470,40901,56569,72.3,96766,40559,56207,72.2
'39,제주특별자치도,'126,평균연령,2019,41.6,40.3,43,,41.9,40.6,43.2,
'39,제주특별자치도,'127,중위연령,2019,42.7,41.5,44,,43.5,42.4,44.6,
'39004, 읍부,'000,합계,2019,151015,78247,72768,107.5,140712,71403,69309,103
'39004, 읍부,'005,0~4세,2019,5240,2718,2522,107.8,4796,2510,2286,109.8
'39004, 읍부,'005001, 0세,2019,779,380,399,95.2,741,359,382,94
'39004, 읍부,'005002, 1세,2019,916,450,466,96.6,830,415,415,100
'39004, 읍부,'005003, 2세,2019,1056,564,492,114.6,937,515,422,122
'39004, 읍부,'005004, 3세,2019,1198,638,560,113.9,1092,581,511,113.7
'39004, 읍부,'005005, 4세,2019,1291,686,605,113.4,1196,640,556,115.1
'39004, 읍부,'010,5~9세,2019,7013,3693,3320,111.2,6782,3584,3198,112.1
'39004, 읍부,'010001, 5세,2019,1260,649,611,106.2,1196,617,579,106.6
'39004, 읍부,'010002, 6세,2019,1367,713,654,109,1318,688,630,109.2
'39004, 읍부,'010003, 7세,2019,1502,808,694,116.4,1459,793,666,119.1
'39004, 읍부,'010004, 8세,2019,1508,810,698,116,1471,792,679,116.6
'39004, 읍부,'010005, 9세,2019,1376,713,663,107.5,1338,694,644,107.8
'39004, 읍부,'015,10~14세,2019,6642,3445,3197,107.8,6494,3379,3115,108.5
'39004, 읍부,'015001, 10세,2019,1419,726,693,104.8,1384,714,670,106.6
'39004, 읍부,'015002, 11세,2019,1419,715,704,101.6,1388,703,685,102.6
'39004, 읍부,'015003, 12세,2019,1360,681,679,100.3,1333,667,666,100.2
'39004, 읍부,'015004, 13세,2019,1258,687,571,120.3,1231,673,558,120.6
'39004, 읍부,'015005, 14세,2019,1186,636,550,115.6,1158,622,536,116
'39004, 읍부,'020,15~19세,2019,6475,3517,2958,118.9,6264,3393,2871,118.2
'39004, 읍부,'020001, 15세,2019,1293,707,586,120.6,1275,695,580,119.8
'39004, 읍부,'020002, 16세,2019,1274,676,598,113,1246,661,585,113
'39004, 읍부,'020003, 17세,2019,1311,730,581,125.6,1287,717,570,125.8
'39004, 읍부,'020004, 18세,2019,1357,717,640,112,1317,697,620,112.4
'39004, 읍부,'020005, 19세,2019,1240,687,553,124.2,1139,623,516,120.7
'39004, 읍부,'025,20~24세,2019,7687,4610,3077,149.8,6361,3629,2732,132.8
'39004, 읍부,'025001, 20세,2019,1391,833,558,149.3,1229,745,484,153.9
'39004, 읍부,'025002, 21세,2019,1523,903,620,145.6,1315,764,551,138.7
'39004, 읍부,'025003, 22세,2019,1540,941,599,157.1,1298,767,531,144.4
'39004, 읍부,'025004, 23세,2019,1607,967,640,151.1,1274,700,574,122
'39004, 읍부,'025005, 24세,2019,1626,966,660,146.4,1245,653,592,110.3
'39004, 읍부,'030,25~29세,2019,8793,5296,3497,151.4,6709,3650,3059,119.3
'39004, 읍부,'030001, 25세,2019,1749,1101,648,169.9,1331,748,583,128.3
'39004, 읍부,'030002, 26세,2019,1897,1118,779,143.5,1461,775,686,113
'39004, 읍부,'030003, 27세,2019,1776,1088,688,158.1,1357,755,602,125.4
'39004, 읍부,'030004, 28세,2019,1686,998,688,145.1,1294,696,598,116.4
'39004, 읍부,'030005, 29세,2019,1685,991,694,142.8,1266,676,590,114.6
'39004, 읍부,'035,30~34세,2019,8027,4519,3508,128.8,6137,3194,2943,108.5
'39004, 읍부,'035001, 30세,2019,1581,949,632,150.2,1186,663,523,126.8
'39004, 읍부,'035002, 31세,2019,1520,883,637,138.6,1112,594,518,114.7
'39004, 읍부,'035003, 32세,2019,1606,904,702,128.8,1230,641,589,108.8
'39004, 읍부,'035004, 33세,2019,1621,861,760,113.3,1256,626,630,99.4
'39004, 읍부,'035005, 34세,2019,1699,922,777,118.7,1353,670,683,98.1
'39004, 읍부,'040,35~39세,2019,11018,5867,5151,113.9,9575,4891,4684,104.4
'39004, 읍부,'040001, 35세,2019,1851,1008,843,119.6,1558,798,760,105
'39004, 읍부,'040002, 36세,2019,2049,1118,931,120.1,1757,910,847,107.4
'39004, 읍부,'040003, 37세,2019,2367,1280,1087,117.8,2043,1056,987,107
'39004, 읍부,'040004, 38세,2019,2341,1240,1101,112.6,2038,1046,992,105.4
'39004, 읍부,'040005, 39세,2019,2410,1221,1189,102.7,2179,1081,1098,98.5
'39004, 읍부,'045,40~44세,2019,11349,6138,5211,117.8,10435,5591,4844,115.4
'39004, 읍부,'045001, 40세,2019,2377,1234,1143,108,2145,1098,1047,104.9
'39004, 읍부,'045002, 41세,2019,2134,1143,991,115.3,1928,1017,911,111.6
'39004, 읍부,'045003, 42세,2019,2246,1232,1014,121.5,2101,1143,958,119.3
'39004, 읍부,'045004, 43세,2019,2231,1249,982,127.2,2037,1130,907,124.6
'39004, 읍부,'045005, 44세,2019,2361,1280,1081,118.4,2224,1203,1021,117.8
'39004, 읍부,'050,45~49세,2019,13071,7258,5813,124.9,12476,6914,5562,124.3
'39004, 읍부,'050001, 45세,2019,2616,1464,1152,127.1,2472,1385,1087,127.4
'39004, 읍부,'050002, 46세,2019,2479,1371,1108,123.7,2354,1302,1052,123.8
'39004, 읍부,'050003, 47세,2019,2577,1409,1168,120.6,2451,1336,1115,119.8
'39004, 읍부,'050004, 48세,2019,2821,1590,1231,129.2,2717,1522,1195,127.4
'39004, 읍부,'050005, 49세,2019,2578,1424,1154,123.4,2482,1369,1113,123
'39004, 읍부,'055,50~54세,2019,12581,6832,5749,118.8,12196,6623,5573,118.8
'39004, 읍부,'055001, 50세,2019,2583,1404,1179,119.1,2493,1352,1141,118.5
'39004, 읍부,'055002, 51세,2019,2662,1429,1233,115.9,2574,1384,1190,116.3
'39004, 읍부,'055003, 52세,2019,2394,1319,1075,122.7,2319,1276,1043,122.3
'39004, 읍부,'055004, 53세,2019,2522,1363,1159,117.6,2450,1328,1122,118.4
'39004, 읍부,'055005, 54세,2019,2420,1317,1103,119.4,2360,1283,1077,119.1
'39004, 읍부,'060,55~59세,2019,12601,6586,6015,109.5,12334,6457,5877,109.9
'39004, 읍부,'060001, 55세,2019,2414,1313,1101,119.3,2351,1290,1061,121.6
'39004, 읍부,'060002, 56세,2019,2618,1381,1237,111.6,2557,1351,1206,112
'39004, 읍부,'060003, 57세,2019,2487,1268,1219,104,2433,1242,1191,104.3
'39004, 읍부,'060004, 58세,2019,2451,1268,1183,107.2,2419,1251,1168,107.1
'39004, 읍부,'060005, 59세,2019,2631,1356,1275,106.4,2574,1323,1251,105.8
'39004, 읍부,'065,60~64세,2019,11066,5697,5369,106.1,10897,5627,5270,106.8
'39004, 읍부,'065001, 60세,2019,2392,1238,1154,107.3,2358,1221,1137,107.4
'39004, 읍부,'065002, 61세,2019,2241,1181,1060,111.4,2205,1168,1037,112.6
'39004, 읍부,'065003, 62세,2019,2243,1167,1076,108.5,2212,1155,1057,109.3
'39004, 읍부,'065004, 63세,2019,2027,1036,991,104.5,1988,1018,970,104.9
'39004, 읍부,'065005, 64세,2019,2163,1075,1088,98.8,2134,1065,1069,99.6
'39004, 읍부,'070,65~69세,2019,7441,3647,3794,96.1,7335,3587,3748,95.7
'39004, 읍부,'070001, 65세,2019,1733,888,845,105.1,1690,866,824,105.1
'39004, 읍부,'070002, 66세,2019,1450,709,741,95.7,1428,693,735,94.3
'39004, 읍부,'070003, 67세,2019,1594,773,821,94.2,1581,766,815,94
'39004, 읍부,'070004, 68세,2019,1373,691,682,101.3,1356,683,673,101.5
'39004, 읍부,'070005, 69세,2019,1291,586,705,83.1,1280,579,701,82.6
'39004, 읍부,'075,70~74세,2019,6913,3298,3615,91.2,6862,3267,3595,90.9
'39004, 읍부,'075001, 70세,2019,1438,694,744,93.3,1422,687,735,93.5
'39004, 읍부,'075002, 71세,2019,1454,712,742,96,1445,708,737,96.1
'39004, 읍부,'075003, 72세,2019,1471,725,746,97.2,1457,715,742,96.4
'39004, 읍부,'075004, 73세,2019,1345,617,728,84.8,1339,611,728,83.9
'39004, 읍부,'075005, 74세,2019,1205,550,655,84,1199,546,653,83.6
'39004, 읍부,'080,75~79세,2019,6153,2550,3603,70.8,6136,2540,3596,70.6
'39004, 읍부,'080001, 75세,2019,1199,521,678,76.8,1194,516,678,76.1
'39004, 읍부,'080002, 76세,2019,1201,504,697,72.3,1197,500,697,71.7
'39004, 읍부,'080003, 77세,2019,1296,564,732,77,1292,564,728,77.5
'39004, 읍부,'080004, 78세,2019,1286,527,759,69.4,1283,526,757,69.5
'39004, 읍부,'080005, 79세,2019,1171,434,737,58.9,1170,434,736,59
'39004, 읍부,'085,80~84세,2019,4862,1690,3172,53.3,4849,1686,3163,53.3
'39004, 읍부,'085001, 80세,2019,1168,450,718,62.7,1166,450,716,62.8
'39004, 읍부,'085002, 81세,2019,1091,390,701,55.6,1087,389,698,55.7
'39004, 읍부,'085003, 82세,2019,947,325,622,52.3,942,323,619,52.2
'39004, 읍부,'085004, 83세,2019,854,275,579,47.5,853,274,579,47.3
'39004, 읍부,'085005, 84세,2019,802,250,552,45.3,801,250,551,45.4
'39004, 읍부,'086,85세이상,2019,4083,886,3197,27.7,4074,881,3193,27.6
'39004, 읍부,'090,85~89세,2019,2884,710,2174,32.7,2879,706,2173,32.5
'39004, 읍부,'090001, 85세,2019,788,227,561,40.5,786,225,561,40.1
'39004, 읍부,'090002, 86세,2019,734,193,541,35.7,731,191,540,35.4
'39004, 읍부,'090003, 87세,2019,581,128,453,28.3,581,128,453,28.3
'39004, 읍부,'090004, 88세,2019,389,86,303,28.4,389,86,303,28.4
'39004, 읍부,'090005, 89세,2019,392,76,316,24.1,392,76,316,24.1
'39004, 읍부,'095,90~94세,2019,822,139,683,20.4,820,138,682,20.2
'39004, 읍부,'095001, 90세,2019,288,55,233,23.6,288,55,233,23.6
'39004, 읍부,'095002, 91세,2019,201,37,164,22.6,201,37,164,22.6
'39004, 읍부,'095003, 92세,2019,162,18,144,12.5,161,18,143,12.6
'39004, 읍부,'095004, 93세,2019,88,20,68,29.4,87,19,68,27.9
'39004, 읍부,'095005, 94세,2019,83,9,74,12.2,83,9,74,12.2
'39004, 읍부,'100,95~99세,2019,332,35,297,11.8,331,35,296,11.8
'39004, 읍부,'100001, 95세,2019,41,7,34,20.6,41,7,34,20.6
'39004, 읍부,'100002, 96세,2019,136,11,125,8.8,136,11,125,8.8
'39004, 읍부,'100003, 97세,2019,74,11,63,17.5,74,11,63,17.5
'39004, 읍부,'100004, 98세,2019,50,X,47,6.4,49,X,46,6.5
'39004, 읍부,'100005, 99세,2019,31,X,28,10.7,31,X,28,10.7
'39004, 읍부,'101,100세이상,2019,45,X,43,4.7,44,X,42,4.8
'39004, 읍부,'102,15세미만,2019,18895,9856,9039,109,18072,9473,8599,110.2
'39004, 읍부,'103,15~64세,2019,102668,56320,46348,121.5,93384,49969,43415,115.1
'39004, 읍부,'104,65세이상,2019,29452,12071,17381,69.4,29256,11961,17295,69.2
'39004, 읍부,'126,평균연령,2019,44.9,42.9,47,,45.7,43.9,47.7,
'39004, 읍부,'127,중위연령,2019,46.3,44.5,48.4,,47.8,46.4,49.4,
'39005, 면부,'000,합계,2019,35474,18405,17069,107.8,33342,16987,16355,103.9
'39005, 면부,'005,0~4세,2019,1014,474,540,87.8,1000,466,534,87.3
'39005, 면부,'005001, 0세,2019,173,92,81,113.6,169,90,79,113.9
'39005, 면부,'005002, 1세,2019,179,77,102,75.5,177,75,102,73.5
'39005, 면부,'005003, 2세,2019,199,93,106,87.7,197,92,105,87.6
'39005, 면부,'005004, 3세,2019,221,97,124,78.2,219,96,123,78
'39005, 면부,'005005, 4세,2019,242,115,127,90.6,238,113,125,90.4
'39005, 면부,'010,5~9세,2019,1360,739,621,119,1346,731,615,118.9
'39005, 면부,'010001, 5세,2019,242,140,102,137.3,238,136,102,133.3
'39005, 면부,'010002, 6세,2019,252,141,111,127,251,140,111,126.1
'39005, 면부,'010003, 7세,2019,284,142,142,100,281,140,141,99.3
'39005, 면부,'010004, 8세,2019,297,158,139,113.7,293,157,136,115.4
'39005, 면부,'010005, 9세,2019,285,158,127,124.4,283,158,125,126.4
'39005, 면부,'015,10~14세,2019,1230,638,592,107.8,1210,632,578,109.3
'39005, 면부,'015001, 10세,2019,260,131,129,101.6,255,129,126,102.4
'39005, 면부,'015002, 11세,2019,271,137,134,102.2,264,136,128,106.3
'39005, 면부,'015003, 12세,2019,260,145,115,126.1,259,145,114,127.2
'39005, 면부,'015004, 13세,2019,210,119,91,130.8,206,116,90,128.9
'39005, 면부,'015005, 14세,2019,229,106,123,86.2,226,106,120,88.3
'39005, 면부,'020,15~19세,2019,1202,645,557,115.8,1165,627,538,116.5
'39005, 면부,'020001, 15세,2019,223,124,99,125.3,218,124,94,131.9
'39005, 면부,'020002, 16세,2019,209,101,108,93.5,203,98,105,93.3
'39005, 면부,'020003, 17세,2019,236,138,98,140.8,230,134,96,139.6
'39005, 면부,'020004, 18세,2019,274,143,131,109.2,264,139,125,111.2
'39005, 면부,'020005, 19세,2019,260,139,121,114.9,250,132,118,111.9
'39005, 면부,'025,20~24세,2019,1806,999,807,123.8,1528,824,704,117
'39005, 면부,'025001, 20세,2019,290,169,121,139.7,270,158,112,141.1
'39005, 면부,'025002, 21세,2019,341,194,147,132,295,169,126,134.1
'39005, 면부,'025003, 22세,2019,334,169,165,102.4,277,139,138,100.7
'39005, 면부,'025004, 23세,2019,421,235,186,126.3,336,178,158,112.7
'39005, 면부,'025005, 24세,2019,420,232,188,123.4,350,180,170,105.9
'39005, 면부,'030,25~29세,2019,2160,1270,890,142.7,1749,952,797,119.4
'39005, 면부,'030001, 25세,2019,446,278,168,165.5,367,213,154,138.3
'39005, 면부,'030002, 26세,2019,466,268,198,135.4,381,200,181,110.5
'39005, 면부,'030003, 27세,2019,433,263,170,154.7,355,207,148,139.9
'39005, 면부,'030004, 28세,2019,413,236,177,133.3,332,171,161,106.2
'39005, 면부,'030005, 29세,2019,402,225,177,127.1,314,161,153,105.2
'39005, 면부,'035,30~34세,2019,1798,1035,763,135.6,1366,734,632,116.1
'39005, 면부,'035001, 30세,2019,360,201,159,126.4,278,148,130,113.8
'39005, 면부,'035002, 31세,2019,347,205,142,144.4,253,138,115,120
'39005, 면부,'035003, 32세,2019,325,197,128,153.9,235,130,105,123.8
'39005, 면부,'035004, 33세,2019,365,207,158,131,281,150,131,114.5
'39005, 면부,'035005, 34세,2019,401,225,176,127.8,319,168,151,111.3
'39005, 면부,'040,35~39세,2019,2295,1280,1015,126.1,1965,1052,913,115.2
'39005, 면부,'040001, 35세,2019,378,213,165,129.1,302,165,137,120.4
'39005, 면부,'040002, 36세,2019,449,253,196,129.1,381,205,176,116.5
'39005, 면부,'040003, 37세,2019,466,263,203,129.6,402,217,185,117.3
'39005, 면부,'040004, 38세,2019,494,267,227,117.6,444,233,211,110.4
'39005, 면부,'040005, 39세,2019,508,284,224,126.8,436,232,204,113.7
'39005, 면부,'045,40~44세,2019,2540,1458,1082,134.8,2312,1317,995,132.4
'39005, 면부,'045001, 40세,2019,533,280,253,110.7,477,241,236,102.1
'39005, 면부,'045002, 41세,2019,476,283,193,146.6,430,255,175,145.7
'39005, 면부,'045003, 42세,2019,520,293,227,129.1,477,266,211,126.1
'39005, 면부,'045004, 43세,2019,521,303,218,139,476,280,196,142.9
'39005, 면부,'045005, 44세,2019,490,299,191,156.5,452,275,177,155.4
'39005, 면부,'050,45~49세,2019,3034,1782,1252,142.3,2887,1684,1203,140
'39005, 면부,'050001, 45세,2019,603,371,232,159.9,567,347,220,157.7
'39005, 면부,'050002, 46세,2019,580,344,236,145.8,555,327,228,143.4
'39005, 면부,'050003, 47세,2019,597,354,243,145.7,565,332,233,142.5
'39005, 면부,'050004, 48세,2019,650,368,282,130.5,625,347,278,124.8
'39005, 면부,'050005, 49세,2019,604,345,259,133.2,575,331,244,135.7
'39005, 면부,'055,50~54세,2019,3060,1684,1376,122.4,2949,1624,1325,122.6
'39005, 면부,'055001, 50세,2019,608,339,269,126,583,326,257,126.8
'39005, 면부,'055002, 51세,2019,674,375,299,125.4,647,360,287,125.4
'39005, 면부,'055003, 52세,2019,573,298,275,108.4,549,282,267,105.6
'39005, 면부,'055004, 53세,2019,600,339,261,129.9,584,332,252,131.7
'39005, 면부,'055005, 54세,2019,605,333,272,122.4,586,324,262,123.7
'39005, 면부,'060,55~59세,2019,3084,1667,1417,117.6,3027,1639,1388,118.1
'39005, 면부,'060001, 55세,2019,551,307,244,125.8,548,307,241,127.4
'39005, 면부,'060002, 56세,2019,690,384,306,125.5,672,373,299,124.7
'39005, 면부,'060003, 57세,2019,617,327,290,112.8,595,316,279,113.3
'39005, 면부,'060004, 58세,2019,623,327,296,110.5,617,324,293,110.6
'39005, 면부,'060005, 59세,2019,603,322,281,114.6,595,319,276,115.6
'39005, 면부,'065,60~64세,2019,2944,1491,1453,102.6,2911,1474,1437,102.6
'39005, 면부,'065001, 60세,2019,615,311,304,102.3,608,310,298,104
'39005, 면부,'065002, 61세,2019,611,315,296,106.4,602,307,295,104.1
'39005, 면부,'065003, 62세,2019,610,310,300,103.3,605,309,296,104.4
'39005, 면부,'065004, 63세,2019,568,283,285,99.3,559,279,280,99.6
'39005, 면부,'065005, 64세,2019,540,272,268,101.5,537,269,268,100.4
'39005, 면부,'070,65~69세,2019,2061,1012,1049,96.5,2048,1006,1042,96.5
'39005, 면부,'070001, 65세,2019,478,223,255,87.5,474,221,253,87.4
'39005, 면부,'070002, 66세,2019,388,189,199,95,385,187,198,94.4
'39005, 면부,'070003, 67세,2019,420,211,209,101,417,210,207,101.4
'39005, 면부,'070004, 68세,2019,383,203,180,112.8,382,203,179,113.4
'39005, 면부,'070005, 69세,2019,392,186,206,90.3,390,185,205,90.2
'39005, 면부,'075,70~74세,2019,1848,907,941,96.4,1847,906,941,96.3
'39005, 면부,'075001, 70세,2019,389,189,200,94.5,389,189,200,94.5
'39005, 면부,'075002, 71세,2019,431,221,210,105.2,431,221,210,105.2
'39005, 면부,'075003, 72세,2019,373,179,194,92.3,373,179,194,92.3
'39005, 면부,'075004, 73세,2019,353,174,179,97.2,353,174,179,97.2
'39005, 면부,'075005, 74세,2019,302,144,158,91.1,301,143,158,90.5
'39005, 면부,'080,75~79세,2019,1695,694,1001,69.3,1691,691,1000,69.1
'39005, 면부,'080001, 75세,2019,348,145,203,71.4,348,145,203,71.4
'39005, 면부,'080002, 76세,2019,323,128,195,65.6,323,128,195,65.6
'39005, 면부,'080003, 77세,2019,363,164,199,82.4,360,162,198,81.8
'39005, 면부,'080004, 78세,2019,367,146,221,66.1,367,146,221,66.1
'39005, 면부,'080005, 79세,2019,294,111,183,60.7,293,110,183,60.1
'39005, 면부,'085,80~84세,2019,1346,442,904,48.9,1344,440,904,48.7
'39005, 면부,'085001, 80세,2019,315,108,207,52.2,313,106,207,51.2
'39005, 면부,'085002, 81세,2019,305,92,213,43.2,305,92,213,43.2
'39005, 면부,'085003, 82세,2019,256,78,178,43.8,256,78,178,43.8
'39005, 면부,'085004, 83세,2019,240,85,155,54.8,240,85,155,54.8
'39005, 면부,'085005, 84세,2019,230,79,151,52.3,230,79,151,52.3
'39005, 면부,'086,85세이상,2019,997,188,809,23.2,997,188,809,23.2
'39005, 면부,'090,85~89세,2019,713,157,556,28.2,713,157,556,28.2
'39005, 면부,'090001, 85세,2019,202,46,156,29.5,202,46,156,29.5
'39005, 면부,'090002, 86세,2019,180,45,135,33.3,180,45,135,33.3
'39005, 면부,'090003, 87세,2019,137,33,104,31.7,137,33,104,31.7
'39005, 면부,'090004, 88세,2019,108,18,90,20,108,18,90,20
'39005, 면부,'090005, 89세,2019,86,15,71,21.1,86,15,71,21.1
'39005, 면부,'095,90~94세,2019,192,28,164,17.1,192,28,164,17.1
'39005, 면부,'095001, 90세,2019,79,17,62,27.4,79,17,62,27.4
'39005, 면부,'095002, 91세,2019,39,5,34,14.7,39,5,34,14.7
'39005, 면부,'095003, 92세,2019,35,X,32,9.4,35,X,32,9.4
'39005, 면부,'095004, 93세,2019,21,X,19,10.5,21,X,19,10.5
'39005, 면부,'095005, 94세,2019,18,X,17,5.9,18,X,17,5.9
'39005, 면부,'100,95~99세,2019,82,X,80,2.5,82,X,80,2.5
'39005, 면부,'100001, 95세,2019,12,X,12,0,12,X,12,0
'39005, 면부,'100002, 96세,2019,40,X,39,2.6,40,X,39,2.6
'39005, 면부,'100003, 97세,2019,16,X,15,6.7,16,X,15,6.7
'39005, 면부,'100004, 98세,2019,8,X,8,0,8,X,8,0
'39005, 면부,'100005, 99세,2019,6,X,6,0,6,X,6,0
'39005, 면부,'101,100세이상,2019,10,X,9,11.1,10,X,9,11.1
'39005, 면부,'102,15세미만,2019,3604,1851,1753,105.6,3556,1829,1727,105.9
'39005, 면부,'103,15~64세,2019,23923,13311,10612,125.4,21859,11927,9932,120.1
'39005, 면부,'104,65세이상,2019,7947,3243,4704,68.9,7927,3231,4696,68.8
'39005, 면부,'126,평균연령,2019,47.1,45.1,49.3,,47.9,46,49.9,
'39005, 면부,'127,중위연령,2019,48.8,46.9,51.5,,50.2,48.4,52.5,
'39003, 동부,'000,합계,2019,478559,239946,238613,100.6,462977,231712,231265,100.2
'39003, 동부,'005,0~4세,2019,21665,11169,10496,106.4,21396,11038,10358,106.6
'39003, 동부,'005001, 0세,2019,3677,1877,1800,104.3,3623,1846,1777,103.9
'39003, 동부,'005002, 1세,2019,3995,2082,1913,108.8,3941,2055,1886,109
'39003, 동부,'005003, 2세,2019,4288,2210,2078,106.4,4224,2180,2044,106.7
'39003, 동부,'005004, 3세,2019,4757,2474,2283,108.4,4704,2447,2257,108.4
'39003, 동부,'005005, 4세,2019,4948,2526,2422,104.3,4904,2510,2394,104.8
'39003, 동부,'010,5~9세,2019,26602,13599,13003,104.6,26407,13478,12929,104.2
'39003, 동부,'010001, 5세,2019,5125,2612,2513,103.9,5070,2577,2493,103.4
'39003, 동부,'010002, 6세,2019,5122,2603,2519,103.3,5077,2570,2507,102.5
'39003, 동부,'010003, 7세,2019,5621,2829,2792,101.3,5591,2811,2780,101.1
'39003, 동부,'010004, 8세,2019,5453,2777,2676,103.8,5424,2763,2661,103.8
'39003, 동부,'010005, 9세,2019,5281,2778,2503,111,5245,2757,2488,110.8
'39003, 동부,'015,10~14세,2019,26049,13551,12498,108.4,25903,13474,12429,108.4
'39003, 동부,'015001, 10세,2019,5078,2633,2445,107.7,5031,2608,2423,107.6
'39003, 동부,'015002, 11세,2019,5284,2732,2552,107.1,5252,2715,2537,107
'39003, 동부,'015003, 12세,2019,5635,2903,2732,106.3,5618,2894,2724,106.2
'39003, 동부,'015004, 13세,2019,5068,2598,2470,105.2,5047,2590,2457,105.4
'39003, 동부,'015005, 14세,2019,4984,2685,2299,116.8,4955,2667,2288,116.6
'39003, 동부,'020,15~19세,2019,27443,14371,13072,109.9,27013,14145,12868,109.9
'39003, 동부,'020001, 15세,2019,5302,2766,2536,109.1,5286,2757,2529,109
'39003, 동부,'020002, 16세,2019,5443,2841,2602,109.2,5421,2831,2590,109.3
'39003, 동부,'020003, 17세,2019,5278,2762,2516,109.8,5251,2748,2503,109.8
'39003, 동부,'020004, 18세,2019,5776,3033,2743,110.6,5695,3000,2695,111.3
'39003, 동부,'020005, 19세,2019,5644,2969,2675,111,5360,2809,2551,110.1
'39003, 동부,'025,20~24세,2019,30188,16339,13849,118,27841,14961,12880,116.2
'39003, 동부,'025001, 20세,2019,5583,3152,2431,129.7,5245,2961,2284,129.6
'39003, 동부,'025002, 21세,2019,5972,3328,2644,125.9,5494,3054,2440,125.2
'39003, 동부,'025003, 22세,2019,6069,3255,2814,115.7,5591,2974,2617,113.6
'39003, 동부,'025004, 23세,2019,6111,3261,2850,114.4,5573,2930,2643,110.9
'39003, 동부,'025005, 24세,2019,6453,3343,3110,107.5,5938,3042,2896,105
'39003, 동부,'030,25~29세,2019,31662,16575,15087,109.9,29025,15043,13982,107.6
'39003, 동부,'030001, 25세,2019,6560,3432,3128,109.7,6036,3126,2910,107.4
'39003, 동부,'030002, 26세,2019,6590,3429,3161,108.5,6092,3122,2970,105.1
'39003, 동부,'030003, 27세,2019,6560,3500,3060,114.4,6051,3195,2856,111.9
'39003, 동부,'030004, 28세,2019,6101,3171,2930,108.2,5589,2885,2704,106.7
'39003, 동부,'030005, 29세,2019,5851,3043,2808,108.4,5257,2715,2542,106.8
'39003, 동부,'035,30~34세,2019,28815,14648,14167,103.4,26204,13301,12903,103.1
'39003, 동부,'035001, 30세,2019,5597,2800,2797,100.1,5028,2509,2519,99.6
'39003, 동부,'035002, 31세,2019,5420,2777,2643,105.1,4868,2487,2381,104.5
'39003, 동부,'035003, 32세,2019,5805,2932,2873,102.1,5227,2650,2577,102.8
'39003, 동부,'035004, 33세,2019,5816,2995,2821,106.2,5331,2739,2592,105.7
'39003, 동부,'035005, 34세,2019,6177,3144,3033,103.7,5750,2916,2834,102.9
'39003, 동부,'040,35~39세,2019,38758,19486,19272,101.1,36668,18464,18204,101.4
'39003, 동부,'040001, 35세,2019,6596,3294,3302,99.8,6155,3069,3086,99.4
'39003, 동부,'040002, 36세,2019,7335,3643,3692,98.7,6939,3463,3476,99.6
'39003, 동부,'040003, 37세,2019,8360,4199,4161,100.9,7883,3966,3917,101.3
'39003, 동부,'040004, 38세,2019,8232,4182,4050,103.3,7841,3980,3861,103.1
'39003, 동부,'040005, 39세,2019,8235,4168,4067,102.5,7850,3986,3864,103.2
'39003, 동부,'045,40~44세,2019,37675,19022,18653,102,36172,18333,17839,102.8
'39003, 동부,'045001, 40세,2019,8135,4053,4082,99.3,7750,3870,3880,99.7
'39003, 동부,'045002, 41세,2019,7015,3481,3534,98.5,6678,3327,3351,99.3
'39003, 동부,'045003, 42세,2019,7509,3780,3729,101.4,7212,3643,3569,102.1
'39003, 동부,'045004, 43세,2019,7350,3795,3555,106.8,7101,3685,3416,107.9
'39003, 동부,'045005, 44세,2019,7666,3913,3753,104.3,7431,3808,3623,105.1
'39003, 동부,'050,45~49세,2019,44545,22437,22108,101.5,43464,21858,21606,101.2
'39003, 동부,'050001, 45세,2019,8638,4377,4261,102.7,8409,4269,4140,103.1
'39003, 동부,'050002, 46세,2019,8707,4315,4392,98.2,8478,4192,4286,97.8
'39003, 동부,'050003, 47세,2019,8969,4509,4460,101.1,8771,4393,4378,100.3
'39003, 동부,'050004, 48세,2019,9369,4775,4594,103.9,9144,4650,4494,103.5
'39003, 동부,'050005, 49세,2019,8862,4461,4401,101.4,8662,4354,4308,101.1
'39003, 동부,'055,50~54세,2019,39575,20400,19175,106.4,38832,19982,18850,106
'39003, 동부,'055001, 50세,2019,8536,4409,4127,106.8,8372,4304,4068,105.8
'39003, 동부,'055002, 51세,2019,8348,4276,4072,105,8176,4175,4001,104.3
'39003, 동부,'055003, 52세,2019,7678,3944,3734,105.6,7528,3865,3663,105.5
'39003, 동부,'055004, 53세,2019,7769,4042,3727,108.5,7642,3981,3661,108.7
'39003, 동부,'055005, 54세,2019,7244,3729,3515,106.1,7114,3657,3457,105.8
'39003, 동부,'060,55~59세,2019,36036,18178,17858,101.8,35445,17888,17557,101.9
'39003, 동부,'060001, 55세,2019,7046,3554,3492,101.8,6915,3495,3420,102.2
'39003, 동부,'060002, 56세,2019,7595,3861,3734,103.4,7446,3790,3656,103.7
'39003, 동부,'060003, 57세,2019,7005,3569,3436,103.9,6896,3511,3385,103.7
'39003, 동부,'060004, 58세,2019,7183,3584,3599,99.6,7083,3536,3547,99.7
'39003, 동부,'060005, 59세,2019,7207,3610,3597,100.4,7105,3556,3549,100.2
'39003, 동부,'065,60~64세,2019,29475,14584,14891,97.9,29024,14380,14644,98.2
'39003, 동부,'065001, 60세,2019,6527,3230,3297,98,6430,3184,3246,98.1
'39003, 동부,'065002, 61세,2019,5992,2987,3005,99.4,5895,2947,2948,100
'39003, 동부,'065003, 62세,2019,5858,2912,2946,98.8,5786,2878,2908,99
'39003, 동부,'065004, 63세,2019,5518,2725,2793,97.6,5416,2679,2737,97.9
'39003, 동부,'065005, 64세,2019,5580,2730,2850,95.8,5497,2692,2805,96
'39003, 동부,'070,65~69세,2019,18647,8933,9714,92,18396,8822,9574,92.1
'39003, 동부,'070001, 65세,2019,4391,2156,2235,96.5,4324,2125,2199,96.6
'39003, 동부,'070002, 66세,2019,3721,1749,1972,88.7,3672,1726,1946,88.7
'39003, 동부,'070003, 67세,2019,3881,1888,1993,94.7,3831,1868,1963,95.2
'39003, 동부,'070004, 68세,2019,3315,1576,1739,90.6,3258,1556,1702,91.4
'39003, 동부,'070005, 69세,2019,3339,1564,1775,88.1,3311,1547,1764,87.7
'39003, 동부,'075,70~74세,2019,15294,7111,8183,86.9,15165,7054,8111,87
'39003, 동부,'075001, 70세,2019,3227,1494,1733,86.2,3191,1482,1709,86.7
'39003, 동부,'075002, 71세,2019,3426,1634,1792,91.2,3396,1619,1777,91.1
'39003, 동부,'075003, 72세,2019,3291,1507,1784,84.5,3264,1494,1770,84.4
'39003, 동부,'075004, 73세,2019,2752,1261,1491,84.6,2732,1253,1479,84.7
'39003, 동부,'075005, 74세,2019,2598,1215,1383,87.9,2582,1206,1376,87.6
'39003, 동부,'080,75~79세,2019,11724,5103,6621,77.1,11669,5079,6590,77.1
'39003, 동부,'080001, 75세,2019,2569,1188,1381,86,2555,1182,1373,86.1
'39003, 동부,'080002, 76세,2019,2361,1056,1305,80.9,2344,1045,1299,80.4
'39003, 동부,'080003, 77세,2019,2526,1074,1452,74,2520,1073,1447,74.2
'39003, 동부,'080004, 78세,2019,2288,971,1317,73.7,2275,966,1309,73.8
'39003, 동부,'080005, 79세,2019,1980,814,1166,69.8,1975,813,1162,70
'39003, 동부,'085,80~84세,2019,7979,2986,4993,59.8,7950,2970,4980,59.6
'39003, 동부,'085001, 80세,2019,1895,746,1149,64.9,1887,741,1146,64.7
'39003, 동부,'085002, 81세,2019,1716,696,1020,68.2,1713,696,1017,68.4
'39003, 동부,'085003, 82세,2019,1618,601,1017,59.1,1612,596,1016,58.7
'39003, 동부,'085004, 83세,2019,1393,490,903,54.3,1387,488,899,54.3
'39003, 동부,'085005, 84세,2019,1357,453,904,50.1,1351,449,902,49.8
'39003, 동부,'086,85세이상,2019,6427,1454,4973,29.2,6403,1442,4961,29.1
'39003, 동부,'090,85~89세,2019,4415,1190,3225,36.9,4397,1182,3215,36.8
'39003, 동부,'090001, 85세,2019,1243,413,830,49.8,1242,412,830,49.6
'39003, 동부,'090002, 86세,2019,1093,293,800,36.6,1087,291,796,36.6
'39003, 동부,'090003, 87세,2019,800,203,597,34,795,202,593,34.1
'39003, 동부,'090004, 88세,2019,649,160,489,32.7,647,159,488,32.6
'39003, 동부,'090005, 89세,2019,630,121,509,23.8,626,118,508,23.2
'39003, 동부,'095,90~94세,2019,1402,208,1194,17.4,1397,205,1192,17.2
'39003, 동부,'095001, 90세,2019,484,88,396,22.2,482,86,396,21.7
'39003, 동부,'095002, 91세,2019,352,45,307,14.7,351,44,307,14.3
'39003, 동부,'095003, 92세,2019,247,38,209,18.2,247,38,209,18.2
'39003, 동부,'095004, 93세,2019,184,21,163,12.9,183,21,162,13
'39003, 동부,'095005, 94세,2019,135,16,119,13.4,134,16,118,13.6
'39003, 동부,'100,95~99세,2019,544,51,493,10.3,544,51,493,10.3
'39003, 동부,'100001, 95세,2019,95,14,81,17.3,95,14,81,17.3
'39003, 동부,'100002, 96세,2019,209,15,194,7.7,209,15,194,7.7
'39003, 동부,'100003, 97세,2019,127,13,114,11.4,127,13,114,11.4
'39003, 동부,'100004, 98세,2019,76,X,72,5.6,76,X,72,5.6
'39003, 동부,'100005, 99세,2019,37,5,32,15.6,37,5,32,15.6
'39003, 동부,'101,100세이상,2019,66,5,61,8.2,65,X,61,6.6
'39003, 동부,'102,15세미만,2019,74316,38319,35997,106.5,73706,37990,35716,106.4
'39003, 동부,'103,15~64세,2019,344172,176040,168132,104.7,329688,168355,161333,104.4
'39003, 동부,'104,65세이상,2019,60071,25587,34484,74.2,59583,25367,34216,74.1
'39003, 동부,'126,평균연령,2019,40.1,39.1,41.3,,40.3,39.2,41.4,
'39003, 동부,'127,중위연령,2019,41,40.1,42.1,,41.5,40.5,42.5,
'39010, 제주시,'000,합계,2019,487688,246161,241527,101.9,468634,235226,233408,100.8
'39010, 제주시,'005,0~4세,2019,21039,10859,10180,106.7,20727,10700,10027,106.7
'39010, 제주시,'005001, 0세,2019,3576,1792,1784,100.4,3513,1755,1758,99.8
'39010, 제주시,'005002, 1세,2019,3888,2017,1871,107.8,3825,1981,1844,107.4
'39010, 제주시,'005003, 2세,2019,4121,2149,1972,109,4056,2117,1939,109.2
'39010, 제주시,'005004, 3세,2019,4607,2397,2210,108.5,4544,2368,2176,108.8
'39010, 제주시,'005005, 4세,2019,4847,2504,2343,106.9,4789,2479,2310,107.3
'39010, 제주시,'010,5~9세,2019,26422,13621,12801,106.4,26211,13499,12712,106.2
'39010, 제주시,'010001, 5세,2019,5084,2611,2473,105.6,5021,2575,2446,105.3
'39010, 제주시,'010002, 6세,2019,5128,2658,2470,107.6,5078,2624,2454,106.9
'39010, 제주시,'010003, 7세,2019,5609,2841,2768,102.6,5575,2823,2752,102.6
'39010, 제주시,'010004, 8세,2019,5416,2770,2646,104.7,5389,2758,2631,104.8
'39010, 제주시,'010005, 9세,2019,5185,2741,2444,112.2,5148,2719,2429,111.9
'39010, 제주시,'015,10~14세,2019,25507,13286,12221,108.7,25349,13202,12147,108.7
'39010, 제주시,'015001, 10세,2019,5081,2650,2431,109,5036,2627,2409,109
'39010, 제주시,'015002, 11세,2019,5137,2639,2498,105.6,5101,2620,2481,105.6
'39010, 제주시,'015003, 12세,2019,5476,2822,2654,106.3,5452,2810,2642,106.4
'39010, 제주시,'015004, 13세,2019,4944,2551,2393,106.6,4921,2541,2380,106.8
'39010, 제주시,'015005, 14세,2019,4869,2624,2245,116.9,4839,2604,2235,116.5
'39010, 제주시,'020,15~19세,2019,27168,14328,12840,111.6,26622,14024,12598,111.3
'39010, 제주시,'020001, 15세,2019,5192,2725,2467,110.5,5168,2707,2461,110
'39010, 제주시,'020002, 16세,2019,5359,2779,2580,107.7,5329,2767,2562,108
'39010, 제주시,'020003, 17세,2019,5158,2759,2399,115,5119,2739,2380,115.1
'39010, 제주시,'020004, 18세,2019,5712,2981,2731,109.2,5606,2934,2672,109.8
'39010, 제주시,'020005, 19세,2019,5747,3084,2663,115.8,5400,2877,2523,114
'39010, 제주시,'025,20~24세,2019,31017,17040,13977,121.9,27984,15137,12847,117.8
'39010, 제주시,'025001, 20세,2019,5763,3248,2515,129.1,5308,2996,2312,129.6
'39010, 제주시,'025002, 21세,2019,6218,3473,2745,126.5,5624,3116,2508,124.2
'39010, 제주시,'025003, 22세,2019,6226,3416,2810,121.6,5627,3045,2582,117.9
'39010, 제주시,'025004, 23세,2019,6309,3413,2896,117.9,5620,2950,2670,110.5
'39010, 제주시,'025005, 24세,2019,6501,3490,3011,115.9,5805,3030,2775,109.2
'39010, 제주시,'030,25~29세,2019,32281,17382,14899,116.7,28737,15076,13661,110.4
'39010, 제주시,'030001, 25세,2019,6698,3648,3050,119.6,5973,3155,2818,112
'39010, 제주시,'030002, 26세,2019,6812,3621,3191,113.5,6102,3146,2956,106.4
'39010, 제주시,'030003, 27세,2019,6657,3659,2998,122,5966,3209,2757,116.4
'39010, 제주시,'030004, 28세,2019,6190,3303,2887,114.4,5529,2892,2637,109.7
'39010, 제주시,'030005, 29세,2019,5924,3151,2773,113.6,5167,2674,2493,107.3
'39010, 제주시,'035,30~34세,2019,29164,15117,14047,107.6,25872,13223,12649,104.5
'39010, 제주시,'035001, 30세,2019,5633,2918,2715,107.5,4922,2511,2411,104.1
'39010, 제주시,'035002, 31세,2019,5496,2849,2647,107.6,4809,2446,2363,103.5
'39010, 제주시,'035003, 32세,2019,5897,3051,2846,107.2,5178,2654,2524,105.2
'39010, 제주시,'035004, 33세,2019,5900,3070,2830,108.5,5273,2718,2555,106.4
'39010, 제주시,'035005, 34세,2019,6238,3229,3009,107.3,5690,2894,2796,103.5
'39010, 제주시,'040,35~39세,2019,39036,19865,19171,103.6,36492,18461,18031,102.4
'39010, 제주시,'040001, 35세,2019,6639,3391,3248,104.4,6111,3078,3033,101.5
'39010, 제주시,'040002, 36세,2019,7372,3761,3611,104.2,6877,3491,3386,103.1
'39010, 제주시,'040003, 37세,2019,8400,4280,4120,103.9,7827,3960,3867,102.4
'39010, 제주시,'040004, 38세,2019,8263,4194,4069,103.1,7765,3923,3842,102.1
'39010, 제주시,'040005, 39세,2019,8362,4239,4123,102.8,7912,4009,3903,102.7
'39010, 제주시,'045,40~44세,2019,38216,19496,18720,104.1,36411,18607,17804,104.5
'39010, 제주시,'045001, 40세,2019,8236,4118,4118,100,7780,3895,3885,100.3
'39010, 제주시,'045002, 41세,2019,7159,3579,3580,100,6759,3384,3375,100.3
'39010, 제주시,'045003, 42세,2019,7645,3925,3720,105.5,7309,3758,3551,105.8
'39010, 제주시,'045004, 43세,2019,7387,3902,3485,112,7067,3740,3327,112.4
'39010, 제주시,'045005, 44세,2019,7789,3972,3817,104.1,7496,3830,3666,104.5
'39010, 제주시,'050,45~49세,2019,44823,22822,22001,103.7,43582,22141,21441,103.3
'39010, 제주시,'050001, 45세,2019,8726,4492,4234,106.1,8452,4353,4099,106.2
'39010, 제주시,'050002, 46세,2019,8815,4440,4375,101.5,8552,4298,4254,101
'39010, 제주시,'050003, 47세,2019,8986,4562,4424,103.1,8755,4428,4327,102.3
'39010, 제주시,'050004, 48세,2019,9423,4829,4594,105.1,9176,4685,4491,104.3
'39010, 제주시,'050005, 49세,2019,8873,4499,4374,102.9,8647,4377,4270,102.5
'39010, 제주시,'055,50~54세,2019,40413,20986,19427,108,39633,20555,19078,107.7
'39010, 제주시,'055001, 50세,2019,8684,4496,4188,107.4,8498,4379,4119,106.3
'39010, 제주시,'055002, 51세,2019,8509,4393,4116,106.7,8344,4303,4041,106.5
'39010, 제주시,'055003, 52세,2019,7831,4052,3779,107.2,7668,3964,3704,107
'39010, 제주시,'055004, 53세,2019,7951,4182,3769,111,7819,4117,3702,111.2
'39010, 제주시,'055005, 54세,2019,7438,3863,3575,108.1,7304,3792,3512,108
'39010, 제주시,'060,55~59세,2019,36965,18803,18162,103.5,36332,18491,17841,103.6
'39010, 제주시,'060001, 55세,2019,7237,3719,3518,105.7,7093,3655,3438,106.3
'39010, 제주시,'060002, 56세,2019,7854,4048,3806,106.4,7693,3969,3724,106.6
'39010, 제주시,'060003, 57세,2019,7235,3651,3584,101.9,7106,3586,3520,101.9
'39010, 제주시,'060004, 58세,2019,7286,3678,3608,101.9,7195,3631,3564,101.9
'39010, 제주시,'060005, 59세,2019,7353,3707,3646,101.7,7245,3650,3595,101.5
'39010, 제주시,'065,60~64세,2019,30467,15246,15221,100.2,30005,15036,14969,100.4
'39010, 제주시,'065001, 60세,2019,6729,3373,3356,100.5,6638,3328,3310,100.5
'39010, 제주시,'065002, 61세,2019,6227,3140,3087,101.7,6129,3097,3032,102.1
'39010, 제주시,'065003, 62세,2019,6114,3084,3030,101.8,6032,3048,2984,102.1
'39010, 제주시,'065004, 63세,2019,5574,2762,2812,98.2,5467,2713,2754,98.5
'39010, 제주시,'065005, 64세,2019,5823,2887,2936,98.3,5739,2850,2889,98.7
'39010, 제주시,'070,65~69세,2019,19206,9288,9918,93.6,18941,9164,9777,93.7
'39010, 제주시,'070001, 65세,2019,4518,2234,2284,97.8,4438,2197,2241,98
'39010, 제주시,'070002, 66세,2019,3828,1839,1989,92.5,3775,1810,1965,92.1
'39010, 제주시,'070003, 67세,2019,4025,1966,2059,95.5,3984,1949,2035,95.8
'39010, 제주시,'070004, 68세,2019,3452,1665,1787,93.2,3392,1643,1749,93.9
'39010, 제주시,'070005, 69세,2019,3383,1584,1799,88,3352,1565,1787,87.6
'39010, 제주시,'075,70~74세,2019,15969,7488,8481,88.3,15846,7428,8418,88.2
'39010, 제주시,'075001, 70세,2019,3327,1565,1762,88.8,3295,1554,1741,89.3
'39010, 제주시,'075002, 71세,2019,3531,1700,1831,92.8,3506,1687,1819,92.7
'39010, 제주시,'075003, 72세,2019,3421,1581,1840,85.9,3387,1562,1825,85.6
'39010, 제주시,'075004, 73세,2019,3014,1386,1628,85.1,2997,1378,1619,85.1
'39010, 제주시,'075005, 74세,2019,2676,1256,1420,88.5,2661,1247,1414,88.2
'39010, 제주시,'080,75~79세,2019,12852,5488,7364,74.5,12796,5461,7335,74.5
'39010, 제주시,'080001, 75세,2019,2797,1264,1533,82.5,2782,1256,1526,82.3
'39010, 제주시,'080002, 76세,2019,2608,1126,1482,76,2589,1113,1476,75.4
'39010, 제주시,'080003, 77세,2019,2659,1147,1512,75.9,2650,1146,1504,76.2
'39010, 제주시,'080004, 78세,2019,2549,1074,1475,72.8,2539,1069,1470,72.7
'39010, 제주시,'080005, 79세,2019,2239,877,1362,64.4,2236,877,1359,64.5
'39010, 제주시,'085,80~84세,2019,9333,3368,5965,56.5,9301,3351,5950,56.3
'39010, 제주시,'085001, 80세,2019,2227,843,1384,60.9,2217,837,1380,60.7
'39010, 제주시,'085002, 81세,2019,2054,788,1266,62.2,2049,787,1262,62.4
'39010, 제주시,'085003, 82세,2019,1839,657,1182,55.6,1833,654,1179,55.5
'39010, 제주시,'085004, 83세,2019,1676,558,1118,49.9,1670,555,1115,49.8
'39010, 제주시,'085005, 84세,2019,1537,522,1015,51.4,1532,518,1014,51.1
'39010, 제주시,'086,85세이상,2019,7810,1678,6132,27.4,7793,1670,6123,27.3
'39010, 제주시,'090,85~89세,2019,5363,1355,4008,33.8,5350,1348,4002,33.7
'39010, 제주시,'090001, 85세,2019,1452,438,1014,43.2,1451,437,1014,43.1
'39010, 제주시,'090002, 86세,2019,1327,338,989,34.2,1323,336,987,34
'39010, 제주시,'090003, 87세,2019,1001,237,764,31,997,236,761,31
'39010, 제주시,'090004, 88세,2019,805,198,607,32.6,803,197,606,32.5
'39010, 제주시,'090005, 89세,2019,778,144,634,22.7,776,142,634,22.4
'39010, 제주시,'095,90~94세,2019,1688,254,1434,17.7,1685,253,1432,17.7
'39010, 제주시,'095001, 90세,2019,601,109,492,22.2,600,108,492,22
'39010, 제주시,'095002, 91세,2019,403,55,348,15.8,403,55,348,15.8
'39010, 제주시,'095003, 92세,2019,317,48,269,17.8,316,48,268,17.9
'39010, 제주시,'095004, 93세,2019,207,26,181,14.4,207,26,181,14.4
'39010, 제주시,'095005, 94세,2019,160,16,144,11.1,159,16,143,11.2
'39010, 제주시,'100,95~99세,2019,684,64,620,10.3,684,64,620,10.3
'39010, 제주시,'100001, 95세,2019,109,17,92,18.5,109,17,92,18.5
'39010, 제주시,'100002, 96세,2019,274,21,253,8.3,274,21,253,8.3
'39010, 제주시,'100003, 97세,2019,156,13,143,9.1,156,13,143,9.1
'39010, 제주시,'100004, 98세,2019,89,6,83,7.2,89,6,83,7.2
'39010, 제주시,'100005, 99세,2019,56,7,49,14.3,56,7,49,14.3
'39010, 제주시,'101,100세이상,2019,75,5,70,7.1,74,5,69,7.2
'39010, 제주시,'102,15세미만,2019,72968,37766,35202,107.3,72287,37401,34886,107.2
'39010, 제주시,'103,15~64세,2019,349550,181085,168465,107.5,331670,170751,160919,106.1
'39010, 제주시,'104,65세이상,2019,65170,27310,37860,72.1,64677,27074,37603,72
'39010, 제주시,'126,평균연령,2019,40.7,39.5,42,,41,39.7,42.2,
'39010, 제주시,'127,중위연령,2019,41.6,40.4,42.8,,42.2,41.1,43.4,
'39020, 서귀포시,'000,합계,2019,177360,90437,86923,104,168397,84876,83521,101.6
'39020, 서귀포시,'005,0~4세,2019,6880,3502,3378,103.7,6465,3314,3151,105.2
'39020, 서귀포시,'005001, 0세,2019,1053,557,496,112.3,1020,540,480,112.5
'39020, 서귀포시,'005002, 1세,2019,1202,592,610,97,1123,564,559,100.9
'39020, 서귀포시,'005003, 2세,2019,1422,718,704,102,1302,670,632,106
'39020, 서귀포시,'005004, 3세,2019,1569,812,757,107.3,1471,756,715,105.7
'39020, 서귀포시,'005005, 4세,2019,1634,823,811,101.5,1549,784,765,102.5
'39020, 서귀포시,'010,5~9세,2019,8553,4410,4143,106.4,8324,4294,4030,106.6
'39020, 서귀포시,'010001, 5세,2019,1543,790,753,104.9,1483,755,728,103.7
'39020, 서귀포시,'010002, 6세,2019,1613,799,814,98.2,1568,774,794,97.5
'39020, 서귀포시,'010003, 7세,2019,1798,938,860,109.1,1756,921,835,110.3
'39020, 서귀포시,'010004, 8세,2019,1842,975,867,112.5,1799,954,845,112.9
'39020, 서귀포시,'010005, 9세,2019,1757,908,849,106.9,1718,890,828,107.5
'39020, 서귀포시,'015,10~14세,2019,8414,4348,4066,106.9,8258,4283,3975,107.7
'39020, 서귀포시,'015001, 10세,2019,1676,840,836,100.5,1634,824,810,101.7
'39020, 서귀포시,'015002, 11세,2019,1837,945,892,105.9,1803,934,869,107.5
'39020, 서귀포시,'015003, 12세,2019,1779,907,872,104,1758,896,862,103.9
'39020, 서귀포시,'015004, 13세,2019,1592,853,739,115.4,1563,838,725,115.6
'39020, 서귀포시,'015005, 14세,2019,1530,803,727,110.5,1500,791,709,111.6
'39020, 서귀포시,'020,15~19세,2019,7952,4205,3747,112.2,7820,4141,3679,112.6
'39020, 서귀포시,'020001, 15세,2019,1626,872,754,115.6,1611,869,742,117.1
'39020, 서귀포시,'020002, 16세,2019,1567,839,728,115.2,1541,823,718,114.6
'39020, 서귀포시,'020003, 17세,2019,1667,871,796,109.4,1649,860,789,109
'39020, 서귀포시,'020004, 18세,2019,1695,912,783,116.5,1670,902,768,117.4
'39020, 서귀포시,'020005, 19세,2019,1397,711,686,103.6,1349,687,662,103.8
'39020, 서귀포시,'025,20~24세,2019,8664,4908,3756,130.7,7746,4277,3469,123.3
'39020, 서귀포시,'025001, 20세,2019,1501,906,595,152.3,1436,868,568,152.8
'39020, 서귀포시,'025002, 21세,2019,1618,952,666,142.9,1480,871,609,143
'39020, 서귀포시,'025003, 22세,2019,1717,949,768,123.6,1539,835,704,118.6
'39020, 서귀포시,'025004, 23세,2019,1830,1050,780,134.6,1563,858,705,121.7
'39020, 서귀포시,'025005, 24세,2019,1998,1051,947,111,1728,845,883,95.7
'39020, 서귀포시,'030,25~29세,2019,10334,5759,4575,125.9,8746,4569,4177,109.4
'39020, 서귀포시,'030001, 25세,2019,2057,1163,894,130.1,1761,932,829,112.4
'39020, 서귀포시,'030002, 26세,2019,2141,1194,947,126.1,1832,951,881,107.9
'39020, 서귀포시,'030003, 27세,2019,2112,1192,920,129.6,1797,948,849,111.7
'39020, 서귀포시,'030004, 28세,2019,2010,1102,908,121.4,1686,860,826,104.1
'39020, 서귀포시,'030005, 29세,2019,2014,1108,906,122.3,1670,878,792,110.9
'39020, 서귀포시,'035,30~34세,2019,9476,5085,4391,115.8,7835,4006,3829,104.6
'39020, 서귀포시,'035001, 30세,2019,1905,1032,873,118.2,1570,809,761,106.3
'39020, 서귀포시,'035002, 31세,2019,1791,1016,775,131.1,1424,773,651,118.7
'39020, 서귀포시,'035003, 32세,2019,1839,982,857,114.6,1514,767,747,102.7
'39020, 서귀포시,'035004, 33세,2019,1902,993,909,109.2,1595,797,798,99.9
'39020, 서귀포시,'035005, 34세,2019,2039,1062,977,108.7,1732,860,872,98.6
'39020, 서귀포시,'040,35~39세,2019,13035,6768,6267,108,11716,5946,5770,103.1
'39020, 서귀포시,'040001, 35세,2019,2186,1124,1062,105.8,1904,954,950,100.4
'39020, 서귀포시,'040002, 36세,2019,2461,1253,1208,103.7,2200,1087,1113,97.7
'39020, 서귀포시,'040003, 37세,2019,2793,1462,1331,109.8,2501,1279,1222,104.7
'39020, 서귀포시,'040004, 38세,2019,2804,1495,1309,114.2,2558,1336,1222,109.3
'39020, 서귀포시,'040005, 39세,2019,2791,1434,1357,105.7,2553,1290,1263,102.1
'39020, 서귀포시,'045,40~44세,2019,13348,7122,6226,114.4,12508,6634,5874,112.9
'39020, 서귀포시,'045001, 40세,2019,2809,1449,1360,106.5,2592,1314,1278,102.8
'39020, 서귀포시,'045002, 41세,2019,2466,1328,1138,116.7,2277,1215,1062,114.4
'39020, 서귀포시,'045003, 42세,2019,2630,1380,1250,110.4,2481,1294,1187,109
'39020, 서귀포시,'045004, 43세,2019,2715,1445,1270,113.8,2547,1355,1192,113.7
'39020, 서귀포시,'045005, 44세,2019,2728,1520,1208,125.8,2611,1456,1155,126.1
'39020, 서귀포시,'050,45~49세,2019,15827,8655,7172,120.7,15245,8315,6930,120
'39020, 서귀포시,'050001, 45세,2019,3131,1720,1411,121.9,2996,1648,1348,122.3
'39020, 서귀포시,'050002, 46세,2019,2951,1590,1361,116.8,2835,1523,1312,116.1
'39020, 서귀포시,'050003, 47세,2019,3157,1710,1447,118.2,3032,1633,1399,116.7
'39020, 서귀포시,'050004, 48세,2019,3417,1904,1513,125.8,3310,1834,1476,124.3
'39020, 서귀포시,'050005, 49세,2019,3171,1731,1440,120.2,3072,1677,1395,120.2
'39020, 서귀포시,'055,50~54세,2019,14803,7930,6873,115.4,14344,7674,6670,115.1
'39020, 서귀포시,'055001, 50세,2019,3043,1656,1387,119.4,2950,1603,1347,119
'39020, 서귀포시,'055002, 51세,2019,3175,1687,1488,113.4,3053,1616,1437,112.5
'39020, 서귀포시,'055003, 52세,2019,2814,1509,1305,115.6,2728,1459,1269,115
'39020, 서귀포시,'055004, 53세,2019,2940,1562,1378,113.4,2857,1524,1333,114.3
'39020, 서귀포시,'055005, 54세,2019,2831,1516,1315,115.3,2756,1472,1284,114.6
'39020, 서귀포시,'060,55~59세,2019,14756,7628,7128,107,14474,7493,6981,107.3
'39020, 서귀포시,'060001, 55세,2019,2774,1455,1319,110.3,2721,1437,1284,111.9
'39020, 서귀포시,'060002, 56세,2019,3049,1578,1471,107.3,2982,1545,1437,107.5
'39020, 서귀포시,'060003, 57세,2019,2874,1513,1361,111.2,2818,1483,1335,111.1
'39020, 서귀포시,'060004, 58세,2019,2971,1501,1470,102.1,2924,1480,1444,102.5
'39020, 서귀포시,'060005, 59세,2019,3088,1581,1507,104.9,3029,1548,1481,104.5
'39020, 서귀포시,'065,60~64세,2019,13018,6526,6492,100.5,12827,6445,6382,101
'39020, 서귀포시,'065001, 60세,2019,2805,1406,1399,100.5,2758,1387,1371,101.2
'39020, 서귀포시,'065002, 61세,2019,2617,1343,1274,105.4,2573,1325,1248,106.2
'39020, 서귀포시,'065003, 62세,2019,2597,1305,1292,101,2571,1294,1277,101.3
'39020, 서귀포시,'065004, 63세,2019,2539,1282,1257,102,2496,1263,1233,102.4
'39020, 서귀포시,'065005, 64세,2019,2460,1190,1270,93.7,2429,1176,1253,93.9
'39020, 서귀포시,'070,65~69세,2019,8943,4304,4639,92.8,8838,4251,4587,92.7
'39020, 서귀포시,'070001, 65세,2019,2084,1033,1051,98.3,2050,1015,1035,98.1
'39020, 서귀포시,'070002, 66세,2019,1731,808,923,87.5,1710,796,914,87.1
'39020, 서귀포시,'070003, 67세,2019,1870,906,964,94,1845,895,950,94.2
'39020, 서귀포시,'070004, 68세,2019,1619,805,814,98.9,1604,799,805,99.3
'39020, 서귀포시,'070005, 69세,2019,1639,752,887,84.8,1629,746,883,84.5
'39020, 서귀포시,'075,70~74세,2019,8086,3828,4258,89.9,8028,3799,4229,89.8
'39020, 서귀포시,'075001, 70세,2019,1727,812,915,88.7,1707,804,903,89
'39020, 서귀포시,'075002, 71세,2019,1780,867,913,95,1766,861,905,95.1
'39020, 서귀포시,'075003, 72세,2019,1714,830,884,93.9,1707,826,881,93.8
'39020, 서귀포시,'075004, 73세,2019,1436,666,770,86.5,1427,660,767,86
'39020, 서귀포시,'075005, 74세,2019,1429,653,776,84.1,1421,648,773,83.8
'39020, 서귀포시,'080,75~79세,2019,6720,2859,3861,74,6700,2849,3851,74
'39020, 서귀포시,'080001, 75세,2019,1319,590,729,80.9,1315,587,728,80.6
'39020, 서귀포시,'080002, 76세,2019,1277,562,715,78.6,1275,560,715,78.3
'39020, 서귀포시,'080003, 77세,2019,1526,655,871,75.2,1522,653,869,75.1
'39020, 서귀포시,'080004, 78세,2019,1392,570,822,69.3,1386,569,817,69.6
'39020, 서귀포시,'080005, 79세,2019,1206,482,724,66.6,1202,480,722,66.5
'39020, 서귀포시,'085,80~84세,2019,4854,1750,3104,56.4,4842,1745,3097,56.3
'39020, 서귀포시,'085001, 80세,2019,1151,461,690,66.8,1149,460,689,66.8
'39020, 서귀포시,'085002, 81세,2019,1058,390,668,58.4,1056,390,666,58.6
'39020, 서귀포시,'085003, 82세,2019,982,347,635,54.6,977,343,634,54.1
'39020, 서귀포시,'085004, 83세,2019,811,292,519,56.3,810,292,518,56.4
'39020, 서귀포시,'085005, 84세,2019,852,260,592,43.9,850,260,590,44.1
'39020, 서귀포시,'086,85세이상,2019,3697,850,2847,29.9,3681,841,2840,29.6
'39020, 서귀포시,'090,85~89세,2019,2649,702,1947,36.1,2639,697,1942,35.9
'39020, 서귀포시,'090001, 85세,2019,781,248,533,46.5,779,246,533,46.2
'39020, 서귀포시,'090002, 86세,2019,680,193,487,39.6,675,191,484,39.5
'39020, 서귀포시,'090003, 87세,2019,517,127,390,32.6,516,127,389,32.6
'39020, 서귀포시,'090004, 88세,2019,341,66,275,24,341,66,275,24
'39020, 서귀포시,'090005, 89세,2019,330,68,262,26,328,67,261,25.7
'39020, 서귀포시,'095,90~94세,2019,728,121,607,19.9,724,118,606,19.5
'39020, 서귀포시,'095001, 90세,2019,250,51,199,25.6,249,50,199,25.1
'39020, 서귀포시,'095002, 91세,2019,189,32,157,20.4,188,31,157,19.7
'39020, 서귀포시,'095003, 92세,2019,127,11,116,9.5,127,11,116,9.5
'39020, 서귀포시,'095004, 93세,2019,86,17,69,24.6,84,16,68,23.5
'39020, 서귀포시,'095005, 94세,2019,76,10,66,15.2,76,10,66,15.2
'39020, 서귀포시,'100,95~99세,2019,274,24,250,9.6,273,24,249,9.6
'39020, 서귀포시,'100001, 95세,2019,39,X,35,11.4,39,X,35,11.4
'39020, 서귀포시,'100002, 96세,2019,111,6,105,5.7,111,6,105,5.7
'39020, 서귀포시,'100003, 97세,2019,61,12,49,24.5,61,12,49,24.5
'39020, 서귀포시,'100004, 98세,2019,45,X,44,2.3,44,X,43,2.3
'39020, 서귀포시,'100005, 99세,2019,18,X,17,5.9,18,X,17,5.9
'39020, 서귀포시,'101,100세이상,2019,46,X,43,7,45,X,43,4.7
'39020, 서귀포시,'102,15세미만,2019,23847,12260,11587,105.8,23047,11891,11156,106.6
'39020, 서귀포시,'103,15~64세,2019,121213,64586,56627,114.1,113261,59500,53761,110.7
'39020, 서귀포시,'104,65세이상,2019,32300,13591,18709,72.6,32089,13485,18604,72.5
'39020, 서귀포시,'126,평균연령,2019,44,42.5,45.5,,44.5,43.1,46,
'39020, 서귀포시,'127,중위연령,2019,45.6,44.4,47.1,,46.6,45.6,47.8,
